user.id,age,Upper_character,Lower_character,Alphabets,Numeric,Punctuation,Printable,Vowel,Consonent,All_Characters,Stop words,Upper_ratio,Lower_ratio,Number_ratio,Vowel_ratio,Consonent_ratio,Punctuation_ratio
1,17.0,567,5212,5779,62,341,8565,2173,6392,8565,413,0.06619964973730298,0.6085230589608873,0.007238762405137186,0.25370694687682427,0.7462930531231757,0.03981319322825452
2,,118,2500,2618,16,102,3568,1010,2558,3568,271,0.033071748878923765,0.7006726457399103,0.004484304932735426,0.2830717488789238,0.7169282511210763,0.02858744394618834
3,16.0,324,5717,6041,25,605,8313,2298,6015,8313,563,0.03897509924215085,0.6877180319980754,0.003007337904486948,0.2764345001804403,0.7235654998195598,0.07277757728858414
4,17.0,87,1802,1889,16,85,2524,695,1829,2524,200,0.034469096671949286,0.713946117274168,0.006339144215530904,0.2753565768621236,0.7246434231378764,0.033676703645007924
5,47.0,1774,36249,38023,251,1267,49616,14422,35194,49616,3589,0.03575459529184134,0.7305909384069655,0.005058851983231216,0.29067236375362787,0.7093276362463722,0.02553611738148984
6,16.0,32943,433520,466463,7304,33040,632578,176887,455691,632578,39952,0.05207737227662043,0.6853226005330568,0.011546402182813819,0.2796287572441659,0.7203712427558341,0.052230713050406434
7,25.0,128,2676,2804,26,83,3616,1065,2551,3616,246,0.035398230088495575,0.7400442477876106,0.007190265486725664,0.29452433628318586,0.7054756637168141,0.02295353982300885
8,,2693,39078,41771,641,1651,55880,15657,40224,55881,3603,0.04819169306204255,0.699307456917378,0.011470804029992305,0.28018467815536585,0.7198153218446341,0.029544925824519962
9,,23164,498603,521767,1484,28679,688866,199249,489617,688866,52475,0.03362627855054539,0.7238025973121043,0.0021542651255832047,0.28924202965453366,0.7107579703454663,0.04163218971469052
10,,700,16329,17029,70,1205,22991,6360,16631,22991,1827,0.030446696533426125,0.7102344395633073,0.0030446696533426125,0.27662998564655733,0.7233700143534426,0.05241181331825497
11,,126,4080,4206,8,174,5503,1651,3852,5503,411,0.022896601853534437,0.7414137743049246,0.001453752498637107,0.300018171906233,0.6999818280937671,0.03161911684535708
12,23.0,555,7267,7822,33,636,10714,3006,7708,10714,769,0.051801381370169874,0.6782714205712153,0.003080082135523614,0.28056748179951463,0.7194325182004854,0.059361582975546015
13,,529,4684,5213,18,257,6960,2010,4950,6960,557,0.07600574712643678,0.6729885057471264,0.002586206896551724,0.28879310344827586,0.7112068965517241,0.03692528735632184
14,37.0,4391,116673,121064,1261,5395,160785,46119,114666,160785,12466,0.02730976148272538,0.7256460490717418,0.007842771402804987,0.2868364586248717,0.7131635413751283,0.03355412507385639
15,17.0,1054,31738,32792,288,1409,43870,12458,31412,43870,3642,0.024025529974925918,0.7234556644631867,0.006564850695235924,0.28397538180989285,0.7160246181901071,0.03211762024162298
16,15.0,76,28608,28684,180,1738,39225,11232,27993,39225,2556,0.0019375398342893562,0.7293307839388146,0.004588910133843212,0.28634799235181646,0.7136520076481836,0.044308476736775015
17,23.0,182,2746,2928,5,112,4080,1120,2960,4080,223,0.0446078431372549,0.6730392156862746,0.0012254901960784314,0.27450980392156865,0.7254901960784313,0.027450980392156862
18,16.0,1550,30687,32237,50,859,43123,12024,31099,43123,2763,0.03594369593952183,0.7116156111587784,0.0011594740625652203,0.2788303225656842,0.7211696774343158,0.019919764394870487
19,17.0,1531,3068,4599,33,320,7210,1750,5460,7210,181,0.21234396671289876,0.42552011095700415,0.004576976421636616,0.24271844660194175,0.7572815533980582,0.044382801664355064
20,,3238,105597,108835,372,7147,148217,41803,106414,148217,11143,0.02184634691027345,0.7124486394947948,0.0025098335548553808,0.28203917229467607,0.717960827705324,0.04821983982943927
21,24.0,123,2243,2366,8,276,3388,891,2497,3388,172,0.03630460448642267,0.6620425029515938,0.0023612750885478157,0.262987012987013,0.737012987012987,0.08146399055489964
22,27.0,19410,489393,508803,1484,23283,668244,193281,474963,668244,50806,0.029046276509777865,0.7323567439438289,0.0022207457156368034,0.2892371648679225,0.7107628351320775,0.03484206367733941
23,23.0,275,9995,10270,3,835,13580,3574,10006,13580,836,0.02025036818851252,0.7360088365243005,0.00022091310751104566,0.26318114874815907,0.736818851251841,0.06148748159057437
24,34.0,365,12766,13131,6,429,16656,5195,11461,16656,1204,0.02191402497598463,0.7664505283381364,0.00036023054755043225,0.3118996157540826,0.6881003842459174,0.02575648414985591
25,43.0,60,1628,1688,1,62,2349,643,1706,2349,170,0.02554278416347382,0.6930608769689229,0.0004257130693912303,0.2737335036185611,0.7262664963814389,0.02639421030225628
26,,5757,159988,165745,392,5310,218238,63164,155074,218238,17433,0.02637945728974789,0.7330895627709199,0.001796204144099561,0.28942713917832824,0.7105728608216717,0.024331234707062933
27,,83,1597,1680,3,75,2276,623,1653,2276,157,0.03646748681898067,0.7016695957820738,0.0013181019332161687,0.27372583479789103,0.726274165202109,0.032952548330404216
28,26.0,48,3860,3908,13,271,5127,1351,3776,5127,309,0.009362200117027502,0.7528769260776282,0.0025355958650282815,0.26350692412716986,0.7364930758728301,0.0528574214940511
29,,210,4647,4857,50,315,6507,1858,4649,6507,430,0.03227293683725219,0.7141539880129092,0.007684032580298141,0.2855386506838789,0.7144613493161212,0.048409405255878286
30,24.0,484,32111,32595,150,1592,43325,12341,30984,43325,3798,0.01117137911136757,0.7411656087709175,0.003462204270051933,0.28484708597807273,0.7151529140219273,0.03674552798615118
31,,82,2111,2193,6,53,2864,839,2025,2864,219,0.02863128491620112,0.7370810055865922,0.002094972067039106,0.29294692737430167,0.7070530726256983,0.018505586592178772
32,17.0,821,16725,17546,112,1110,24185,6759,17426,24185,1942,0.03394666115360761,0.691544345668803,0.004630969609261939,0.27947074633037006,0.7205292536696299,0.045896216663221
33,,42,6745,6787,12,271,8812,2648,6164,8812,428,0.004766227871084884,0.7654334997730368,0.0013617793917385383,0.30049931911030414,0.6995006808896959,0.030753517930095325
34,24.0,165,3128,3293,34,140,4625,1224,3401,4625,323,0.03567567567567568,0.6763243243243243,0.0073513513513513516,0.2646486486486486,0.7353513513513513,0.03027027027027027
35,,338,8156,8494,35,360,11069,3250,7819,11069,781,0.030535730418285303,0.7368325955370856,0.0031619839190532117,0.2936127924835125,0.7063872075164875,0.03252326316740446
36,,280,8450,8730,8,360,11365,3363,8002,11365,941,0.024637043554773426,0.7435107787065552,0.0007039155301363836,0.2959084909810823,0.7040915090189177,0.03167619885613726
37,25.0,5418,125590,131008,522,6661,175876,50282,125595,175877,14000,0.030805619836590345,0.7140785890139131,0.0029679833065153487,0.2858929820272122,0.7141070179727877,0.03787305901283283
38,,62,2244,2306,20,144,3365,880,2485,3365,206,0.018424962852897474,0.6668647845468053,0.005943536404160475,0.26151560178306094,0.7384843982169391,0.042793462109955424
39,23.0,479,13508,13987,91,672,18593,5224,13369,18593,1268,0.02576238369278761,0.7265099768730168,0.0048943150648093365,0.28096595492927445,0.7190340450707255,0.03614263432474587
40,13.0,29,3325,3354,2,165,4495,1274,3221,4495,395,0.0064516129032258064,0.7397107897664071,0.0004449388209121246,0.28342602892102337,0.7165739710789767,0.03670745272525028
41,17.0,51,1646,1697,0,75,2267,644,1623,2267,148,0.022496691662990738,0.7260696956329952,0.0,0.28407587119541244,0.7159241288045876,0.033083370092633436
42,17.0,1041,17840,18881,170,772,24570,7174,17396,24570,1721,0.04236874236874237,0.7260887260887261,0.006919006919006919,0.29198209198209196,0.708017908017908,0.03142043142043142
43,38.0,1499,36579,38078,436,2043,52267,14152,38115,52267,4014,0.028679664032754893,0.699848853004764,0.008341783534543784,0.27076357931390743,0.7292364206860925,0.03908776091989209
44,13.0,180,6259,6439,33,553,8798,2233,6565,8798,761,0.020459195271652648,0.711411684473744,0.0037508524664696522,0.25380768356444644,0.7461923164355535,0.06285519436235508
45,15.0,234,3267,3501,29,197,4732,1300,3432,4732,312,0.04945054945054945,0.6904057480980558,0.0061284868977176665,0.27472527472527475,0.7252747252747253,0.041631445477599324
46,27.0,327,7112,7439,61,293,9816,2735,7082,9817,689,0.03330956504023633,0.7244575735968218,0.006213710909646532,0.278598349801365,0.721401650198635,0.02984618518895793
47,13.0,94,1897,1991,3,148,2781,775,2006,2781,240,0.03380079108234448,0.68212873067242,0.0010787486515641855,0.2786767349874146,0.7213232650125854,0.05321826681049982
48,,649,22728,23377,56,1077,30840,8829,22011,30840,2450,0.021044098573281454,0.7369649805447471,0.0018158236057068742,0.286284046692607,0.713715953307393,0.03492217898832685
49,,145,9703,9848,49,1176,13881,3736,10145,13881,1227,0.010445933290108782,0.6990130394063828,0.0035300050428643467,0.2691448742885959,0.7308551257114041,0.08472012102874432
50,24.0,41,1804,1845,1,74,2449,692,1757,2449,215,0.016741527153940384,0.7366271947733769,0.0004083299305839118,0.28256431196406695,0.717435688035933,0.030216414863209473
51,14.0,8,3324,3332,12,476,4979,1284,3695,4979,332,0.0016067483430407712,0.6676039365334404,0.002410122514561157,0.2578831090580438,0.7421168909419562,0.09560152641092588
52,41.0,3807,100452,104259,301,4579,136437,39816,96621,136437,9777,0.027902988192352516,0.7362518964796939,0.002206146426555846,0.29182699707557336,0.7081730029244266,0.033561277366110365
53,,2513,60267,62780,327,3602,84727,23426,61301,84727,6314,0.029659966716631063,0.7113080836097112,0.0038594544832225857,0.2764880144463984,0.7235119855536015,0.04251301238094114
54,,540,3580,4120,33,260,5680,1532,4148,5680,356,0.09507042253521127,0.6302816901408451,0.0058098591549295775,0.2697183098591549,0.7302816901408451,0.045774647887323945
55,13.0,108,1907,2015,45,224,2960,734,2226,2960,201,0.03648648648648649,0.6442567567567568,0.015202702702702704,0.24797297297297297,0.7520270270270271,0.07567567567567568
56,16.0,75,9733,9808,35,1057,13326,3686,9640,13326,914,0.005628095452498875,0.730376707188954,0.0026264445444994745,0.27660213117214466,0.7233978688278553,0.07931862524388414
57,23.0,1175,29798,30973,260,1864,41790,11827,29963,41790,2837,0.028116774347930126,0.713041397463508,0.006221584111031347,0.2830102895429529,0.7169897104570472,0.0446039722421632
58,33.0,445,10309,10754,33,549,14380,4147,10233,14380,1156,0.030945757997218357,0.7168984700973574,0.0022948539638386646,0.28838664812239223,0.7116133518776078,0.03817802503477052
59,,77,1495,1572,6,91,2107,606,1501,2107,148,0.036544850498338874,0.7095396298054105,0.0028476506881822496,0.2876127195064072,0.7123872804935928,0.04318936877076412
60,16.0,50,2194,2244,15,58,2946,841,2105,2946,257,0.01697216564833673,0.7447386286490156,0.0050916496945010185,0.28547182620502376,0.7145281737949762,0.019687712152070606
61,17.0,1591,39620,41211,264,1472,54735,15625,39110,54735,4387,0.02906732438110898,0.7238512834566548,0.004823239243628392,0.2854663378094455,0.7145336621905545,0.026893212752352243
62,23.0,5324,108296,113620,442,6550,153483,43471,110012,153483,10807,0.034687880742492655,0.7055895441188926,0.0028797977626186613,0.2832300645674114,0.7167699354325886,0.04267573607500505
63,17.0,303,4927,5230,13,617,7478,1964,5514,7478,478,0.04051885530890612,0.658866006953731,0.0017384327360256753,0.26263706873495585,0.7373629312650442,0.08250869216368013
64,16.0,674,12891,13565,77,737,18619,4992,13627,18619,1340,0.03619958107309738,0.6923572694559321,0.004135560449003706,0.26811321768086366,0.7318867823191364,0.03958322144046404
65,42.0,438,8105,8543,71,443,11161,3151,8010,11161,722,0.03924379535883881,0.7261894095511154,0.006361437147209032,0.2823223725472628,0.7176776274527372,0.039691783890332406
66,,922,20732,21654,91,898,27785,8186,19599,27785,1694,0.033183372323195966,0.7461579989202807,0.003275148461400036,0.29461939895627137,0.7053806010437287,0.03231959690480475
67,34.0,200,4404,4604,377,409,6863,1757,5106,6863,414,0.029141774734081305,0.6417018796444703,0.05493224537374326,0.2560104910389043,0.7439895089610957,0.05959492933119627
68,,857,24425,25282,62,1196,34133,9413,24720,34133,2675,0.0251076670670612,0.7155831599917968,0.0018164239885155129,0.27577417748220195,0.724225822517798,0.03503940468168634
69,17.0,1979,33676,35655,115,1563,47948,13860,34088,47948,3996,0.041273880036706435,0.7023442062234087,0.00239843163427046,0.2890631517477267,0.7109368482522733,0.032597814298823725
70,17.0,85,7455,7540,71,1436,11233,2605,8628,11233,465,0.00756699011840114,0.6636695450903588,0.006320662334193893,0.23190599127570552,0.7680940087242945,0.12783762129440043
71,25.0,203,3063,3266,48,265,4589,1224,3365,4589,233,0.04423621704074962,0.6674656787971236,0.010459795162344738,0.26672477663979083,0.7332752233602092,0.05774678579211157
72,,370,13134,13504,32,908,18152,5161,12991,18152,1480,0.020383428823270162,0.7235566328779198,0.0017628911414720142,0.28432128691053327,0.7156787130894667,0.0500220361392684
73,25.0,2107,40076,42183,117,2716,59406,16332,43074,59406,4343,0.035467797865535465,0.6746119920546746,0.0019694980305019695,0.27492172507827495,0.725078274921725,0.04571928761404572
74,26.0,724,12895,13619,162,926,20645,5133,15512,20645,1213,0.03506902397674982,0.62460644223783,0.007846936304189877,0.24863162993460886,0.7513683700653911,0.0448534754177767
75,14.0,452,9001,9453,7,420,12483,3568,8915,12483,876,0.03620924457261876,0.7210606424737643,0.0005607626371865737,0.28582872706881357,0.7141712729311864,0.03364575823119442
76,,334,9856,10190,26,563,13531,3900,9631,13531,1015,0.024684058827876727,0.7284014485256078,0.0019215135614514818,0.2882270342177223,0.7117729657822778,0.041608159042199395
77,15.0,497,7238,7735,16,552,10702,3071,7631,10702,741,0.04643991777237899,0.6763221827695758,0.0014950476546439918,0.28695570921323116,0.7130442907867688,0.051579144085217715
78,25.0,271,9063,9334,38,463,12437,3717,8720,12437,752,0.0217898206963094,0.7287127120688269,0.003055399212028624,0.29886628608185256,0.7011337139181475,0.037227627241296135
79,24.0,856,27768,28624,126,1261,37412,11018,26394,37412,2929,0.02288035924302363,0.7422217470330376,0.003367903346519833,0.2945044370790121,0.7054955629209879,0.03370576285683738
80,13.0,1181,12479,13660,282,1225,19394,5366,14028,19394,1017,0.06089512220274312,0.6434464267299165,0.014540579560688873,0.2766835103640301,0.7233164896359698,0.06316386511292152
81,26.0,675,15779,16454,28,854,22564,6308,16256,22564,1573,0.029914908704130473,0.699299769544407,0.0012409147314305974,0.27956036163800746,0.7204396383619925,0.03784789930863322
82,24.0,1098,22624,23722,159,1050,31512,9004,22508,31512,2129,0.034843869002284845,0.717948717948718,0.005045696877380046,0.28573241939578575,0.7142675806042142,0.03332063975628332
83,,91,3211,3302,2,115,4222,1251,2971,4222,318,0.021553765987683562,0.7605400284225485,0.0004737091425864519,0.2963050686878257,0.7036949313121743,0.027238275698720987
84,27.0,673,15835,16508,253,838,22030,6242,15788,22030,1490,0.030549251021334545,0.7187925556059919,0.011484339536995007,0.28334089877439855,0.7166591012256015,0.0380390376758965
85,35.0,591,12869,13460,6,389,17568,5224,12344,17568,1240,0.033640710382513664,0.7325250455373407,0.00034153005464480874,0.29735883424408016,0.7026411657559198,0.022142531876138433
86,14.0,40,2879,2919,16,502,4120,1106,3014,4120,214,0.009708737864077669,0.6987864077669903,0.003883495145631068,0.2684466019417476,0.7315533980582525,0.12184466019417475
87,15.0,161,5476,5637,0,146,7261,2180,5081,7261,715,0.02217325437267594,0.7541660928246798,0.0,0.30023412753064316,0.6997658724693568,0.020107423219942158
88,43.0,55,2077,2132,24,81,2899,812,2087,2899,218,0.018972059330803724,0.7164539496378062,0.008278716798896172,0.28009658502932044,0.7199034149706796,0.027940669196274578
89,,168,4576,4744,28,190,6269,1776,4493,6269,469,0.026798532461317595,0.7299409794225554,0.004466422076886266,0.28329877173392887,0.7167012282660712,0.030307864093156802
90,,661,16574,17235,19,1080,23091,6459,16632,23091,1656,0.028625871551686805,0.7177688276817807,0.0008228314061755663,0.27971937118357804,0.720280628816422,0.046771469403663765
91,,34,2977,3011,32,473,4441,1162,3279,4441,199,0.007655933348344968,0.6703445170006755,0.007205584327854087,0.26165278090520155,0.7383472190947985,0.10650754334609322
92,27.0,1158,34934,36092,35,1624,47129,13666,33463,47129,3688,0.024570858706953257,0.7412421226845467,0.0007426425343206943,0.28997008211504594,0.7100299178849541,0.03445861359248022
93,16.0,2604,11434,14038,74,1671,20143,5336,14807,20143,710,0.12927567889589436,0.5676413642456436,0.0036737328104056,0.2649059226530308,0.7350940773469692,0.08295685846199673
94,,2612,51475,54087,353,2140,72423,20460,51964,72424,5423,0.03606539268750691,0.7107450568872197,0.004874074892300895,0.2825030376670717,0.7174969623329283,0.029548216060974263
95,,1192,23589,24781,748,1953,34819,9273,25546,34819,1964,0.03423418248657342,0.6774749418420977,0.021482523909359834,0.2663201125822109,0.7336798874177891,0.05609006576868951
96,,324,4704,5028,46,452,7029,1913,5116,7029,382,0.046094750320102434,0.6692274861288946,0.006544316403471333,0.2721582017356665,0.7278417982643335,0.06430502205150092
97,37.0,6308,123104,129412,905,4630,172201,49712,122489,172201,13236,0.03663161073396786,0.7148855116985383,0.005255486321217646,0.2886858961330074,0.7113141038669927,0.026887184162693596
98,24.0,800,21351,22151,45,1673,30358,8431,21927,30358,1768,0.026352197114434418,0.7033072007378616,0.0014823110876869359,0.2777192173397457,0.7222807826602543,0.055109032215560974
99,13.0,166,2205,2371,39,472,3706,895,2811,3706,143,0.04479222881813276,0.5949811117107393,0.010523475445223961,0.24150026983270373,0.7584997301672963,0.1273610361575823
100,26.0,1764,39467,41231,163,1839,54129,15677,38452,54129,4219,0.03258881560716067,0.729128563247058,0.003011324798167341,0.2896229377967448,0.7103770622032551,0.03397439450202294
101,,1133,63823,64956,322,5310,88839,24636,64203,88839,6358,0.0127534078501559,0.7184119587118271,0.0036245342698589585,0.2773106405970351,0.7226893594029649,0.05977104649984804
102,23.0,172,4193,4365,4,257,5783,1681,4102,5783,392,0.029742348262147673,0.7250561992045651,0.0006916825177243646,0.2906795780736642,0.7093204219263358,0.04444060176379042
103,34.0,117,4674,4791,2,132,6140,1837,4303,6140,553,0.019055374592833876,0.7612377850162867,0.0003257328990228013,0.299185667752443,0.700814332247557,0.021498371335504887
104,25.0,76,1903,1979,8,125,2752,752,2000,2752,223,0.027616279069767442,0.6914970930232558,0.0029069767441860465,0.27325581395348836,0.7267441860465116,0.045421511627906974
105,,220,4480,4700,19,590,6630,1736,4894,6630,405,0.033182503770739065,0.6757164404223228,0.002865761689291101,0.2618401206636501,0.73815987933635,0.0889894419306184
106,25.0,630,3473,4103,95,513,6130,1500,4630,6130,207,0.10277324632952692,0.566557911908646,0.015497553017944535,0.24469820554649266,0.7553017944535073,0.08368678629690049
107,40.0,89,2578,2667,3,97,3589,1018,2571,3589,309,0.024797993870158817,0.7183059348007802,0.0008358874338255781,0.2836444692114795,0.7163555307885204,0.02702702702702703
108,,439,8374,8813,46,535,12214,3379,8835,12214,965,0.03594236122482397,0.6856066808580318,0.0037661699688881613,0.2766497461928934,0.7233502538071066,0.043802194203373175
109,23.0,2159,47465,49624,138,2469,67040,18991,48049,67040,5230,0.0322046539379475,0.7080101431980907,0.002058472553699284,0.28327863961813843,0.7167213603818616,0.03682875894988067
110,23.0,4,2676,2680,21,111,3493,1012,2481,3493,275,0.001145147437732608,0.7661036358431148,0.006012024048096192,0.28972230174634983,0.7102776982536502,0.03177784139707988
111,39.0,298,11741,12039,22,616,15411,4516,10895,15411,1090,0.01933683732398936,0.7618584128220103,0.0014275517487508922,0.2930374407890468,0.7069625592109532,0.03997144896502498
112,16.0,275,4934,5209,8,1147,8007,1979,6028,8007,537,0.03434494817035094,0.6162108155364057,0.0009991257649556637,0.24715873610590733,0.7528412638940927,0.1432496565505183
113,16.0,214,21026,21240,150,1804,29207,8080,21127,29207,2456,0.007327010648132297,0.7198959153627555,0.005135755127195535,0.2766460095182662,0.7233539904817339,0.06176601499640497
114,17.0,868,30710,31578,57,1241,40049,11764,28285,40049,1940,0.021673450023720942,0.7668106569452421,0.0014232565107743015,0.29374016829384003,0.7062598317061599,0.030987040874928214
115,,561,7218,7779,41,346,10426,2950,7476,10426,659,0.05380778822175331,0.6923076923076923,0.003932476501055055,0.28294647995396127,0.7170535200460387,0.03318626510646461
116,16.0,84,1874,1958,2,116,2724,733,1991,2724,205,0.030837004405286344,0.6879588839941263,0.0007342143906020558,0.26908957415565343,0.7309104258443465,0.042584434654919234
117,16.0,7173,75838,83011,1280,6567,114802,31053,83860,114913,7216,0.062421135989835785,0.6599601437609321,0.011138861573538243,0.2702305222211586,0.7297694777788414,0.057147581213613775
118,26.0,532,14220,14752,25,496,19713,5608,14105,19713,1720,0.02698726728554761,0.7213513924821184,0.0012681986506366358,0.28448232131081014,0.7155176786891899,0.025161061228630852
119,,900,20462,21362,66,1451,29191,8082,21109,29191,2193,0.030831420643348977,0.700969476893563,0.002260970847178925,0.2768661573772738,0.7231338426227262,0.049707101503888185
120,,8,3632,3640,0,213,4947,1412,3535,4947,487,0.0016171417020416413,0.7341823327269051,0.0,0.2854255104103497,0.7145744895896503,0.0430563978168587
121,17.0,3112,88074,91186,164,4966,121079,34760,86319,121079,9313,0.025702227471320376,0.7274093773486732,0.0013544875659693258,0.28708529142130346,0.7129147085786965,0.041014544223193124
122,17.0,3077,66161,69238,171,4591,94179,26277,67902,94179,6808,0.03267182705273999,0.7025026810647809,0.001815691396171121,0.27901124454496223,0.7209887554550377,0.048747597659775536
123,,862,22038,22900,132,1011,30003,8622,21381,30003,2437,0.028730460287304603,0.7345265473452655,0.004399560043995601,0.2873712628737126,0.7126287371262874,0.0336966303369663
124,,121,2191,2312,1,128,3156,899,2257,3156,195,0.03833967046894803,0.694233206590621,0.0003168567807351077,0.28485424588086183,0.7151457541191382,0.04055766793409379
125,47.0,6126,171711,177837,588,8187,234751,67643,167108,234751,18870,0.026095735481425,0.7314601428747908,0.0025047816622719393,0.28814786731472924,0.7118521326852708,0.03487525079765368
126,,332,4827,5159,71,275,6705,1911,4794,6705,379,0.04951528709917972,0.719910514541387,0.010589112602535422,0.28501118568232664,0.7149888143176734,0.041014168530947054
127,25.0,1187,27566,28754,133,1233,36983,10839,26148,36987,2172,0.03209235677400168,0.7452888852840187,0.003595858004163625,0.2930489090761619,0.7069510909238381,0.03333603698596804
128,23.0,3875,75162,79037,434,5431,108500,30503,77997,108500,7506,0.03571428571428571,0.6927373271889401,0.004,0.2811336405529954,0.7188663594470046,0.050055299539170504
129,26.0,5356,120623,125979,664,5179,167799,47929,119870,167799,12292,0.03191914135364335,0.7188541052092087,0.003957115358256009,0.28563340663531966,0.7143665933646803,0.030864307892180524
130,15.0,2151,64988,67139,165,3138,87766,25724,62042,87766,7093,0.024508351753526423,0.740468974318073,0.0018799990884852905,0.29309755486179156,0.7069024451382084,0.035754164482829344
131,13.0,70,4312,4382,4,514,5920,1614,4306,5920,376,0.011824324324324325,0.7283783783783784,0.0006756756756756757,0.27263513513513515,0.7273648648648648,0.08682432432432433
132,25.0,2899,75531,78430,293,2870,102896,29704,73201,102905,7204,0.02817161459598659,0.7339876585199941,0.002847286332053836,0.28865458432534863,0.7113454156746514,0.027889801273018804
133,36.0,317,8852,9169,352,452,12500,3623,8877,12500,808,0.02536,0.70816,0.02816,0.28984,0.71016,0.03616
134,,260,10719,10979,27,11715,25934,4277,21657,25934,1174,0.010025449217243772,0.4133184236909077,0.0010411043417906994,0.16491863962366007,0.83508136037634,0.4517236060769646
135,23.0,1201,34297,35498,110,1589,47889,13582,34307,47889,3920,0.025078828123368622,0.7161769926287874,0.002296978429284387,0.28361419115036857,0.7163858088496314,0.03318089749211719
136,15.0,5085,56114,61199,256,4522,85478,23413,62065,85478,6256,0.05948899131940382,0.6564730105992185,0.002994922670160743,0.2739067362362245,0.7260932637637755,0.05290250122838625
137,,178,4605,4783,10,232,6294,1857,4437,6294,469,0.028280902446774708,0.7316491897044805,0.0015888147442008262,0.2950428979980934,0.7049571020019065,0.03686050206545917
138,34.0,89,1925,2014,6,137,2761,786,1975,2761,205,0.03223469757334299,0.6972111553784861,0.0021731256791017745,0.2846794639623325,0.7153205360376675,0.04961970300615719
139,40.0,87,2132,2219,24,99,2992,848,2144,2992,243,0.029077540106951873,0.7125668449197861,0.008021390374331552,0.28342245989304815,0.7165775401069518,0.03308823529411765
140,,5308,105780,111088,618,4397,149772,42065,107707,149772,11767,0.035440536281815024,0.706273535774377,0.0041262719333386745,0.28086024089950057,0.7191397591004994,0.029357957428624844
141,40.0,1069,24972,26041,117,1502,35155,9904,25251,35155,2445,0.030408192291281468,0.7103399231972692,0.0033281183330962877,0.28172379462380887,0.7182762053761912,0.04272507466932158
142,,184,3005,3189,10,140,4572,1213,3359,4572,254,0.04024496937882765,0.6572615923009624,0.0021872265966754157,0.2653105861767279,0.7346894138232721,0.03062117235345582
143,14.0,465,6566,7031,18,669,9759,2622,7137,9759,557,0.04764832462342453,0.6728148375858182,0.0018444512757454657,0.26867506916692285,0.7313249308330771,0.06855210574853982
144,,402,9497,9899,60,605,13323,3761,9562,13323,1058,0.030173384372888988,0.7128274412669819,0.004503490204908804,0.2822937776777002,0.7177062223222997,0.04541019289949711
145,,167,2460,2627,22,206,3913,941,2972,3913,208,0.042678251980577564,0.6286736519294659,0.005622284692052134,0.24048044978277536,0.7595195502172246,0.052645029389215434
146,,590,4997,5587,27,435,7604,2154,5450,7604,435,0.0775907417148869,0.657154129405576,0.0035507627564439767,0.2832719621251973,0.7167280378748028,0.05720673329826407
147,,96,2823,2919,2,131,3857,1134,2723,3857,272,0.02488981073373088,0.7319159968887736,0.0005185377236193933,0.294010889292196,0.705989110707804,0.03396422089707026
148,14.0,284,3310,3594,5,214,5141,1361,3780,5141,326,0.055242170783894186,0.6438436101925695,0.0009725734292939117,0.26473448745380274,0.7352655125461972,0.04162614277377942
149,23.0,1280,27054,28608,112,2078,38917,10682,28235,38917,2713,0.03289051057378523,0.6951717758306138,0.0028779196752062083,0.27448158902279207,0.7255184109772079,0.05339568825962947
150,25.0,734,16488,17222,89,860,23166,6504,16662,23166,1502,0.03168436501769835,0.7117327117327117,0.0038418371751705086,0.28075628075628073,0.7192437192437192,0.03712337045670379
151,23.0,10,3935,3945,0,196,5230,1525,3705,5230,414,0.0019120458891013384,0.7523900573613767,0.0,0.29158699808795413,0.7084130019120459,0.03747609942638623
152,16.0,4519,89579,94098,125,5171,126100,35450,90650,126100,9194,0.03583663758921491,0.7103806502775575,0.0009912767644726407,0.2811260904044409,0.7188739095955591,0.041007137192704206
153,23.0,8023,195350,203373,1505,9908,267950,77202,190748,267950,19683,0.0299421533868259,0.7290539279716365,0.0056167195372270945,0.2881209180817317,0.7118790819182683,0.036977047956708343
154,,319,9423,9742,25,394,12515,3772,8743,12515,944,0.025489412704754296,0.7529364762285258,0.001997602876548142,0.3013983220135837,0.6986016779864163,0.03148222133439872
155,,79,1561,1640,8,98,2353,623,1730,2353,171,0.03357416064598385,0.6634084147896303,0.003399915002124947,0.26476838079048026,0.7352316192095197,0.0416489587760306
156,14.0,289,2983,3272,144,389,4659,1110,3549,4659,140,0.06203047864348573,0.640266151534664,0.030907920154539602,0.23824855119124275,0.7617514488087572,0.08349431208413823
157,,133,3974,4107,23,251,5833,1572,4261,5833,460,0.02280130293159609,0.6812960740613749,0.003943082461854963,0.2695011143493914,0.7304988856506086,0.04303103034459112
158,16.0,226,4177,4403,17,209,5727,1661,4066,5727,385,0.0394621966125371,0.7293521913741924,0.002968395320412083,0.2900296839532041,0.7099703160467958,0.036493801292125025
159,16.0,2147,16972,19119,80,1806,26117,7122,18995,26117,1605,0.08220699161465712,0.6498449285905732,0.0030631389516406937,0.27269594516981277,0.7273040548301872,0.06915036183328867
160,35.0,53,2008,2061,3,57,2702,795,1907,2702,227,0.019615099925980754,0.7431532198371577,0.0011102886750555144,0.2942264988897113,0.7057735011102887,0.021095484826054774
161,23.0,469,8478,8947,12,534,12172,3473,8699,12172,789,0.03853105488005258,0.6965165954650017,0.000985869208018403,0.28532697995399275,0.7146730200460072,0.04387117975681893
162,25.0,5382,209518,214900,291,6695,277884,81482,196402,277884,22837,0.01936779375566783,0.7539764793942796,0.001047199550891739,0.29322307149745935,0.7067769285025406,0.024092786918282448
163,17.0,1776,31849,33625,336,1589,45058,12879,32179,45058,3156,0.03941586399751432,0.7068445115184873,0.007457055350881087,0.28583159483332593,0.714168405166674,0.03526565759687514
164,13.0,1199,11761,12960,41,1569,18807,4721,14086,18807,1167,0.06375285797841229,0.6253522624554687,0.0021800393470516296,0.2510235550592864,0.7489764449407136,0.08342638379326846
165,35.0,2240,33804,36044,103,2550,48053,13483,34570,48053,3218,0.046615195721390966,0.7034732482883482,0.002143466588974674,0.2805860196033546,0.7194139803966454,0.05306640584354775
166,,268,5258,5526,148,480,7741,2048,5693,7741,522,0.03462085001937734,0.6792404082159927,0.01911897687637256,0.2645653016406149,0.7354346983593851,0.06200749257201912
167,,344,9169,9513,0,324,12295,3691,8604,12295,989,0.027978853192354616,0.7457503050020333,0.0,0.3002033346888979,0.6997966653111021,0.026352175681171208
168,25.0,225,5480,5705,23,243,7608,2168,5440,7608,607,0.029574132492113565,0.7202944269190326,0.0030231335436382754,0.28496319663512093,0.7150368033648791,0.03194006309148265
169,,5615,102433,108048,476,6614,148764,41259,107505,148764,10367,0.03774434675055793,0.6885604043989138,0.003199698851872765,0.27734532548197144,0.7226546745180286,0.04445968110564384
170,17.0,5297,91691,96988,347,7215,130933,37185,93748,130933,8555,0.040455805641053055,0.7002894610220495,0.0026502104129592996,0.2840002138498316,0.7159997861501685,0.05510451910519121
171,24.0,18778,451688,470466,1476,24413,627469,181479,445990,627469,39050,0.029926578046086737,0.7198570766045813,0.0023523074446705735,0.28922385010255486,0.7107761498974451,0.038907101386682054
172,,509,15353,15862,55,849,21193,6026,15167,21193,1884,0.024017364224036237,0.7244373142075213,0.002595196527155193,0.28433916859340347,0.7156608314065965,0.040060397300995615
173,46.0,128,3416,3544,21,172,4645,1360,3285,4645,354,0.027556512378902047,0.7354144241119484,0.004520990312163617,0.29278794402583425,0.7072120559741658,0.037029063509149626
174,15.0,626,14157,14783,37,984,19558,5549,14009,19558,1463,0.03200736271602413,0.7238470191226096,0.0018918089784231516,0.28372021679108295,0.716279783208917,0.05031189283157787
175,,1063,23105,24168,68,1339,31608,9142,22466,31608,2122,0.033630726398380155,0.7309858263730701,0.0021513540875727666,0.28923057453809164,0.7107694254619084,0.04236269298911668
176,27.0,400,6186,6586,38,314,8776,2491,6285,8776,555,0.04557885141294439,0.704876937101185,0.004329990884229718,0.2838422971741112,0.7161577028258888,0.03577939835916135
177,25.0,805,18700,19505,63,964,25699,7452,18247,25699,1969,0.03132417603797813,0.7276547725592436,0.0024514572551461145,0.2899723724658547,0.7100276275341453,0.037511187205727846
178,15.0,419,14520,14939,119,990,20134,5686,14448,20134,1560,0.02081056918645078,0.7211681732392967,0.005910400317870269,0.2824078672891626,0.7175921327108374,0.04917055726631568
179,17.0,46,3005,3051,34,489,4684,1140,3544,4684,289,0.00982066609735269,0.6415456874466268,0.007258753202391118,0.24338172502134928,0.7566182749786508,0.10439795046968403
180,16.0,310,8097,8407,23,417,11146,3177,7969,11146,781,0.0278126682217836,0.7264489502960704,0.0020635205454871703,0.2850349901309887,0.7149650098690113,0.03741252467252826
181,38.0,402,8284,8686,46,506,11804,3347,8457,11804,833,0.03405625211792613,0.7017960013554727,0.003896984073195527,0.2835479498475093,0.7164520501524907,0.0428668248051508
182,17.0,808,15576,16384,78,1455,22661,6100,16561,22661,1584,0.0356559728167336,0.6873483076651515,0.0034420369798331936,0.2691849432946472,0.7308150567053529,0.06420722827765765
183,,51,2169,2220,6,107,3018,894,2124,3018,257,0.016898608349900597,0.7186878727634195,0.0019880715705765406,0.2962226640159046,0.7037773359840954,0.03545394300861498
184,,245,28981,29226,186,1813,39917,10985,28932,39917,3530,0.006137735801788712,0.7260315153944434,0.004659668812786532,0.2751960317659143,0.7248039682340858,0.045419244933236465
185,,264,9164,9428,33,330,12317,3606,8711,12317,1171,0.02143379069578631,0.7440123406673703,0.002679223836973289,0.29276609564017214,0.7072339043598279,0.02679223836973289
186,17.0,59,2397,2456,16,186,3396,904,2492,3396,279,0.017373380447585393,0.7058303886925795,0.004711425206124852,0.2661955241460542,0.7338044758539458,0.054770318021201414
187,23.0,98,2877,2975,10,125,3947,1114,2833,3947,321,0.02482898403851026,0.7289080314162655,0.002533569799847986,0.28223967570306563,0.7177603242969344,0.03166962249809982
188,,6461,159460,165921,436,8756,217467,63577,153890,217467,16186,0.029710254889247563,0.7332606786317004,0.0020049018931608013,0.29235240289331255,0.7076475971066875,0.04026358022136692
189,17.0,649,13018,13667,84,811,18966,5097,13869,18966,1291,0.03421912896762628,0.6863861647158073,0.004428978171464726,0.26874406833280606,0.7312559316671939,0.04276072972687968
190,23.0,398,10483,10881,64,569,14338,4076,10262,14338,1014,0.027758404240479845,0.7311340493792718,0.004463662993443995,0.28427953689496444,0.7157204631050356,0.03968475380108802
191,34.0,26,4252,4278,31,252,5813,1590,4223,5813,452,0.004472733528298641,0.7314639600894547,0.005332874591432995,0.2735248580767246,0.7264751419232754,0.04335110958197144
192,16.0,1680,50197,51877,27,1733,67549,19485,48064,67549,5002,0.024870834505322063,0.7431198093236021,0.0003997098402641046,0.28845726805726213,0.7115427319427379,0.025655450117692342
193,23.0,170,6398,6568,0,253,8302,2574,5728,8302,597,0.020476993495543244,0.7706576728499157,0.0,0.3100457721031077,0.6899542278968923,0.030474584437484943
194,,1302,28649,29951,60,2908,40671,11488,29183,40671,3186,0.03201298222320573,0.7044085466302771,0.0014752526370140886,0.2824617049002975,0.7175382950997025,0.07150057780728283
195,17.0,1609,43784,45393,157,1818,61147,17028,44119,61147,5274,0.026313637627357025,0.716044940880174,0.0025675830375979196,0.2784764583708113,0.7215235416291886,0.029731630333458714
196,14.0,47,1606,1653,30,316,2808,627,2181,2808,134,0.01673789173789174,0.5719373219373219,0.010683760683760684,0.2232905982905983,0.7767094017094017,0.11253561253561253
197,25.0,148,2192,2340,13,79,3061,893,2168,3061,228,0.04835021234890559,0.7161058477621692,0.004246978111728194,0.291734727213329,0.7082652727866711,0.025808559294348252
198,14.0,3679,53505,57184,2384,4342,81693,21569,60124,81693,3830,0.04503445827671894,0.6549520766773163,0.029182426890920887,0.26402506946739623,0.7359749305326038,0.05315020870821245
199,15.0,82,3901,3983,13,181,5439,1502,3937,5439,447,0.015076300790586505,0.7172274315131458,0.0023901452472881043,0.2761537047251333,0.7238462952748667,0.03327817613531899
200,,645,21899,22544,68,658,29404,8661,20743,29404,2448,0.021935791048836892,0.7447626173309754,0.0023126105291797036,0.29455176166507957,0.7054482383349204,0.02237790776765066
201,17.0,3270,83477,86747,138,4584,116583,32914,83669,116583,8902,0.028048686343635006,0.7160306391154799,0.0011837060291809269,0.2823224655395727,0.7176775344604274,0.039319626360618615
202,34.0,257,7932,8189,21,217,10177,3191,6986,10177,628,0.025253021519111723,0.7794045396482264,0.002063476466542203,0.3135501621302938,0.6864498378697061,0.02132259015426943
203,34.0,194,5579,5773,19,291,7599,2243,5356,7599,622,0.025529674957231213,0.7341755494143967,0.0025003289906566652,0.29517041716015263,0.7048295828398473,0.03829451243584682
204,,1864,39709,41573,683,2057,55997,15901,40096,55997,4712,0.03328749754451131,0.709127274675429,0.012197081986534993,0.28396164080218583,0.7160383591978142,0.03673411075593335
205,23.0,1233,32427,33660,21,1433,44873,12845,32028,44873,3730,0.02747754774586054,0.7226394491119381,0.00046798743119470505,0.28625231208076124,0.7137476879192387,0.03193457090009583
206,34.0,124,2556,2680,29,147,3732,1034,2698,3732,302,0.03322615219721329,0.684887459807074,0.007770632368703108,0.2770632368703108,0.7229367631296891,0.03938906752411576
207,15.0,182,3122,3304,15,135,4382,1242,3140,4382,327,0.04153354632587859,0.7124600638977636,0.0034230944774075764,0.2834322227293473,0.7165677772706527,0.030807850296668188
208,25.0,1245,34612,35857,189,1446,48483,13614,34869,48483,3566,0.025679104015840604,0.7138997174267269,0.0038982736216818265,0.2807994554792401,0.7192005445207599,0.029824887073819688
209,26.0,324,9840,10164,41,324,13259,3913,9346,13259,1203,0.024436231993363,0.7421374160947282,0.003092239233728034,0.29512029564823894,0.7048797043517611,0.024436231993363
210,16.0,733,19458,20191,83,2502,28853,7674,21179,28853,2346,0.025404637299414272,0.6743839462100994,0.002876650608255641,0.26596887671992514,0.7340311232800749,0.08671541954042908
211,48.0,102,1707,1809,23,74,2435,688,1747,2435,182,0.04188911704312115,0.7010266940451746,0.00944558521560575,0.28254620123203283,0.7174537987679671,0.030390143737166326
212,24.0,240,4879,5119,13,355,7197,2017,5180,7197,413,0.03334722801167153,0.6779213561206058,0.0018063081839655411,0.28025566208142283,0.7197443379185772,0.04932610810059747
213,16.0,717,20177,20894,99,671,26547,7793,18754,26547,2133,0.027008701548197536,0.7600482163709648,0.0037292349418013336,0.29355482728745247,0.7064451727125476,0.02527592571665348
214,25.0,101,1967,2068,2,96,2740,773,1967,2740,198,0.03686131386861314,0.7178832116788321,0.00072992700729927,0.2821167883211679,0.7178832116788321,0.035036496350364967
215,25.0,77,2126,2203,13,52,2917,860,2057,2917,264,0.026396983201919782,0.728830990743915,0.004456633527596846,0.2948234487487144,0.7051765512512855,0.017826534110387385
216,,62,11559,11621,105,204,15575,4327,11248,15575,1647,0.0039807383627608346,0.7421508828250402,0.006741573033707865,0.2778170144462279,0.722182985553772,0.013097913322632423
217,,207,19069,19276,30,1209,26339,7175,19164,26339,1671,0.00785906830175785,0.7239834466000987,0.0011389954060518623,0.27240973461407036,0.7275902653859296,0.04590151486389005
218,23.0,1405,19839,21244,80,1647,28780,8182,20598,28780,2059,0.04881862404447533,0.6893328700486449,0.002779708130646282,0.2842946490618485,0.7157053509381515,0.057227241139680335
219,16.0,169,2765,2934,57,160,3949,1112,2837,3949,290,0.04279564446695366,0.7001772600658395,0.014434033932641175,0.28159027601924536,0.7184097239807546,0.04051658647758926
220,24.0,124,4273,4397,3,178,5661,1681,3980,5661,471,0.021904257198374844,0.7548136371665783,0.0005299417064122947,0.29694400282635575,0.7030559971736442,0.03144320791379615
221,,647,14749,15396,195,871,20685,5868,14817,20685,1399,0.031278704375151074,0.7130287648054145,0.009427121102248005,0.28368382886149385,0.7163161711385062,0.04210780759004109
222,,631,13173,13804,52,696,17963,5286,12677,17963,1137,0.03512776262316985,0.7333407559984413,0.0028948393920837276,0.2942715582029728,0.7057284417970272,0.038746311863274506
223,,377,5982,6359,25,434,8640,2380,6260,8640,640,0.04363425925925926,0.6923611111111111,0.0028935185185185184,0.27546296296296297,0.7245370370370371,0.05023148148148148
224,17.0,0,1783,1783,0,60,2271,692,1579,2271,206,0.0,0.7851166886833993,0.0,0.3047115808014091,0.695288419198591,0.026420079260237782
225,16.0,663,31874,32537,116,1986,43293,12428,30865,43293,3470,0.01531425403644931,0.7362391148684545,0.0026794169958191854,0.28706719331069686,0.7129328066893031,0.045873466842214675
226,16.0,5054,117609,122663,848,4645,164013,47517,116496,164013,14058,0.030814630547578544,0.7170712077701158,0.005170321864730235,0.28971483967734263,0.7102851603226573,0.028320925780273516
227,17.0,175,3494,3669,30,200,4876,1354,3522,4876,363,0.03589007383100903,0.7165709598031174,0.0061525840853158325,0.2776866283839213,0.7223133716160788,0.04101722723543889
228,35.0,1081,27492,28573,284,1851,39005,10857,28148,39005,2650,0.027714395590308936,0.7048327137546468,0.007281117805409563,0.2783489296244071,0.7216510703755928,0.047455454428919366
229,,1234,48166,49402,258,8939,70629,18202,52427,70629,4216,0.017471576831046737,0.6819578360163672,0.0036528904557617974,0.25771283750300866,0.7422871624969913,0.12656274334904927
230,,1827,43087,44914,186,1435,58899,16722,42177,58899,4199,0.0310192023633678,0.7315404336236608,0.003157948352264045,0.28390974379870626,0.7160902562012937,0.024363741319886587
231,26.0,208,4693,4901,37,200,6562,1906,4656,6562,461,0.03169765315452606,0.7151782992989942,0.005638524839987808,0.2904602255409936,0.7095397744590064,0.03047851264858275
232,,76,1622,1698,5,102,2330,632,1698,2330,174,0.03261802575107296,0.696137339055794,0.002145922746781116,0.271244635193133,0.728755364806867,0.04377682403433476
233,16.0,3402,91482,94884,213,5023,127714,36540,91174,127714,8062,0.02663764348466104,0.7163036158917582,0.0016677889659708412,0.286108022613026,0.7138919773869741,0.039330065615359316
234,37.0,946,36685,37631,266,1127,47269,14444,32826,47270,3180,0.020012693039983077,0.7760736196319018,0.005627247725830336,0.305563782525915,0.694436217474085,0.02384176010154432
235,33.0,111,3265,3376,12,245,4488,1221,3267,4488,314,0.024732620320855617,0.7274955436720143,0.00267379679144385,0.27205882352941174,0.7279411764705882,0.05459001782531194
236,,8658,144769,153427,1044,11573,210003,58157,151846,210003,14038,0.04122798245739347,0.6893663423855849,0.004971357552034971,0.27693413903610903,0.723065860963891,0.055108736541858924
237,25.0,69,2870,2939,13,158,3860,1125,2735,3860,287,0.017875647668393783,0.7435233160621761,0.003367875647668394,0.2914507772020725,0.7085492227979274,0.04093264248704663
238,17.0,63,1293,1356,0,117,1857,505,1352,1857,129,0.033925686591276254,0.6962843295638126,0.0,0.2719439956919763,0.7280560043080236,0.0630048465266559
239,34.0,111,2420,2531,17,141,3427,976,2451,3427,238,0.032389845345783486,0.706156988619784,0.004960606944849723,0.2847971987160782,0.7152028012839218,0.041143857601400644
240,,23203,536028,559231,3571,23797,731063,214619,516444,731063,46850,0.03173871472089273,0.73321724666684,0.004884667942434509,0.29357114229553405,0.706428857704466,0.03255123019493532
241,16.0,933,19257,20190,88,778,26360,7752,18608,26360,1754,0.03539453717754173,0.7305386949924128,0.003338391502276176,0.29408194233687407,0.705918057663126,0.029514415781487103
242,,731,34165,34896,232,1827,47690,13199,34491,47690,3125,0.015328161040050326,0.7163975676242399,0.0048647515202348505,0.27676661773956807,0.723233382260432,0.03830991822184945
243,16.0,98,4565,4663,7,250,6191,1803,4388,6191,449,0.015829429817476984,0.7373606848651268,0.001130673558391213,0.2912292036827653,0.7087707963172347,0.04038119851397189
244,16.0,1510,41183,42693,38,2264,56361,16146,40215,56361,4914,0.026791575734994057,0.7307003069498412,0.0006742250847217047,0.28647468994517483,0.7135253100548251,0.040169620837103674
245,17.0,242,5733,5975,28,574,8263,2275,5988,8263,641,0.029287183831538183,0.6938158053975554,0.0033885997821614428,0.2753237323006172,0.7246762676993828,0.06946629553430957
246,,824,28654,29478,53,748,36925,11490,25435,36925,2573,0.022315504400812456,0.7760054163845633,0.0014353419092755586,0.31117129316181447,0.6888287068381855,0.02025727826675694
247,,63,13526,13589,86,1072,18555,5046,13509,18555,1272,0.003395311236863379,0.7289679331716519,0.004634869307464295,0.2719482619240097,0.7280517380759903,0.05777418485583401
248,15.0,142,1928,2070,6,153,2874,813,2061,2874,191,0.049408489909533754,0.6708420320111343,0.0020876826722338203,0.2828810020876827,0.7171189979123174,0.05323590814196242
249,25.0,384,6542,6926,24,561,9935,2661,7274,9935,575,0.03865123301459487,0.6584801207851032,0.002415702063412179,0.2678409662808254,0.7321590337191747,0.05646703573225969
250,,1485,36318,37803,141,4185,52303,14124,38179,52303,2855,0.028392252834445443,0.6943769955834274,0.0026958300671089614,0.27004187140317,0.72995812859683,0.08001453071525534
251,23.0,249,7118,7367,24,335,10305,2800,7505,10305,794,0.02416302765647744,0.6907326540514314,0.0023289665211062593,0.2717127607957302,0.7282872392042697,0.032508491023774864
252,37.0,335,7894,8229,81,396,11101,3156,7945,11101,822,0.03017746148995586,0.7111071074677957,0.0072966399423475365,0.2842987118277633,0.7157012881722368,0.03567246194036573
253,24.0,847,18274,19121,147,743,25646,7303,18343,25646,1903,0.03302659284098885,0.7125477657334477,0.005731888013725337,0.28476175621929345,0.7152382437807066,0.02897137955236684
254,23.0,90,2534,2624,0,127,3447,1013,2434,3447,261,0.02610966057441253,0.7351319988395706,0.0,0.29387873513199886,0.7061212648680012,0.03684363214389324
255,15.0,180,2587,2767,132,335,4051,1097,2954,4051,229,0.04443347321648976,0.63860775117255,0.03258454702542582,0.270797333991607,0.729202666008393,0.08269563070846704
256,16.0,36,2738,2774,13,254,3919,1049,2870,3919,315,0.009186016841030875,0.6986476141872927,0.003317172748150038,0.26767032406226077,0.7323296759377392,0.06481245215616228
257,14.0,706,8398,9104,97,482,12367,3374,8993,12367,1017,0.05708741004285599,0.6790652543058139,0.007843454354330072,0.27282283496401716,0.7271771650359828,0.038974690709145304
258,16.0,157,11337,11494,67,2299,16888,4367,12521,16888,735,0.009296541923259119,0.6713050686878257,0.003967314069161535,0.25858597820937945,0.7414140217906205,0.1361321648507816
259,16.0,1921,42187,44108,255,3235,59275,16027,43248,59275,4387,0.03240826655419654,0.71171657528469,0.0043019822859552935,0.2703838043019823,0.7296161956980177,0.05457612821594264
260,,55,1450,1505,6,78,2121,571,1550,2121,156,0.02593116454502593,0.6836397925506836,0.002828854314002829,0.2692126355492692,0.7307873644507308,0.036775106082036775
261,24.0,582,15674,16256,46,653,21780,6167,15613,21780,1671,0.02672176308539945,0.7196510560146924,0.0021120293847566576,0.2831496786042241,0.716850321395776,0.029981634527089074
262,17.0,306,5943,6249,54,613,8654,2446,6208,8654,494,0.035359371388953086,0.6867344580540791,0.00623988906863878,0.2826438641090825,0.7173561358909175,0.07083429627917726
263,,94,2596,2690,81,316,3850,1003,2847,3850,221,0.024415584415584415,0.6742857142857143,0.021038961038961038,0.26051948051948054,0.7394805194805195,0.08207792207792208
264,14.0,136,4079,4215,64,255,5896,1584,4312,5896,436,0.023066485753052916,0.6918249660786974,0.010854816824966078,0.26865671641791045,0.7313432835820896,0.04324966078697422
265,,10204,20514,30726,376,4234,45670,11669,34001,45670,731,0.22342894679220496,0.44917889205167505,0.008232975695204729,0.25550689730676596,0.7444931026932341,0.09270856141887454
266,14.0,156,3293,3449,9,258,4935,1306,3629,4935,374,0.031610942249240125,0.667274569402229,0.00182370820668693,0.2646403242147923,0.7353596757852077,0.052279635258358666
267,,143,2309,2452,5,151,3423,927,2496,3423,235,0.04177621969033012,0.6745544843704353,0.001460706982179375,0.2708150744960561,0.7291849255039439,0.04411335086181712
268,23.0,1138,13752,14890,135,851,19796,5827,13969,19796,1057,0.057486360880986055,0.6946857951101233,0.006819559506971105,0.2943523944231158,0.7056476055768842,0.04298848252172156
269,16.0,340,4147,4487,51,211,6547,1642,4905,6547,429,0.05193218267908966,0.6334198869711318,0.007789827401863449,0.25080189399725067,0.7491981060027494,0.03222850160378799
270,,288,6039,6327,5,222,8244,2451,5793,8244,646,0.034934497816593885,0.732532751091703,0.0006065016982047549,0.29730713245997087,0.7026928675400291,0.026928675400291122
271,,256,4271,4527,35,220,6052,1716,4336,6052,387,0.04230006609385327,0.7057171183079973,0.005783212161269002,0.2835426305353602,0.7164573694646398,0.036351619299405155
272,24.0,70,1923,1993,2,119,2672,759,1913,2672,169,0.02619760479041916,0.719685628742515,0.0007485029940119761,0.28405688622754494,0.7159431137724551,0.04453592814371257
273,,80,3428,3508,4,184,4708,1340,3368,4708,346,0.016992353440951572,0.7281223449447749,0.0008496176720475786,0.28462192013593884,0.7153780798640612,0.03908241291418862
274,14.0,41,2449,2490,7,169,3373,949,2424,3373,290,0.012155351319300326,0.7260598873406463,0.0020753038837829827,0.2813519122442929,0.7186480877557071,0.05010376519418915
275,,849,18735,19584,68,623,25019,7508,17511,25019,1992,0.033934210000399694,0.7488308885247212,0.0027179343698788922,0.30009193013309887,0.6999080698669011,0.024901075182861027
276,,791,57237,58028,217,2381,76741,21945,54796,76741,5911,0.01030739761014321,0.7458464184725244,0.002827693149685305,0.28596187175043325,0.7140381282495667,0.03102643958249176
277,,126,2527,2653,1,107,3622,1060,2562,3622,321,0.034787410270568746,0.6976808393152955,0.0002760905577029266,0.29265599116510216,0.7073440088348979,0.029541689674213143
278,26.0,94,1426,1520,9,97,2201,585,1616,2201,153,0.04270786006360745,0.647887323943662,0.00408905043162199,0.26578827805542937,0.7342117219445706,0.04407087687414812
279,17.0,13,1863,1876,3,118,2664,712,1952,2664,210,0.00487987987987988,0.6993243243243243,0.0011261261261261261,0.2672672672672673,0.7327327327327328,0.044294294294294295
280,15.0,78,2320,2398,21,86,3123,889,2234,3123,238,0.024975984630163303,0.7428754402817803,0.0067243035542747355,0.2846621837976305,0.7153378162023695,0.027537624079410822
281,14.0,2207,24559,28948,717,2826,42277,10367,31910,42277,830,0.05220332568536083,0.580906876079192,0.016959576128864395,0.24521607493436148,0.7547839250656385,0.06684485654138184
282,,2028,38354,40382,527,2007,54619,15579,39040,54619,3615,0.037129936468994304,0.7022098537139091,0.009648657060729782,0.28523041432468554,0.7147695856753145,0.03674545487833904
283,,2292,78477,80769,397,3470,113495,30525,82970,113495,8719,0.02019472223445967,0.6914577734701969,0.0034979514516057975,0.26895457949689416,0.7310454205031058,0.030574034098418433
284,26.0,79,1560,1639,7,60,2155,626,1529,2155,182,0.03665893271461717,0.7238979118329466,0.0032482598607888632,0.2904872389791183,0.7095127610208817,0.027842227378190254
285,15.0,858,9618,10476,121,560,14272,4042,10230,14272,958,0.060117713004484305,0.6739069506726457,0.008478139013452915,0.28321188340807174,0.7167881165919282,0.03923766816143498
286,24.0,72,2201,2273,9,121,2989,879,2110,2989,220,0.024088323854131816,0.7363666778186685,0.003011040481766477,0.2940782870525259,0.7059217129474741,0.04048176647708264
287,17.0,53,2080,2133,4,70,2780,829,1951,2780,228,0.019064748201438848,0.7482014388489209,0.0014388489208633094,0.29820143884892086,0.7017985611510792,0.025179856115107913
288,,316,33950,34266,4,942,43329,12484,30845,43329,3220,0.007293036996007293,0.7835398924507836,9.231692400009232e-05,0.2881211198042881,0.7118788801957119,0.02174063560202174
289,,378,8814,9192,0,461,12248,3484,8764,12248,772,0.030862181580666233,0.7196276943174396,0.0,0.2844546048334422,0.7155453951665578,0.03763879817112998
290,,702,11269,11971,29,1263,16829,4534,12295,16829,1097,0.04171370847941054,0.6696179214451244,0.0017232158773545665,0.26941588923881393,0.730584110761186,0.07504902252064888
291,23.0,7444,145983,153427,458,8589,204926,58171,146755,204926,15150,0.03632530767203771,0.712369343079941,0.0022349531050232766,0.283863443389321,0.716136556610679,0.0419126904345959
292,25.0,262,6121,6383,22,353,8372,2370,6002,8372,525,0.031294792164357384,0.7311275680840899,0.0026278069756330625,0.28308647873865267,0.7169135212613473,0.04216435738174869
293,15.0,632,5711,6343,28,649,9417,2353,7064,9417,659,0.06711266857810343,0.6064564086227037,0.0029733460762450888,0.2498672613358819,0.7501327386641181,0.06891791441010937
294,25.0,144,6077,6221,3,266,8107,2371,5736,8107,685,0.017762427531762673,0.7495991118786234,0.00037005057357838907,0.29246330331812015,0.7075366966818799,0.03281115085728383
295,13.0,237,7773,8010,85,980,11373,3183,8190,11373,595,0.020838828805064626,0.6834608282774993,0.007473841554559043,0.279873384331311,0.720126615668689,0.08616899674668073
296,36.0,2061,45966,48027,278,2300,63622,18461,45161,63622,4483,0.03239445474835748,0.7224859325390588,0.004369557700166609,0.29016692339127975,0.7098330766087203,0.036151016943824464
297,24.0,99,2214,2313,14,146,3105,872,2233,3105,213,0.03188405797101449,0.7130434782608696,0.0045088566827697265,0.28083735909822866,0.7191626409017713,0.047020933977455714
298,,1162,18688,19850,66,1231,26929,7506,19424,26930,1601,0.04314890456739696,0.6939472707018195,0.0024507983661344224,0.2787226141849239,0.7212773858150762,0.04571110285926476
299,14.0,560,7477,8037,27,859,11503,3082,8421,11503,668,0.04868295227332,0.6500043466921672,0.002347213770320786,0.2679301051899505,0.7320698948100496,0.07467617143353908
300,,703,11482,12185,29,981,16843,4705,12138,16843,987,0.041738407647093745,0.681707534287241,0.0017217835302499554,0.2793445348215876,0.7206554651784124,0.058243780799145044
301,23.0,2459,54954,57413,545,1605,73655,22185,51470,73655,4673,0.03338537777476071,0.7461000610956486,0.007399361889892065,0.301201547756432,0.698798452243568,0.02179078134546195
302,17.0,849,17178,18027,418,763,26007,6806,19201,26007,2294,0.03264505710001153,0.6605144768716115,0.016072595839581653,0.26169877340715963,0.7383012265928404,0.02933825508516938
303,,203,4786,4989,12,146,6824,1896,4928,6824,555,0.02974794841735053,0.7013481828839391,0.0017584994138335288,0.27784290738569756,0.7221570926143025,0.021395076201641265
304,,2153,33147,35300,81,2493,47564,13519,34045,47564,3044,0.04526532671768564,0.69689260785468,0.0017029686317382895,0.28422756706753005,0.71577243293247,0.05241359011016735
305,,114,2101,2215,7,421,3053,755,2298,3053,139,0.037340320995741895,0.688175565018015,0.0022928267278087126,0.24729773992793974,0.7527022600720603,0.137897150343924
306,,3342,60863,64205,489,3300,86485,24531,61958,86489,6237,0.03864075200314491,0.7037079859866573,0.0056538981835840395,0.28363144446114535,0.7163685555388547,0.03815514111621131
307,,66,3683,3749,20,697,5323,1403,3920,5323,179,0.012399023107270337,0.6919030621829795,0.0037572797294758596,0.26357317302273153,0.7364268269772685,0.1309411985722337
308,13.0,299,6183,6482,27,352,9802,2398,7404,9802,536,0.03050397877984085,0.6307896347684147,0.0027545398898184046,0.24464395021424198,0.755356049785758,0.035911038563558456
309,14.0,136,2864,3000,23,180,4203,1113,3090,4203,275,0.03235783963835356,0.6814180347370925,0.005472281703545087,0.2648108493932905,0.7351891506067095,0.042826552462526764
310,33.0,58,2686,2744,10,84,3513,1060,2453,3513,259,0.01651010532308568,0.7645886706518645,0.002846569883290635,0.30173640762880727,0.6982635923711927,0.02391118701964133
311,27.0,86,1607,1693,12,124,2312,670,1642,2312,159,0.037197231833910036,0.6950692041522492,0.005190311418685121,0.2897923875432526,0.7102076124567474,0.05363321799307959
312,,141,5037,5178,79,293,7252,1884,5368,7252,498,0.019442912300055157,0.6945670159955875,0.010893546607832321,0.2597904026475455,0.7402095973524545,0.04040264754550469
313,24.0,111,5772,5883,16,158,7658,2228,5430,7658,544,0.014494646121702795,0.7537215983285454,0.0020893183598850876,0.2909375816139984,0.7090624183860016,0.02063201880386524
314,17.0,334,10671,11005,58,570,14955,4155,10800,14955,1172,0.022333667669675695,0.7135406218655967,0.0038783015713808092,0.2778335005015045,0.7221664994984955,0.03811434302908726
315,37.0,9695,232278,241973,2289,9326,309048,92680,216368,309048,19727,0.03137053143848205,0.7515919857109575,0.007406616447930419,0.2998886904299656,0.7001113095700344,0.030176542155263907
316,16.0,306,7253,7559,34,473,10215,2869,7346,10215,765,0.029955947136563875,0.710034263338228,0.0033284385707293197,0.2808614782183064,0.7191385217816936,0.04630445423396965
317,27.0,207,5394,5601,20,322,7405,2159,5246,7405,548,0.027954085077650237,0.7284267386900742,0.0027008777852802163,0.29155975692099934,0.7084402430790007,0.04348413234301148
318,26.0,314,6609,6923,51,580,9257,2507,6750,9257,582,0.03392027654747758,0.7139462028735011,0.005509344280004321,0.2708220805876634,0.7291779194123366,0.06265528789024521
319,16.0,42,2971,3013,21,148,4182,1130,3052,4182,354,0.010043041606886656,0.7104256336681014,0.005021520803443328,0.2702056432329029,0.729794356767097,0.03538976566236251
320,,973,14300,15273,72,612,20124,5782,14342,20124,1307,0.048350228582786724,0.710594315245478,0.0035778175313059034,0.28731862452792684,0.7126813754720731,0.03041144901610018
321,,146,4776,4922,15,205,6392,1888,4504,6392,483,0.022841051314142678,0.7471839799749687,0.002346683354192741,0.295369211514393,0.704630788485607,0.03207133917396746
322,17.0,192,2147,2339,5,153,3296,930,2366,3296,148,0.05825242718446602,0.6513956310679612,0.001516990291262136,0.2821601941747573,0.7178398058252428,0.04641990291262136
323,,188,3496,3684,5,240,5024,1396,3628,5024,352,0.037420382165605094,0.695859872611465,0.0009952229299363057,0.2778662420382166,0.7221337579617835,0.04777070063694268
324,16.0,78,2800,2878,2,109,3694,1059,2635,3694,259,0.021115322144017325,0.7579859231185706,0.0005414185165132648,0.2866811044937737,0.7133188955062263,0.02950730914997293
325,,125,2212,2337,28,187,3246,871,2375,3246,190,0.038508934072704865,0.6814540973505854,0.00862600123228589,0.2683302526186075,0.7316697473813925,0.05760936537276648
326,27.0,14,2729,2743,0,108,3913,1060,2853,3913,385,0.0035778175313059034,0.6974188602095579,0.0,0.27089189879887554,0.7291081012011245,0.027600306670074112
327,,437,13807,14244,52,1000,18845,5367,13478,18845,1359,0.02318917484743964,0.7326611833377553,0.002759352613425312,0.2847970283894932,0.7152029716105067,0.05306447333510215
328,23.0,6419,146185,152604,501,7307,203106,58208,144898,203106,15563,0.031604186976258705,0.7197473240573887,0.0024666922690614753,0.2865892686577452,0.7134107313422547,0.035976288243577244
329,23.0,118,2990,3108,3,199,4209,1193,3016,4209,310,0.028035162746495604,0.7103825136612022,0.0007127583749109052,0.28344024708957,0.7165597529104301,0.04727963886909004
330,,28,1516,1544,3,239,2470,575,1895,2470,129,0.011336032388663968,0.6137651821862348,0.0012145748987854252,0.23279352226720648,0.7672064777327935,0.09676113360323886
331,,1004,63369,64373,757,8198,89252,24040,65212,89252,5110,0.01124904764038901,0.7100008963384574,0.008481602653161833,0.2693497064491552,0.7306502935508448,0.09185228342222022
332,,14,1844,1858,0,91,2553,711,1842,2553,259,0.005483744614179397,0.7222875048962005,0.0,0.2784958871915394,0.7215041128084606,0.03564433999216608
333,,173,1966,2139,11,171,3150,815,2335,3150,234,0.05492063492063492,0.6241269841269841,0.003492063492063492,0.25873015873015875,0.7412698412698413,0.054285714285714284
334,,169,4722,4891,93,1008,7168,1757,5411,7168,200,0.023577008928571428,0.6587611607142857,0.012974330357142858,0.2451171875,0.7548828125,0.140625
335,27.0,1429,7677,9106,90,367,11713,3440,8273,11713,629,0.12200119525313755,0.6554255954921882,0.007683770169896696,0.2936907709382737,0.7063092290617263,0.031332707248356524
336,27.0,88,2882,2970,24,139,3958,1131,2827,3958,267,0.02223345123799899,0.7281455280444669,0.00606366851945427,0.28575037897928246,0.7142496210207175,0.03511874684183931
337,27.0,109,4389,4498,10,206,5896,1735,4161,5896,500,0.018487109905020352,0.7444029850746269,0.0016960651289009499,0.29426729986431477,0.7057327001356852,0.034938941655359566
338,24.0,764,18578,19342,77,834,25606,7260,18346,25606,1747,0.029836757010075765,0.7255330781848004,0.0030071077091306723,0.2835272982894634,0.7164727017105366,0.03257049129110365
339,,220,3627,3847,8,224,5180,1458,3722,5180,438,0.04247104247104247,0.7001930501930502,0.0015444015444015444,0.28146718146718147,0.7185328185328186,0.043243243243243246
340,14.0,518,11421,11939,62,837,15994,4445,11549,15994,1085,0.032387145179442293,0.7140802801050394,0.0038764536701262975,0.27791671876953855,0.7220832812304614,0.052332124546705015
341,,387,11925,12312,21,396,15768,4640,11128,15768,1143,0.02454337899543379,0.7562785388127854,0.0013318112633181126,0.29426686960933535,0.7057331303906647,0.02511415525114155
342,,1367,37588,38955,173,2659,51512,14266,37246,51512,3371,0.026537505823885695,0.7296940518714086,0.003358440751669514,0.2769451778226433,0.7230548221773567,0.05161904022363721
343,23.0,282,4818,5100,69,237,6995,1931,5064,6995,438,0.040314510364546106,0.6887776983559686,0.009864188706218727,0.2760543245175125,0.7239456754824874,0.033881343817012154
344,44.0,205,4503,4708,16,148,6074,1815,4259,6074,447,0.03375041159038525,0.7413566019097794,0.0026341784655910436,0.298814619690484,0.7011853803095159,0.024366150806717154
345,25.0,558,17117,17675,20,1055,23481,6714,16767,23481,1771,0.023763894212341895,0.7289723606320003,0.0008517524807291001,0.2859333077807589,0.7140666922192411,0.04492994335846003
346,14.0,187,3708,3895,1,319,5347,1454,3893,5347,384,0.03497288198990088,0.6934729755002805,0.0001870207593042828,0.27192818402842717,0.7280718159715729,0.059659622218066206
347,25.0,2640,85691,88331,1175,5114,119283,33217,86066,119283,9048,0.022132240134805463,0.7183840111331875,0.009850523544847127,0.27847220475675494,0.7215277952432451,0.0428728318368921
348,15.0,1269,44801,46070,436,2270,62139,17612,44527,62139,5065,0.020421957224931203,0.7209803826904199,0.007016527462624117,0.2834290864030641,0.7165709135969359,0.036531003073754
349,26.0,79,2724,2803,7,113,3661,1063,2598,3661,323,0.02157880360557225,0.7440590002731494,0.0019120458891013384,0.2903578257306747,0.7096421742693253,0.03086588363835018
350,15.0,109,9649,10780,99,1719,15412,3408,12006,15414,666,0.007071493447515246,0.6259893603217854,0.006422732580770728,0.22109770338653173,0.7789022966134683,0.11152199299338264
351,24.0,62,2125,2187,14,84,2789,818,1971,2789,183,0.022230190032269632,0.761921835783435,0.005019720329867336,0.2932950878451058,0.7067049121548943,0.030118321979204016
352,26.0,795,24225,25020,107,1535,32568,9422,23146,32568,2070,0.024410464259395727,0.743828297715549,0.003285433554409236,0.28930238270695163,0.7106976172930484,0.047132154261852126
353,38.0,1665,39357,41022,116,2194,56710,15675,41035,56710,4188,0.02935990125198378,0.6940045847293246,0.002045494621759831,0.2764062775524599,0.7235937224475402,0.03868806207018163
354,,5428,110776,116204,3055,7842,157578,44904,112737,157641,10197,0.0344326666286055,0.7027105892502585,0.01937947615150881,0.2848497535539612,0.7151502464460388,0.04974594172835747
355,,109,3870,3979,9,268,5289,1393,3896,5289,407,0.020608810739270185,0.7317073170731707,0.0017016449234259785,0.2633768198147098,0.7366231801852903,0.05067120438646247
356,27.0,722,16190,16912,124,754,22300,6286,16014,22300,1519,0.03237668161434978,0.7260089686098655,0.005560538116591928,0.2818834080717489,0.7181165919282512,0.03381165919282511
357,23.0,1393,29381,30774,632,1030,39826,11601,28225,39826,2597,0.034977150605132325,0.7377341435243309,0.015869030281725507,0.2912921207251544,0.7087078792748456,0.025862501883191884
358,36.0,173,3465,3638,3,227,4768,1358,3410,4768,305,0.036283557046979865,0.7267197986577181,0.0006291946308724832,0.28481543624161076,0.7151845637583892,0.04760906040268456
359,16.0,1364,53607,54971,818,3887,76041,19224,56817,76041,5151,0.017937691508528295,0.7049749477255691,0.0107573545850265,0.2528109835483489,0.747189016451651,0.05111716047921516
360,26.0,86,2037,2123,9,89,2829,819,2010,2829,246,0.0303994344291269,0.7200424178154825,0.003181336161187699,0.28950159066808057,0.7104984093319194,0.031459879816189466
361,17.0,252,6409,6661,15,249,8616,2584,6032,8616,523,0.02924791086350975,0.7438486536675951,0.0017409470752089136,0.2999071494893222,0.7000928505106778,0.028899721448467967
362,15.0,60,1983,2043,18,330,2944,753,2191,2944,154,0.020380434782608696,0.6735733695652174,0.006114130434782609,0.25577445652173914,0.7442255434782609,0.11209239130434782
363,36.0,1438,36168,37606,379,1860,52027,13715,38315,52030,2923,0.0276379012108399,0.695137420718816,0.007284259081299251,0.26359792427445705,0.736402075725543,0.035748606573130885
364,,212,3264,3476,25,160,4717,1323,3394,4717,303,0.0449438202247191,0.6919652321390715,0.0052999788000848,0.2804748781004876,0.7195251218995125,0.03391986432054272
365,,6378,132642,139020,1697,10837,195167,52839,142328,195167,13283,0.03267970507309125,0.6796333396527077,0.008695117514743783,0.27073736851004526,0.7292626314899547,0.05552680524883818
366,45.0,7145,169030,176175,365,7479,231781,66594,165187,231781,17338,0.03082651295835293,0.7292659881526096,0.0015747623834567975,0.2873143182573205,0.7126856817426795,0.03226752839965312
367,27.0,569,48213,48782,182,2783,65138,18351,46787,65138,5204,0.008735300439067825,0.7401670299978507,0.002794067978752802,0.28172495317633334,0.7182750468236667,0.04272467683993982
368,15.0,160,6815,6975,0,210,8877,2682,6195,8877,701,0.018024107243438097,0.7677143179001915,0.0,0.3021290976681311,0.6978709023318689,0.023656640757012504
369,27.0,1039,22683,23722,131,1373,31727,8977,22750,31727,2339,0.03274813250543701,0.7149431083934819,0.004128975320704762,0.2829451256027989,0.7170548743972012,0.04327544362845526
370,,8814,523204,532018,4041,27500,715779,202602,513177,715779,56678,0.012313856651284824,0.7309574603334269,0.005645597314254819,0.2830510534676206,0.7169489465323794,0.0384196798173738
371,25.0,178,5985,6163,12,245,8255,2324,5931,8255,691,0.021562689279224712,0.725015142337977,0.00145366444579043,0.28152634766807993,0.7184736523319201,0.029678982434887948
372,17.0,1190,53511,54701,73,3720,73299,20930,52369,73299,5582,0.016234873599912686,0.7300372447100233,0.0009959208174736354,0.28554277684552315,0.7144572231544769,0.05075103343838252
373,24.0,353,8094,8447,37,515,11428,3168,8260,11428,721,0.03088904445222261,0.708260413020651,0.003237661883094155,0.27721386069303466,0.7227861393069653,0.04506475323766188
374,14.0,177,3861,4038,8,199,5498,1641,3857,5498,528,0.032193524918152056,0.7022553655874864,0.0014550745725718443,0.2984721716987996,0.7015278283012004,0.03619497999272463
375,14.0,478,14159,14637,34,969,20338,5621,14717,20338,1597,0.023502802635460715,0.6961844822499754,0.0016717474677942767,0.2763791916609303,0.7236208083390697,0.04764480283213689
376,16.0,1366,20814,22180,50,1584,30588,8397,22191,30588,1902,0.04465803583104486,0.6804629266378972,0.0016346279586766052,0.27451941938014907,0.7254805806198509,0.05178501373087485
377,27.0,778,26374,27152,24,1023,35352,10503,24849,35352,2968,0.022007241457343292,0.7460398280153882,0.0006788866259334691,0.29709775967413443,0.7029022403258656,0.02893754243041412
378,,1448,49378,50826,132,1761,66758,19260,47498,66758,6240,0.021690284310494624,0.7396566703616047,0.0019772911111776864,0.2885047484945624,0.7114952515054376,0.026378860960484137
379,,1141,57105,58246,894,4531,81163,21965,59198,81163,6100,0.014058129936054606,0.7035841454850117,0.011014871308354792,0.27062824193290047,0.7293717580670995,0.055825930534849626
380,15.0,598,16350,16948,48,1115,23435,6341,17094,23435,1741,0.025517388521442287,0.6976744186046512,0.002048218476637508,0.27057819500746744,0.7294218049925325,0.04757840836355878
381,14.0,62,18860,18922,142,1467,25900,7117,18783,25900,1734,0.002393822393822394,0.7281853281853282,0.005482625482625483,0.2747876447876448,0.7252123552123552,0.05664092664092664
382,33.0,780,6320,7100,355,385,10241,1910,8331,10241,280,0.07616443706669271,0.617127233668587,0.034664583536763986,0.18650522409920905,0.8134947759007909,0.03759398496240601
383,25.0,2336,31541,33877,121,2511,46214,12999,33215,46214,3002,0.050547453152724284,0.6824988098844506,0.002618254208681352,0.2812784004847016,0.7187215995152983,0.054334184446271694
384,17.0,233,2678,2911,41,113,4330,1134,3196,4330,235,0.053810623556581984,0.6184757505773673,0.009468822170900693,0.26189376443418017,0.7381062355658199,0.026096997690531178
385,25.0,192,6317,6509,29,346,8651,2473,6178,8651,636,0.02219396601548954,0.7302046006242053,0.003352213616922899,0.28586290602242515,0.7141370939775749,0.039995376257080106
386,24.0,1105,74639,75744,58,4072,100625,28826,71799,100625,9280,0.010981366459627329,0.7417540372670808,0.0005763975155279503,0.2864695652173913,0.7135304347826087,0.04046708074534162
387,,226,33631,33857,109,1817,45323,12830,32493,45323,4135,0.004986430730534166,0.7420294331796218,0.0024049599541071864,0.28307923129536877,0.7169207687046312,0.040090020519383096
388,44.0,2663,55237,57900,323,2930,78204,21988,56232,78220,4789,0.03404500127844541,0.7061748913321401,0.004129378675530555,0.2811045768345692,0.7188954231654309,0.03745845052416262
389,17.0,3630,94797,98427,151,3434,129840,37873,91967,129840,10825,0.027957486136783734,0.7301062846580406,0.001162969808995687,0.2916897720271103,0.7083102279728897,0.026447935921133703
390,23.0,359,18114,18473,57,258,22569,7063,15506,22569,1719,0.01590677477956489,0.8026053436129204,0.002525588196198325,0.3129513935043644,0.6870486064956356,0.01143160973016084
391,23.0,1258,34161,35419,189,2107,45813,12920,32893,45813,3060,0.027459454739920983,0.7456617117412089,0.004125466570624059,0.2820160216532425,0.7179839783467574,0.045991312509549694
392,,3993,91675,95668,426,4042,126829,36539,90290,126829,10059,0.031483335830133484,0.7228236444346324,0.0033588532591126634,0.28809657097351554,0.7119034290264845,0.03186968280125208
393,15.0,85,8646,8731,71,789,12084,3263,8821,12084,856,0.007034094670638862,0.7154915590863953,0.005875537901357166,0.2700264812975836,0.7299735187024164,0.06529294935451838
394,16.0,63,1515,1578,2,55,2215,583,1632,2215,221,0.028442437923250564,0.6839729119638827,0.0009029345372460496,0.2632054176072235,0.7367945823927765,0.024830699774266364
395,35.0,1579,46282,47861,126,2060,63501,18490,45014,63504,4718,0.024864575459813555,0.7288044847568657,0.001984126984126984,0.2911627614008566,0.7088372385991434,0.03243890148652053
396,14.0,157,1463,1620,38,91,2327,630,1697,2327,140,0.06746884400515686,0.6287064890416846,0.01633003867640739,0.2707348517404383,0.7292651482595617,0.03910614525139665
397,25.0,72,1813,1885,8,106,2567,740,1827,2567,197,0.028048305414881184,0.7062719127386053,0.0031164783794312427,0.28827425009738994,0.7117257499026101,0.04129333852746397
398,23.0,124,38875,38999,123,1707,51316,14746,36570,51316,4635,0.002416400342972952,0.7575609946215606,0.0023969132434328473,0.2873567698183802,0.7126432301816198,0.0332644789149583
399,25.0,920,14730,15650,154,1341,21535,5984,15551,21535,1720,0.0427211516136522,0.6840027861620618,0.007151149291850476,0.27787322962618993,0.7221267703738101,0.06227072208033434
400,16.0,5,2314,2319,6,339,3352,886,2466,3352,219,0.0014916467780429594,0.6903341288782816,0.0017899761336515514,0.26431980906921243,0.7356801909307876,0.10113365155131265
401,,560,8933,9493,34,480,12651,3570,9081,12651,785,0.04426527547229468,0.7061101889178721,0.0026875345822464625,0.28219113113587857,0.7178088688641214,0.0379416646905383
402,,1333,20599,21932,105,1600,30580,8373,22207,30580,2141,0.04359058207979071,0.6736102027468934,0.0034336167429692608,0.2738064094179202,0.7261935905820798,0.052321778940483975
403,17.0,235,6205,6440,50,216,8544,2432,6112,8544,653,0.027504681647940076,0.7262406367041199,0.005852059925093633,0.2846441947565543,0.7153558052434457,0.025280898876404494
404,41.0,89,2068,2157,4,119,2871,818,2053,2871,204,0.03099965168930686,0.7203065134099617,0.0013932427725531174,0.2849181469871125,0.7150818530128875,0.04144897248345524
405,37.0,117,8009,8126,17,670,11005,3086,7919,11005,804,0.010631531122217174,0.7277601090413448,0.0015447523852794185,0.28041799182189914,0.7195820081781009,0.06088141753748296
406,,359,11412,11771,41,579,15518,4421,11097,15518,1175,0.023134424539244747,0.735404046913262,0.0026420930532285087,0.28489496069081066,0.7151050393091893,0.03731150921510504
407,16.0,132,4028,4160,11,248,5492,1585,3907,5492,408,0.02403495994173343,0.7334304442825929,0.002002913328477786,0.2886016023306628,0.7113983976693372,0.04515659140568099
408,,134,3776,3910,3,138,5081,1494,3587,5081,393,0.026372761267467033,0.7431607951190711,0.000590434953749262,0.29403660696713246,0.7059633930328676,0.02716000787246605
409,,250,5720,5970,0,306,8197,2257,5940,8197,641,0.0304989630352568,0.6978162742466756,0.0,0.2753446382822984,0.7246553617177016,0.03733073075515433
410,,867,16074,16941,0,872,22780,6603,16177,22780,1837,0.03805970149253731,0.7056189640035119,0.0,0.2898595258999122,0.7101404741000878,0.0382791922739245
411,,309,8084,8393,12,481,11122,3134,7988,11122,812,0.027782772882575076,0.7268476892645208,0.001078942636216508,0.2817838518252113,0.7182161481747887,0.04324761733501169
412,26.0,951,26890,27841,83,1462,37139,10551,26588,37139,2960,0.02560650529093406,0.7240367268908694,0.0022348474649290504,0.28409488677670375,0.7159051132232963,0.039365626430437006
413,,928,20071,20999,113,2238,29305,8226,21079,29305,1019,0.03166695103224706,0.684900187681283,0.0038559972700904282,0.2807029517147244,0.7192970482852755,0.07636922026957857
414,37.0,218,6691,6909,4,333,9182,2629,6553,9182,786,0.023742104116750165,0.7287083424090612,0.00043563493792202136,0.28632106294924853,0.7136789370507515,0.036266608582008274
415,27.0,94,2867,2961,4,100,3851,1114,2737,3851,302,0.024409244352116333,0.7444819527395482,0.001038691249026227,0.2892755128538042,0.7107244871461957,0.025967281225655673
416,,78,1604,1682,2,107,2272,632,1640,2272,157,0.03433098591549296,0.7059859154929577,0.0008802816901408451,0.27816901408450706,0.721830985915493,0.04709507042253521
417,,135,1929,2064,7,111,2708,778,1930,2708,176,0.04985228951255539,0.7123338257016248,0.00258493353028065,0.28729689807976366,0.7127031019202363,0.04098966026587888
418,25.0,0,3420,3420,132,388,5206,1298,3908,5206,340,0.0,0.656934306569343,0.025355359200922013,0.24932769880906647,0.7506723011909335,0.07452938916634652
419,36.0,4493,108523,113016,453,4567,150497,42313,108184,150497,11034,0.029854415702638592,0.721097430513565,0.0030100267779424174,0.2811551060818488,0.7188448939181512,0.030346119856209757
420,15.0,772,12645,13417,43,718,17879,5194,12685,17879,1375,0.043179148721964315,0.7072543207114492,0.0024050562111974944,0.2905084176967392,0.7094915823032608,0.040158845573018624
421,,362,16637,16999,35,857,22445,6471,15974,22445,2017,0.016128313655602584,0.741234127868122,0.001559367342392515,0.28830474493205616,0.7116952550679438,0.03818222321229672
422,23.0,39,7763,7802,15,350,10341,2983,7358,10341,846,0.0037713954163040323,0.7507010927376463,0.001450536698578474,0.28846339812397254,0.7115366018760274,0.033845856300164394
423,25.0,2820,54831,57651,218,3458,78086,21462,56624,78086,5141,0.03611402812283892,0.7021873319160925,0.0027917936633967675,0.27485080552211666,0.7251491944778834,0.044284506825807445
424,,119,5919,6038,4,267,7965,2319,5646,7965,720,0.014940364092906467,0.7431261770244821,0.0005021971123666039,0.2911487758945386,0.7088512241054614,0.03352165725047081
425,17.0,1582,41264,42846,75,2228,55281,16076,39205,55281,3518,0.02861742732584432,0.7464409109820734,0.0013567048352960329,0.2908051590962537,0.7091948409037463,0.040303178307194154
426,,196,1584,1780,14,99,2490,667,1823,2490,141,0.078714859437751,0.636144578313253,0.005622489959839358,0.2678714859437751,0.7321285140562249,0.03975903614457831
427,17.0,1553,36065,37618,207,1369,49187,14439,34748,49187,3698,0.03157338321101104,0.7332221928558359,0.004208429056458007,0.29355317461930996,0.70644682538069,0.027832557383048368
428,42.0,266,6470,6736,18,320,8897,2554,6343,8897,743,0.02989771833202203,0.7272114195796335,0.0020231538720917163,0.28706305496234685,0.7129369450376531,0.03596717994829718
429,23.0,130,2355,2485,3,86,3391,968,2423,3391,197,0.038336773813034505,0.694485402536125,0.0008846947803007962,0.2854615157770569,0.7145384842229431,0.025361250368622825
430,,844,24820,25664,68,621,35612,9945,25667,35612,2746,0.02369987644614175,0.6969560822194766,0.001909468718409525,0.27925980006739304,0.720740199932607,0.01743794226665169
431,25.0,165,3443,3608,18,216,5402,1358,4044,5402,353,0.030544242873009997,0.6373565346168086,0.0033320992225101815,0.2513883746760459,0.7486116253239541,0.03998519067012218
432,,235,3582,3817,8,298,5193,1455,3738,5193,341,0.04525322549585981,0.6897746967071057,0.0015405353360292702,0.2801848642403235,0.7198151357596765,0.05738494126709032
433,,140,3838,3978,57,146,5195,1584,3611,5195,408,0.026948989412897015,0.7387872954764196,0.0109720885466795,0.3049085659287777,0.6950914340712223,0.028103946102021174
434,,149,3503,3652,19,460,5261,1388,3873,5261,271,0.028321611860862954,0.6658429956282076,0.003611480707089907,0.2638281695495153,0.7361718304504847,0.08743584869796617
435,,446,9923,10369,39,664,13918,3946,9972,13918,988,0.03204483402787757,0.7129616324184509,0.0028021267423480383,0.28351774680270153,0.7164822531972984,0.047708004023566605
436,,198,2540,2738,43,137,3617,1049,2568,3617,195,0.05474149847940282,0.7022394249377938,0.011888305225324854,0.29001935305501797,0.709980646944982,0.03787669339231407
437,23.0,208,5290,5498,15,262,7411,2099,5312,7411,586,0.02806638780191607,0.7138038051545,0.002024018351099717,0.28322763459722033,0.7167723654027797,0.03535285386587505
438,24.0,293,5788,6081,1,318,8043,2330,5713,8043,617,0.03642919308715653,0.7196319781176178,0.00012433171702101205,0.2896929006589581,0.7103070993410419,0.03953748601268184
439,16.0,265,16248,16513,62,860,22230,6358,15872,22230,1778,0.011920827710301394,0.7309041835357625,0.0027890238416554206,0.28600989653621234,0.7139901034637877,0.038686459739091315
440,,89,2869,2958,0,149,3924,1131,2793,3924,299,0.0226809378185525,0.7311416921508664,0.0,0.2882262996941896,0.7117737003058104,0.03797145769622834
441,25.0,57,1341,1398,0,110,1973,539,1434,1973,127,0.02889001520527116,0.6796756208819057,0.0,0.27318803852002027,0.7268119614799797,0.055752660922453116
442,27.0,134,3994,4128,41,302,5751,1571,4180,5751,424,0.023300295600765086,0.6944879151451921,0.0071291949226221524,0.273169883498522,0.726830116501478,0.05251260650321683
443,23.0,415,7885,8300,33,407,11126,3137,7989,11126,857,0.03730001797591228,0.7087003415423333,0.0029660255257954343,0.2819521840733417,0.7180478159266582,0.03658098148481036
444,42.0,171,3397,3568,11,189,4859,1346,3513,4859,320,0.03519242642519037,0.6991150442477876,0.002263840296357275,0.2770117308088084,0.7229882691911916,0.03889689236468409
445,15.0,1255,39116,40371,171,3281,54674,14577,40097,54674,4344,0.022954237846142592,0.7154406116252697,0.0031276292204704247,0.2666166733730841,0.7333833266269159,0.06001024252844131
446,,228,7412,7640,30,391,9927,2870,7057,9927,763,0.022967663946811726,0.7466505490077566,0.0030220610456331218,0.289110506698902,0.710889493301098,0.03938752896141835
447,24.0,65,3570,3635,19,60,4911,1350,3561,4911,497,0.013235593565465283,0.7269395235186317,0.003868865811443698,0.2748930971288943,0.7251069028711057,0.012217470983506415
448,17.0,1012,23996,25008,73,1119,33313,9670,23643,33313,2744,0.03037853090385135,0.7203193948308468,0.0021913367153963918,0.2902770690120974,0.7097229309879026,0.033590490199021404
449,27.0,319,10699,11020,53,411,14736,4108,10628,14736,1157,0.021647665580890336,0.7260450597176982,0.0035966340933767642,0.27877307274701413,0.7212269272529859,0.02789087947882736
450,17.0,515,10078,10593,39,668,14345,4038,10307,14345,1051,0.03590101080515859,0.7025444405716278,0.002718717323109097,0.2814918089926804,0.7185081910073197,0.04656674799581736
451,,192,6323,6515,8,271,8480,2498,5989,8487,663,0.022622834924001415,0.7450217980440674,0.0009426181218333922,0.2943325085424767,0.7056674914575233,0.031931188877106165
452,,92,3190,3282,19,139,4287,1237,3050,4287,329,0.02146022859808724,0.7441101003032423,0.004432003732213669,0.2885467693025426,0.7114532306974575,0.0324236062514579
453,,1321,25526,26847,219,1421,34947,10287,24660,34947,2121,0.03780009729018228,0.7304203508169513,0.006266632328955275,0.29436003090394025,0.7056399690960597,0.040661573239476924
454,,927,23706,24633,69,890,32587,9382,23205,32587,2847,0.028446926688556785,0.7274680087151318,0.0021174087826433853,0.28790622027188756,0.7120937797281124,0.02731150458771903
455,23.0,1665,33851,35516,118,2113,48254,13624,34630,48254,3428,0.034504911509926635,0.7015169726862022,0.002445393128030837,0.282339287934679,0.717660712065321,0.043789115928213204
456,23.0,375,13897,14272,13,724,18720,5437,13283,18720,1585,0.020032051282051284,0.7423611111111111,0.0006944444444444445,0.2904380341880342,0.7095619658119658,0.03867521367521368
457,25.0,3944,73323,77267,273,4931,102419,28602,73817,102419,6804,0.03850847987189877,0.7159120866245521,0.0026655210458996865,0.2792645895781056,0.7207354104218944,0.048145363653228405
458,,470,9085,9555,66,287,12322,3558,8764,12322,929,0.0381431585781529,0.7372991397500406,0.005356273332251258,0.28875182600227234,0.7112481739977277,0.023291673429638046
459,24.0,138,3264,3402,38,197,4594,1313,3281,4594,291,0.030039181541140617,0.7104919460165433,0.00827165868524162,0.28580757509795385,0.7141924249020462,0.04288202002612103
460,27.0,139,3562,3701,16,179,5209,1428,3781,5209,349,0.026684584373200232,0.683816471491649,0.0030716068343252063,0.2741409099635247,0.7258590900364753,0.034363601459013245
461,14.0,1222,10741,11963,224,1480,17138,4530,12608,17138,801,0.0713035360018672,0.6267359085074105,0.013070369938149142,0.2643248920527483,0.7356751079472518,0.08635780137705683
462,,123,2830,2953,1,202,4086,1174,2912,4086,259,0.03010279001468429,0.6926089084679393,0.0002447381302006853,0.2873225648556045,0.7126774351443955,0.049437102300538424
463,17.0,44,6575,6619,82,669,9387,2447,6940,9387,563,0.004687333546393949,0.7004367742622776,0.008735485245552359,0.2606796633642271,0.7393203366357729,0.07126877596676254
464,23.0,102,1542,1644,6,140,2303,636,1667,2303,175,0.04429005644811116,0.6695614415979158,0.0026052974381241857,0.2761615284411637,0.7238384715588363,0.060790273556231005
465,,139,1895,2034,5,174,2783,764,2019,2783,166,0.04994610132950054,0.6809198706431908,0.0017966223499820337,0.2745238950772548,0.7254761049227453,0.06252245777937478
466,,559,14617,15176,65,672,19996,5690,14306,19996,1567,0.027955591118223645,0.7309961992398479,0.003250650130026005,0.28455691138227646,0.7154430886177235,0.033606721344268856
467,38.0,170,4658,4828,10,242,6575,1848,4727,6575,561,0.02585551330798479,0.7084410646387833,0.001520912547528517,0.28106463878327,0.7189353612167301,0.03680608365019011
468,,4989,145690,150679,647,6029,199974,57336,142638,199974,14820,0.02494824327162531,0.7285447108124056,0.003235420604678608,0.28671727324552193,0.7132827267544781,0.030148919359516736
469,14.0,839,15348,16187,106,1153,21938,6081,15857,21938,1509,0.038244142583644815,0.699607986142766,0.004831798705442611,0.2771902634697785,0.7228097365302215,0.052557206673352175
470,,73,15405,15519,50,1355,21190,5951,15239,21190,2005,0.0034450212364322795,0.7269938650306749,0.0023596035865974517,0.2808400188768287,0.7191599811231713,0.06394525719679094
471,,458,16301,16759,12,709,21605,6367,15238,21605,1609,0.021198796574866927,0.7545012728535061,0.0005554269844943301,0.2947003008562833,0.7052996991437167,0.03281647766720667
472,13.0,30,1663,1693,3,85,2212,632,1580,2212,178,0.013562386980108499,0.7518083182640145,0.00135623869801085,0.2857142857142857,0.7142857142857143,0.03842676311030741
473,17.0,577,15432,16009,48,834,20756,6101,14655,20756,1553,0.02779919059549046,0.7434958566197726,0.0023125843129697438,0.29393910194642514,0.7060608980535749,0.040181152437849296
474,45.0,289,5272,5561,131,209,7485,2127,5358,7485,435,0.03861055444221777,0.7043420173680695,0.017501670006680025,0.2841683366733467,0.7158316633266533,0.02792251169004676
475,24.0,463,9388,9851,21,524,13388,3711,9677,13388,941,0.034583208843740665,0.7012249775918733,0.001568568867642665,0.27718852703913954,0.7228114729608605,0.039139527935464595
476,25.0,45947,1297996,1343943,2328,86016,1757326,500577,1256749,1757326,117221,0.026145974053761227,0.7386199259556849,0.0013247399742563417,0.28485153010881303,0.715148469891187,0.048947093481801325
477,,10777,242881,253658,862,14395,341424,95525,245899,341424,24052,0.03156485777215427,0.7113764703125732,0.0025247199962509957,0.2797840807910399,0.7202159192089601,0.042161652373588265
478,17.0,97,1587,1684,6,93,2329,662,1667,2329,176,0.04164877629884071,0.6814083297552598,0.0025762129669386004,0.28424216401889224,0.7157578359811078,0.0399313009875483
479,34.0,488,4855,5343,142,380,7878,2019,5859,7878,473,0.061944656004061946,0.6162731657781163,0.018024879411018026,0.2562833206397563,0.7437166793602438,0.048235592790048236
480,,91,2115,2206,5,60,2935,876,2059,2935,275,0.03100511073253833,0.7206132879045997,0.0017035775127768314,0.2984667802385009,0.7015332197614992,0.020442930153321975
481,27.0,568,19413,19981,29,1080,26233,7683,18550,26233,2071,0.02165211756184958,0.7400221095566653,0.0011054778332634468,0.2928753859642435,0.7071246140357564,0.04116951930774216
482,25.0,4944,96765,101709,543,4538,132992,38451,94541,132992,9126,0.03717516843118383,0.727600156400385,0.004082952358036573,0.2891226539942252,0.7108773460057748,0.03412235322425409
483,26.0,4852,109636,114488,624,5832,149916,43610,106306,149916,10100,0.03236479094959844,0.7313162037407615,0.004162330905306972,0.29089623522505936,0.7091037647749406,0.03890178499959977
484,23.0,214,1810,2024,12,116,2792,783,2009,2792,184,0.07664756446991404,0.6482808022922636,0.004297994269340974,0.2804441260744986,0.7195558739255015,0.04154727793696275
485,,9264,210520,219784,2281,9156,291327,83227,208100,291327,22931,0.03179931829181641,0.7226244048783669,0.007829689661445729,0.28568241186021204,0.714317588139788,0.03142860085059057
486,,384,6375,6759,95,460,9295,2589,6706,9295,590,0.041312533620225925,0.685852608929532,0.010220548682087143,0.278536847767617,0.721463152232383,0.04948897256589564
487,17.0,228,5976,6204,49,640,8622,2278,6344,8622,606,0.026443980514961725,0.6931106471816284,0.0056831361633031775,0.26420784040825795,0.735792159591742,0.07422871723498028
488,,585,12144,12729,74,970,17185,4818,12367,17185,1188,0.034041315100378236,0.7066627873145185,0.00430608088449229,0.2803607797497818,0.7196392202502182,0.05644457375618272
489,14.0,529,25644,26173,77,2294,37469,9799,27670,37469,2767,0.014118337825936108,0.6844057754410312,0.0020550321599188664,0.2615228588966879,0.7384771411033121,0.061223945127972454
490,26.0,2762,61528,64290,513,21306,119744,24353,95391,119744,6177,0.02306587386424372,0.5138295029396045,0.004284139497594869,0.20337553447354356,0.7966244655264565,0.17792958311063603
491,16.0,299,4906,5205,5,242,7056,2060,4996,7056,518,0.04237528344671202,0.6952947845804989,0.0007086167800453515,0.2919501133786848,0.7080498866213152,0.03429705215419501
492,24.0,1597,42795,44392,294,1949,58261,16992,41269,58261,4132,0.027411132661643293,0.7345394002849247,0.005046257359125316,0.29165307838863047,0.7083469216113695,0.03345291018005184
493,27.0,172,5476,5648,19,302,7660,2175,5485,7660,613,0.022454308093994776,0.7148825065274151,0.0024804177545691905,0.2839425587467363,0.7160574412532638,0.039425587467362924
494,15.0,122,2076,2198,28,182,3064,793,2271,3064,171,0.03981723237597911,0.6775456919060052,0.009138381201044387,0.2588120104438642,0.7411879895561357,0.05939947780678851
495,25.0,30,2104,2134,3,135,3117,827,2290,3117,222,0.009624639076034648,0.6750080205325634,0.0009624639076034649,0.2653192171960218,0.7346807828039782,0.04331087584215592
496,,1887,31469,33356,255,1679,43263,12728,30535,43263,2540,0.04361694750710769,0.7273882994706793,0.005894182095555093,0.2942005871067656,0.7057994128932344,0.03880914407230197
497,13.0,132,1761,1893,37,559,3089,727,2362,3089,116,0.04273227581741664,0.5700874069278083,0.011977986403366786,0.23535124635804466,0.7646487536419553,0.1809647134995144
498,26.0,2552,43868,46420,189,1962,61128,17729,43399,61128,3968,0.04174846224316189,0.7176416699384898,0.0030918727915194345,0.2900307551367622,0.7099692448632378,0.03209658421672556
499,27.0,1190,26067,27257,50,2041,37455,10532,26923,37455,2991,0.03177145908423441,0.6959551461754105,0.0013349352556401015,0.28119076224803097,0.718809237751969,0.05449205713522894
500,23.0,407,9714,10121,53,458,13735,3850,9885,13735,1013,0.02963232617400801,0.7072442664725155,0.0038587550054605024,0.28030578813250817,0.7196942118674918,0.03334546778303604
501,17.0,178,10461,10639,99,1402,15588,3846,11742,15588,1110,0.011419040287400565,0.6710931485758276,0.006351039260969977,0.24672825250192457,0.7532717474980755,0.0899409802412112
502,,532,11759,12291,118,476,16120,4635,11485,16120,1218,0.03300248138957816,0.7294665012406948,0.007320099255583127,0.287531017369727,0.7124689826302729,0.029528535980148884
503,,388,8687,9075,55,461,12339,3436,8903,12339,906,0.031445011751357485,0.7040278790825837,0.004457411459599644,0.2784666504578977,0.7215333495421022,0.037361212415917014
504,,92,2295,2387,6,78,3102,912,2190,3102,240,0.029658284977433915,0.7398452611218569,0.0019342359767891683,0.2940038684719536,0.7059961315280464,0.025145067698259187
505,,2351,58580,60931,403,2256,77212,23294,53919,77213,5009,0.030448240581249272,0.7586805330708559,0.00521932835144341,0.30168494942561486,0.6983150505743851,0.029217877818502064
506,,2067,54958,57025,244,2545,76221,21545,54676,76221,5903,0.027118510646672176,0.721034885399037,0.003201217512234161,0.2826648823814959,0.7173351176185041,0.03338974823211451
507,,2166,45580,47746,188,2757,64548,18258,46290,64548,4545,0.03355642312697527,0.7061411662638657,0.0029125611947697838,0.2828592675218442,0.7171407324781558,0.04271240007436326
508,15.0,229,7685,7914,30,432,10662,3050,7612,10662,952,0.021478146689176515,0.7207840930407053,0.0028137310073157004,0.28606265241042955,0.7139373475895704,0.04051772650534609
509,25.0,1256,22240,23496,125,1728,31779,8882,22897,31779,2225,0.03952295541080588,0.6998332231977091,0.003933415148368419,0.2794927467824664,0.7205072532175336,0.05437553101104503
510,40.0,6248,120648,126896,1540,4169,164163,48057,116106,164163,8721,0.038059733313840514,0.7349280897644415,0.00938092018298886,0.29273953326876334,0.7072604667312367,0.025395491066805553
511,13.0,1153,3345,4498,59,496,6378,1686,4692,6378,208,0.18077767325180308,0.5244590780809031,0.0092505487613672,0.264346190028222,0.735653809971778,0.07776732518030731
512,24.0,549,15648,16197,53,982,21465,6064,15401,21465,1573,0.025576519916142557,0.7290006988120196,0.0024691358024691358,0.28250640577684605,0.717493594223154,0.045748893547635686
513,,50,1507,1557,8,36,2148,595,1553,2148,221,0.023277467411545624,0.7015828677839852,0.0037243947858473,0.2770018621973929,0.722998137802607,0.01675977653631285
514,16.0,376,10936,11312,42,1058,15623,4250,11373,15623,1107,0.02406708058631505,0.6999935991806951,0.0026883441080458297,0.2720348204570185,0.7279651795429815,0.06772066824553542
515,,649,14305,14954,127,698,20070,5704,14366,20070,1450,0.0323368211260588,0.7127553562531141,0.0063278525161933235,0.28420528151469854,0.7157947184853014,0.034778276033881415
516,,1555,12049,13604,64,753,18233,5304,12929,18233,1461,0.0852849229419185,0.6608347501782482,0.0035101190149728514,0.29090111336587504,0.7090988866341249,0.04129874403553996
517,,2711,52707,55418,365,2453,72968,21061,51907,72968,4835,0.03715327266747067,0.7223303365859006,0.005002192742023901,0.2886333735336038,0.7113666264663963,0.03361747615393049
518,47.0,645,14124,14769,163,677,19176,5695,13481,19176,1344,0.03363579474342929,0.7365456821026283,0.008500208594075928,0.2969858156028369,0.7030141843971631,0.03530454735085523
519,14.0,131,2190,2321,3,182,3293,883,2410,3293,234,0.03978135438809596,0.6650470695414515,0.0009110233829334953,0.26814454904342544,0.7318554509565746,0.05526875189796538
520,24.0,86,2527,2613,11,149,3511,1005,2506,3511,255,0.024494446026773,0.7197379663913415,0.0031330105383081744,0.28624323554542863,0.7137567644545714,0.04243805183708345
521,,883,16961,17844,93,838,24102,6743,17359,24102,1655,0.03663596382042984,0.7037175338146212,0.0038586009459795866,0.2797693137498963,0.7202306862501038,0.03476889884656875
522,15.0,382,13658,14040,103,1598,19679,5208,14471,19679,1309,0.01941155546521673,0.6940393312668327,0.005234005792977285,0.2646475938818029,0.7353524061181971,0.08120331317648255
523,16.0,2052,37954,40006,888,2850,55413,15672,39741,55413,4011,0.037031021601429265,0.684929529171855,0.016025120459098045,0.2828217205348925,0.7171782794651075,0.05143197444642954
524,15.0,62,1459,1521,21,74,2057,546,1511,2057,157,0.030140982012639768,0.7092853670393777,0.010209042294603793,0.2654350996596986,0.7345649003403014,0.03597472046669908
525,27.0,1051,10163,11214,97,804,15158,4325,10833,15158,747,0.06933632405330518,0.6704710383955667,0.006399261116242248,0.2853278796675023,0.7146721203324977,0.05304129832431719
526,,168,4187,4355,25,254,5819,1621,4198,5819,459,0.028870940024059117,0.7195394397662829,0.004296270836913559,0.27857020106547514,0.7214297989345249,0.04365011170304176
527,25.0,4031,81183,85214,594,4308,113823,32569,81254,113823,7722,0.0354146350034703,0.7132389763053162,0.0052186289238554595,0.28613724818358327,0.7138627518164167,0.037848238053820406
528,15.0,1383,35861,37244,344,1138,47852,14009,33843,47852,3301,0.028901613307698738,0.7494148624926857,0.007188832232717546,0.2927568335701747,0.7072431664298253,0.023781660118699324
529,,63,2518,2581,7,135,3425,979,2446,3425,291,0.018394160583941607,0.7351824817518248,0.0020437956204379564,0.28583941605839414,0.7141605839416059,0.03941605839416058
530,,94,11201,11295,12,1195,16008,4248,11760,16008,1299,0.005872063968015992,0.6997126436781609,0.0007496251874062968,0.2653673163418291,0.7346326836581709,0.07465017491254373
531,34.0,0,2909,2909,0,6,3857,1152,2705,3857,421,0.0,0.7542131190044076,0.0,0.29867772880477056,0.7013222711952295,0.00155561317085818
532,16.0,252,6487,6739,47,782,10700,2514,8186,10700,709,0.02355140186915888,0.6062616822429907,0.004392523364485981,0.2349532710280374,0.7650467289719626,0.07308411214953271
533,41.0,140,2139,2279,40,122,2962,810,2152,2962,157,0.04726536124240378,0.7221471978392978,0.01350438892640108,0.2734638757596219,0.7265361242403782,0.041188386225523295
534,,373,12228,12601,155,506,17360,4780,12580,17360,1229,0.021486175115207375,0.7043778801843318,0.008928571428571428,0.27534562211981567,0.7246543778801844,0.02914746543778802
535,14.0,50,3856,3906,69,539,5601,1479,4122,5601,349,0.008926977325477594,0.688448491340832,0.012319228709159078,0.2640599892876272,0.7359400107123728,0.09623281556864846
536,,435,10585,11020,56,529,14874,4079,10795,14874,1007,0.029245663574021783,0.7116444803011968,0.003764958988839586,0.2742369234906548,0.7257630765093451,0.035565416162431085
537,24.0,10920,168137,179057,1806,10465,244617,67065,177552,244617,15093,0.04464121463348827,0.6873479766328587,0.007382970112461522,0.27416328382737093,0.725836716172629,0.042781164023759595
538,,473,11700,12173,41,723,16276,4699,11577,16276,1253,0.029061194396657657,0.7188498402555911,0.002519046448758909,0.28870729909068565,0.7112927009093143,0.04442123371835832
539,16.0,859,21558,22417,7,1119,29770,8582,21188,29770,2323,0.028854551561975143,0.724151830702049,0.000235136042996305,0.28827678871346996,0.71172321128653,0.03758817601612362
540,25.0,433,5889,6322,49,368,9317,2330,6987,9317,478,0.04647418697005474,0.6320704089299131,0.005259203606311044,0.2500804980143823,0.7499195019856177,0.03949769239025437
541,25.0,1062,26724,27786,167,1389,36582,10433,26149,36582,2523,0.029030670821715596,0.7305232081351485,0.004565086654638894,0.28519490459788965,0.7148050954021103,0.03796949319337379
542,,98,4342,4440,0,182,5597,1640,3957,5597,409,0.0175093800250134,0.7757727353939611,0.0,0.2930141147043059,0.7069858852956942,0.03251742004645346
543,14.0,976,9164,10140,314,796,14393,3906,10487,14393,763,0.06781074133259224,0.6366983950531508,0.021816160633641352,0.2713819217675259,0.7286180782324742,0.05530466198846662
544,23.0,3686,94523,98209,344,4694,130494,37644,92850,130494,10831,0.028246509418057536,0.7243474795776051,0.0026361365273499166,0.28847303324290774,0.7115269667570923,0.03597100249819915
545,17.0,267,13743,14010,0,2078,19030,4249,14781,19030,1148,0.014030478192327903,0.7221755123489227,0.0,0.2232790331056227,0.7767209668943773,0.1091960063058329
546,,437,5587,6024,16,488,8416,2297,6119,8416,559,0.05192490494296578,0.6638545627376425,0.0019011406844106464,0.2729325095057034,0.7270674904942965,0.05798479087452472
547,26.0,3986,220212,224198,886,13937,304095,85271,218824,304095,24186,0.013107745934658577,0.7241552804222364,0.0029135631957118665,0.2804090826879758,0.7195909173120242,0.04583107252667752
548,25.0,765,14084,14849,61,804,19471,5611,13860,19471,1173,0.039289199322068716,0.7233321349699553,0.0031328642596682244,0.2881721534589903,0.7118278465410097,0.04129217811103693
549,27.0,148,3691,3839,6,124,5067,1469,3598,5067,431,0.029208604697059402,0.7284389184922044,0.0011841326228537595,0.2899151371620288,0.7100848628379712,0.024472074205644366
550,37.0,2022,50078,52100,157,1901,68257,19954,48303,68257,5181,0.02962333533556998,0.7336683417085427,0.002300130389557115,0.29233631715428454,0.7076636828457155,0.027850623379287107
551,16.0,178,7509,7687,15,397,10230,2858,7372,10230,834,0.01739980449657869,0.7340175953079179,0.001466275659824047,0.2793743890518084,0.7206256109481916,0.03880742913000978
552,,344,10508,10852,23,545,14321,4023,10298,14321,1134,0.02402066894769918,0.7337476433209972,0.001606033098247329,0.28091613714126107,0.7190838628587389,0.03805600167586062
553,33.0,53,2135,2188,14,93,2841,860,1981,2841,196,0.018655403027103133,0.7514959521295319,0.004927842309046111,0.3027103132699754,0.6972896867300247,0.03273495248152059
554,13.0,10,3338,3348,5,557,5084,1198,3886,5084,336,0.001966955153422502,0.6565696302124312,0.000983477576711251,0.23564122738001572,0.7643587726199843,0.10955940204563336
555,36.0,123,3505,3628,0,172,4861,1385,3476,4861,370,0.025303435507097304,0.7210450524583419,0.0,0.2849207981896729,0.7150792018103271,0.035383665912363714
556,26.0,173,5131,5304,15,138,6899,2000,4899,6899,581,0.025076097985215248,0.7437309755036962,0.0021742281490071025,0.2898970865342803,0.7101029134657196,0.02000289897086534
557,24.0,587,13953,14540,48,802,19461,5519,13942,19461,1463,0.03016288988232876,0.7169724063511639,0.002466471404347156,0.28359282667899904,0.716407173321001,0.041210626380967064
558,23.0,182,22908,23090,154,763,31134,8459,22675,31134,3109,0.0058456992355624075,0.7357872422432068,0.00494636089162973,0.2716965375473759,0.7283034624526241,0.02450696987216548
559,25.0,70,1783,1853,7,59,2590,728,1862,2590,185,0.02702702702702703,0.6884169884169884,0.002702702702702703,0.2810810810810811,0.7189189189189189,0.02277992277992278
560,17.0,240,5700,5940,7,334,8279,2257,6022,8279,598,0.028989008334339896,0.6884889479405726,0.0008455127430849137,0.27261746587752145,0.7273825341224786,0.040343036598623025
561,,65831,1264643,1330474,5598,65469,1808532,501883,1306649,1808532,126148,0.03640024063715765,0.6992649286824895,0.0030953281445946215,0.2775084986054988,0.7224915013945011,0.03620007829554578
562,23.0,48,8525,8573,24,475,11469,3288,8181,11469,989,0.00418519487313628,0.7433080477809748,0.00209259743656814,0.2866858488098352,0.7133141511901648,0.041415990932077776
563,,633,13440,14073,1,558,19095,5510,13585,19095,1461,0.03315003927729772,0.7038491751767478,5.2369730295888974e-05,0.2885572139303483,0.7114427860696517,0.02922230950510605
564,,1349,19941,21290,1189,1823,30888,8073,22815,30888,1846,0.04367391867391868,0.6455905205905206,0.03849391349391349,0.26136363636363635,0.7386363636363636,0.05901968401968402
565,24.0,155,3669,3824,12,168,5158,1479,3679,5158,389,0.030050407134548273,0.7113222179139201,0.0023264831329972858,0.2867390461419155,0.7132609538580845,0.032570763861962
566,35.0,338,13339,13677,18,672,17927,5222,12705,17927,1422,0.01885424220449601,0.7440731856975512,0.0010040720700619178,0.29129246388129637,0.7087075361187036,0.037485357282311595
567,27.0,225,5504,5729,18,314,7858,2181,5677,7858,618,0.028633240010180708,0.7004326800712649,0.0022906592008144567,0.2775515398320183,0.7224484601679817,0.0399592771697633
568,24.0,149,7256,7405,36,614,10179,2826,7353,10179,893,0.014637980155221535,0.7128401611160232,0.0035366931918656055,0.27763041556145,0.7223695844385499,0.06032026721681894
569,,1618,32615,34233,121,1865,45552,13027,32525,45552,3650,0.035519845451352304,0.7159949069195645,0.0026563048823322797,0.28598085704250087,0.7140191429574991,0.040942219880576045
570,42.0,54,2092,2146,0,62,2748,854,1894,2748,203,0.019650655021834062,0.7612809315866085,0.0,0.31077147016011647,0.6892285298398836,0.022561863173216887
571,27.0,187,5024,5211,30,277,6902,1972,4930,6902,496,0.027093596059113302,0.7279049550854825,0.004346566212691973,0.2857142857142857,0.7142857142857143,0.04013329469718922
572,,43,3677,3720,26,229,5021,1428,3593,5021,437,0.008564031069508066,0.7323242381995618,0.005178251344353714,0.28440549691296557,0.7155945030870344,0.04560844453296156
573,16.0,1602,30078,31680,32,1591,44855,11848,33013,44861,2748,0.03571030516484251,0.6704710104545151,0.0007133144602215734,0.26410467889703754,0.7358953211029625,0.03546510331914135
574,,15398,468992,484390,990,25052,637158,184255,452903,637158,46823,0.024166690208708045,0.7360686046475129,0.0015537747309144671,0.28918258893398496,0.710817411066015,0.03931834803926185
575,15.0,95,1507,1602,3,114,2145,636,1509,2145,153,0.04428904428904429,0.7025641025641025,0.0013986013986013986,0.2965034965034965,0.7034965034965035,0.05314685314685315
576,26.0,128,2710,2838,3,124,3747,1083,2664,3747,261,0.03416066186282359,0.7232452628769682,0.0008006405124099279,0.289031224979984,0.710968775020016,0.033093141179610354
577,,270,2620,2890,13,167,4163,1091,3072,4163,332,0.06485707422531828,0.629353831371607,0.0031227480182560653,0.2620706221474898,0.7379293778525102,0.04011530146528945
578,,60,2246,2306,8,128,3168,867,2301,3168,265,0.01893939393939394,0.7089646464646465,0.0025252525252525255,0.27367424242424243,0.7263257575757576,0.04040404040404041
579,35.0,170,4497,4667,32,208,6301,1807,4494,6301,499,0.026979844469131885,0.7136962386922711,0.005078558958895413,0.28677987621012535,0.7132201237898746,0.033010633232820184
580,13.0,551,16071,16622,98,3186,24661,6334,18327,24661,1806,0.022342970682454076,0.6516767365475853,0.003973885892705081,0.25684278820810186,0.7431572117918981,0.12919184136896314
581,15.0,228,1902,2130,14,157,2927,799,2164,2963,209,0.07694903813702329,0.6419169760377995,0.004724940938238272,0.26965912926088426,0.7303408707391158,0.05298683766452919
582,26.0,123,4273,4396,10,184,5992,1658,4334,5992,449,0.020527369826435247,0.7131174899866488,0.0016688918558077437,0.2767022696929239,0.7232977303070761,0.030707610146862484
583,16.0,146,1983,2129,11,164,2925,811,2114,2925,175,0.049914529914529916,0.6779487179487179,0.0037606837606837607,0.27726495726495726,0.7227350427350427,0.05606837606837607
584,,448,8158,8606,41,502,11522,3151,8371,11522,892,0.038882138517618466,0.7080367991668113,0.0035584099982641903,0.2734768269397674,0.7265231730602326,0.043568824856795696
585,33.0,224,2922,3146,7,116,4030,1216,2814,4030,273,0.055583126550868486,0.7250620347394541,0.0017369727047146402,0.30173697270471467,0.6982630272952853,0.028784119106699754
586,15.0,100,4197,4297,5,330,5946,1622,4324,5946,551,0.016818028927009756,0.7058526740665994,0.0008409014463504877,0.2727884291960982,0.7272115708039018,0.055499495459132187
587,,193,2398,2591,35,153,4261,972,3289,4261,205,0.04529453180004694,0.5627786904482516,0.008214034264257217,0.22811546585308612,0.7718845341469138,0.03590706406946726
588,,1878,32079,34253,226,2515,48281,12863,35418,48281,3400,0.03889728878855036,0.6644228578529856,0.004680930386694559,0.2664195024958058,0.7335804975041942,0.05209088461299476
589,,245,9302,9547,52,476,12732,3484,9248,12732,976,0.019242852654728245,0.7306000628338046,0.004084197298146403,0.273641218975809,0.726358781024191,0.0373861137291863
590,15.0,1136,23372,24508,112,1155,32530,9359,23171,32530,2553,0.03492161082078082,0.7184752536120504,0.003442975714724869,0.2877036581616969,0.7122963418383031,0.03550568705810021
591,17.0,743,11622,12907,144,829,17804,4694,13111,17805,1162,0.041729851165402974,0.6527379949452401,0.008087615838247682,0.2636338107273238,0.7363661892726762,0.046559955068800896
592,26.0,57,1800,1857,30,81,2480,702,1778,2480,176,0.022983870967741935,0.7258064516129032,0.012096774193548387,0.2830645161290323,0.7169354838709677,0.032661290322580645
593,25.0,194,3710,3904,8,209,5570,1511,4059,5570,344,0.0348294434470377,0.6660682226211849,0.001436265709156194,0.27127468581687614,0.7287253141831239,0.03752244165170557
594,40.0,150,3508,3658,11,155,5057,1329,3728,5057,331,0.029661854854656913,0.6936919122009096,0.002175202689341507,0.2628040340122602,0.7371959659877397,0.030650583349812143
595,25.0,213,7541,7754,17,548,10452,2930,7522,10452,718,0.020378874856486796,0.7214887102946804,0.0016264829697665518,0.2803291236127057,0.7196708763872943,0.052430156907768845
596,,451,11819,12270,29,412,15632,4781,10851,15632,1101,0.0288510747185261,0.7560772773797338,0.0018551688843398157,0.30584698055271237,0.6941530194472876,0.026356192425793245
597,,370,8508,8878,25,371,11651,3369,8282,11651,887,0.03175693073555918,0.730237747832804,0.002145738563213458,0.2891597287786456,0.7108402712213544,0.03184276027808772
598,,721,11650,12371,33,863,16454,4606,11848,16454,1075,0.04381913212592683,0.708034520481342,0.0020055913455694664,0.27993193144524126,0.7200680685547587,0.05244925246140756
599,17.0,287,4764,5051,55,373,6977,1936,5041,6977,414,0.041135158377526154,0.6828149634513401,0.007883044288376093,0.27748315895083847,0.7225168410491616,0.05346137308298696
600,23.0,173,2556,2729,64,187,3784,1017,2767,3784,226,0.045718816067653274,0.6754756871035941,0.016913319238900635,0.2687632135306554,0.7312367864693446,0.04941860465116279
601,16.0,611,3083,3694,49,39,4887,1415,3472,4887,349,0.1250255780642521,0.6308573767137303,0.01002660118682218,0.2895436873337426,0.7104563126662574,0.00798035604665439
602,,329,8079,8408,30,595,11497,3144,8353,11497,814,0.028616160737583718,0.7027050534922153,0.002609376359050187,0.2734626424284596,0.7265373575715404,0.05175263112116204
603,14.0,87,2052,2139,5,174,3076,793,2283,3076,244,0.028283485045513652,0.6671001300390117,0.001625487646293888,0.25780234070221064,0.7421976592977894,0.056566970091027305
604,,11924,262332,274256,1035,16059,362291,102231,260137,362368,27375,0.03290577534440127,0.723938096079124,0.0028562124690921934,0.28211928205581066,0.7178807179441893,0.04431682709290004
605,16.0,318,4287,4605,41,298,6287,1707,4580,6287,437,0.05058056306664546,0.6818832511531732,0.006521393351359949,0.2715126451407667,0.7284873548592333,0.04739939557817719
606,14.0,3241,87774,91015,168,4846,121072,33879,87193,121072,8745,0.026769195189639224,0.7249735694462799,0.0013876040703052729,0.2798252279635258,0.7201747720364742,0.0400257697898771
607,,143,2164,2307,12,113,3149,854,2295,3149,218,0.04541124166402032,0.6872022864401397,0.003810733566211496,0.27119720546205145,0.7288027945379486,0.03588440774849158
608,13.0,214,3316,3530,20,454,5050,1373,3677,5050,271,0.04237623762376238,0.6566336633663367,0.0039603960396039604,0.2718811881188119,0.7281188118811881,0.0899009900990099
609,,490,46403,46893,110,2505,62320,17939,44381,62320,5182,0.007862644415917844,0.7445924261874197,0.0017650834403080873,0.2878530166880616,0.7121469833119384,0.04019576379974326
610,16.0,4321,66480,70801,273,5068,95124,26810,68314,95124,5740,0.04542491905302552,0.6988772549514318,0.0028699381859467643,0.2818426474916951,0.7181573525083049,0.05327782683655019
611,16.0,672,19205,19877,32,1011,26644,7574,19070,26644,2179,0.025221438222489116,0.7208001801531302,0.001201020867737577,0.28426662663263774,0.7157333733673623,0.03794475304008407
612,23.0,71,3096,3167,7,193,4259,1166,3093,4259,345,0.016670579948344682,0.7269312045081004,0.001643578304766377,0.27377318619394225,0.7262268138060578,0.04531580183141583
613,,85,1710,1795,10,91,2440,685,1755,2440,175,0.03483606557377049,0.7008196721311475,0.004098360655737705,0.2807377049180328,0.7192622950819673,0.037295081967213116
614,33.0,544,8155,8699,9,694,12890,3334,9556,12890,660,0.042203258339798294,0.6326609775019395,0.0006982156710628394,0.25865011636927854,0.7413498836307215,0.053840186190845615
615,17.0,2,176,348,9,56,528,72,456,528,24,0.003787878787878788,0.3333333333333333,0.017045454545454544,0.13636363636363635,0.8636363636363636,0.10606060606060606
616,34.0,477,11720,12197,106,565,16087,4667,11420,16087,1053,0.029651271212780505,0.7285385715173742,0.00658917138061789,0.29011002672965747,0.7098899732703425,0.03512152669857649
617,,84,2089,2173,0,125,2983,835,2148,2983,236,0.028159570901776735,0.7003017096882334,0.0,0.2799195440831378,0.7200804559168622,0.04190412336573919
618,27.0,6806,94198,101004,603,7077,138256,39134,99122,138256,10777,0.04922751996296725,0.6813302858465455,0.004361474366392779,0.28305462330748754,0.7169453766925125,0.05118765189214211
619,13.0,669,3900,4569,10,581,7004,1648,5356,7004,290,0.09551684751570531,0.5568246716162193,0.0014277555682467161,0.23529411764705882,0.7647058823529411,0.08295259851513422
620,,623,8948,9571,55,449,13145,3671,9474,13145,833,0.04739444655762647,0.6807151007987828,0.0041841004184100415,0.2792696842906048,0.7207303157093952,0.034157474324838344
621,46.0,1664,80506,82170,76,2497,104560,31048,73512,104560,8193,0.015914307574598316,0.7699502677888294,0.0007268553940321347,0.29693955623565416,0.7030604437643458,0.023881025248661057
622,16.0,510,14844,15354,43,718,20021,5858,14163,20021,1386,0.025473253084261526,0.7414215074172119,0.0021477448678887167,0.2925927775835373,0.7074072224164627,0.03586234453823486
623,23.0,513,12682,13195,33,819,17561,4978,12583,17561,1102,0.029212459427139684,0.7221684414327202,0.0018791640567165878,0.2834690507374295,0.7165309492625704,0.04663743522578441
624,,336,9662,9998,54,989,14575,3791,10784,14575,867,0.023053173241852486,0.6629159519725557,0.003704974271012007,0.26010291595197255,0.7398970840480275,0.06785591766723842
625,17.0,4121,68494,72615,376,3488,97444,27392,70078,97470,6836,0.04227967579768134,0.7027187852672617,0.0038575972093977634,0.2810300605314456,0.7189699394685545,0.035785369857392016
626,,59,3738,3797,22,146,5008,1420,3588,5008,461,0.01178115015974441,0.7464057507987221,0.00439297124600639,0.28354632587859424,0.7164536741214057,0.02915335463258786
627,24.0,171,8189,8360,74,543,11068,3028,8040,11068,926,0.015449945789663896,0.739880737260571,0.006685941452837007,0.2735814962052765,0.7264185037947235,0.04906035417419588
628,14.0,733,8988,9721,42,745,13296,3688,9608,13296,909,0.055129362214199756,0.6759927797833934,0.00315884476534296,0.27737665463297234,0.7226233453670277,0.05603188929001204
629,35.0,860,8490,9350,36,453,13640,3696,9944,13640,701,0.06304985337243402,0.6224340175953079,0.0026392961876832845,0.2709677419354839,0.7290322580645161,0.03321114369501466
630,24.0,180,2638,2818,27,124,3934,1046,2888,3934,238,0.045754956786985254,0.6705643111337062,0.0068632435180477885,0.2658871377732588,0.7341128622267412,0.0315200813421454
631,17.0,300,5662,5962,40,305,8006,2279,5727,8006,656,0.03747189607794155,0.7072195853110167,0.004996252810392206,0.28466150387209593,0.7153384961279041,0.03809642767924057
632,15.0,78,5059,5137,14,231,6804,1932,4872,6804,643,0.01146384479717813,0.743533215755438,0.00205761316872428,0.2839506172839506,0.7160493827160493,0.033950617283950615
633,,171,27806,27977,397,3883,39117,10637,28480,39117,1755,0.004371500881969476,0.7108418334739371,0.010149040059309252,0.2719278063246159,0.7280721936753841,0.09926630365314314
634,23.0,1872,20970,22842,96,1745,30968,8656,22312,30968,2279,0.06044949625419788,0.6771506070782743,0.003099974166881943,0.27951433738052184,0.7204856626194782,0.05634848876259364
635,13.0,147,2390,2537,15,205,3660,982,2678,3660,230,0.04016393442622951,0.6530054644808743,0.004098360655737705,0.2683060109289617,0.7316939890710382,0.056010928961748634
636,17.0,1706,17798,19504,77,1629,28260,7316,20944,28260,1504,0.060368011323425334,0.6297947629157821,0.0027246992215145083,0.2588818117480538,0.7411181882519462,0.05764331210191083
637,14.0,73,1583,1656,17,102,2231,626,1605,2231,184,0.03272075302554908,0.7095472882115643,0.00761990138951143,0.2805916629314209,0.7194083370685791,0.04571940833706858
638,42.0,106,4394,4500,16,109,5829,1736,4093,5829,524,0.01818493738205524,0.7538171212901013,0.0027448962086121117,0.2978212386344141,0.7021787613655859,0.018699605421170013
639,,288,4777,5065,25,353,7116,1861,5255,7116,409,0.04047217537942664,0.6713041034288927,0.0035132096683530073,0.2615233277121979,0.7384766722878021,0.04960652051714446
640,,169,4687,4856,0,219,6565,1881,4684,6565,535,0.02574257425742574,0.713937547600914,0.0,0.28651942117288653,0.7134805788271135,0.03335872048743336
641,15.0,172,3650,3822,34,188,5093,1400,3693,5093,378,0.03377184370704889,0.7166699391321422,0.006675829569998037,0.2748870999410956,0.7251129000589044,0.03691341056351855
642,17.0,463,8104,8567,49,347,11147,3254,7893,11147,712,0.0415358392392572,0.7270117520409078,0.004395801560958105,0.29191710774199336,0.7080828922580067,0.03112945187045842
643,13.0,278,11420,11698,85,1087,16451,4360,12091,16451,1238,0.016898668773934714,0.6941827244544405,0.005166859157498024,0.2650294814904869,0.7349705185095131,0.06607501063765121
644,27.0,1474,19859,21333,185,836,28553,8158,20395,28553,1608,0.051623297026582145,0.6955136062760481,0.0064791790705004725,0.2857142857142857,0.7142857142857143,0.029278884880748084
645,16.0,36,2767,2803,20,166,3871,1092,2779,3871,332,0.009299922500645827,0.7148023766468613,0.005166623611469905,0.2820976491862568,0.7179023508137432,0.04288297597520021
646,,50,1450,1500,7,112,2178,551,1627,2178,169,0.02295684113865932,0.6657483930211203,0.0032139577594123047,0.2529843893480257,0.7470156106519743,0.051423324150596875
647,,981,11770,12751,80,648,17123,4784,12339,17123,756,0.05729136249488991,0.687379547976406,0.004672078490918647,0.27939029375693514,0.7206097062430649,0.03784383577644104
648,23.0,59,1514,1573,4,94,2100,592,1508,2100,159,0.028095238095238097,0.7209523809523809,0.0019047619047619048,0.2819047619047619,0.7180952380952381,0.04476190476190476
649,23.0,780,13742,14522,71,933,19785,5285,14512,19797,1213,0.0393999090771329,0.6941455776127696,0.003586401980097995,0.2669596403495479,0.7330403596504521,0.04712835278072435
650,,646,12183,12829,77,578,16973,4907,12066,16973,1109,0.0380604489483297,0.7177870735874624,0.004536616979909268,0.28910622753785425,0.7108937724621458,0.0340540859011371
651,14.0,165,3580,3745,4,1198,6100,848,5252,6100,212,0.027049180327868853,0.5868852459016394,0.0006557377049180328,0.13901639344262295,0.860983606557377,0.19639344262295083
652,23.0,1873,40552,42425,68,1316,53906,15837,38069,53906,3417,0.03474566838570846,0.7522724743071272,0.0012614551255889883,0.2937891885875413,0.7062108114124587,0.024412866842281007
653,17.0,1230,40448,41717,274,5984,61731,15615,46116,61731,3350,0.01992515915828352,0.6552299492961398,0.004438612690544459,0.25295232541186763,0.7470476745881324,0.09693670927086877
654,13.0,190,3477,3667,10,140,4769,1394,3375,4769,366,0.0398406374501992,0.7290836653386454,0.0020968756552736424,0.29230446634514573,0.7076955336548543,0.02935625917383099
655,24.0,1501,44034,45535,128,3042,60651,17006,43645,60651,4396,0.024748149247333102,0.7260226542019093,0.002110435112364182,0.28039109000676,0.71960890999324,0.05015580946728001
656,24.0,1121,32058,33179,105,1416,44135,12519,31616,44135,3200,0.02539934292511612,0.7263622974963181,0.0023790642347343376,0.2836524300441826,0.7163475699558174,0.03208338053698878
657,27.0,442,10061,10503,139,663,13955,3814,10141,13955,1041,0.03167323539949839,0.7209602293084916,0.009960587603009673,0.2733070584020065,0.7266929415979936,0.04750985309924758
658,24.0,2625,47448,50073,106,3793,68798,18770,50028,68798,4545,0.038155178929620046,0.6896712113724236,0.0015407424634437047,0.272827698479607,0.727172301520393,0.055132416640018604
659,24.0,88,6789,6877,62,165,8462,2684,5778,8462,511,0.010399432758213189,0.802292602221697,0.007326873079650201,0.31718269912550223,0.6828173008744978,0.019498936421649727
660,34.0,1458,33007,34465,410,2026,46907,13121,33786,46907,3309,0.03108278082162577,0.7036689619886157,0.008740699682350183,0.2797237086149189,0.7202762913850811,0.04319184769863773
661,27.0,354,13365,13719,51,362,17844,5262,12582,17844,1457,0.01983860121049092,0.7489912575655683,0.0028581035642232682,0.2948890383322125,0.7051109616677875,0.020286931181349475
662,,94,2148,2242,4,81,3082,844,2238,3082,247,0.030499675535366644,0.6969500324464634,0.0012978585334198572,0.2738481505515899,0.7261518494484102,0.02628163530175211
663,34.0,669,21536,22205,87,825,28380,8523,19857,28380,1957,0.023572938689217757,0.7588442565186752,0.00306553911205074,0.3003171247357294,0.6996828752642706,0.029069767441860465
664,23.0,512,8259,8771,15,615,12520,3350,9170,12520,901,0.04089456869009585,0.6596645367412141,0.0011980830670926517,0.26757188498402557,0.7324281150159745,0.04912140575079872
665,,850,17179,18029,102,1183,24336,6799,17537,24336,1613,0.03492767915844839,0.7059089414858646,0.004191321499013806,0.2793803418803419,0.7206196581196581,0.04861111111111111
666,,174,4255,4429,4,194,5849,1719,4130,5849,449,0.029748674987177294,0.7274747820140195,0.0006838775859121217,0.2938963925457343,0.7061036074542657,0.033168062916737906
667,15.0,125,3705,3830,17,227,5169,1442,3727,5169,404,0.024182627200619075,0.7167730702263494,0.0032888372992841944,0.2789707873863417,0.7210292126136584,0.04391565099632424
668,16.0,146,2640,2786,6,179,3853,1064,2789,3853,261,0.037892551258759406,0.6851803789255125,0.0015572281339216196,0.2761484557487672,0.7238515442512328,0.04645730599532832
669,25.0,543,24393,24936,133,1099,34405,9397,25008,34405,2364,0.015782589739863392,0.7089957854962942,0.0038657171922685655,0.2731289056823136,0.7268710943176864,0.031943031536113935
670,,26314,659140,685454,2848,26123,901273,251161,650112,901273,75915,0.02919648097746188,0.7313433332630623,0.003159974835593655,0.27867360943909336,0.7213263905609066,0.028984558507799525
671,,261,3505,3766,52,135,4960,1396,3564,4960,347,0.05262096774193548,0.7066532258064516,0.010483870967741936,0.2814516129032258,0.7185483870967742,0.02721774193548387
672,23.0,472,10335,10807,98,719,15077,4131,10946,15077,976,0.031305962724679975,0.6854811965245076,0.006499966836903894,0.2739935000331631,0.7260064999668369,0.04768853220136632
673,,91,38226,38317,134,2482,50559,14352,36207,50559,3952,0.001799877370992306,0.7560671690500208,0.0026503688759666926,0.283866373939358,0.716133626060642,0.04909116082200993
674,27.0,1034,16517,17551,49,1454,23706,6707,16999,23706,1764,0.043617649540200795,0.6967434404792036,0.0020669872606091286,0.2829241542225597,0.7170758457774403,0.06133468320256475
675,25.0,481,9731,10212,53,366,13489,3928,9561,13489,1046,0.035658684854325745,0.7214026243605901,0.003929127437171028,0.29120023723033583,0.7087997627696642,0.027133219660464083
676,24.0,8534,41080,49614,341,1889,68327,18902,49425,68327,5060,0.12489938091823144,0.6012264551348662,0.004990706455720286,0.27664027397661245,0.7233597260233875,0.02764646479429801
677,23.0,69,1840,1909,11,91,2587,725,1862,2587,231,0.026671820641669886,0.7112485504445304,0.004252029377657518,0.2802473908001546,0.7197526091998454,0.035175879396984924
678,16.0,134,4066,4200,31,184,5551,1621,3930,5551,488,0.024139794631597912,0.7324806341199784,0.005584579355071158,0.2920194559538822,0.7079805440461178,0.033147180688164295
679,34.0,90,1801,1891,16,104,2530,718,1812,2530,186,0.03557312252964427,0.7118577075098814,0.006324110671936759,0.2837944664031621,0.7162055335968379,0.04110671936758893
680,13.0,83,1332,1415,19,81,1946,548,1398,1946,147,0.04265159301130524,0.68448098663926,0.009763617677286743,0.2816032887975334,0.7183967112024666,0.04162384378211716
681,,177,3766,3943,58,241,5363,1468,3895,5363,357,0.03300391571881409,0.7022189073279881,0.010814842438933433,0.27372739138541863,0.7262726086145814,0.044937534961775126
682,,266,7326,7592,17,473,10198,2863,7335,10198,799,0.026083545793292803,0.7183761521867033,0.001666993528142773,0.28074132182780936,0.7192586781721906,0.04638164345950186
683,25.0,596,16489,17085,59,746,22461,6423,16038,22461,1831,0.026534882685543833,0.7341169137616312,0.0026267752994078627,0.2859623347135034,0.7140376652864966,0.03321312497217399
684,,1907,51356,53263,207,2823,69369,19846,49523,69369,5157,0.02749066585938964,0.7403306952673384,0.0029840418630800503,0.286093211665153,0.713906788334847,0.04069541149504822
685,27.0,414,8876,9290,6,442,12211,3526,8685,12211,940,0.03390385717795431,0.7268855949553681,0.0004913602489558594,0.2887560396363934,0.7112439603636066,0.036196871673081644
686,,2405,52933,55338,272,3508,72488,20384,52104,72488,4925,0.03317790530846485,0.7302312106831476,0.00375234521575985,0.2812051649928264,0.7187948350071736,0.04839421697384395
687,16.0,3,2210,2213,9,73,2901,863,2038,2901,328,0.001034126163391934,0.7618062736987246,0.0031023784901758012,0.2974836263357463,0.7025163736642537,0.025163736642537057
688,27.0,77,1984,2061,10,110,2725,772,1956,2728,217,0.028225806451612902,0.7272727272727273,0.0036656891495601175,0.2829912023460411,0.717008797653959,0.04032258064516129
689,16.0,2127,40265,42392,464,2627,58510,16061,42449,58510,4175,0.03635276021192958,0.688172961886857,0.007930268330199965,0.2745000854554777,0.7254999145445223,0.04489830798154162
690,48.0,172,3534,3706,19,174,4878,1416,3462,4878,380,0.035260352603526036,0.7244772447724477,0.003895038950389504,0.2902829028290283,0.7097170971709718,0.03567035670356704
691,13.0,62,4888,4950,27,628,7089,1884,5205,7089,473,0.008745944420933842,0.6895189730568486,0.003808717731696995,0.2657638595006348,0.7342361404993653,0.08858795316687826
692,33.0,875,16846,17721,100,629,24254,6719,17535,24254,1558,0.036076523460047825,0.6945658448091037,0.004123031252576894,0.27702646986064156,0.7229735301393585,0.025933866578708668
693,25.0,193,10098,10291,88,746,13826,3965,9861,13826,1050,0.01395920729061189,0.7303630840445537,0.006364819904527702,0.286778533198322,0.713221466801678,0.05395631419065529
694,36.0,1606,42119,43725,368,1688,56862,16710,40152,56862,4080,0.02824381836727516,0.7407231543034012,0.006471808940944743,0.29386936794344204,0.706130632056558,0.029685906229116106
695,16.0,1041,9704,10745,52,587,14202,4013,10189,14202,1130,0.07329953527672159,0.6832840445007745,0.0036614561329390226,0.28256583579777494,0.717434164202225,0.041332206731446275
696,27.0,342,6675,7017,6,393,9385,2664,6721,9385,659,0.0364411294619073,0.7112413425679276,0.0006393180607352157,0.2838572189664358,0.7161427810335642,0.04187533297815663
697,17.0,1144,30152,31296,59,2403,42066,11944,30122,42066,3123,0.027195359672894975,0.7167783958541339,0.0014025578852279751,0.28393476917225313,0.7160652308277469,0.05712451861360719
698,16.0,233,13547,14062,814,1602,21193,4984,16209,21193,798,0.010994196196857453,0.6392204973340254,0.03840890860189685,0.23517199075166328,0.7648280092483367,0.07559099702732035
699,27.0,82,2265,2347,6,94,3110,915,2195,3110,221,0.026366559485530548,0.7282958199356914,0.0019292604501607716,0.2942122186495177,0.7057877813504824,0.03022508038585209
700,25.0,3215,48093,51308,445,5043,71520,18501,53019,71520,4308,0.044952460850111856,0.6724412751677852,0.0062220357941834455,0.25868288590604027,0.7413171140939597,0.07051174496644295
701,15.0,755,9897,10652,24,889,14565,4004,10561,14565,855,0.051836594576038446,0.6795056642636458,0.0016477857878475798,0.27490559560590455,0.7250944043940954,0.06103673189152077
702,,2391,48768,51159,86,2467,68137,19806,48331,68137,5247,0.0350910665277309,0.7157344761289754,0.0012621629951421402,0.29067907304401425,0.7093209269559857,0.03620646638390302
703,,75,2874,2949,4,193,4051,1075,2976,4051,256,0.0185139471735374,0.7094544556899531,0.0009874105159219946,0.265366576154036,0.734633423845964,0.04764255739323624
704,17.0,20,5135,5155,38,375,7107,1947,5160,7107,591,0.0028141269171239624,0.7225270859715773,0.005346841142535528,0.2739552553820177,0.7260447446179823,0.052764879696074296
705,26.0,281,8629,8910,98,388,11817,3300,8517,11817,876,0.02377930100702378,0.7302191757637302,0.008293137006008294,0.2792586951002793,0.7207413048997208,0.03283405263603283
706,34.0,217,20693,20910,98,1138,28505,7926,20581,28507,2626,0.007612165433051531,0.7258918862033886,0.0034377521310555302,0.2780369733749605,0.7219630266250394,0.039920019644297894
707,14.0,199,3758,3957,10,132,5234,1491,3743,5234,465,0.03802063431410011,0.7179977072984334,0.0019105846388995033,0.28486816965991596,0.7151318303400841,0.025219717233473445
708,17.0,554,12353,12907,75,1350,18024,4923,13101,18024,1234,0.030736795383932536,0.685363959165557,0.004161118508655127,0.2731358189081225,0.7268641810918774,0.07490013315579228
709,37.0,2200,34618,36818,417,2238,49453,13720,35733,49453,3035,0.044486684326532265,0.7000181990981336,0.008432248801892707,0.2774351404363739,0.722564859563626,0.045255090692172366
710,,18,14591,14609,31,759,19789,5404,14385,19789,1940,0.0009095962403355399,0.7373288190408813,0.0015665268583556521,0.2730810045985143,0.7269189954014856,0.03835464146748194
711,25.0,429,8219,8648,21,369,11271,3303,7968,11271,762,0.03806228373702422,0.7292165735072309,0.0018631887143997872,0.29305296779345225,0.7069470322065478,0.032738887410167686
712,26.0,107,2653,2760,0,191,3699,1050,2649,3699,237,0.028926736955934035,0.7172208705055421,0.0,0.28386050283860503,0.716139497161395,0.05163557718302244
713,16.0,89,6111,6200,6,317,8403,2427,5976,8403,820,0.0105914554325836,0.7272402713316672,0.0007140307033202428,0.2888254194930382,0.7111745805069618,0.03772462215875283
714,,87,2351,2438,11,129,3286,936,2350,3286,255,0.026475958612294584,0.7154595252586732,0.0033475349969567863,0.28484479610468655,0.7151552038953134,0.03925745587340231
715,,14169,404686,418855,1789,23977,568086,158854,409232,568086,41901,0.02494164615920829,0.7123674936541299,0.003149171076210292,0.2796301968363945,0.7203698031636055,0.042206637727386344
716,,3507,79002,82509,551,3655,108638,31541,77097,108638,8124,0.03228152211933209,0.7272041090594451,0.00507189013052523,0.29033119166405863,0.7096688083359414,0.03364384469522635
717,,791,12758,13549,83,890,18588,5162,13426,18588,1203,0.042554336130837096,0.6863567893264472,0.004465246395523994,0.27770604691198625,0.7222939530880138,0.047880352915859695
718,,153,3470,3623,46,119,4648,1370,3278,4648,302,0.03291738382099828,0.7465576592082617,0.009896729776247849,0.29475043029259895,0.705249569707401,0.025602409638554216
719,16.0,6,29931,29937,73,4546,43179,11075,32104,43179,2953,0.0001389564371569513,0.6931841867574515,0.0016906366520762408,0.25649042358553925,0.7435095764144607,0.10528266055258344
720,42.0,440,5837,6277,44,379,8719,2284,6435,8719,638,0.05046450280995527,0.669457506594793,0.005046450280995527,0.2619566464044042,0.7380433535955958,0.04346828764766602
721,27.0,136,3471,3607,1,172,4893,1400,3493,4893,394,0.02779480891068874,0.7093807480073574,0.00020437359493153485,0.2861230329041488,0.7138769670958512,0.035152258328223995
722,,2502,42298,44800,357,2725,61382,17146,44236,61382,4253,0.04076113518621094,0.6890945228242807,0.005816037274771106,0.2793327033983904,0.7206672966016096,0.04439412205532567
723,,748,11772,12520,27,786,16754,4779,11975,16754,1169,0.0446460546735108,0.7026381759579802,0.0016115554494449088,0.28524531455174884,0.7147546854482512,0.04691416975050734
724,23.0,542,37539,38081,248,2605,51722,14416,37306,51722,4330,0.010479099802791849,0.7257839990719617,0.0047948648544139825,0.2787208537952902,0.7212791462047098,0.05036541510382429
725,17.0,2760,59340,62100,270,2388,80461,23795,56666,80461,5651,0.03430233280719852,0.7375001553547681,0.0033556629920085505,0.2957333366475684,0.7042666633524316,0.02967897490709785
726,,525,17031,17556,6,599,22824,6762,16062,22824,1978,0.02300210304942166,0.7461882229232387,0.0002628811777076761,0.296267087276551,0.703732912723449,0.026244304241149666
727,16.0,156,1578,1734,10,135,2360,676,1684,2360,145,0.06610169491525424,0.6686440677966101,0.00423728813559322,0.2864406779661017,0.7135593220338983,0.057203389830508475
728,41.0,393,8130,8523,70,448,11444,3245,8199,11444,936,0.03434113946172667,0.7104159384830478,0.00611674239776302,0.28355470115344283,0.7164452988465572,0.03914715134568333
729,25.0,1272,37390,38662,195,1997,51401,14567,36834,51401,3856,0.024746600260695317,0.7274177545183946,0.003793700511663197,0.2833991556584502,0.7166008443415498,0.038851384214314895
730,14.0,37,9682,9719,14,303,12879,3746,9133,12879,1372,0.002872893858218806,0.7517664414939048,0.0010870409193260346,0.2908610916996661,0.7091389083003339,0.023526671325413463
731,23.0,317,11564,11881,58,621,15881,4490,11391,15881,1342,0.019960959637302437,0.7281657326364839,0.003652162962030099,0.2827277879226749,0.717272212077325,0.03910333102449468
732,17.0,113,4739,4852,14,271,6529,1833,4696,6529,505,0.017307397763822945,0.725838566396079,0.0021442793689692144,0.28074743452289785,0.7192525654771021,0.04150712207076122
733,15.0,184,4180,4364,13,335,6042,1684,4358,6042,437,0.030453492221118834,0.6918238993710691,0.0021516054286660046,0.2787156570671963,0.7212843429328037,0.05544521681562396
734,,1376,34397,35773,18,1566,47121,13928,33193,47121,3249,0.02920141762696038,0.7299717747925554,0.0003819952887247724,0.295579465631035,0.704420534368965,0.0332335901190552
735,23.0,153,4128,4281,21,165,5501,1628,3873,5501,434,0.027813124886384294,0.7504090165424468,0.0038174877295037266,0.295946191601527,0.704053808398473,0.02999454644610071
736,,867,17974,18841,84,1064,25162,7123,18039,25162,1920,0.034456720451474444,0.7143311342500596,0.0033383673793816074,0.28308560527779986,0.7169143947222001,0.04228598680550036
737,,827,11267,12094,114,855,16440,4464,11976,16440,1062,0.050304136253041365,0.6853406326034063,0.006934306569343066,0.27153284671532846,0.7284671532846715,0.05200729927007299
738,25.0,159,29000,29159,57,1596,38204,11107,27097,38204,2989,0.004161867867239033,0.7590828185530311,0.0014919903675007853,0.2907287195058109,0.7092712804941891,0.04177573029002199
739,,67,1987,2054,0,122,2912,773,2139,2912,227,0.02300824175824176,0.6823489010989011,0.0,0.2654532967032967,0.7345467032967034,0.04189560439560439
740,,1740,42555,44295,138,2312,58130,16612,41518,58130,3566,0.02993290899707552,0.7320660588336487,0.002373989334250817,0.28577326681575776,0.7142267331842422,0.03977292275933253
741,14.0,89,2503,2592,14,230,3609,978,2631,3609,231,0.024660570795234135,0.6935439179828208,0.0038791909116098642,0.2709891936824605,0.7290108063175395,0.06372956497644777
742,16.0,169,2362,2531,24,151,3372,981,2391,3372,246,0.05011862396204033,0.7004744958481613,0.0071174377224199285,0.29092526690391457,0.7090747330960854,0.04478054567022539
743,39.0,338,20636,20974,133,118,27342,8160,19182,27342,2367,0.012361934020920196,0.7547363031233999,0.00486431131592422,0.29844195742813256,0.7015580425718675,0.004315704776534269
744,15.0,871,12001,12872,78,453,16639,5090,11549,16639,1321,0.052346895847106195,0.7212572870965803,0.0046877817176513015,0.30590780695955283,0.6940921930404471,0.027225193821744095
745,26.0,1739,33290,35029,154,1916,47237,13348,33889,47237,3273,0.03681436162330377,0.704744162415056,0.003260156233461058,0.2825751000275208,0.7174248999724792,0.0405614243072168
746,23.0,657,13870,14527,45,907,19319,5526,13793,19319,1255,0.0340079714270925,0.7179460634608417,0.0023293131114446915,0.28603965008540816,0.7139603499145919,0.04694859982400745
747,17.0,103,1599,1702,1,112,2522,675,1847,2522,186,0.0408406026962728,0.634020618556701,0.0003965107057890563,0.267644726407613,0.732355273592387,0.04440919904837431
748,24.0,1541,112558,114099,386,8508,157483,42866,114617,157483,12431,0.009785183162627078,0.7147311138345092,0.002451058209457529,0.2721944590844726,0.7278055409155274,0.05402487887581517
749,,6,3856,3862,0,82,5116,1487,3629,5116,485,0.0011727912431587178,0.7537138389366693,0.0,0.2906567630961689,0.7093432369038312,0.01602814698983581
750,24.0,6236,203214,209450,1128,7535,273983,81125,192861,273986,23895,0.022760287021964625,0.7416948311227581,0.004116998678764608,0.2960917711123926,0.7039082288876074,0.027501405181286635
751,25.0,67,2065,2132,0,80,2749,827,1922,2749,230,0.02437249909057839,0.7511822480902146,0.0,0.3008366678792288,0.6991633321207712,0.029101491451436885
752,17.0,20573,215000,235573,1475,15097,315176,89104,226072,315176,22863,0.06527464020103053,0.6821585399903546,0.004679924867375689,0.28271188161535143,0.7172881183846486,0.047900220828997135
753,14.0,521,7946,8515,30,701,11818,3184,8634,11818,704,0.04408529361990184,0.6723641902183111,0.002538500592316805,0.26941952953122356,0.7305804704687764,0.05931629717380267
754,24.0,115,2471,2586,6,139,3369,996,2373,3369,194,0.034134758088453544,0.7334520629266845,0.0017809439002671415,0.2956366874443455,0.7043633125556545,0.04125853368952211
755,,1330,27656,28986,72,1484,38712,10972,27740,38712,2846,0.03435627195701591,0.7144038024385203,0.0018598884066955983,0.2834263277536681,0.7165736722463318,0.038334366604670385
756,42.0,345,9231,9576,9,426,12609,3649,8960,12609,975,0.027361408517725436,0.7320961218177492,0.0007137758743754461,0.28939646284400034,0.7106035371559997,0.03378539138710445
757,23.0,491,8448,8939,19,565,12121,3477,8644,12121,860,0.04050820889365564,0.6969721970134477,0.0015675274317300553,0.28685752000660014,0.7131424799933999,0.04661331573302533
758,24.0,586,10520,11106,98,698,14647,4232,10415,14647,929,0.040008192803987166,0.7182358162080972,0.006690789922851096,0.2889328872806718,0.7110671127193282,0.04765480985867413
759,,81,2230,2311,2,121,3026,880,2146,3026,212,0.026768010575016522,0.73694646397885,0.0006609385327164573,0.29081295439524124,0.7091870456047588,0.03998678122934567
760,,77,1614,1691,9,109,2328,627,1701,2328,155,0.03307560137457045,0.6932989690721649,0.003865979381443299,0.2693298969072165,0.7306701030927835,0.0468213058419244
761,,2840,38416,41256,595,9935,61796,15619,46182,61801,2935,0.0459539489652271,0.6216080645944241,0.009627675927573987,0.25273053834080356,0.7472694616591965,0.16075791653856733
762,,437,10925,11362,57,415,14419,4285,10134,14419,917,0.030307233511339206,0.7576808377834802,0.003953117414522505,0.29717733546015673,0.7028226645398432,0.02878146889520771
763,,37,6638,6675,60,510,9140,2456,6684,9140,641,0.004048140043763676,0.7262582056892779,0.006564551422319475,0.2687089715536105,0.7312910284463895,0.05579868708971553
764,,579,13475,14054,369,688,19312,5403,13909,19312,1424,0.02998135874067937,0.6977526926263463,0.019107290803645403,0.27977423363711684,0.7202257663628832,0.035625517812758904
765,16.0,77,2391,2468,1,82,3137,953,2184,3137,247,0.024545744341727765,0.7621931781957284,0.000318775900541919,0.30379343321644886,0.6962065667835512,0.02613962384443736
766,,48591,880052,928643,4752,56301,1272953,355086,917867,1272953,84544,0.038171872802845036,0.6913468132759025,0.0037330522022415596,0.2789466696728002,0.7210533303271999,0.04422865573198696
767,,269,13217,13486,11,558,17453,4891,12562,17453,1261,0.01541282301037071,0.757291010141523,0.0006302641379705494,0.2802383544376325,0.7197616455623675,0.03197158081705151
768,,263,6206,6469,18,313,8732,2438,6294,8732,688,0.030119102153000458,0.7107191937700412,0.002061383417315621,0.27920293174530464,0.7207970682546954,0.035845167201099405
769,,119,4137,4256,12,218,5597,1663,3934,5597,426,0.021261390030373414,0.7391459710559228,0.0021440057173485795,0.29712345899589065,0.7028765410041093,0.03894943719849919
770,,11467,224523,235990,1149,14168,324024,90849,233175,324024,23046,0.0353893538750216,0.6929208947485371,0.0035460336271387304,0.2803773794533738,0.7196226205466262,0.043725156161272004
771,,329,66933,67262,18,12541,95217,25363,69854,95217,6296,0.003455265341273092,0.7029522039131668,0.00018904187277481963,0.26637050106598614,0.7336294989340139,0.13170967369272293
772,,2475,20757,23232,56,711,30200,8759,21441,30200,2308,0.08195364238410596,0.687317880794702,0.0018543046357615894,0.29003311258278147,0.7099668874172186,0.023543046357615893
773,25.0,317,6534,6851,23,401,9509,2593,6916,9509,706,0.033336838784309604,0.6871385003680723,0.002418761173624987,0.2726890314438953,0.7273109685561048,0.0421705752445052
774,,233,10027,10260,11,391,13200,3755,9445,13200,1082,0.01765151515151515,0.7596212121212121,0.0008333333333333334,0.284469696969697,0.7155303030303031,0.02962121212121212
775,,16850,280192,297042,1269,16822,391574,113129,278445,391574,27227,0.04303145765551339,0.7155531266120836,0.003240766751622937,0.2889083544872744,0.7110916455127255,0.04295995137572975
776,17.0,3084,63782,66866,101,3682,89026,25579,63448,89027,6862,0.03464117627236681,0.7164343401440012,0.0011344872903725836,0.2873173306974289,0.7126826693025712,0.04135823963516686
777,23.0,1195,31495,32690,168,1245,42821,12523,30301,42824,3327,0.027904913132822715,0.7354520829441434,0.003923033812815244,0.2924294787969363,0.7075705212030637,0.02907248271997011
778,,115,6880,6995,47,508,9555,2447,7108,9555,619,0.012035583464154892,0.7200418628990057,0.004918890633176348,0.2560962846677132,0.7439037153322867,0.05316588173731031
779,,4952,33539,38491,51,1741,50766,14435,36331,50766,3872,0.09754560138675492,0.6606587085844857,0.0010046093842335422,0.28434385218453295,0.715656147815467,0.03429460662648229
780,,146,4268,4414,16,207,5764,1675,4089,5764,402,0.02532963219986121,0.7404580152671756,0.002775850104094379,0.2905968077723803,0.7094031922276197,0.035912560721721026
781,17.0,2998,63534,66538,443,3067,88644,25424,63220,88644,6196,0.03382067596227607,0.716732096927034,0.004997518162537792,0.28681016199629983,0.7131898380037002,0.03459907043905961
782,15.0,1015,37492,38507,100,1451,50255,14682,35573,50255,4236,0.020196995323848374,0.7460352203760819,0.0019898517560441747,0.29215003482240576,0.7078499651775942,0.028872748980200976
783,15.0,19,7214,7233,23,902,9777,2702,7075,9777,542,0.0019433364017592309,0.7378541474890048,0.002352459854761174,0.2763628925028127,0.7236371074971872,0.09225733865193822
784,,51,1551,1602,5,73,2100,618,1482,2100,158,0.024285714285714285,0.7385714285714285,0.002380952380952381,0.29428571428571426,0.7057142857142857,0.034761904761904765
785,,660,12632,13292,50,407,17007,5117,11890,17007,1320,0.03880754983242194,0.7427529840653848,0.002939965896395602,0.30087610983712587,0.6991238901628741,0.0239313223966602
786,23.0,11434,104087,115521,521,8901,157224,42849,114375,157224,10506,0.0727242660153666,0.6620299699791381,0.0033137434488373276,0.2725347275225157,0.7274652724774844,0.05661349412303465
787,,56,4037,4093,52,500,6120,1570,4550,6120,426,0.009150326797385621,0.659640522875817,0.00849673202614379,0.2565359477124183,0.7434640522875817,0.08169934640522876
788,,1015,26522,27537,100,1269,36695,10338,26357,36695,3112,0.027660444202207386,0.7227687695871372,0.002725166916473634,0.2817277558250443,0.7182722441749557,0.034582368170050413
789,16.0,355,19239,19594,70,1255,26024,7389,18635,26024,2103,0.013641254226867508,0.7392791269597295,0.002689824777128804,0.28393021826006765,0.7160697817399324,0.04822471564709499
790,,640,11281,11921,39,1035,16492,4612,11880,16492,1157,0.038806694154741694,0.6840286199369391,0.0023647829250545717,0.27965073975260735,0.7203492602473927,0.06275770070337133
791,25.0,4242,85907,90149,422,2974,120772,34406,86366,120772,8201,0.03512403537243732,0.7113155367138079,0.003494187394429172,0.28488391348988173,0.7151160865101183,0.024624913059318385
792,23.0,249,7317,7566,1,288,9989,2823,7166,9989,882,0.024927420162178398,0.7325057563319651,0.00010011012113324657,0.2826108719591551,0.717389128040845,0.028831714886375013
793,25.0,247,5522,5769,12,279,7752,2199,5553,7752,528,0.031862745098039214,0.7123323013415893,0.0015479876160990713,0.2836687306501548,0.7163312693498453,0.035990712074303405
794,15.0,175,1788,1963,3,149,2684,750,1934,2684,161,0.06520119225037257,0.6661698956780924,0.0011177347242921013,0.27943368107302535,0.7205663189269746,0.05551415797317437
795,,61,1395,1456,3,185,1998,438,1560,1998,132,0.03053053053053053,0.6981981981981982,0.0015015015015015015,0.21921921921921922,0.7807807807807807,0.09259259259259259
796,46.0,1108,33652,34760,100,1619,45206,13016,32190,45206,4008,0.02451002079369995,0.7444144582577534,0.0022120957395036058,0.2879263814537893,0.7120736185462107,0.03581383002256338
797,,543,11394,11937,45,1168,16393,4371,12022,16393,1077,0.03312389434514732,0.6950527664246935,0.002745074117001159,0.26663819923137927,0.7333618007686208,0.07124992374794119
798,17.0,148,10325,10473,60,597,14472,3918,10554,14472,1020,0.010226644555002764,0.7134466556108348,0.0041459369817578775,0.2707296849087894,0.7292703150912107,0.04125207296849088
799,27.0,6060,87473,93533,698,4185,124366,35559,88808,124367,8297,0.04872675227351307,0.7033457428417507,0.005612421301470647,0.285919898365322,0.714080101634678,0.03365040565423304
800,,136,5022,5158,6,269,6821,1934,4887,6821,564,0.019938425450813663,0.7362556809851928,0.0008796364169476617,0.2835361383961296,0.7164638616038704,0.0394370326931535
801,,92,1976,2068,4,110,2697,750,1947,2697,182,0.03411197626992955,0.7326659251019652,0.0014831294030404152,0.27808676307007785,0.7219132369299222,0.04078605858361142
802,13.0,199,5942,6141,13,472,8309,2423,5886,8309,505,0.02394993380671561,0.7151281742688651,0.0015645685401372007,0.2916115055963413,0.7083884944036587,0.05680587314959682
803,33.0,71,2206,2277,0,139,2954,889,2065,2954,195,0.024035206499661475,0.7467840216655383,0.0,0.3009478672985782,0.6990521327014217,0.04705484089370345
804,23.0,556,13976,14532,49,856,19312,5542,13770,19312,1380,0.028790389395194696,0.723695111847556,0.0025372825186412594,0.2869718309859155,0.7130281690140845,0.04432477216238608
805,16.0,107,2324,2431,1,139,3243,932,2311,3243,235,0.03299414122725871,0.7166204131976565,0.0003083564600678384,0.2873882207832254,0.7126117792167745,0.04286154794942954
806,25.0,510,13909,14419,90,556,18842,5467,13376,18843,1429,0.027065753860850184,0.7381520989226769,0.004776309504855914,0.29013426736719206,0.7098657326328079,0.02950697871888765
807,,60,3584,3644,11,269,4851,1344,3507,4851,347,0.012368583797155226,0.7388167388167388,0.0022675736961451248,0.27705627705627706,0.7229437229437229,0.0554524840239126
808,,105,4121,4226,2,127,5460,1650,3810,5460,438,0.019230769230769232,0.7547619047619047,0.0003663003663003663,0.3021978021978022,0.6978021978021978,0.02326007326007326
809,,2318,62800,65118,407,2652,83411,25033,58379,83412,5447,0.027789766460461326,0.7528892725267348,0.00487939385220352,0.3001126936172253,0.6998873063827746,0.031793986476765936
810,,309,3997,4306,38,236,6113,1689,4424,6113,361,0.050548012432520856,0.6538524456077213,0.006216260428594798,0.2762964174709635,0.7237035825290364,0.03860624897758874
811,,383,11497,11880,19,436,15592,4580,11012,15592,1229,0.0245638789122627,0.737365315546434,0.0012185736275012826,0.29374037968188815,0.7062596203181118,0.027963057978450487
812,39.0,761,15750,16511,90,1063,22253,6137,16116,22253,1516,0.034197636273760844,0.7077697389116074,0.004044398508066328,0.2757830404889228,0.7242169595110771,0.047768840156383406
813,37.0,387,6947,7334,14,339,9808,2762,7046,9808,588,0.03945758564437194,0.7082993474714518,0.0014274061990212073,0.2816068515497553,0.7183931484502447,0.034563621533442085
814,16.0,1236,21161,22397,127,1276,29810,8320,21490,29810,2156,0.04146259644414626,0.7098624622609863,0.004260315330426032,0.2791009728279101,0.7208990271720899,0.042804428044280446
815,15.0,99,2242,2341,2,136,3252,869,2383,3252,207,0.03044280442804428,0.6894218942189422,0.0006150061500615006,0.267220172201722,0.732779827798278,0.041820418204182044
816,16.0,121,27227,27348,43,438,35547,10381,25166,35547,3850,0.0034039440740428165,0.7659436801980477,0.0012096660758995133,0.2920358961375081,0.7079641038624919,0.012321714912650857
817,37.0,5429,124519,129948,289,6448,172473,48582,123891,172473,13202,0.031477390664045965,0.7219622781536821,0.001675624590515617,0.2816788714755353,0.7183211285244647,0.03738556179807854
818,38.0,59,1796,1855,10,143,2578,727,1851,2578,192,0.022885958107059737,0.6966640806826998,0.003878975950349108,0.28200155159038015,0.7179984484096199,0.05546935608999224
819,17.0,580,9444,10024,1560,1770,16191,3719,12472,16191,784,0.035822370452720645,0.5832870113025755,0.09634982397628312,0.22969550985115186,0.7703044901488482,0.10931999258847508
820,23.0,3163,97049,100212,297,5950,133349,39315,94034,133349,7690,0.023719712933730288,0.72778198561669,0.002227238299499809,0.2948278577267171,0.7051721422732828,0.044619757178531526
821,16.0,915,18235,19150,13,1193,25394,7265,18129,25394,1784,0.0360321335748602,0.7180830117350555,0.0005119319524297078,0.2860912026462944,0.7139087973537056,0.046979601480664726
822,,360,8959,9319,33,382,12362,3538,8824,12362,849,0.029121501375182008,0.7247209189451546,0.0026694709593916843,0.2861996440705388,0.7138003559294612,0.03090114868144313
823,14.0,190,6104,6294,8,116,8031,2406,5625,8031,726,0.02365832399452123,0.7600547876976715,0.0009961399576640518,0.29958909226746355,0.7004109077325364,0.014444029386128751
824,,35,1712,1747,4,109,2499,667,1832,2499,182,0.014005602240896359,0.6850740296118447,0.001600640256102441,0.266906762705082,0.7330932372949179,0.04361744697879152
825,15.0,1426,26765,28191,65,1758,38175,10745,27430,38175,2852,0.03735428945645056,0.7011132940406025,0.0017026850032743942,0.28146692861820566,0.7185330713817943,0.04605108055009823
826,23.0,135,3480,3615,10,148,4814,1410,3404,4814,367,0.028043207312006647,0.7228915662650602,0.002077274615704196,0.29289572081429166,0.7071042791857084,0.030743664312422102
827,,85,1869,1954,4,104,2633,733,1900,2633,188,0.032282567413596655,0.7098366881883783,0.0015191796429927839,0.27838966957842765,0.7216103304215723,0.03949867071781238
828,,550,4344,4894,43,529,6981,1874,5107,6981,347,0.07878527431600058,0.6222604211431028,0.006159575991978227,0.2684429164876092,0.7315570835123908,0.07577710929666237
829,17.0,811,45552,46363,354,4863,64827,17358,47469,64827,5104,0.012510219507304056,0.7026701837197464,0.0054606876764311165,0.2677588042019529,0.7322411957980471,0.07501504002961729
830,,28194,645427,673621,4253,32556,914535,256382,658153,914535,64138,0.03082878183995145,0.7057433559131143,0.004650450775530734,0.28034137567178946,0.7196586243282105,0.035598418868605354
831,16.0,173,3134,3307,13,164,4414,1274,3140,4414,381,0.039193475305845035,0.7100135931128229,0.0029451744449478933,0.2886270956048935,0.7113729043951065,0.03715450838241957
832,,942,7629,8571,26,480,11587,3243,8344,11587,790,0.08129800638646759,0.6584102873910417,0.002243894019159403,0.27988262708207473,0.7201173729179252,0.04142573573832744
833,15.0,3,5387,5390,45,422,7598,2016,5582,7598,740,0.0003948407475651487,0.7090023690444854,0.005922611213477231,0.26533298236377995,0.7346670176362201,0.05554093182416425
834,,41,2396,2437,3,58,3122,901,2221,3122,256,0.01313260730301089,0.7674567584881486,0.0009609224855861628,0.2885970531710442,0.7114029468289558,0.018577834721332478
835,16.0,1208,24010,25218,97,1954,34785,9195,25590,34785,2312,0.03472761247664223,0.6902400459968377,0.002788558286617795,0.26433807675722293,0.735661923242777,0.056173638062383215
836,27.0,8778,223196,231974,671,10257,303283,87803,215480,303283,21377,0.028943264211973636,0.7359331053834207,0.002212455033747358,0.2895084788794624,0.7104915211205376,0.033819897587401865
837,23.0,103,2125,2228,19,75,2869,845,2024,2869,234,0.03590101080515859,0.7406761937957477,0.006622516556291391,0.29452771000348554,0.7054722899965145,0.02614151272220286
838,24.0,287,7581,7868,17,439,10531,3010,7521,10531,854,0.02725287247175007,0.7198746557781787,0.0016142816446681227,0.2858228088500617,0.7141771911499383,0.04168644952995917
839,23.0,1233,37164,38397,98,1860,50117,14116,36001,50117,4125,0.02460243031306742,0.7415447852026259,0.001955424307121336,0.2816609134624978,0.7183390865375022,0.037113155216792704
840,27.0,98,1772,1870,4,132,2514,692,1822,2514,195,0.03898170246618934,0.7048528241845664,0.0015910898965791568,0.2752585521081941,0.7247414478918058,0.05250596658711217
841,17.0,496,10473,10969,13,584,14643,4091,10552,14643,874,0.033872840264973024,0.7152222905142389,0.0008877962166222768,0.2793826401693642,0.7206173598306358,0.03988253773133921
842,47.0,565,7446,8011,61,351,10713,3158,7555,10713,750,0.05273966209278447,0.6950434052086251,0.0056940166153271726,0.29478204051152807,0.705217959488472,0.03276393167180062
843,14.0,695,7798,8493,394,1006,12223,3254,8969,12223,640,0.056860017998854616,0.6379775832447027,0.032234312361940604,0.2662194224003927,0.7337805775996074,0.08230385339114783
844,15.0,365,3594,3959,6,279,5418,1501,3917,5418,317,0.06736803248431156,0.6633444075304541,0.0011074197120708748,0.27703949796973054,0.7229605020302695,0.05149501661129568
845,,910,30338,31248,54,1076,41136,11765,29371,41136,3304,0.022121742512640995,0.7375048619214314,0.0013127187864644108,0.2860025281991443,0.7139974718008557,0.026157137300661222
846,24.0,129,4721,4850,0,236,6487,1836,4651,6487,500,0.019885925697548944,0.7277632187451827,0.0,0.2830275936488361,0.7169724063511639,0.03638045321412055
847,14.0,1843,46513,48356,349,4158,65834,17336,48498,65834,4742,0.027994653218701582,0.7065194276513656,0.005301212139623902,0.26332897894704865,0.7366710210529513,0.06315885408755355
848,27.0,2695,55171,57866,241,3217,76459,21859,54600,76459,4886,0.035247649066820125,0.7215762696347062,0.003152016113211002,0.2858917851397481,0.7141082148602519,0.04207483749460495
849,,4599,118646,123245,532,5455,164909,46894,118015,164909,12043,0.0278881079868291,0.7194634616667374,0.003226021624047202,0.2843628910490028,0.7156371089509972,0.0330788495473261
850,15.0,197,7087,7284,53,205,9677,2735,6942,9677,912,0.02035754882711584,0.7323550687196445,0.005476903999173298,0.2826289139196032,0.7173710860803968,0.021184251317557093
851,17.0,3836,57421,61257,221,3135,83329,23461,59868,83329,5907,0.046034393788477,0.6890878325672934,0.002652137911171381,0.28154664042530214,0.7184533595746979,0.03762195634172977
852,25.0,1513,223266,224779,821,10328,298608,85085,213523,298608,22090,0.00506684348711354,0.747689278251085,0.002749423993998821,0.28493878261801425,0.7150612173819857,0.034587151047527194
853,23.0,676,10450,11126,42,718,15216,4097,11119,15216,1121,0.04442691903259727,0.6867770767613038,0.0027602523659305996,0.26925604626708727,0.7307439537329127,0.04718717139852786
854,41.0,144,4077,4221,13,240,5668,1590,4078,5668,425,0.025405786873676783,0.7193013408609739,0.0022935779816513763,0.28052223006351446,0.7194777699364855,0.04234297812279464
855,37.0,79,2425,2504,22,117,3340,957,2383,3340,227,0.023652694610778444,0.7260479041916168,0.006586826347305389,0.28652694610778445,0.7134730538922156,0.03502994011976048
856,,207,5834,6041,12,303,8001,2257,5744,8001,584,0.025871766029246346,0.7291588551431071,0.0014998125234345708,0.28208973878265214,0.7179102612173478,0.03787026621672291
857,14.0,135,1848,1983,37,125,3059,753,2306,3059,158,0.04413206930369402,0.6041189931350115,0.012095456031382805,0.2461588754494933,0.7538411245505067,0.04086302713305002
858,,593,16881,17474,76,757,22948,6625,16323,22948,1672,0.025841031898204636,0.7356196618441694,0.0033118354540700714,0.28869618267387137,0.7113038173261287,0.03298762419382953
859,39.0,186,4018,4204,28,202,5682,1623,4059,5682,444,0.03273495248152059,0.7071453713481168,0.004927842309046111,0.2856388595564942,0.7143611404435058,0.03555086237240408
860,17.0,3345,64490,67835,379,3508,91872,25883,65989,91872,6614,0.03640935214211076,0.7019548937652386,0.004125304771856496,0.28172892720306514,0.7182710727969349,0.038183559735283874
861,,255,6519,6774,52,461,8830,2607,6223,8830,539,0.028878822197055492,0.7382785956964892,0.005889014722536806,0.29524348810872025,0.7047565118912797,0.0522083805209513
862,25.0,3861,45646,49507,781,2332,66460,18484,47976,66460,3704,0.05809509479386097,0.686819139331929,0.011751429431236833,0.2781221787541378,0.7218778212458622,0.0350887752031297
863,17.0,51,2118,2169,7,290,2983,833,2150,2983,154,0.01709688233322159,0.7100234663090849,0.0023466309084813944,0.27924907810928595,0.720750921890714,0.09721756620851492
864,,878,15953,16831,101,1053,22897,6383,16514,22897,1677,0.03834563479931869,0.6967288291042495,0.004411058217233699,0.27877014456042276,0.7212298554395772,0.045988557452941434
865,16.0,15,1693,1708,7,207,2421,644,1777,2421,130,0.006195786864931847,0.6992978108219744,0.0028913672036348617,0.2660057827344073,0.7339942172655928,0.08550185873605948
866,17.0,1822,40180,42002,192,2239,56112,15890,40222,56112,3943,0.03247077274023382,0.7160678642714571,0.003421727972626176,0.28318363273453095,0.716816367265469,0.039902338180781295
867,,956,20715,21671,102,1252,29589,8349,21240,29589,2040,0.03230930413329278,0.7000912501267363,0.003447227010037514,0.2821656696745412,0.7178343303254587,0.0423130217310487
868,33.0,539,12844,13383,32,792,17831,5103,12728,17831,1221,0.030228254164096236,0.7203185463518591,0.0017946273344175874,0.28618697773540464,0.7138130222645954,0.04441702652683529
869,25.0,218,7198,7416,6,237,9736,2800,6936,9736,872,0.0223911257189811,0.7393179950698439,0.0006162695152013147,0.2875924404272802,0.7124075595727198,0.02434264585045193
870,36.0,8847,211069,219916,818,14684,295904,82807,213097,295904,16954,0.029898210230344977,0.7133022872282903,0.0027644100789445225,0.27984413863955876,0.7201558613604412,0.049624202444035904
871,16.0,969,18620,19589,160,1383,26946,7223,19723,26946,1706,0.03596081050990871,0.6910116529355006,0.0059378015289838935,0.26805462777406663,0.7319453722259334,0.05132487196615453
872,25.0,6610,182730,189340,412,8845,246588,71722,174866,246588,17690,0.02680584618878453,0.7410336269404837,0.0016708031209953444,0.29085762486414585,0.7091423751358541,0.03586954758544617
873,,57,7293,7350,24,1060,10092,2727,7365,10092,535,0.005648038049940547,0.7226516052318668,0.0023781212841854932,0.2702140309155767,0.7297859690844233,0.10503369005152596
874,27.0,1659,28482,30141,189,1643,39922,11395,28527,39922,2589,0.0415560342668203,0.7134412103602024,0.004734231751916237,0.2854315916036271,0.7145684083963729,0.04115525274284856
875,16.0,321,7093,7414,34,346,10080,2779,7301,10080,728,0.03184523809523809,0.703670634920635,0.003373015873015873,0.27569444444444446,0.7243055555555555,0.03432539682539683
876,35.0,96,2493,2589,1,158,3437,964,2473,3437,239,0.027931335466977014,0.7253418679080593,0.0002909514111143439,0.28047716031422754,0.7195228396857725,0.04597032295606634
877,,685,8445,9130,184,691,13459,3568,9891,13459,655,0.050895311687346755,0.6274611783936399,0.013671149416747158,0.2651014191247492,0.7348985808752507,0.05134111003789286
878,26.0,63,2168,2231,0,104,2931,842,2089,2931,243,0.021494370522006142,0.7396792903445923,0.0,0.2872739679290345,0.7127260320709655,0.03548277038553395
879,27.0,85,1528,1613,18,78,2149,630,1519,2149,157,0.03955328059562587,0.7110283852954863,0.00837598883201489,0.2931596091205212,0.7068403908794788,0.03629595160539786
880,40.0,67,2154,2221,8,97,2936,866,2070,2936,242,0.02282016348773842,0.7336512261580381,0.0027247956403269754,0.2949591280653951,0.7050408719346049,0.03303814713896458
881,23.0,208,4693,4901,37,200,6562,1906,4656,6562,461,0.03169765315452606,0.7151782992989942,0.005638524839987808,0.2904602255409936,0.7095397744590064,0.03047851264858275
882,,194,47156,47350,88,3615,63977,18188,45789,63977,5429,0.0030323397470966127,0.73707738718602,0.0013754943182706285,0.284289666598934,0.715710333401066,0.0565046813698673
883,17.0,82,6714,6796,19,248,9068,2580,6488,9068,899,0.009042787825319806,0.7404058226731363,0.0020952801058667842,0.28451698279664756,0.7154830172033525,0.027348919276576972
884,27.0,291,5711,6002,52,303,8077,2260,5817,8077,604,0.036028228302587596,0.7070694564813669,0.006438033923486443,0.2798068589822954,0.7201931410177046,0.037513928438776774
885,26.0,378,5992,6370,89,326,8914,2444,6470,8914,694,0.042405205295041506,0.6722010320843617,0.009984294368409244,0.2741754543414853,0.7258245456585147,0.03657168498990352
886,,126,6076,6202,4,747,8592,2309,6283,8592,530,0.014664804469273743,0.707169459962756,0.0004655493482309125,0.26873836126629425,0.7312616387337058,0.0869413407821229
887,,205,4902,5107,19,584,7503,1928,5575,7503,436,0.0273224043715847,0.6533386645341863,0.002532320405171265,0.25696388111422097,0.743036118885779,0.0778355324536852
888,25.0,238,6252,6490,44,215,8407,2459,5948,8407,665,0.028309741881765195,0.7436659926251933,0.005233733793267515,0.29249434994647316,0.7075056500535268,0.025573926489829903
889,25.0,110,2277,2387,2,146,3380,910,2470,3380,236,0.03254437869822485,0.6736686390532545,0.000591715976331361,0.2692307692307692,0.7307692307692307,0.04319526627218935
890,,2,5899,5901,33,347,8269,2260,6009,8269,778,0.00024186721489902045,0.7133873503446608,0.003990809045833837,0.2733099528358931,0.7266900471641069,0.04196396178498005
891,33.0,2648,52534,55182,528,3284,77977,21004,56973,77977,5038,0.03395873142080357,0.6737114790258666,0.006771227413211588,0.2693614783846519,0.7306385216153481,0.042114982623081165
892,15.0,542,7674,8216,583,651,11982,3160,8822,11982,525,0.04523451844433317,0.6404606910365548,0.04865631781004841,0.26372892672341847,0.7362710732765816,0.054331497245868804
893,26.0,192,4695,4887,7,205,6301,1823,4478,6301,456,0.030471353753372482,0.7451198222504365,0.0011109347722583717,0.28931915568957306,0.7106808443104269,0.03253451833042374
894,16.0,95,7600,7695,13,937,10943,2979,7964,10943,825,0.008681348807456822,0.6945079045965458,0.0011879740473361967,0.2722288220780408,0.7277711779219592,0.08562551402723202
895,,81,3023,3104,6,106,3998,1166,2832,3998,318,0.020260130065032515,0.756128064032016,0.0015007503751875938,0.29164582291145574,0.7083541770885443,0.026513256628314157
896,17.0,321,8667,8988,138,632,12332,3322,9010,12332,803,0.0260298410638988,0.7028057087252676,0.01119039896204995,0.2693804735647097,0.7306195264352903,0.05124878365228673
897,16.0,4895,55982,60877,804,4409,84455,23537,60918,84455,5107,0.05795986028062282,0.6628618791072168,0.009519862648747855,0.27869279497957494,0.7213072050204251,0.05220531644070807
898,33.0,387,13201,13588,50,835,18544,5155,13389,18544,1720,0.020869283865401208,0.711874460742019,0.0026962899050905955,0.2779874892148404,0.7220125107851596,0.045028041415012945
899,33.0,104,3273,3377,5,168,4441,1266,3175,4441,411,0.023418149065525782,0.7369961720333258,0.001125872551227201,0.2850709299707273,0.7149290700292726,0.037829317721233956
900,16.0,95,1787,1882,3,165,2602,711,1891,2602,221,0.03651037663335895,0.6867794004611837,0.0011529592621060721,0.2732513451191391,0.7267486548808608,0.06341275941583398
901,23.0,184,4916,5100,20,232,6790,1907,4883,6790,540,0.027098674521354935,0.7240058910162003,0.0029455081001472753,0.2808541973490427,0.7191458026509573,0.03416789396170839
902,37.0,46,1855,1901,2,99,2594,738,1856,2594,227,0.017733230531996914,0.7151117964533539,0.0007710100231303007,0.284502698535081,0.7154973014649191,0.038164996144949885
903,,315,5803,6118,7,440,8142,2364,5778,8142,552,0.03868828297715549,0.7127241464013756,0.0008597396217145664,0.290346352247605,0.709653647752395,0.05404077622205846
904,16.0,708,19359,20067,27,728,26536,7629,18907,26536,2287,0.026680735604461863,0.7295372324389509,0.0010174856798311727,0.28749623153451914,0.7125037684654808,0.027434428700633104
905,25.0,509,11767,12276,36,531,16476,4759,11717,16476,1198,0.030893420733187668,0.7141903374605487,0.0021849963583394027,0.2888443797038116,0.7111556202961884,0.03222869628550619
906,35.0,132,5373,5505,21,82,7142,2090,5053,7143,688,0.018479630407391853,0.752204955900882,0.0029399412011759767,0.29259414811703766,0.7074058518829623,0.011479770404591909
907,,59,1684,1743,5,95,2333,676,1657,2333,172,0.02528932704672096,0.7218174024860694,0.0021431633090441492,0.28975567938276897,0.7102443206172311,0.04072010287183883
908,15.0,98,7015,7113,3,292,9382,2705,6677,9382,896,0.010445534001279046,0.7477083777446174,0.0003197612449371136,0.2883180558516308,0.7116819441483693,0.031123427840545725
909,15.0,1489,37368,38857,129,1845,51398,14822,36576,51398,3538,0.028969998832639402,0.7270321802404763,0.002509825285030546,0.2883769796490136,0.7116230203509865,0.03589633837892525
910,34.0,311,36725,37036,69,2232,49299,13766,35533,49299,3751,0.006308444390352746,0.7449441165135195,0.0013996227103998053,0.2792348729183148,0.7207651270816853,0.045274752023367615
911,15.0,9386,148909,158295,392,12707,220035,60311,159729,220040,13814,0.04265588074895474,0.6767360479912743,0.0017814942737684057,0.27409107435011815,0.7259089256498819,0.05774859116524268
912,17.0,1929,35349,37278,358,2078,50051,14185,35866,50051,3983,0.03854068849773231,0.7062596151925037,0.007152704241673493,0.28341092086072206,0.7165890791392779,0.041517651994965134
913,15.0,2199,14602,16801,1209,2007,25128,6939,18189,25128,769,0.08751193887297039,0.5811047437121936,0.04811365807067813,0.27614613180515757,0.7238538681948424,0.07987106017191978
914,34.0,1274,33650,34924,252,1703,47436,13237,34199,47436,3621,0.02685723922759086,0.7093768445906062,0.005312420946116873,0.2790496669196391,0.7209503330803609,0.035901003457289825
915,16.0,651,15456,16107,41,939,21510,6156,15354,21510,1627,0.030264993026499303,0.7185495118549512,0.001906090190609019,0.28619246861924685,0.7138075313807531,0.04365411436541144
916,17.0,496,11979,12475,81,805,16751,4764,11987,16751,1093,0.029610172527013312,0.7151214852844606,0.004835532207032416,0.28440093128768434,0.7155990687123157,0.04805683242791475
917,38.0,717,12717,13434,59,640,18507,5120,13387,18507,1297,0.03874209758469768,0.6871454044415627,0.003187982925379586,0.2766520775922624,0.7233479224077376,0.0345815096990328
918,35.0,207,5925,6132,9,276,8074,2310,5764,8074,647,0.025637849888531086,0.7338370076789695,0.001114689125588308,0.28610354223433243,0.7138964577656676,0.034183799851374784
919,,1205,29279,30484,262,1382,39726,11489,28237,39726,2867,0.03033277953984796,0.7370236117404219,0.006595176962191009,0.28920606152142175,0.7107939384785783,0.0347882998539999
920,25.0,74,1999,2073,15,151,2742,775,1967,2742,171,0.02698760029175784,0.7290299051787017,0.005470459518599562,0.2826404084609774,0.7173595915390226,0.05506929248723559
921,35.0,425,9290,9715,27,386,13012,3707,9305,13012,796,0.032662158007992624,0.713956347986474,0.002075007685213649,0.28489086996618507,0.7151091300338149,0.02966492468490624
922,26.0,111,3871,3982,20,162,5322,1492,3830,5322,422,0.020856820744081173,0.7273581360390831,0.003757985719654265,0.2803457346862082,0.7196542653137918,0.030439684329199548
923,,222,3981,4203,9,285,5606,1627,3979,5606,386,0.039600428112736355,0.7101320014270425,0.0016054227613271496,0.2902247591865858,0.7097752408134143,0.0508383874420264
924,14.0,373,5367,5740,49,702,7953,2242,5711,7953,493,0.046900540676474284,0.6748396831384383,0.0061611970325663274,0.28190619891864704,0.7180938010813529,0.08826857789513391
925,25.0,1246,13920,15166,41,688,20201,5641,14560,20201,1787,0.061680114845799716,0.689074798277313,0.0020296024949259936,0.279243601801891,0.720756398198109,0.0340577199148557
926,25.0,175,8171,8346,414,1212,12081,2770,9311,12081,404,0.014485555831470905,0.6763512954225643,0.0342686863670226,0.2292856551609966,0.7707143448390034,0.10032282095852993
927,15.0,71,1650,1721,0,105,2345,664,1681,2345,187,0.030277185501066096,0.7036247334754797,0.0,0.2831556503198294,0.7168443496801705,0.04477611940298507
928,27.0,163,3298,3461,12,148,4620,1310,3310,4620,387,0.03528138528138528,0.7138528138528139,0.0025974025974025974,0.28354978354978355,0.7164502164502164,0.032034632034632034
929,17.0,648,25612,37230,463,1710,49033,10007,39026,49033,2838,0.013215589500948342,0.5223420961393347,0.009442620276140559,0.20408704341973774,0.7959129565802623,0.034874472294169234
930,15.0,372,5413,5785,69,346,7867,2113,5754,7867,489,0.04728613194356172,0.688064065081988,0.00877081479598322,0.26859031396974703,0.7314096860302529,0.04398118723782891
931,,424,8043,8467,22,660,11330,3057,8273,11330,781,0.03742277140335393,0.7098852603706972,0.001941747572815534,0.26981465136804944,0.7301853486319506,0.05825242718446602
932,,374,2036,2410,2,475,3712,905,2807,3712,191,0.10075431034482758,0.5484913793103449,0.0005387931034482759,0.24380387931034483,0.7561961206896551,0.12796336206896552
933,47.0,147,6985,7132,14,110,9198,2774,6424,9198,868,0.01598173515981735,0.7594042183083279,0.0015220700152207,0.30158730158730157,0.6984126984126984,0.011959121548162643
934,16.0,279,7649,7928,22,432,10530,3074,7456,10530,759,0.026495726495726495,0.726400759734093,0.002089268755935423,0.29192782526115857,0.7080721747388414,0.041025641025641026
935,35.0,456,11904,12360,58,706,16472,4673,11799,16472,1231,0.027683341427877612,0.7226809130645945,0.0035211267605633804,0.2836935405536668,0.7163064594463332,0.04286061194754735
936,,50,1473,1523,1,70,2030,574,1456,2030,181,0.024630541871921183,0.725615763546798,0.0004926108374384236,0.2827586206896552,0.7172413793103448,0.034482758620689655
937,15.0,3085,69226,72311,510,5300,97703,27204,70499,97703,7346,0.03157528427990952,0.7085350501008157,0.005219901128931558,0.27843566727736097,0.721564332722639,0.054246031339876974
938,17.0,370,11116,11486,59,401,15185,4381,10804,15185,1175,0.024366150806717154,0.7320381955877511,0.0038854132367467896,0.28850839644385906,0.7114916035561409,0.026407639117550213
939,27.0,228,5635,5863,16,276,7849,2323,5526,7849,621,0.02904828640591158,0.717925850426806,0.002038476239011339,0.2959612689514588,0.7040387310485412,0.035163715122945596
940,23.0,1013,23247,24260,153,1637,32419,9334,23085,32419,2012,0.03124710817730343,0.7170794904222832,0.0047194546407970635,0.28791757919738425,0.7120824208026157,0.050495080045652244
941,34.0,1176,35404,36580,92,1409,47462,14199,33263,47462,3611,0.024777716910370402,0.7459441237200286,0.0019383928195187729,0.2991656483081202,0.7008343516918798,0.02968690742067338
942,23.0,724,14976,15700,109,963,21160,5971,15189,21160,1412,0.03421550094517958,0.7077504725897921,0.005151228733459357,0.2821833648393195,0.7178166351606805,0.04551039697542533
943,26.0,136,2740,4298,71,182,5684,1066,4620,5686,201,0.02391839606049947,0.481885332395357,0.012486809708054871,0.18747801618009144,0.8125219838199086,0.03200844178684488
944,45.0,701,19252,19953,81,1195,26304,7273,19031,26304,1982,0.026649939172749392,0.7319038929440389,0.0030793795620437958,0.2764978710462287,0.7235021289537713,0.045430352798053526
945,37.0,29890,778581,808471,3456,39012,1056626,308790,747836,1056626,75324,0.028288154938455046,0.7368558032832809,0.0032707883394881444,0.29224153106207873,0.7077584689379213,0.03692129476276374
946,16.0,17,1981,1998,3,243,2821,757,2064,2821,224,0.006026231832683446,0.7022332506203474,0.0010634526763559022,0.2683445586671393,0.7316554413328606,0.08613966678482808
947,26.0,35,1734,1769,4,76,2309,696,1613,2309,206,0.015158077089649198,0.750974447812906,0.0017323516673884798,0.3014291901255955,0.6985708098744045,0.03291468168038112
948,,163,3431,3594,33,174,4790,1425,3365,4790,359,0.03402922755741127,0.7162839248434238,0.006889352818371607,0.2974947807933194,0.7025052192066806,0.03632567849686848
949,16.0,129,2902,3031,9,362,4243,1160,3083,4243,248,0.030403016733443318,0.683950035352345,0.0021211407023332546,0.27339146830073063,0.7266085316992694,0.0853169926938487
950,,1200,54235,55435,96,4576,72881,18385,54496,72881,4989,0.016465196690495464,0.7441582854241846,0.0013172157352396372,0.2522605342956326,0.7477394657043674,0.06278728337975605
951,24.0,142,4994,5136,7,282,6933,1995,4938,6933,575,0.020481753930477426,0.720323092456368,0.0010096639261502956,0.28775421895283426,0.7122457810471657,0.04067503245348334
952,,17201,346458,363659,1294,16446,476026,140498,335572,476070,34505,0.03613124120402462,0.7277459197176885,0.002718087676182074,0.2951204654777659,0.7048795345222342,0.03454533997101267
953,25.0,538,11852,12390,51,615,16541,4696,11845,16541,1053,0.03252524031195212,0.7165225802551236,0.003083247687564234,0.28390061060395383,0.7160993893960462,0.037180339761804
954,,144,2484,2628,0,190,3661,1028,2633,3661,252,0.03933351543294182,0.6785031412182464,0.0,0.280797596285168,0.719202403714832,0.0518983884184649
955,16.0,21,3355,3376,5,145,4574,1278,3296,4574,436,0.004591167468299082,0.7334936598163533,0.0010931351114997813,0.2794053344993441,0.7205946655006559,0.031700918233493657
956,,1036,26144,27180,58,1365,36030,10297,25733,36030,2602,0.02875381626422426,0.7256175409381072,0.0016097696364140994,0.28578961976131,0.71421038023869,0.03788509575353872
957,27.0,10524,113982,124506,1318,6321,175456,46414,129042,175456,11394,0.05998084989968995,0.649632956410724,0.007511854824001459,0.26453355827101954,0.7354664417289805,0.03602612620828014
958,17.0,289,9710,9999,47,1042,13814,3756,10058,13814,872,0.02092080498045461,0.7029100912118141,0.003402345446648328,0.27189807441725783,0.7281019255827421,0.07543072245547995
959,15.0,234,4778,5012,11,340,6929,1879,5050,6929,466,0.03377110694183865,0.6895655938807909,0.0015875306682060903,0.2711791023235676,0.7288208976764324,0.04906912974455188
960,15.0,127,11040,11167,121,1295,15442,4229,11213,15442,946,0.008224323274187281,0.7149332987954928,0.007835772568320166,0.2738634891853387,0.7261365108146614,0.08386219401631913
961,,78,1628,1706,16,63,2289,682,1607,2289,189,0.03407601572739188,0.7112276103101791,0.0069899519440803845,0.2979467016164264,0.7020532983835737,0.027522935779816515
962,,1051,9843,10894,43,1578,17065,4344,12721,17065,738,0.061588045707588635,0.5767946088485204,0.002519777322004102,0.25455610899501907,0.745443891004981,0.09246996777029007
963,16.0,477,9386,9863,106,523,13369,3783,9586,13369,1030,0.03567955718453138,0.702071957513651,0.007928790485451417,0.28296806043832745,0.7170319395616725,0.03912035305557633
964,,11,4388,4399,35,464,6025,1601,4424,6025,471,0.0018257261410788382,0.728298755186722,0.005809128630705394,0.2657261410788382,0.7342738589211618,0.07701244813278009
965,23.0,945,29570,30515,96,1606,39186,11393,27793,39186,2393,0.024115755627009645,0.7546062369213494,0.0024498545398866944,0.2907415913846782,0.7092584086153217,0.04098402490685449
966,24.0,363,8616,8979,56,217,12133,3584,8549,12133,951,0.029918404351767906,0.7101293991593176,0.004615511415148768,0.29539273056952114,0.7046072694304789,0.017885106733701476
967,,109,4755,4864,6,203,6252,1901,4351,6252,444,0.01743442098528471,0.760556621880998,0.0009596928982725527,0.3040626999360205,0.6959373000639796,0.032469609724888035
968,33.0,106,1832,1938,85,282,3114,729,2385,3114,128,0.0340398201669878,0.588310854206808,0.027296082209377008,0.23410404624277456,0.7658959537572254,0.0905587668593449
969,,106,1938,2044,15,103,2800,759,2041,2800,211,0.03785714285714286,0.6921428571428572,0.005357142857142857,0.2710714285714286,0.7289285714285715,0.03678571428571428
970,,198,4259,4457,7,235,6016,1715,4301,6016,444,0.03291223404255319,0.7079454787234043,0.001163563829787234,0.28507313829787234,0.7149268617021277,0.0390625
971,,157,1654,2057,47,123,3032,634,2398,3032,102,0.05178100263852243,0.5455145118733509,0.01550131926121372,0.2091029023746702,0.7908970976253298,0.04056728232189974
972,,1969,43241,45210,456,1624,58187,17239,40948,58187,3657,0.03383917369859247,0.7431385017271899,0.007836802034818773,0.2962689260487738,0.7037310739512262,0.02791001426435458
973,,1762,22201,23963,77,1065,32653,9239,23456,32695,2410,0.05389203242085946,0.6790334913595351,0.0023551001682214404,0.2825814344701025,0.7174185655298976,0.03257378804098486
974,26.0,1250,30411,31661,360,1910,43214,11921,31293,43214,3167,0.028925811079742677,0.7037302725968436,0.008330633590965891,0.27585967510528997,0.72414032489471,0.04419863932984681
975,16.0,223,2529,2752,17,183,3779,1016,2763,3779,247,0.05901032019052659,0.6692246626091558,0.00449854458851548,0.2688541942312781,0.7311458057687219,0.04842550939401958
976,,472,5169,5641,108,677,8878,2134,6744,8878,498,0.05316512728091913,0.5822257265149808,0.012164902004956072,0.24036945257940978,0.7596305474205902,0.07625591349403019
977,,1149,24550,25699,63,1740,34677,9811,24866,34677,2561,0.03313435418288779,0.7079620497736252,0.0018167661562418895,0.2829252818871298,0.7170747181128702,0.050177350981918854
978,45.0,82,1981,2063,4,109,3047,740,2307,3047,163,0.026911716442402363,0.6501476862487693,0.0013127666557269445,0.24286183130948474,0.7571381686905153,0.03577289136855924
979,14.0,724,22387,23111,168,1180,31030,8618,22412,31030,2556,0.023332259104092812,0.7214631002255881,0.005414115372220432,0.27773122784402193,0.7222687721559781,0.03802771511440541
980,47.0,233,5286,5519,27,239,7304,2096,5208,7304,597,0.031900328587075574,0.7237130339539978,0.003696604600219058,0.28696604600219056,0.7130339539978094,0.03272179627601314
981,14.0,70,2718,2788,7,141,3805,1035,2770,3805,274,0.018396846254927726,0.714323258869908,0.0018396846254927727,0.2720105124835742,0.7279894875164258,0.037056504599211566
982,44.0,138,2701,2839,62,224,3750,1016,2734,3750,181,0.0368,0.7202666666666667,0.016533333333333334,0.27093333333333336,0.7290666666666666,0.05973333333333333
983,23.0,242,23711,23953,59,1282,31709,9077,22632,31709,2705,0.007631902614399697,0.7477687722728563,0.0018606704721057113,0.28625942161531426,0.7137405783846857,0.04043016178372071
984,,806,14931,15844,254,1365,21498,5968,15530,21498,1271,0.037491859707879806,0.6945297236952275,0.01181505256302912,0.27760721927621174,0.7223927807237882,0.06349427853753838
985,23.0,500,8878,9378,51,473,12747,3540,9207,12747,929,0.03922491566643132,0.6964776025731545,0.004000941397975994,0.2777124029183337,0.7222875970816662,0.03710677022044403
986,16.0,124,2308,2432,15,126,3219,914,2305,3219,254,0.03852127990059025,0.7169928549238894,0.004659832246039142,0.2839391115253184,0.7160608884746815,0.0391425908667288
987,17.0,132,1295,1427,6,85,1971,567,1404,1971,150,0.0669710806697108,0.6570268899036023,0.0030441400304414,0.2876712328767123,0.7123287671232876,0.043125317097919835
988,,111,5048,5159,22,379,7088,1917,5171,7088,602,0.015660270880361173,0.7121896162528216,0.0031038374717832955,0.2704571106094808,0.7295428893905191,0.053470654627539506
989,,324,3100,3424,11,216,4710,1292,3418,4710,171,0.06878980891719745,0.6581740976645435,0.002335456475583864,0.2743099787685775,0.7256900212314225,0.045859872611464965
990,38.0,1075,19372,20447,222,959,26673,7815,18858,26673,1725,0.04030292805458704,0.7262775090915907,0.008323023281970533,0.2929929141828816,0.7070070858171185,0.035953960934278106
991,,568,14500,15068,177,754,20165,5601,14564,20165,1519,0.028167617158442848,0.7190676915447558,0.008777584924373916,0.27775849243739154,0.7222415075626085,0.0373915199603273
992,17.0,3166,30109,33275,140,3906,46398,12501,33897,46398,3036,0.06823569981464718,0.6489288331393595,0.00301737143842407,0.2694297167981379,0.7305702832018621,0.08418466313203156
993,16.0,638,18465,19103,89,772,25073,7192,17881,25073,1740,0.025445698560204205,0.7364495672635903,0.0035496350656084234,0.28684242013321104,0.713157579866789,0.030790092928648347
994,16.0,164,4404,4568,6,141,6032,1740,4292,6032,556,0.027188328912466843,0.730106100795756,0.0009946949602122016,0.28846153846153844,0.7115384615384616,0.023375331564986737
995,35.0,83,1828,1911,11,196,2583,659,1924,2583,147,0.03213317847464189,0.7077042198993418,0.004258614014711576,0.2551296941540844,0.7448703058459156,0.07588075880758807
996,,348,5634,5982,102,634,8914,2290,6624,8914,499,0.03903971281130805,0.6320394884451425,0.01144267444469374,0.2568992595916536,0.7431007404083464,0.07112407448956698
997,,30,1692,1722,19,208,2397,640,1757,2397,130,0.012515644555694618,0.7058823529411765,0.007926574885273258,0.2670004171881519,0.7329995828118482,0.08677513558614935
998,35.0,675,18214,18889,94,837,24750,7120,17631,24751,2138,0.027271625388873177,0.7358894590117571,0.003797826350450487,0.2876651448426326,0.7123348551573674,0.033816815482202736
999,15.0,88,2296,2384,0,82,3146,906,2240,3146,256,0.027972027972027972,0.729815638906548,0.0,0.28798474253019707,0.7120152574698029,0.026064844246662427
1000,23.0,137,3183,3320,47,206,4584,1263,3321,4584,328,0.02988656195462478,0.694371727748691,0.01025305410122164,0.2755235602094241,0.724476439790576,0.04493891797556719
1001,,475,10198,10673,46,380,13998,4016,9982,13998,1158,0.033933419059865695,0.7285326475210745,0.003286183740534362,0.28689812830404343,0.7131018716959565,0.027146735247892555
1002,,494,18839,19333,44,725,25509,7389,18120,25509,2117,0.01936571406170371,0.7385236583166725,0.0017248814144027599,0.2896624720686816,0.7103375279313183,0.028421341487318202
1003,15.0,13200,37776,51636,251,9841,75574,19853,55802,75655,1626,0.17447624083008392,0.499319278302822,0.0033176921551781114,0.26241490978785276,0.7375850902121472,0.1300773246976406
1004,24.0,384,12828,13212,33,450,16953,5098,11855,16953,1284,0.022650858255176074,0.7566802335869758,0.001946558131304194,0.3007137379814782,0.6992862620185218,0.026543974517784463
1005,,497,23462,23959,20,922,30856,9205,21651,30856,2272,0.016107078039927405,0.7603707544723879,0.0006481721545242416,0.29832123411978223,0.7016787658802178,0.02988073632356754
1006,14.0,1,1563,1564,12,97,2151,556,1595,2151,192,0.00046490004649000463,0.7266387726638772,0.005578800557880056,0.2584844258484426,0.7415155741515574,0.04509530450953045
1007,14.0,182,2852,3034,35,167,4123,1177,2946,4123,214,0.044142614601018676,0.6917293233082706,0.008488964346349746,0.2854717438758186,0.7145282561241815,0.04050448702401164
1008,,524,13907,14431,34,552,18622,5578,13044,18622,1504,0.028138760605735152,0.7468048544732038,0.0018257974438835786,0.2995381806465471,0.7004618193534529,0.029642358500698098
1009,,1072,11810,12882,267,1459,18847,4993,13854,18847,1186,0.056879078898498435,0.6266249270440919,0.014166710882368547,0.2649227993845174,0.7350772006154825,0.07741285085159441
1010,24.0,524,7964,8488,6,605,13830,2989,10841,13830,617,0.037888647866955893,0.5758496023138105,0.0004338394793926247,0.21612436731742588,0.7838756326825741,0.043745480838756325
1011,23.0,42,5294,5336,16,398,7256,2004,5252,7256,653,0.005788313120176406,0.7296030871003307,0.002205071664829107,0.27618522601984563,0.7238147739801544,0.05485115766262404
1012,17.0,348,12927,13275,82,562,17564,5051,12514,17565,1457,0.019812126387702817,0.7359521776259608,0.004668374608596641,0.28756048961001995,0.7124395103899801,0.03199544548818674
1013,23.0,162,5247,5409,16,444,7344,2046,5298,7344,588,0.022058823529411766,0.7144607843137255,0.002178649237472767,0.2785947712418301,0.7214052287581699,0.06045751633986928
1014,,6213,132002,138215,605,6242,185085,52223,132862,185085,12840,0.033568360483021316,0.7131966393819056,0.003268768403706405,0.2821568468541481,0.7178431531458519,0.03372504524947997
1015,17.0,4118,68104,72222,481,7451,97842,24567,73275,97842,5084,0.042088264753377895,0.6960609963001574,0.0049160892050448685,0.2510884896056908,0.7489115103943091,0.07615339015964515
1016,,1126,15283,16412,167,1768,25423,6209,19214,25423,1381,0.04429060299728592,0.6011485662588995,0.006568854973842584,0.24422766785981198,0.755772332140188,0.06954332690870471
1017,,503,11003,11506,55,649,15245,4338,10907,15245,1140,0.032994424401443095,0.7217448343719253,0.0036077402427025255,0.2845523122335192,0.7154476877664808,0.0425713348638898
1018,,144,4679,4823,4,238,6416,1839,4577,6416,474,0.022443890274314215,0.7292705735660848,0.0006234413965087282,0.2866271820448878,0.7133728179551122,0.03709476309226933
1019,,96,2650,2746,2,124,3706,1044,2662,3706,290,0.025903939557474366,0.715056664867782,0.0005396654074473826,0.2817053426875337,0.7182946573124662,0.03345925526173772
1020,23.0,105,2729,2834,19,159,3973,1081,2892,3973,283,0.02642839164359426,0.6868864837654166,0.00478228039265039,0.2720865844450038,0.7279134155549962,0.04002013591744274
1021,24.0,48599,471378,519977,6538,23989,711066,195666,516009,711675,41977,0.06828819334668212,0.6623500895774054,0.009186777672392595,0.27493729581620824,0.7250627041837917,0.03370780201636983
1022,,147,3465,3612,0,202,4937,1399,3538,4937,359,0.029775167105529673,0.7018432246303423,0.0,0.2833704678954831,0.716629532104517,0.04091553575045574
1023,27.0,224,3563,3787,9,217,5041,1409,3632,5041,287,0.04443562785161674,0.7068042055147788,0.0017853600476096013,0.27950803412021424,0.7204919658797858,0.04304701448125372
1024,27.0,124,3453,3577,0,210,4702,1308,3394,4702,309,0.026371756699276903,0.7343683538919609,0.0,0.2781794980859209,0.7218205019140791,0.04466184602296895
1025,,17276,348386,365662,1298,16695,478788,141263,337569,478832,34659,0.03607946001938049,0.7275745981889263,0.0027107628562836237,0.29501578841848497,0.704984211581515,0.03486609082099776
1026,33.0,142,2301,2443,14,130,3377,926,2451,3377,232,0.042049156055670715,0.6813740005922416,0.00414569144210838,0.27420787681374,0.72579212318626,0.03849570624814924
1027,23.0,4446,90612,95058,558,6087,128274,36382,91892,128274,8813,0.034660180551008,0.7063941250760092,0.004350063146077927,0.2836272354491167,0.7163727645508833,0.04745310819028018
1028,24.0,2135,55989,58124,161,2765,78688,22718,55970,78688,5087,0.027132472549817,0.7115316185441236,0.0020460553070353804,0.2887098413989427,0.7112901586010574,0.03513877592517283
1029,24.0,1070,30043,31113,61,1889,42145,11669,30477,42146,3385,0.025387937170787262,0.7128315854410857,0.0014473496891757225,0.27687087742609023,0.7231291225739097,0.0448203862762777
1030,,7381,173505,180886,764,6863,239990,69567,170423,239990,18824,0.03075544814367265,0.7229676236509854,0.003183465977749073,0.2898745781074211,0.7101254218925789,0.028597024876036502
1031,,152,2260,2412,36,71,3191,904,2287,3191,235,0.047633970542149795,0.7082419304293325,0.011281729865246004,0.283296772171733,0.716703227828267,0.022250078345346286
1032,16.0,228,13177,13405,57,1692,19244,4826,14418,19244,1092,0.011847848680108086,0.6847329037622116,0.0029619621700270214,0.2507794637289545,0.7492205362710456,0.08792350862606527
1033,26.0,162,3806,3968,16,207,5298,1510,3788,5298,384,0.030577576443941108,0.7183842959607399,0.003020007550018875,0.28501321253303136,0.7149867874669686,0.039071347678369193
1034,,140,3543,3683,214,283,5330,1393,3937,5330,333,0.02626641651031895,0.6647279549718574,0.0401500938086304,0.2613508442776735,0.7386491557223265,0.05309568480300188
1035,16.0,2245,49441,51686,58,2344,68990,19788,49202,68990,5555,0.03254094796347297,0.7166400927670676,0.000840701550949413,0.28682417741701693,0.7131758225829831,0.03397593854181766
1036,,3033,64754,67787,315,2844,89055,25874,63181,89055,6466,0.034057604850934814,0.7271236876087811,0.0035371399696816574,0.29053955420807365,0.7094604457919264,0.03193532086912582
1037,,333,8076,8409,38,571,11626,3185,8441,11626,1083,0.02864269740237399,0.6946499225873043,0.003268536039910545,0.27395492860829174,0.7260450713917083,0.04911405470497161
1038,17.0,183,4165,4348,12,502,6127,1647,4480,6127,407,0.02986779826995267,0.6797780316631304,0.001958544148849355,0.268810184429574,0.731189815570426,0.0819324302268647
1039,25.0,5091,109757,114848,914,6136,150184,43431,106753,150184,9273,0.03389841794065946,0.7308168646460342,0.006085868001917648,0.2891852660736164,0.7108147339263836,0.04085654929952592
1040,14.0,143,2426,2569,0,225,4031,977,3054,4031,149,0.035475068221285044,0.6018357727611015,0.0,0.24237161994542297,0.757628380054577,0.05581741503349045
1041,17.0,1476,27794,29270,103,2293,40409,11152,29257,40409,2792,0.036526516370115565,0.6878170704546017,0.002548937117968769,0.2759781236853176,0.7240218763146824,0.05674478457769309
1042,17.0,70,2782,2852,0,93,3688,1066,2622,3688,242,0.01898047722342733,0.7543383947939263,0.0,0.2890455531453362,0.7109544468546638,0.025216919739696312
1043,,52909,977296,1030205,4459,65630,1409971,394613,1015358,1409971,103114,0.03752488526359762,0.6931319864025572,0.003162476391358404,0.27987313214243414,0.7201268678575659,0.0465470566415905
1044,,1370,29278,30648,69,2877,42145,11085,31060,42145,2719,0.03250682168703286,0.6946968798196702,0.0016372048878870566,0.26302052438011625,0.7369794756198838,0.06826432554276901
1045,26.0,344,2837,3321,30,215,4627,1198,3429,4627,155,0.07434622865787767,0.6131402636697644,0.006483682731791658,0.25891506375621354,0.7410849362437865,0.04646639291117355
1046,39.0,2734,80852,83586,304,4003,109602,31945,77675,109620,8122,0.02494070425104908,0.7375661375661375,0.0027732165663200145,0.2914158000364897,0.7085841999635103,0.03651705893085203
1047,17.0,106,7393,7499,18,422,10060,2842,7218,10060,848,0.010536779324055666,0.7348906560636183,0.0017892644135188867,0.28250497017892645,0.7174950298210736,0.04194831013916501
1048,,875,19471,20346,120,865,27102,7670,19432,27102,1790,0.032285440188915944,0.7184340639067227,0.004427717511622758,0.28300494428455464,0.7169950557154453,0.03191646372961405
1049,15.0,163,3312,3475,25,256,4765,1356,3409,4765,315,0.03420776495278069,0.6950682056663169,0.005246589716684155,0.28457502623294856,0.7154249737670514,0.05372507869884575
1050,27.0,476,8818,9294,26,480,13314,3525,9789,13314,938,0.035751840168243953,0.6623103500075109,0.0019528316058284513,0.2647589004055881,0.7352410995944119,0.03605227579990987
1051,,243,5792,6035,11,340,7963,2352,5611,7963,551,0.030516137134245887,0.7273640587718196,0.0013813889237724475,0.2953660680647997,0.7046339319352003,0.04269747582569383
1052,24.0,81,2373,2454,2,244,3420,884,2536,3420,247,0.02368421052631579,0.6938596491228071,0.0005847953216374269,0.2584795321637427,0.7415204678362574,0.07134502923976609
1053,16.0,367,5407,5774,11,872,7942,2075,5867,7942,257,0.04621002266431629,0.6808108788718207,0.0013850415512465374,0.261269201712415,0.738730798287585,0.10979602115336187
1054,42.0,6520,127739,134259,744,5763,176977,50970,126007,176977,13400,0.036840945433587416,0.7217830565553716,0.00420393610469157,0.28800352588189426,0.7119964741181057,0.032563553456098814
1055,45.0,1427,58002,59429,561,1628,75410,23015,52395,75410,4621,0.018923219732131017,0.7691552844450338,0.00743933165362684,0.3051982495690227,0.6948017504309774,0.021588648720328868
1056,13.0,137,2097,2234,0,99,3005,834,2171,3005,203,0.04559068219633943,0.6978369384359401,0.0,0.27753743760399335,0.7224625623960067,0.03294509151414309
1057,26.0,44,2334,2378,2,94,3084,929,2155,3084,247,0.014267185473411154,0.7568093385214008,0.0006485084306095979,0.3012321660181582,0.6987678339818417,0.0304798962386511
1058,17.0,218,10350,10568,14,328,13867,3973,9894,13867,1276,0.015720775942885987,0.7463762890315137,0.0010095911155981827,0.28650753587654143,0.7134924641234586,0.023653277565443137
1059,25.0,437,12341,12778,56,850,17096,4821,12275,17096,1203,0.025561534861956014,0.7218647636874123,0.003275620028076743,0.28199578848853535,0.7180042115114647,0.04971923256902199
1060,,308,8122,8430,23,451,11142,3163,7979,11142,734,0.027643152037336204,0.7289535092443008,0.0020642613534374438,0.2838808113444624,0.7161191886555376,0.040477472626099444
1061,15.0,10662,30946,41608,322,5287,59774,16745,43029,59774,610,0.1783718673670827,0.5177167330277378,0.005386957540067588,0.280138521765316,0.7198614782346839,0.08844982768427745
1062,,9633,197795,207428,1384,15088,281722,79885,201837,281722,19286,0.034193282739722136,0.7020928432994228,0.004912644379920631,0.28355967940025983,0.7164403205997402,0.05355634277763185
1063,37.0,82,2015,2097,8,91,2790,787,2003,2790,218,0.02939068100358423,0.7222222222222222,0.002867383512544803,0.28207885304659497,0.717921146953405,0.03261648745519713
1064,24.0,99,4163,4262,9,223,5610,1620,3990,5610,385,0.01764705882352941,0.7420677361853832,0.0016042780748663102,0.2887700534759358,0.7112299465240641,0.03975044563279857
1065,26.0,1512,22236,23748,121,1293,31451,8809,22652,31461,1859,0.04805950224086965,0.7067798226375512,0.0038460315946727695,0.2799974571691936,0.7200025428308064,0.041098502908362734
1066,,139,5667,5806,11,178,7321,2219,5102,7321,473,0.0189864772572053,0.7740745799754132,0.0015025269771889087,0.30310066930747165,0.6968993306925283,0.024313618358147795
1067,17.0,300,12339,12639,51,1131,17346,4694,12652,17346,1246,0.017295053614666205,0.711345555171221,0.002940159114493255,0.2706099388908106,0.7293900611091895,0.0652023521272916
1068,,695,16001,16696,71,867,22586,6272,16314,22586,1528,0.030771274240680067,0.7084477109713982,0.003143540246170194,0.2776941468166121,0.7223058531833879,0.0383866111750642
1069,27.0,115,3063,3178,6,179,4249,1224,3025,4249,288,0.02706519180983761,0.7208755001176748,0.0014120969639915275,0.2880677806542716,0.7119322193457284,0.04212755942574724
1070,,117,5074,5191,2,293,6791,2076,4715,6791,437,0.017228685024296864,0.7471653659254897,0.0002945074363127669,0.30569871889265204,0.694301281107348,0.04314533941982035
1071,26.0,1294,14470,15764,29,521,21000,5969,15031,21000,1465,0.06161904761904762,0.689047619047619,0.001380952380952381,0.28423809523809523,0.7157619047619047,0.02480952380952381
1072,,219,5464,5683,18,208,7534,2162,5372,7534,581,0.02906822405096894,0.7252455534908415,0.002389169100079639,0.28696575524289886,0.7130342447571011,0.02760817626758694
1073,16.0,4921,97254,102175,291,5603,136611,38079,98532,136611,9558,0.036021989444481047,0.7119046050464457,0.002130135933416782,0.27874036497793003,0.7212596350220699,0.04101426678671556
1074,15.0,412,11104,11516,43,709,15543,4432,11111,15543,1232,0.02650710930965708,0.7144051984816316,0.002766518690085569,0.28514443801068007,0.71485556198932,0.04561538956443415
1075,,1609,28065,29674,71,2644,42532,10989,31543,42532,2763,0.03783033950907552,0.6598561083419543,0.0016693313270008463,0.25837016834383525,0.7416298316561648,0.06216495814915828
1076,38.0,505,9831,10336,26,558,13751,3962,9789,13751,1000,0.03672460184713839,0.7149298232855792,0.0018907715802487092,0.288124500036361,0.711875499963639,0.040578866991491526
1077,,577,10755,11332,61,821,15602,4198,11404,15602,1008,0.036982438148955264,0.6893347006794001,0.003909755159594924,0.26906806819638507,0.7309319318036149,0.05262145878733496
1078,,426,10441,10867,43,1139,14824,3988,10836,14824,764,0.028737182946573125,0.7043308148947652,0.002900701565029682,0.26902320561252024,0.7309767943874798,0.0768348623853211
1079,,1645,34541,36186,297,1688,48546,13831,34719,48550,2972,0.03388259526261586,0.7114521112255406,0.00611740473738414,0.28488156539649845,0.7151184346035016,0.03476828012358393
1080,,63,1591,1654,2,84,2293,657,1636,2293,174,0.027474923680767552,0.6938508504143044,0.0008722197993894462,0.2865242040994331,0.713475795900567,0.03663323157435674
1081,16.0,965,17314,18279,25,1547,26589,6842,19747,26589,1532,0.03629320395652338,0.651171537101809,0.0009402384444695174,0.25732445748241756,0.7426755425175825,0.05818195494377374
1082,24.0,114,2861,2975,3,103,3834,1151,2683,3834,273,0.0297339593114241,0.7462180490349505,0.000782472613458529,0.3002086593635889,0.699791340636411,0.02686489306207616
1083,35.0,109,1871,1980,4,142,2645,756,1889,2645,195,0.04120982986767486,0.7073724007561437,0.0015122873345935729,0.2858223062381853,0.7141776937618147,0.053686200378071834
1084,,259,7077,7336,56,632,10100,2752,7348,10100,714,0.025643564356435642,0.7006930693069306,0.005544554455445544,0.2724752475247525,0.7275247524752475,0.06257425742574257
1085,,62,2178,2240,7,106,2949,869,2080,2949,258,0.02102407595795185,0.7385554425228891,0.002373685995252628,0.2946761614106477,0.7053238385893523,0.03594438792811122
1086,,72,1790,1862,0,180,2644,705,1939,2644,186,0.02723146747352496,0.6770045385779122,0.0,0.2666414523449319,0.733358547655068,0.0680786686838124
1087,,598,9459,10057,30,644,13769,3866,9903,13769,1084,0.043430895489868546,0.6869779940445929,0.002178807466046917,0.2807756554579127,0.7192243445420873,0.04677173360447382
1088,23.0,564,17275,17839,89,824,23526,6612,16914,23526,1717,0.023973476154042335,0.7342939726260308,0.0037830485420385957,0.28105075235909205,0.718949247640908,0.03502507863640228
1089,25.0,906,23398,24304,107,781,32027,9353,22674,32027,2346,0.02828863146719955,0.730571080650701,0.0033409310893933244,0.2920348455990258,0.7079651544009742,0.024385674587067162
1090,,365,15557,15922,64,1100,21527,5932,15595,21527,1316,0.01695545129372416,0.7226738514423747,0.0029730106378036882,0.27556092349142935,0.7244390765085706,0.05109862033725089
1091,47.0,28177,1036126,1064303,337,33539,1369866,394942,974924,1369866,115955,0.020569165159219954,0.7563703311126782,0.00024600946369936915,0.28830703149067133,0.7116929685093286,0.024483416626151756
1092,,116,3109,3225,4,196,4299,1203,3096,4299,334,0.02698301930681554,0.7231914398697371,0.0009304489416143289,0.27983251919050944,0.7201674808094906,0.04559199813910211
1093,15.0,60,2790,2850,2,106,3831,1099,2732,3831,332,0.015661707126076743,0.7282693813625685,0.0005220569042025581,0.28687026885930567,0.7131297311406943,0.027669015922735577
1094,,432,14880,15312,93,458,19954,5911,14043,19954,1711,0.02164979452741305,0.7457151448331162,0.004660719655206976,0.29623133206374663,0.7037686679362534,0.022952791420266613
1095,24.0,4292,142265,146557,116,10729,199066,56478,142588,199066,15367,0.021560688414897573,0.7146624737524239,0.0005827213085107452,0.2837149488109471,0.7162850511890528,0.0538966975776878
1096,25.0,57,2011,2068,11,77,2711,782,1929,2711,183,0.02102545186278126,0.7417926964219845,0.004057543341940244,0.28845444485429733,0.7115455551457027,0.028402803393581703
1097,27.0,24,3181,3205,3,172,4393,1203,3190,4393,345,0.005463236967903483,0.7241065331208741,0.0006829046209879354,0.27384475301616207,0.7261552469838379,0.03915319826997496
1098,,42,4832,4874,36,287,6731,1837,4894,6731,561,0.006239786064477789,0.7178725300846828,0.005348388055266677,0.272916357153469,0.7270836428465309,0.042638538107264895
1099,16.0,2664,76731,79395,403,3795,106370,30099,76271,106370,7507,0.02504465544796465,0.7213594058475133,0.0037886622167904484,0.2829651217448529,0.7170348782551471,0.035677352637021716
1100,17.0,149,3288,3437,8,119,4385,1275,3110,4385,304,0.033979475484606614,0.7498289623717218,0.0018244013683010262,0.29076396807297605,0.7092360319270239,0.027137970353477765
1101,15.0,797,7302,8099,43,1225,11641,3146,8495,11641,405,0.06846490851301434,0.6272656988231251,0.003693840735332016,0.27025169658964004,0.7297483034103599,0.10523150932050511
1102,,311,10438,10749,19,521,14241,4035,10206,14241,1119,0.021838354048170774,0.7329541464784777,0.0013341759707885682,0.28333684432273015,0.7166631556772699,0.03658450951478127
1103,,973,29474,30447,27,1024,39768,11609,28159,39768,3705,0.024466908066787366,0.7411486622409977,0.0006789378394689197,0.29191812512572923,0.7080818748742708,0.025749346208006438
1104,15.0,669,15152,15821,44,562,21278,5973,15305,21278,1822,0.03144092489895667,0.7120970015978946,0.0020678635210076134,0.28071247297678353,0.7192875270232165,0.026412256791051792
1105,13.0,113,3198,3311,5,180,4370,1280,3090,4370,308,0.02585812356979405,0.7318077803203661,0.0011441647597254005,0.2929061784897025,0.7070938215102975,0.041189931350114416
1106,27.0,179,5251,5430,17,276,7105,2089,5016,7105,519,0.025193525686136524,0.7390570021111893,0.0023926812104152007,0.294018296973962,0.705981703026038,0.03884588318085855
1107,,3891,75634,79525,236,3539,103838,29597,74241,103838,7450,0.03747183112155473,0.7283845990870395,0.0022727710472081513,0.2850305283229646,0.7149694716770354,0.03408193532232901
1108,25.0,553,11269,11822,39,650,16040,4457,11583,16040,1174,0.03447630922693267,0.7025561097256858,0.00243142144638404,0.27786783042394014,0.7221321695760599,0.040523690773067333
1109,,215,5485,5700,20,359,7648,2125,5523,7648,594,0.028111924686192467,0.7171809623430963,0.002615062761506276,0.2778504184100418,0.7221495815899581,0.046940376569037656
1110,,129,2255,2384,12,82,3492,943,2549,3492,250,0.036941580756013746,0.6457617411225659,0.003436426116838488,0.27004581901489116,0.7299541809851088,0.023482245131729668
1111,27.0,118,2928,3046,0,114,3954,1155,2799,3954,280,0.029843196762771876,0.7405159332321699,0.0,0.2921092564491654,0.7078907435508346,0.028831562974203338
1112,23.0,102,2346,2448,6,128,3306,914,2392,3306,272,0.030852994555353903,0.7096188747731398,0.0018148820326678765,0.2764670296430732,0.7235329703569268,0.03871748336358137
1113,17.0,1415,26025,27440,272,1262,35605,10627,24978,35605,2351,0.03974160932453307,0.7309366661985676,0.007639376492065721,0.29846931610728833,0.7015306838927117,0.0354444600477461
1114,40.0,254,4023,4277,38,95,5539,1649,3890,5539,434,0.04585665282541975,0.726304387073479,0.006860444123487994,0.297707167358729,0.702292832641271,0.017151110308719984
1115,,320,6387,6707,41,298,9062,2535,6527,9062,750,0.03531229309203266,0.7048112999337894,0.004524387552416685,0.2797395718384463,0.7202604281615538,0.03288457294195542
1116,16.0,386,10323,10709,10,554,14190,4063,10127,14190,1144,0.027202255109231854,0.7274841437632136,0.0007047216349541931,0.28632840028188866,0.7136715997181113,0.039041578576462295
1117,36.0,828,20534,21362,55,990,27944,8089,19855,27944,2252,0.029630689951331234,0.7348267964500429,0.0019682221586029202,0.2894718007443458,0.7105281992556541,0.03542799885485256
1118,26.0,1042,7718,8760,59,510,11528,3350,8178,11528,506,0.09038861901457321,0.669500346981263,0.005117973629424011,0.2905968077723803,0.7094031922276197,0.044240111034004166
1119,,303,6316,6619,61,228,8775,2504,6271,8775,590,0.03452991452991453,0.7197720797720798,0.006951566951566951,0.28535612535612537,0.7146438746438747,0.025982905982905983
1120,27.0,489,13098,13587,41,652,18033,5132,12901,18033,1252,0.027116952254200632,0.7263350524039262,0.0022736094937059834,0.2845893639438807,0.7154106360561193,0.03615593633893418
1121,17.0,200,3238,3438,4,201,4581,1333,3248,4581,294,0.04365858982754857,0.7068325693080113,0.0008731717965509714,0.2909845012006112,0.7090154987993887,0.04387688277668631
1122,15.0,379,10048,10427,71,823,13829,4002,9827,13829,738,0.027406175428447466,0.7265890519921904,0.005134138404801504,0.28939185769036085,0.7106081423096392,0.05951261841058645
1123,,473,8177,8650,61,301,11437,3183,8254,11437,811,0.04135699921308035,0.7149602168400805,0.005333566494710151,0.2783072484043018,0.7216927515956981,0.02631809040832386
1124,27.0,1633,27224,28857,183,1652,38544,10918,27626,38544,2693,0.04236716479867165,0.7063096720630967,0.004747820672478207,0.2832606890826069,0.7167393109173931,0.04286010792860108
1125,23.0,136,4877,5013,1,184,6963,1962,5001,6963,577,0.019531811001005314,0.700416487146345,0.0001436162573603332,0.2817750969409737,0.7182249030590263,0.026425391354301307
1126,16.0,1155,24816,25971,80,1562,35172,9807,25365,35172,2481,0.03283862163084272,0.7055612418969635,0.002274536563175253,0.27882975093824636,0.7211702490617536,0.04441032639599682
1127,,143,2064,2207,4,157,2914,830,2084,2914,201,0.04907343857240906,0.7083047357584077,0.0013726835964310226,0.2848318462594372,0.7151681537405628,0.053877831159917636
1128,16.0,4,3888,3892,38,198,5277,1513,3764,5277,516,0.0007580064430547659,0.7367822626492325,0.007201061209020277,0.2867159370854652,0.7132840629145347,0.03752131893121091
1129,23.0,213,7604,7817,18,238,10070,3044,7026,10070,811,0.021151936444885798,0.7551142005958292,0.0017874875868917578,0.30228401191658394,0.6977159880834161,0.023634558093346573
1130,17.0,221,5655,5876,22,267,7816,2214,5602,7816,616,0.028275332650972363,0.7235158648925282,0.0028147389969293756,0.28326509723643806,0.7167349027635619,0.03416069600818833
1131,24.0,4315,99985,104300,366,4467,137926,39540,98386,137926,11232,0.031284891898554296,0.7249177094963967,0.0026535968562852543,0.28667546365442337,0.7133245363455766,0.03238693212302249
1132,44.0,1341,34193,35534,147,1192,44700,13624,31076,44700,2805,0.03,0.7649440715883669,0.0032885906040268456,0.3047874720357942,0.6952125279642059,0.02666666666666667
1133,25.0,619,13680,14299,75,758,18903,5502,13401,18903,1227,0.03274612495371105,0.7236946516425964,0.003967624186637042,0.2910649103316934,0.7089350896683067,0.040099455112945034
1134,15.0,167,10122,10289,48,1429,14372,3810,10562,14372,839,0.011619816309490676,0.7042861118842193,0.003339827442248817,0.2650988032284999,0.7349011967715001,0.0994294461452825
1135,24.0,0,2759,2759,9,164,3738,1076,2662,3738,328,0.0,0.7380952380952381,0.002407704654895666,0.28785446762974853,0.7121455323702515,0.043873729266987696
1136,24.0,688,22183,22871,29,1198,30016,8767,21249,30016,2216,0.022921108742004266,0.7390391791044776,0.0009661513859275053,0.2920775586353945,0.7079224413646056,0.03991204690831557
1137,37.0,1031,29964,30995,108,1128,40280,11609,28671,40280,3104,0.025595829195630585,0.7438927507447864,0.0026812313803376365,0.28820754716981134,0.7117924528301887,0.028003972194637537
1138,33.0,1174,35097,36271,108,1704,47538,13755,33783,47538,3696,0.024696032647566157,0.7382935756657831,0.002271866717152594,0.28934746939290673,0.7106525306070933,0.03584500820396314
1139,14.0,212,2295,2507,8,253,3556,948,2608,3556,184,0.05961754780652419,0.6453880764904387,0.0022497187851518562,0.26659167604049494,0.7334083239595051,0.07114735658042745
1140,16.0,1117,37975,39092,121,4811,53909,14788,39121,53909,2831,0.020720102394776382,0.7044278320874066,0.0022445231779480235,0.2743141219462427,0.7256858780537573,0.08924298354634662
1141,17.0,631,18318,18949,79,1866,26670,7210,19460,26670,2196,0.023659542557180353,0.6868391451068616,0.002962129733783277,0.27034120734908135,0.7296587926509186,0.06996625421822272
1142,,13012,353131,366143,1318,20300,490421,140182,350244,490426,37608,0.026532035414109367,0.7200495079787776,0.002687459474008311,0.28583721091459263,0.7141627890854074,0.04139258522182755
1143,,5971,90576,96547,1582,6906,134586,36836,97750,134586,8748,0.04436568439510796,0.6729971913869199,0.011754565853803516,0.2736986016376146,0.7263013983623854,0.05131291516205252
1144,16.0,2222,41209,43431,68,2410,58154,16561,41593,58154,4140,0.03820889362726554,0.7086184957182653,0.0011693090759019155,0.28477834714722977,0.7152216528527703,0.041441689307700244
1145,23.0,134,4603,4737,6,184,6196,1804,4392,6196,517,0.021626856036152355,0.7428986442866365,0.0009683666881859264,0.2911555842479019,0.7088444157520981,0.029696578437701744
1146,24.0,875,32867,33742,177,1825,44908,12755,32153,44908,3537,0.01948427897033936,0.7318740536207358,0.003941391288857219,0.2840251180190612,0.7159748819809388,0.04063863899527924
1147,16.0,236,3801,4037,27,243,5556,1495,4061,5556,387,0.042476601871850254,0.6841252699784017,0.004859611231101512,0.26907847372210225,0.7309215262778977,0.04373650107991361
1148,24.0,88,1494,1582,11,83,2271,591,1680,2271,145,0.038749449581682076,0.6578599735799208,0.0048436811977102595,0.26023778071334214,0.7397622192866579,0.036547776309995596
1149,13.0,335,4009,4344,20,361,6327,1594,4733,6327,341,0.05294768452663189,0.6336336336336337,0.00316105579263474,0.2519361466729888,0.7480638533270112,0.057057057057057055
1150,,677,14034,14711,86,682,19486,5583,13903,19486,1464,0.03474289233295699,0.7202093810941188,0.004413425023093503,0.28651339423175615,0.7134866057682439,0.034999486811043826
1151,,782,18711,19493,110,2526,29406,7361,22045,29406,2159,0.026593212269604843,0.6362987145480514,0.003740733183704006,0.2503230633204108,0.7496769366795892,0.08590083656396653
1152,15.0,247,8708,8955,338,688,12509,3446,9063,12509,1069,0.019745783036213927,0.6961387800783436,0.027020545207450637,0.27548165320968904,0.724518346790311,0.05500039971220721
1153,16.0,290,5610,5900,8,444,8027,2312,5715,8027,586,0.036128067771271956,0.6988912420580541,0.0009966363523109506,0.2880279058178647,0.7119720941821353,0.05531331755325775
1154,26.0,745,7814,8559,39,663,12389,3195,9194,12389,633,0.06013398982968762,0.6307208007103076,0.0031479538300104933,0.25789006376624424,0.7421099362337558,0.053515215110178385
1155,14.0,89,4325,4414,41,309,6120,1661,4459,6120,463,0.01454248366013072,0.7066993464052288,0.006699346405228758,0.2714052287581699,0.72859477124183,0.050490196078431374
1156,,132,3696,3828,5,233,5184,1420,3764,5184,390,0.02546296296296296,0.7129629629629629,0.0009645061728395061,0.27391975308641975,0.7260802469135802,0.044945987654320986
1157,40.0,177,3348,3525,21,205,4727,1358,3369,4727,274,0.03744446795007404,0.7082716310556378,0.0044425639940765815,0.2872858049502856,0.7127141950497144,0.04336788660884282
1158,42.0,98,4227,4325,12,174,5560,1666,3894,5560,338,0.01762589928057554,0.7602517985611511,0.002158273381294964,0.2996402877697842,0.7003597122302159,0.031294964028776975
1159,23.0,2711,53254,55965,373,3012,74442,21121,53328,74449,4572,0.036414189579443645,0.7153084661983371,0.005010141170465688,0.28369756477588687,0.7163024352241132,0.04045722575185698
1160,17.0,80,1553,1633,1,127,2344,636,1708,2344,154,0.034129692832764506,0.662542662116041,0.0004266211604095563,0.2713310580204778,0.7286689419795221,0.05418088737201365
1161,24.0,272,6935,7207,24,537,9684,2651,7033,9684,786,0.02808756712102437,0.7161296984717059,0.0024783147459727386,0.27375051631557207,0.7262494836844279,0.05545229244114003
1162,,57,3001,3058,2,120,3801,1191,2610,3801,279,0.01499605367008682,0.7895290712970271,0.0005261773217574323,0.31333859510655093,0.6866614048934491,0.03157063930544594
1163,23.0,236,4799,5035,6,203,6595,1959,4636,6595,528,0.0357846853677028,0.7276724791508719,0.0009097801364670204,0.2970432145564822,0.7029567854435178,0.030780894617134194
1164,,180,3736,3916,0,172,5129,1522,3607,5129,378,0.03509456034314681,0.7284070968999805,0.0,0.2967440046792747,0.7032559953207252,0.03353480210567362
1165,,5,4110,4115,5,642,6042,1612,4430,6042,327,0.0008275405494869249,0.6802383316782522,0.0008275405494869249,0.26679907315458457,0.7332009268454154,0.10625620655412116
1166,,318,6868,7186,7,215,9379,2828,6551,9379,799,0.0339055336389807,0.7322742296620108,0.0007463482247574368,0.30152468280200445,0.6984753171979955,0.022923552617549844
1167,,14885,309012,323897,1594,19138,440563,123594,316969,440563,34922,0.03378631432961915,0.7014025235891348,0.0036180977521943513,0.2805364953479979,0.7194635046520022,0.043439871255643345
1168,13.0,371,6260,6631,71,338,9332,2409,6923,9332,649,0.039755679382768964,0.6708101157308187,0.007608229747106729,0.25814402057436775,0.7418559794256322,0.03621945992284612
1169,24.0,2432,77665,80097,294,2523,102597,30967,71630,102597,7741,0.023704396814721678,0.7569909451543417,0.002865580864937571,0.3018314375664006,0.6981685624335994,0.024591362320535687
1170,,725,5576,6301,23,988,8768,1812,6956,8768,395,0.08268704379562043,0.6359489051094891,0.0026231751824817517,0.20666058394160583,0.7933394160583942,0.11268248175182481
1171,41.0,116,1527,1643,4,260,2534,544,1990,2534,123,0.04577742699289661,0.6026045777426993,0.0015785319652722968,0.21468034727703236,0.7853196527229677,0.1026045777426993
1172,,1181,3746,4927,24,706,7190,1910,5280,7190,185,0.16425591098748263,0.5210013908205842,0.003337969401947149,0.26564673157162727,0.7343532684283728,0.09819193324061196
1173,24.0,169,3612,3781,23,103,4963,1446,3517,4963,377,0.03405198468668144,0.7277856135401974,0.00463429377392706,0.29135603465645776,0.7086439653435422,0.02075357646584727
1174,25.0,139,3594,3733,13,188,5006,1409,3597,5006,455,0.027766679984019178,0.7179384738314023,0.0025968837395125848,0.28146224530563324,0.7185377546943668,0.037554934079105075
1175,,1110,25730,26840,104,1122,35097,10108,24989,35097,2483,0.031626634755107276,0.7331110921161352,0.002963216229307348,0.28800182351767956,0.7119981764823204,0.03196854432002735
1176,16.0,127,6208,6335,9,674,8465,2345,6120,8465,547,0.015002953337271117,0.7333727111636149,0.00106320141760189,0.2770230360307147,0.7229769639692853,0.0796219728292971
1177,33.0,692,16946,17638,170,710,23381,6610,16771,23381,1832,0.029596681065822677,0.7247765279500449,0.007270860955476669,0.2827081818570634,0.7172918181429365,0.030366536931696678
1178,23.0,118,1929,2047,37,118,3454,623,2831,3454,162,0.034163288940359006,0.5584829183555298,0.010712217718587146,0.18037058482918356,0.8196294151708164,0.034163288940359006
1179,,5477,185865,191342,1334,14682,258450,71857,186593,258450,19462,0.021191719868446507,0.7191526407428903,0.005161539949700135,0.2780305668407816,0.7219694331592185,0.05680789320951828
1180,16.0,211,2837,3048,10,195,4142,1167,2975,4142,244,0.050941574118783195,0.6849348140994689,0.0024142926122646064,0.2817479478512796,0.7182520521487205,0.047078705939159825
1181,,1699,31432,33131,155,1449,43501,12602,30899,43501,2832,0.03905657341210547,0.7225581021125951,0.003563136479621158,0.2896944897818441,0.7103055102181559,0.033309579090135856
1182,34.0,2125,32581,34706,138,1760,48393,12950,35443,48393,3079,0.043911309486909265,0.6732585291261133,0.00285165209844399,0.2676006860496353,0.7323993139503647,0.03636889632798132
1183,,94,1909,2003,6,111,2646,753,1893,2646,148,0.03552532123960695,0.7214663643235072,0.0022675736961451248,0.28458049886621317,0.7154195011337868,0.04195011337868481
1184,15.0,246,6988,7234,59,683,10135,2727,7408,10135,723,0.024272323630981748,0.6894918598914652,0.005821410952146029,0.2690675875678342,0.7309324124321658,0.06739023186975826
1185,,240,6726,6966,0,364,9313,2606,6707,9313,766,0.025770428433372704,0.72221625684527,0.0,0.27982390207237196,0.720176097927628,0.03908514979061527
1186,26.0,348,7397,7745,45,411,10060,2981,7079,10060,749,0.03459244532803181,0.7352882703777336,0.0044731610337972166,0.2963220675944334,0.7036779324055666,0.04085487077534791
1187,,1686,22942,24628,491,1404,33432,9260,24172,33432,2087,0.05043072505384063,0.6862287628619287,0.014686527877482652,0.27698013878918404,0.723019861210816,0.04199569274946159
1188,27.0,1723,48100,49823,98,3650,68170,19035,49135,68170,5359,0.025275047674930322,0.7055889687545841,0.001437582514302479,0.27922839958926216,0.7207716004107378,0.05354261405310254
1189,,209,4673,4882,38,226,6400,1882,4518,6400,465,0.03265625,0.73015625,0.0059375,0.2940625,0.7059375,0.0353125
1190,,3415,34662,38077,162,4265,53381,14322,39059,53381,3408,0.06397407317210244,0.6493321593825518,0.0030347876585301884,0.26829770892265037,0.7317022910773496,0.07989734175081022
1191,,1226,19485,20711,288,1313,28831,7841,20990,28831,1908,0.04252367243591967,0.6758350386736499,0.00998924768478374,0.27196420519579617,0.7280357948042038,0.04554125767403142
1192,34.0,2169,58443,60612,569,2186,81551,22653,58898,81551,6239,0.02659685350271609,0.7166435727336268,0.006977228973280524,0.27777709654081495,0.722222903459185,0.026805312013341343
1193,14.0,337,9292,9629,5,582,12909,3726,9183,12909,985,0.026105817646603146,0.719807885971028,0.0003873266713145867,0.28863583546363003,0.71136416453637,0.04508482454101789
1194,14.0,373,9807,10180,82,551,13936,3714,10222,13936,1011,0.026765212399540758,0.7037169919632607,0.005884041331802526,0.26650401836969,0.7334959816303099,0.03953788748564868
1195,,107,1781,1888,3,133,2527,751,1776,2527,206,0.042342698852394146,0.704788286505738,0.001187178472497032,0.297190344281757,0.7028096557182429,0.05263157894736842
1196,,3379,105129,108508,278,5117,143623,41189,102434,143623,10815,0.02352687243686596,0.7319788613244397,0.0019356231244299312,0.2867855427055555,0.7132144572944444,0.035627998301107765
1197,41.0,95,1470,1565,23,64,2108,595,1513,2108,158,0.04506641366223909,0.6973434535104365,0.010910815939278937,0.28225806451612906,0.717741935483871,0.030360531309297913
1198,27.0,183,3705,3888,71,273,5519,1426,4093,5519,341,0.03315818082986048,0.6713172676209458,0.012864649393005979,0.2583801413299511,0.7416198586700489,0.04946548287733285
1199,14.0,2308,45976,48284,517,2789,66159,18150,48009,66159,4864,0.03488565425716834,0.6949319064677519,0.007814507474417691,0.27433909218700403,0.725660907812996,0.042156018077661395
1200,16.0,0,2321,2321,6,141,3127,874,2253,3127,285,0.0,0.742244963223537,0.0019187719859290054,0.27950111928365845,0.7204988807163415,0.045091141669331626
1201,25.0,279,6418,6697,48,563,9417,2434,6983,9417,622,0.02962726983115642,0.6815333970478921,0.005097164702134438,0.2584687267707338,0.7415312732292663,0.05978549431878517
1202,23.0,607,20476,21083,84,1216,28337,7974,20363,28337,2390,0.021420757313759396,0.7225888414440484,0.002964322264177577,0.28139887779228573,0.7186011222077143,0.04291209372904683
1203,23.0,1144,24609,25753,159,1417,34128,9846,24282,34128,2527,0.03352086263478669,0.7210794655414908,0.004658931082981716,0.28850210970464135,0.7114978902953587,0.041520159399906234
1204,24.0,97,8310,8407,4,194,10805,3228,7577,10805,958,0.008977325312355391,0.7690883850069412,0.00037019898195279964,0.2987505784359093,0.7012494215640906,0.017954650624710782
1205,16.0,3217,58428,61645,211,4439,84673,23382,61292,84674,5938,0.037992772279566336,0.6900347214020833,0.002491910149514609,0.2761414365684862,0.7238585634315138,0.05242459314547559
1206,15.0,2612,7726,10338,41,1147,14721,4102,10619,14721,802,0.1774335982609877,0.5248284763263366,0.0027851368792880917,0.2786495482643842,0.7213504517356157,0.07791590245227906
1207,17.0,45,2131,2176,5,172,2928,763,2165,2928,215,0.015368852459016393,0.7278005464480874,0.0017076502732240437,0.26058743169398907,0.7394125683060109,0.05874316939890711
1208,,68,1698,1766,41,129,2361,643,1718,2361,136,0.028801355357899194,0.7191867852604829,0.01736552308343922,0.2723422278695468,0.7276577721304532,0.054637865311308764
1209,40.0,790,12959,13749,139,718,18475,5030,13446,18476,1018,0.04275817276466768,0.701396406148517,0.007523273435808616,0.2722450746914917,0.7277549253085084,0.03886122537345746
1210,15.0,223,3840,4063,12,213,5488,1559,3929,5488,431,0.04063411078717201,0.6997084548104956,0.002186588921282799,0.2840743440233236,0.7159256559766763,0.03881195335276968
1211,33.0,184,3441,3625,7,160,4828,1376,3452,4828,327,0.03811101905550953,0.7127174813587407,0.0014498757249378626,0.28500414250207123,0.7149958574979287,0.033140016570008285
1212,14.0,2194,3296,5490,23,688,7734,2153,5581,7734,122,0.28368244116886476,0.426170157745022,0.002973881561934316,0.27838117403672097,0.721618825963279,0.08895784846133954
1213,37.0,10029,249847,259876,1721,12173,338062,98763,239301,338064,19733,0.029665980406076955,0.7390523687822425,0.00509075204694969,0.2921429078517677,0.7078570921482323,0.0360079748213356
1214,24.0,683,12209,12892,90,725,18241,4816,13425,18241,966,0.037443122635820406,0.6693163751987281,0.004933940025217916,0.26402061290499423,0.7359793870950058,0.0397456279809221
1215,17.0,25,1958,1983,26,296,2913,748,2165,2913,222,0.008582217645039478,0.6721592859594919,0.008925506350841057,0.2567799519395812,0.7432200480604189,0.10161345691726742
1216,,1627,24588,26215,322,1153,34087,10028,24059,34087,2378,0.04773080646580808,0.7213307125883768,0.009446416522427906,0.2941884002698976,0.7058115997301024,0.03382521195763781
1217,,54,1561,1615,4,140,2209,626,1583,2209,158,0.02444545043005885,0.7066545948392938,0.0018107741059302852,0.2833861475780896,0.7166138524219103,0.06337709370755998
1218,14.0,1697,18093,19790,81,1391,27008,7477,19531,27008,1980,0.0628332345971564,0.6699126184834123,0.002999111374407583,0.2768438981042654,0.7231561018957346,0.05150325829383886
1219,,1912,31959,33871,70,1345,44542,12806,31736,44542,3561,0.04292577791747115,0.7175025818328769,0.0015715504467693413,0.2875039288761169,0.712496071123883,0.030196219298639488
1220,34.0,3026,79803,82829,338,2950,106932,31269,75663,106932,7815,0.028298357834885723,0.7462967119290764,0.0031608872928590133,0.29241948153967007,0.7075805184603299,0.027587625780870085
1221,26.0,2143,42975,45118,206,1751,58968,17532,41436,58968,3816,0.03634174467507801,0.7287851037851037,0.0034934201600868267,0.2973137973137973,0.7026862026862026,0.02969407136073803
1222,13.0,15,2256,2271,22,69,2994,864,2130,2994,281,0.00501002004008016,0.7535070140280561,0.007348029392117568,0.28857715430861725,0.7114228456913828,0.023046092184368736
1223,25.0,116,1920,2036,12,175,2831,779,2052,2831,167,0.04097492052278347,0.6782055810667609,0.0042387848816672555,0.2751677852348993,0.7248322147651006,0.06181561285764747
1224,24.0,2120,44384,46504,199,2557,63062,17654,45408,63062,4139,0.03361770955567537,0.7038152928863658,0.0031556246233865083,0.27994671910183627,0.7200532808981637,0.04054739779899147
1225,14.0,609,7152,7761,59,388,10382,2842,7540,10382,823,0.05865921787709497,0.6888846079753419,0.005682912733577346,0.2737430167597765,0.7262569832402235,0.037372375264881526
1226,,81,3093,3174,42,317,4571,1169,3402,4571,283,0.0177204112885583,0.6766571866112449,0.009188361408882083,0.2557427258805513,0.7442572741194488,0.0693502515860862
1227,14.0,357,6137,6494,23,410,8714,2470,6244,8714,568,0.04096855634610971,0.7042689924259812,0.002639430801009869,0.28345191645627726,0.7165480835437228,0.047050722974523757
1228,24.0,129,3293,3422,5,279,4786,1323,3463,4786,363,0.026953614709569577,0.6880484747179273,0.0010447137484329294,0.2764312578353531,0.7235687421646468,0.05829502716255746
1229,,155,4087,4242,31,226,5680,1626,4054,5680,430,0.027288732394366196,0.7195422535211268,0.005457746478873239,0.2862676056338028,0.7137323943661972,0.0397887323943662
1230,,1143,21135,22278,84,1226,30135,8407,21728,30135,2303,0.03792931806869089,0.7013439522150323,0.0027874564459930314,0.2789779326364692,0.7210220673635308,0.04068359050937448
1231,,9231,163326,172557,709,6444,220416,66092,154325,220417,14547,0.04187970982274507,0.7409864030451372,0.0032166302962112724,0.2998498300947749,0.700150169905225,0.029235494539894834
1232,25.0,143,4635,4778,3,229,6322,1847,4475,6322,500,0.02261942423283771,0.7331540651692502,0.0004745333755140778,0.2921543815248339,0.7078456184751661,0.03622271433090794
1233,,132,2123,2255,6,151,3002,875,2127,3002,204,0.04397068620919387,0.7071952031978681,0.001998667554963358,0.2914723517654897,0.7085276482345103,0.050299800133244504
1234,27.0,68,2504,2572,12,106,3369,989,2380,3369,198,0.02018403086969427,0.7432472543781538,0.003561887800534283,0.2935589195607005,0.7064410804392995,0.03146334223805283
1235,,396,5444,5840,40,263,8883,2148,6735,8883,422,0.044579533941236066,0.6128560171113363,0.004502983226387482,0.24181019925700778,0.7581898007429922,0.029607114713497692
1236,35.0,234,7027,7261,31,389,9296,2781,6515,9296,586,0.025172117039586918,0.7559165232358004,0.0033347676419965577,0.2991609294320138,0.7008390705679862,0.04184595524956971
1237,,1479,35167,36646,189,2503,49945,13931,36014,49945,3854,0.029612573831214337,0.7041145259785765,0.0037841625788367205,0.2789268195014516,0.7210731804985484,0.05011512663930323
1238,,53,4719,4772,6,1174,7094,1016,6078,7094,303,0.0074711023400056385,0.6652100366506907,0.0008457851705666761,0.14321962221595716,0.8567803777840428,0.16549196504087962
1239,,1112,31314,32426,98,1530,42261,12459,29802,42261,2798,0.02631267598968316,0.7409668488677504,0.0023189228839828684,0.29481081848512813,0.7051891815148719,0.036203591964222334
1240,13.0,675,12890,13565,84,843,18493,5025,13469,18494,1156,0.036498323780685626,0.69698280523413,0.004542013626040878,0.2717097437006597,0.7282902562993403,0.045582351032767386
1241,23.0,118,3519,3637,29,307,4946,1358,3588,4946,420,0.023857662757784066,0.7114840274969673,0.005863323898099474,0.27456530529720985,0.7254346947027901,0.06207035988677719
1242,25.0,289,8368,8657,37,410,11513,3255,8258,11513,833,0.025102058542517156,0.7268305393902545,0.003213758360114653,0.2827238773560323,0.7172761226439677,0.03561191696343264
1243,34.0,47,2166,2213,5,69,2845,846,1999,2845,223,0.016520210896309315,0.761335676625659,0.0017574692442882249,0.29736379613356767,0.7026362038664323,0.024253075571177504
1244,25.0,202,3330,3532,103,258,5020,1328,3692,5020,282,0.0402390438247012,0.6633466135458167,0.020517928286852588,0.2645418326693227,0.7354581673306773,0.05139442231075697
1245,14.0,98,2802,2900,43,245,4060,1080,2980,4060,319,0.02413793103448276,0.6901477832512315,0.010591133004926109,0.2660098522167488,0.7339901477832512,0.0603448275862069
1246,,130,2569,2699,10,141,3579,1003,2576,3579,258,0.03632299525006985,0.7177982676725342,0.002794076557697681,0.2802458787370774,0.7197541212629226,0.039396479463537304
1247,,1486,6558,8044,46,662,11225,3105,8120,11225,469,0.13238307349665923,0.5842316258351893,0.004097995545657015,0.27661469933184857,0.7233853006681514,0.058975501113585745
1248,17.0,37,1514,1551,11,141,2059,527,1532,2059,118,0.017969888295288974,0.7353084021369597,0.005342399222923749,0.25594949004371054,0.7440505099562894,0.06847984458474989
1249,23.0,237,8814,9051,28,503,11859,3384,8475,11859,927,0.019984821654439665,0.7432329876043511,0.0023610759760519435,0.28535289653427776,0.7146471034657222,0.042415043426933134
1250,23.0,1075,25859,26934,324,987,34461,10406,24055,34461,2141,0.031194683845506516,0.75038449261484,0.009401932619482894,0.30196453962450304,0.6980354603754969,0.028641072516758074
1251,25.0,31374,943279,974653,2765,38743,1292135,371777,920358,1292135,95254,0.024280744659033307,0.7300158265196748,0.0021398692861040063,0.28772303203612626,0.7122769679638737,0.02998370913255968
1252,27.0,140,5379,5519,2,220,7147,2098,5049,7147,528,0.019588638589618023,0.7526234783825382,0.0002798376941374003,0.29354974115013294,0.7064502588498671,0.030782146355114035
1253,24.0,64,1579,1643,0,99,2226,637,1589,2226,179,0.028751123090745734,0.7093441150044923,0.0,0.2861635220125786,0.7138364779874213,0.0444743935309973
1254,16.0,226,8964,9190,0,235,11924,3500,8424,11924,1021,0.018953371351895336,0.7517611539751761,0.0,0.2935256625293526,0.7064743374706475,0.019708151626970816
1255,16.0,739,16613,17352,26,959,23248,6714,16534,23248,1721,0.031787680660702,0.7145991052993806,0.0011183757742601514,0.28879903647625604,0.711200963523744,0.041250860289057126
1256,41.0,267,9484,9751,41,471,12781,3675,9106,12781,1012,0.020890384163993428,0.7420389640873171,0.0032078867068304514,0.28753618652687585,0.7124638134731242,0.0368515765589547
1257,24.0,344,7885,8229,52,486,11640,3031,8609,11640,800,0.029553264604810996,0.677405498281787,0.004467353951890034,0.26039518900343644,0.7396048109965636,0.041752577319587626
1258,,667,29504,30171,108,1098,39533,11333,28200,39533,3381,0.016871980370829435,0.7463132066880833,0.0027318948726380494,0.28667189436673157,0.7133281056332684,0.027774264538486835
1259,24.0,552,11597,12149,19,651,15957,4659,11298,15957,1223,0.03459296860312089,0.726765682772451,0.0011907000062668421,0.2919721752209062,0.7080278247790938,0.04079714231998496
1260,14.0,137,2473,2610,18,234,3707,998,2709,3707,267,0.036957108173725384,0.6671162665227948,0.0048556784461828975,0.269220393849474,0.7307796061505261,0.06312381980037766
1261,24.0,2391,43758,46149,330,2518,60657,17363,43294,60657,4375,0.03941836886097235,0.7214006627429645,0.0054404273208368365,0.286248907793,0.7137510922070001,0.041512109072324714
1262,16.0,382,4814,5196,15,460,8156,1845,6311,8156,308,0.04683668464933791,0.5902403138793526,0.0018391368317802845,0.226213830308975,0.773786169691025,0.05640019617459539
1263,,5229,128884,134113,668,6141,177441,51117,126327,177444,13582,0.029468452018665044,0.7263361962083812,0.003764567976375645,0.28807398390478123,0.7119260160952188,0.03460810171096233
1264,38.0,30,2554,2584,0,127,3393,983,2410,3393,307,0.008841732979664015,0.7527262010020631,0.0,0.2897141173003242,0.7102858826996759,0.03743000294724433
1265,26.0,93,3570,3663,17,135,4739,1387,3352,4739,367,0.019624393331926566,0.7533234859675036,0.003587254695083351,0.2926777801223887,0.7073222198776113,0.02848702257860308
1266,42.0,92,2281,2373,7,103,3067,892,2175,3067,236,0.029996739484838605,0.7437235083143137,0.0022823606129768505,0.29083795239647864,0.7091620476035213,0.033583306162373656
1267,38.0,111,3341,3452,9,187,4664,1333,3331,4664,339,0.023799313893653515,0.7163379073756432,0.0019296740994854203,0.28580617495711835,0.7141938250428816,0.04009433962264151
1268,17.0,880,17969,18849,85,1432,25880,7101,18779,25880,1823,0.03400309119010819,0.6943199381761979,0.0032843894899536323,0.27438176197836167,0.7256182380216384,0.0553323029366306
1269,25.0,4755,133553,138308,723,6491,184908,52496,132412,184908,14925,0.025715490946849245,0.7222672896791918,0.003910052566681809,0.2839033465290847,0.7160966534709152,0.03510394358275467
1270,26.0,95,2350,2445,111,171,3475,973,2502,3475,255,0.027338129496402876,0.6762589928057554,0.03194244604316547,0.28,0.72,0.04920863309352518
1271,24.0,263,12261,12524,11,351,15986,4956,11030,15986,1187,0.016451895408482423,0.766983610659327,0.0006881020893281622,0.31002126861003376,0.6899787313899662,0.021956712123107718
1272,17.0,2712,96878,99590,158,5186,128745,38021,90724,128745,9183,0.02106489572410579,0.7524797079498233,0.0012272321255194377,0.29532020660996544,0.7046797933900346,0.04028117596799876
1273,26.0,1924,43024,44948,206,1750,60467,17099,43368,60467,4868,0.03181900871549771,0.7115286023781566,0.003406816941472208,0.2827823440885111,0.7172176559114889,0.028941406056195943
1274,,3061,68337,71398,228,3851,95133,27017,68116,95133,6803,0.03217600622286693,0.7183311784554256,0.002396644697423607,0.28399188504514733,0.7160081149548527,0.04048016986744873
1275,37.0,168,6159,6327,5,381,8348,2440,5908,8348,672,0.020124580737901295,0.7377815045519885,0.0005989458552946814,0.2922855773838045,0.7077144226161955,0.04563967417345472
1276,26.0,550,10573,11123,187,293,14407,4342,10065,14407,1063,0.03817588672173249,0.7338793641979593,0.012979801485389048,0.3013812729922954,0.6986187270077046,0.020337336017213853
1277,25.0,582,11962,12544,100,561,16550,4747,11803,16550,1058,0.03516616314199396,0.7227794561933535,0.006042296072507553,0.2868277945619335,0.7131722054380665,0.03389728096676737
1278,27.0,104,1910,2014,15,131,2754,775,1979,2754,183,0.03776325344952796,0.6935366739288308,0.0054466230936819175,0.2814088598402324,0.7185911401597677,0.04756717501815541
1279,26.0,7635,129859,137494,1327,6811,187233,52455,134778,187233,13586,0.04077806796878755,0.693568975554523,0.007087425827711995,0.2801589463395876,0.7198410536604124,0.03637713437268003
1280,37.0,383,5762,6145,218,307,8517,2378,6139,8517,488,0.044968885757895975,0.6765292943524716,0.02559586708935071,0.2792062932957614,0.7207937067042386,0.036045555946929674
1281,24.0,1605,14031,15636,387,1153,22942,5851,17091,22942,1229,0.06995902711184726,0.6115857379478685,0.01686862522883794,0.25503443466131986,0.7449655653386802,0.050257170255426725
1282,48.0,1234,30419,31653,64,1460,41455,12209,29246,41455,3144,0.02976721746472078,0.7337836207936317,0.0015438427210227959,0.2945121215776143,0.7054878784223857,0.03521891207333253
1283,,238,4843,5081,8,239,6858,1948,4910,6858,480,0.0347039953339166,0.7061825605132692,0.0011665208515602217,0.28404782735491396,0.715952172645086,0.034849810440361624
1284,27.0,2009,31657,33666,252,1891,45606,12591,33015,45606,3073,0.044051221330526684,0.6941411217822216,0.005525588738323905,0.2760820944612551,0.7239179055387449,0.04146384247686708
1285,24.0,831,14324,15155,116,833,20573,5663,14910,20573,1402,0.04039274777621154,0.6962523696106547,0.0056384581733339816,0.27526369513439947,0.7247363048656006,0.04048996257230351
1286,15.0,232,5977,6209,40,647,8813,2301,6512,8813,569,0.02632474753205492,0.6782026551685011,0.004538749574492227,0.26109156927266536,0.7389084307273346,0.07341427436741178
1287,38.0,222,3823,4045,7,191,5365,1567,3798,5365,418,0.041379310344827586,0.7125815470643057,0.00130475302889096,0.29207828518173345,0.7079217148182665,0.03560111835973905
1288,13.0,37,1820,1857,18,39,2548,693,1855,2548,207,0.014521193092621664,0.7142857142857143,0.00706436420722135,0.27197802197802196,0.728021978021978,0.015306122448979591
1289,16.0,3473,101406,104879,328,3901,139633,39452,100183,139635,11680,0.024871987682171377,0.7262219357610914,0.002348981272603574,0.28253661331328106,0.7174633866867189,0.027937121781788234
1290,17.0,949,24452,25401,122,1570,33748,9649,24099,33748,2497,0.028120184899845916,0.7245466398008771,0.0036150290387578525,0.28591323930306983,0.7140867606969302,0.046521275334834654
1291,34.0,102,2719,2821,6,162,3678,1074,2604,3678,246,0.02773246329526917,0.7392604676454595,0.0016313213703099511,0.29200652528548127,0.7079934747145188,0.04404567699836868
1292,25.0,5988,153752,159740,430,7311,209358,60687,148671,209358,17930,0.02860172527441034,0.7343975391434767,0.0020538981075478367,0.28987189407617575,0.7101281059238242,0.03492104433554008
1293,,5778,154046,159824,813,8010,210578,59798,150780,210578,16147,0.027438763783491152,0.7315389071982829,0.003860802173066512,0.2839707851722402,0.7160292148277598,0.03803816163131951
1294,16.0,699,25875,26574,160,637,35359,10008,25351,35359,3415,0.019768658615911084,0.7317797449022879,0.004525014847704969,0.2830396787239458,0.7169603212760541,0.018015215362425407
1295,,76,17589,17665,155,698,23742,6681,17061,23742,1914,0.0032010782579395165,0.7408390194591863,0.006528514868166119,0.28140005054334094,0.7185999494566591,0.029399376632128715
1296,16.0,862,11407,12269,26,799,16569,4744,11825,16569,1196,0.05202486571307864,0.6884543424467379,0.0015691954855452954,0.28631782243949544,0.7136821775605046,0.04822258434425735
1297,24.0,140,2385,2525,21,104,3363,965,2398,3363,269,0.041629497472494795,0.7091882247992863,0.006244424620874219,0.2869461790068391,0.7130538209931608,0.030924769550996135
1298,,1114,26792,27906,42,1337,37121,10398,26723,37121,2859,0.03000996740389537,0.7217477977425177,0.0011314350367716388,0.2801109883893214,0.7198890116106786,0.03601734867056383
1299,,384,27509,27893,728,1499,39843,10560,29283,39843,2727,0.009637828476771327,0.6904349572070376,0.01827171648721231,0.2650402831112115,0.7349597168887885,0.03762266897572974
1300,26.0,83,1619,1702,5,73,2322,657,1665,2322,185,0.03574504737295435,0.6972437553832903,0.002153316106804479,0.28294573643410853,0.7170542635658915,0.031438415159345395
1301,23.0,158,3065,3223,14,193,4277,1234,3043,4277,286,0.03694178162263269,0.7166238017301847,0.0032733224222585926,0.2885199906476502,0.7114800093523498,0.04512508767827917
1302,24.0,111,3944,4055,1,188,5373,1561,3812,5373,366,0.02065884980457845,0.7340405732365531,0.00018611576400521124,0.2905267076121347,0.7094732923878653,0.03498976363297971
1303,,509,11649,12158,45,586,16510,4638,11872,16510,1254,0.030829800121138704,0.7055723803755299,0.0027256208358570565,0.2809206541490006,0.7190793458509994,0.03549364021804967
1304,,88,18532,18620,44,2333,26498,7484,19014,26498,1825,0.003321005358895011,0.6993735376254812,0.0016605026794475055,0.2824364102951166,0.7175635897048834,0.08804438070797796
1305,42.0,64,1476,1540,12,82,2074,577,1497,2074,146,0.03085824493731919,0.7116682738669238,0.0057859209257473485,0.27820636451301833,0.7217936354869817,0.03953712632594021
1306,,2200,43230,45463,357,1940,60065,17338,42727,60065,3729,0.03662698743028386,0.7197203030050778,0.005943561142096062,0.28865395821193707,0.7113460417880629,0.03229834346125031
1307,15.0,86,12003,12089,37,261,15981,4583,11398,15981,1788,0.005381390401101308,0.7510794067955697,0.0023152493586133535,0.28677804893310804,0.7132219510668919,0.016331894124272574
1308,24.0,128,7647,7775,25,241,10126,2986,7140,10126,822,0.012640726841793404,0.7551846731187043,0.002468891961287774,0.29488445585621176,0.7051155441437883,0.02380011850681414
1309,25.0,238,7417,7655,61,344,10057,2873,7184,10057,750,0.02366510887938749,0.7374962712538531,0.006065427065725365,0.28567167147260614,0.7143283285273938,0.034205031321467634
1310,33.0,59,2589,2648,2,128,3481,970,2511,3481,275,0.01694915254237288,0.7437517954610744,0.0005745475438092502,0.2786555587474864,0.7213444412525136,0.036771042803792016
1311,,24983,493857,518840,2381,28773,693867,198626,495241,693867,50515,0.036005459259483445,0.7117459109598814,0.003431493355354845,0.28625947047488925,0.7137405295251107,0.04146760113969968
1312,23.0,1028,20972,22000,88,655,28905,8479,20426,28905,2341,0.03556478117972669,0.7255492129389379,0.0030444559764746582,0.2933402525514617,0.7066597474485383,0.02266043937035115
1313,15.0,341,7092,7433,54,443,9743,2881,6862,9743,639,0.034999486811043826,0.7279072154367238,0.005542440726675562,0.2956994765472647,0.7043005234527353,0.04546854151698655
1314,27.0,2359,40326,42685,256,1457,57263,15868,41395,57263,3789,0.04119588565041999,0.7042243682657213,0.004470600562317727,0.27710738172991284,0.7228926182700871,0.025444003981628625
1315,,53,2647,2700,10,125,3489,1047,2442,3489,265,0.015190599025508742,0.7586701060475781,0.002866150759529951,0.3000859845227859,0.6999140154772141,0.03582688449412439
1316,27.0,875,16846,17721,100,629,24254,6719,17535,24254,1558,0.036076523460047825,0.6945658448091037,0.004123031252576894,0.27702646986064156,0.7229735301393585,0.025933866578708668
1317,17.0,29,1920,1949,5,82,2557,760,1797,2557,205,0.01134141572154869,0.7508799374266719,0.0019554165037152915,0.2972233085647243,0.7027766914352758,0.032068830660930775
1318,16.0,87,3385,3472,0,175,4532,1314,3218,4532,378,0.019196822594880848,0.7469108561341571,0.0,0.28993821712268314,0.7100617828773168,0.038614298323036186
1319,,40,2667,2707,9,52,3545,1056,2489,3545,316,0.011283497884344146,0.7523272214386459,0.002538787023977433,0.29788434414668546,0.7021156558533145,0.01466854724964739
1320,16.0,237,3664,3901,23,206,5303,1449,3854,5303,320,0.04469168395247973,0.690929662455214,0.0043371676409579485,0.2732415613803508,0.7267584386196493,0.03884593626249293
1321,13.0,403,8938,9341,82,637,12800,3528,9272,12800,997,0.031484375,0.69828125,0.00640625,0.275625,0.724375,0.049765625
1322,24.0,22,1772,1794,9,76,2535,687,1848,2535,224,0.008678500986193294,0.6990138067061143,0.0035502958579881655,0.2710059171597633,0.7289940828402367,0.029980276134122286
1323,38.0,4266,144749,149015,294,6118,191011,57315,133696,191011,14209,0.022333792294684598,0.7578045243467654,0.0015391783719262242,0.30006125301684194,0.699938746983158,0.03202956897770286
1324,47.0,13210,277107,290317,1175,10035,389444,111533,277931,389464,31562,0.03391841094427213,0.7115086375120678,0.0030169669083663702,0.2863756342049586,0.7136243657950414,0.02576618121315449
1325,25.0,1305,13302,14607,60,597,19000,5678,13322,19000,1107,0.06868421052631579,0.7001052631578948,0.003157894736842105,0.2988421052631579,0.7011578947368421,0.03142105263157895
1326,27.0,1588,19270,20858,93,753,30872,7892,22980,30872,2003,0.051438196423944024,0.6241902047162478,0.003012438455558435,0.25563617517491577,0.7443638248250842,0.024391033946618294
1327,17.0,285,10284,10569,339,1135,14323,3553,10770,14323,816,0.019898066047615723,0.7180060043287021,0.02366822593032186,0.2480625567269427,0.7519374432730573,0.07924317531243455
1328,25.0,1516,36073,37589,99,1623,49949,14420,35529,49949,3630,0.03035095797713668,0.7221966405733848,0.0019820216620953374,0.2886944683577249,0.7113055316422752,0.03249314300586598
1329,,787,29286,30073,146,1207,38664,11507,27157,38664,2696,0.020354852058762675,0.7574487895716946,0.0037761224912062903,0.29761535278295054,0.7023846472170494,0.03121767018415063
1330,,1291,25649,26940,128,1757,35711,9862,25849,35711,2529,0.03615132592198482,0.7182380779031671,0.003584329758337767,0.27616140684943014,0.7238385931505699,0.04920052644843326
1331,,325,3605,3930,2,87,6000,1515,4485,6000,195,0.05416666666666667,0.6008333333333333,0.0003333333333333333,0.2525,0.7475,0.0145
1332,,369,7077,7446,144,424,9909,2811,7098,9909,590,0.03723887375113533,0.714199212836815,0.014532243415077202,0.2836815016651529,0.7163184983348471,0.04278938338883843
1333,17.0,178,3656,3834,11,237,5213,1425,3788,5213,351,0.03414540571647803,0.7013236140418185,0.0021101093420295416,0.27335507385382696,0.726644926146173,0.04546326491463649
1334,25.0,7296,136982,144278,532,8074,195579,55321,140258,195579,13162,0.03730461859402083,0.7003921688933884,0.002720128439147352,0.28285756650765165,0.7171424334923484,0.04128255078510474
1335,,77,3365,3442,10,220,4625,1236,3389,4625,368,0.016648648648648647,0.7275675675675676,0.002162162162162162,0.2672432432432432,0.7327567567567568,0.04756756756756757
1336,14.0,188,3614,3802,26,239,5203,1439,3764,5203,387,0.03613300019219681,0.6945992696521238,0.004997117047857005,0.27657120891793197,0.723428791082068,0.045935037478377856
1337,26.0,216,7506,7722,17,305,10017,2936,7081,10017,757,0.0215633423180593,0.7493261455525606,0.0016971149046620744,0.29310172706399124,0.7068982729360088,0.030448237995407808
1338,,549,16732,17281,8,423,22315,6638,15677,22315,2078,0.024602285458211966,0.7498095451490029,0.0003585032489356935,0.29746807080439164,0.7025319291956084,0.018955859287474792
1339,23.0,556,13414,13970,23,619,18770,5399,13371,18770,1431,0.029621736814065,0.7146510388918487,0.0012253596164091636,0.2876398508257858,0.7123601491742142,0.03297815663292488
1340,23.0,1138,27978,29116,77,1263,38510,11057,27453,38510,2728,0.029550766034796158,0.7265125941313945,0.001999480654375487,0.2871202285120748,0.7128797714879253,0.03279667618800312
1341,14.0,205,2261,2466,8,223,3489,943,2546,3489,233,0.058756090570364,0.648036686729722,0.002292920607623961,0.2702780166236744,0.7297219833763255,0.06391516193751791
1342,24.0,447,7965,8412,26,363,11172,3187,7985,11172,692,0.040010741138560686,0.7129430719656283,0.002327246688148944,0.2852667382742571,0.7147332617257429,0.032491944146079484
1343,,152,2056,2208,27,130,3008,824,2184,3008,171,0.05053191489361702,0.6835106382978723,0.008976063829787235,0.27393617021276595,0.726063829787234,0.04321808510638298
1344,27.0,102,2844,2946,17,131,3938,1134,2804,3938,328,0.02590147282884713,0.7221940071102082,0.004316912138141189,0.28796343321482987,0.7120365667851701,0.03326561706449974
1345,33.0,1747,53481,55228,771,2060,72043,20897,51147,72044,4397,0.024249070012769974,0.7423380156570984,0.010701793348509245,0.2900588529232136,0.7099411470767865,0.028593637221697853
1346,24.0,443,6758,7201,49,417,9690,2731,6959,9690,651,0.0457172342621259,0.6974200206398349,0.005056759545923633,0.2818369453044376,0.7181630546955624,0.04303405572755418
1347,,1218,22484,23702,71,832,30828,8939,21889,30828,2649,0.039509536784741145,0.7293369663941871,0.002303101076943039,0.2899636693914623,0.7100363306085377,0.026988452056571948
1348,24.0,540,17197,17737,49,649,22842,6910,15936,22846,1758,0.023636522804867374,0.7527357086579708,0.0021447955878490764,0.3024599492252473,0.6975400507747527,0.02840759870436838
1349,34.0,77,2243,2320,12,112,3092,887,2205,3092,218,0.024902975420439843,0.7254204398447607,0.0038809831824062097,0.286869340232859,0.713130659767141,0.03622250970245795
1350,16.0,1034,25206,26240,104,1085,33905,10019,23886,33905,2690,0.030496976847072702,0.7434301725409231,0.0030673941896475444,0.2955021383276803,0.7044978616723198,0.03200117976699602
1351,44.0,129,3408,3537,0,134,4705,1382,3323,4705,360,0.027417640807651435,0.7243358129649309,0.0,0.29373007438894794,0.7062699256110521,0.028480340063761954
1352,14.0,204,3357,3561,9,200,4840,1334,3506,4840,331,0.04214876033057851,0.6935950413223141,0.001859504132231405,0.2756198347107438,0.7243801652892562,0.04132231404958678
1353,15.0,2007,43692,45699,360,4620,64442,16923,47519,64442,3985,0.031144284783215914,0.6780050277769156,0.00558641879519568,0.2626082368641569,0.7373917631358431,0.07169237453834455
1354,,371,7788,8159,1,574,11075,3133,7942,11075,714,0.03349887133182844,0.7032054176072234,9.029345372460496e-05,0.2828893905191874,0.7171106094808126,0.05182844243792325
1355,13.0,4462,35794,40256,1041,3491,57977,14981,42996,57977,3165,0.07696155371957845,0.6173827552305224,0.01795539610535212,0.25839557065732965,0.7416044293426703,0.06021353295272263
1356,14.0,339,5598,5937,36,317,8145,2252,5893,8145,578,0.04162062615101289,0.687292817679558,0.004419889502762431,0.2764886433394721,0.7235113566605279,0.03891958256599141
1357,16.0,156,2585,2741,3,393,3920,1082,2838,3920,314,0.03979591836734694,0.6594387755102041,0.0007653061224489796,0.2760204081632653,0.7239795918367347,0.10025510204081632
1358,17.0,72,2112,2184,15,285,3110,853,2257,3110,111,0.02315112540192926,0.6790996784565917,0.00482315112540193,0.27427652733118973,0.7257234726688103,0.09163987138263666
1359,,116,2217,2333,3,125,3265,902,2363,3265,221,0.03552833078101072,0.6790199081163859,0.0009188361408882082,0.27626339969372127,0.7237366003062787,0.03828483920367534
1360,,53,1877,1930,0,92,2616,753,1863,2616,218,0.020259938837920488,0.7175076452599388,0.0,0.28784403669724773,0.7121559633027523,0.035168195718654434
1361,25.0,304,3583,3887,47,226,6112,1371,4741,6112,200,0.049738219895287955,0.5862238219895288,0.007689790575916231,0.22431282722513088,0.7756871727748691,0.03697643979057592
1362,26.0,2964,49413,52377,156,2815,70207,19732,50475,70207,5139,0.04221801244890111,0.7038187075362855,0.0022220006552053214,0.2810545956955859,0.7189454043044141,0.04009571695130115
1363,,837,12945,13782,50,940,18507,5232,13275,18507,1278,0.04522613065326633,0.6994650672718431,0.0027016804452369373,0.2827038417895931,0.7172961582104068,0.05079159237045442
1364,,7,1699,1706,6,105,2340,653,1687,2340,198,0.0029914529914529917,0.726068376068376,0.002564102564102564,0.27905982905982907,0.7209401709401709,0.04487179487179487
1365,,419,16563,16982,12,578,21782,6507,15275,21782,1775,0.019236066476907537,0.7603984941694978,0.0005509135983839868,0.29873289872371683,0.7012671012762832,0.026535671655495363
1366,25.0,74,1828,1902,116,124,2682,750,1932,2682,215,0.027591349739000747,0.6815809097688292,0.04325130499627144,0.2796420581655481,0.7203579418344519,0.04623415361670395
1367,13.0,95,1574,1669,6,116,2242,644,1598,2242,165,0.0423728813559322,0.7020517395182873,0.0026761819803746653,0.2872435325602141,0.7127564674397859,0.05173951828724353
1368,17.0,47,1980,2027,5,75,2832,758,2074,2832,249,0.016596045197740113,0.6991525423728814,0.0017655367231638418,0.2676553672316384,0.7323446327683616,0.026483050847457626
1369,17.0,53,1607,1660,14,51,2352,612,1740,2352,196,0.022534013605442178,0.6832482993197279,0.005952380952380952,0.2602040816326531,0.7397959183673469,0.021683673469387755
1370,16.0,895,23880,24775,110,1529,32883,9227,23656,32883,2479,0.027217711279384483,0.7262111121248062,0.003345193565064015,0.28060091840768786,0.7193990815923121,0.04649819055438981
1371,13.0,169,2696,2865,88,133,4029,1092,2937,4029,219,0.041945892280963015,0.6691486721270786,0.021841648051625712,0.2710349962769918,0.7289650037230082,0.03301067262347977
1372,34.0,398,9007,9405,14,399,12828,3620,9208,12828,893,0.03102588088556283,0.7021359526036794,0.001091362644215778,0.28219519800436543,0.7178048019956346,0.031103835360149674
1373,23.0,82,2747,2829,6,74,3639,1049,2590,3639,261,0.022533663094256664,0.7548777136575983,0.0016488046166529267,0.28826600714482,0.71173399285518,0.020335256938719428
1374,14.0,290,3467,3757,18,369,5293,1370,3923,5293,336,0.05478934441715473,0.6550160589457774,0.0034007179293406384,0.25883242017759306,0.741167579822407,0.06971471755148309
1375,17.0,32,2907,4434,28,154,5712,1153,4559,5712,326,0.0056022408963585435,0.5089285714285714,0.004901960784313725,0.20185574229691877,0.7981442577030813,0.02696078431372549
1376,23.0,236,5468,5704,40,233,7521,2201,5320,7521,578,0.03137880600983912,0.7270309799228826,0.005318441696582901,0.29264725435447414,0.7073527456455259,0.0309799228825954
1377,,77,1752,1829,18,158,2532,680,1852,2532,174,0.030410742496050552,0.6919431279620853,0.0071090047393364926,0.2685624012638231,0.731437598736177,0.06240126382306477
1378,14.0,434,9320,9755,53,781,13142,3608,9534,13142,823,0.033023892862577994,0.7091766854360066,0.004032871709024502,0.2745396438898189,0.7254603561101811,0.05942778876883275
1379,23.0,128,3294,3422,18,108,4590,1325,3265,4590,380,0.027886710239651415,0.7176470588235294,0.00392156862745098,0.2886710239651416,0.7113289760348583,0.023529411764705882
1380,15.0,41,2088,2129,3,142,2868,811,2057,2868,177,0.014295676429567642,0.7280334728033473,0.0010460251046025104,0.28277545327754533,0.7172245467224547,0.04951185495118549
1381,,200,6561,6761,17,333,8900,2515,6385,8900,684,0.02247191011235955,0.7371910112359551,0.001910112359550562,0.28258426966292133,0.7174157303370786,0.03741573033707865
1382,,1587,5062,6649,171,1080,10219,2583,7636,10219,414,0.15529895293081514,0.49535179567472354,0.016733535570995203,0.25276445836187494,0.7472355416381251,0.10568548781681182
1383,15.0,950,7933,8883,29,828,12443,3333,9110,12443,766,0.07634814755284096,0.637547215301776,0.0023306276621393555,0.26786144820380936,0.7321385517961906,0.066543438077634
1384,,1016,35270,36286,265,2942,50532,13465,37067,50532,3795,0.0201060714003008,0.6979735613076862,0.005244201693976094,0.2664648143750495,0.7335351856249506,0.05822053352331196
1385,16.0,333,19190,19523,104,911,26027,7405,18622,26027,2193,0.012794405809351827,0.7373112536980828,0.0039958504629807505,0.2845122372920429,0.7154877627079571,0.03500211319014869
1386,,1794,42676,44470,135,2409,59118,16844,42274,59118,3799,0.030346087486044858,0.7218782773436179,0.0022835684563077235,0.2849216820596096,0.7150783179403905,0.04074901045366893
1387,17.0,236,3928,4164,23,244,5587,1599,3988,5587,389,0.04224091641310184,0.7030606765706103,0.004116699480937892,0.2862001073921604,0.7137998926078396,0.04367281188473241
1388,33.0,3092,87202,90294,711,6068,123764,33209,90555,123764,8517,0.02498303222261724,0.7045829158721437,0.005744804628163278,0.2683251995733816,0.7316748004266184,0.04902879674218674
1389,13.0,122,2068,2190,13,128,2937,834,2103,2937,195,0.04153898535921008,0.704119850187266,0.004426285325161729,0.2839632277834525,0.7160367722165475,0.04358188627851549
1390,36.0,2858,71155,74013,356,4903,97721,27119,70602,97721,6770,0.029246528381821717,0.7281444111296446,0.0036430245290162812,0.2775145567482936,0.7224854432517064,0.05017345299372704
1391,23.0,749,19026,19775,38,727,25982,7604,18378,25982,2126,0.028827649911477175,0.7322761912092988,0.0014625509968439689,0.29266415210530367,0.7073358478946963,0.027980909860672774
1392,16.0,617,13959,14576,37,995,19703,5558,14145,19703,1504,0.031315028168299244,0.7084707912500634,0.0018778866162513324,0.2820890219763488,0.7179109780236512,0.050499923869461505
1393,,118,2248,2366,0,107,3115,926,2189,3115,197,0.037881219903691817,0.721669341894061,0.0,0.2972712680577849,0.7027287319422151,0.03434991974317817
1394,15.0,4332,75850,80182,346,4979,110092,30505,79587,110092,7416,0.0393489081858809,0.6889692257384733,0.0031428260000726663,0.27708643679831413,0.7229135632016859,0.04522581113977401
1395,,203,4942,5145,19,188,6818,1942,4876,6818,580,0.029774127310061602,0.7248459958932238,0.0027867409797594604,0.28483426224699326,0.7151657377530067,0.02757406864183045
1396,17.0,3616,97321,100937,280,3286,132360,37527,94833,132360,9047,0.02731943185252342,0.7352750075551526,0.0021154427319431852,0.2835222121486854,0.7164777878513146,0.024826231489876095
1397,14.0,0,1655,1655,9,79,2287,597,1690,2287,143,0.0,0.7236554438128553,0.003935286401399213,0.2610406646261478,0.7389593353738522,0.03454306952339309
1398,,71637,1199331,1270968,8841,66577,1758158,486694,1271464,1758158,106727,0.0407454847630304,0.6821520022660079,0.005028558297945919,0.27682039953178267,0.7231796004682173,0.03786747266172892
1399,16.0,3857,79082,82939,199,3942,110545,31446,79099,110545,8639,0.03489076846533086,0.7153828757519562,0.0018001718757067258,0.28446334072097335,0.7155366592790267,0.03565968610068298
1400,,41,1342,1383,13,45,2032,513,1519,2032,178,0.020177165354330708,0.6604330708661418,0.0063976377952755905,0.25246062992125984,0.7475393700787402,0.02214566929133858
1401,23.0,133,3392,3525,28,115,4623,1359,3264,4623,350,0.028769197490806836,0.7337226908933593,0.006056673155959333,0.29396495781959764,0.7060350421804024,0.024875621890547265
1402,14.0,98,1487,1585,14,96,2270,595,1675,2270,148,0.04317180616740088,0.6550660792951541,0.006167400881057269,0.2621145374449339,0.737885462555066,0.04229074889867841
1403,17.0,223,4911,5134,18,473,7155,1922,5233,7155,541,0.03116701607267645,0.6863731656184486,0.0025157232704402514,0.2686233403214535,0.7313766596785465,0.06610761705101328
1404,25.0,616,21973,22589,48,1438,29715,8327,21388,29715,1940,0.02073027090694935,0.7394581861012957,0.0016153457849570924,0.2802288406528689,0.7197711593471311,0.04839306747433956
1405,13.0,1782,24502,26284,162,4228,38086,9665,28421,38086,1857,0.046788846295226595,0.6433335083757812,0.004253531481384236,0.25376778868875705,0.746232211311243,0.11101192039069474
1406,,176,4626,4802,6,213,6313,1857,4456,6313,511,0.02787897988278156,0.7327736416917472,0.0009504197687311896,0.2941549184223032,0.7058450815776968,0.033739901789957234
1407,,882,24849,25731,52,1136,35118,9858,25260,35118,2781,0.025115325474115838,0.7075858534085084,0.001480722136795945,0.28071074662566203,0.7192892533743379,0.03234808360384988
1408,,6033,130505,136538,2074,9892,186845,52372,134473,186845,12902,0.03228879552570312,0.6984666434745377,0.011100109716610025,0.28029650244855364,0.7197034975514464,0.052942278359067674
1409,24.0,78,1570,1648,6,93,2223,605,1618,2223,148,0.03508771929824561,0.7062528115159694,0.002699055330634278,0.2721547458389564,0.7278452541610436,0.04183535762483131
1410,35.0,1052,19583,20635,81,633,26420,8142,18278,26420,1427,0.03981831945495837,0.7412187736563209,0.003065859197577593,0.3081756245268736,0.6918243754731265,0.02395912187736563
1411,35.0,198,3742,3940,3,230,5310,1474,3836,5310,346,0.03728813559322034,0.7047080979284369,0.0005649717514124294,0.2775894538606403,0.7224105461393597,0.04331450094161959
1412,,215,4719,4934,38,281,6553,1894,4659,6553,392,0.03280940027468335,0.7201281855638639,0.0057988707462231035,0.28902792614069894,0.7109720738593011,0.042881123149702424
1413,23.0,278,5355,5633,37,228,7264,2100,5164,7264,516,0.03827092511013216,0.7371971365638766,0.005093612334801762,0.28909691629955947,0.7109030837004405,0.03138766519823789
1414,24.0,97,3330,3427,6,112,4470,1336,3134,4470,424,0.021700223713646532,0.7449664429530202,0.0013422818791946308,0.29888143176733784,0.7011185682326622,0.02505592841163311
1415,,58,1782,1840,0,89,2362,678,1684,2362,177,0.024555461473327687,0.7544453852667231,0.0,0.2870448772226926,0.7129551227773073,0.03767993226079593
1416,15.0,535,3500,4035,5,265,5542,1525,4017,5542,413,0.09653554673403103,0.6315409599422591,0.0009022013713460845,0.27517141826055574,0.7248285817394442,0.04781667268134247
1417,43.0,3634,101181,104815,195,5050,138041,39421,98620,138041,9734,0.026325511985569504,0.7329778833824733,0.001412623785686861,0.28557457566954747,0.7144254243304525,0.036583333937018715
1418,23.0,823,33248,34071,49,700,43347,13186,30161,43347,3887,0.0189863196991718,0.7670196322698226,0.0011304127159895724,0.3041963688375205,0.6958036311624796,0.01614875308556532
1419,46.0,174,6302,6476,16,280,8551,2447,6104,8551,680,0.020348497251783417,0.7369898257513741,0.0018711261840720383,0.2861653607765174,0.7138346392234827,0.032744708221260674
1420,27.0,20,2089,2109,1,9,2832,839,1993,2832,310,0.007062146892655367,0.7376412429378532,0.00035310734463276836,0.2962570621468927,0.7037429378531074,0.0031779661016949155
1421,16.0,1448,23681,25129,57,1292,34018,9330,24688,34018,2599,0.042565700511493915,0.6961314598153918,0.0016755835146099124,0.274266564759833,0.725733435240167,0.03797989299782468
1422,,288,5965,6253,19,273,8169,2349,5820,8169,631,0.03525523319867793,0.7301995348267842,0.0023258660790794468,0.2875504957767169,0.7124495042232831,0.033419023136246784
1423,,347,8231,8578,4,446,11311,3226,8085,11311,862,0.03067810096366369,0.7276987003801609,0.0003536380514543365,0.28520908849792237,0.7147909115020776,0.03943064273715852
1424,25.0,688,17130,17818,158,638,23554,6910,16644,23554,1888,0.029209476097478135,0.7272650080665705,0.0067079901502929435,0.29336842999065976,0.7066315700093403,0.027086694404347456
1425,17.0,239,3716,3955,7,245,5369,1522,3847,5369,437,0.044514807226671636,0.6921214378841497,0.001303780964797914,0.283479232631775,0.716520767368225,0.04563233376792699
1426,,536,10031,10567,39,695,14502,3960,10542,14502,1089,0.0369604192525169,0.6916976968693973,0.0026892842366570127,0.273065784029789,0.726934215970211,0.04792442421734933
1427,24.0,298,10349,10647,19,466,13813,4035,9778,13813,1067,0.02157387967856367,0.7492217476290451,0.001375515818431912,0.29211612249330343,0.7078838775066966,0.03373633533627742
1428,14.0,9,1532,1541,0,128,2075,609,1466,2075,167,0.004337349397590362,0.7383132530120482,0.0,0.2934939759036145,0.7065060240963855,0.061686746987951804
1429,,25646,359905,385551,3422,25323,529544,145482,384062,529544,34230,0.048430347619838957,0.6796507938905927,0.0064621636728959255,0.27473071170667596,0.725269288293324,0.0478203888628707
1430,16.0,432,16442,16874,136,1829,23627,6146,17481,23627,1388,0.018284166419773987,0.6958987598933424,0.005756126465484403,0.260126126888729,0.739873873111271,0.07741143606890422
1431,14.0,18,1718,1736,8,121,2367,650,1717,2367,175,0.0076045627376425855,0.7258132657372202,0.0033798056611744824,0.2746092099704267,0.7253907900295733,0.05111956062526405
1432,,279,13498,13777,32,791,18313,5283,13030,18313,1556,0.015235078905695408,0.7370720253371922,0.0017473925626604052,0.28848359089171627,0.7115164091082837,0.04319335990826189
1433,16.0,223,11458,11681,94,1783,16385,4352,12033,16385,744,0.013610009154714678,0.6992981385413488,0.0057369545315837656,0.26560878852609093,0.7343912114739091,0.10881904180653036
1434,35.0,90,2953,3043,5,181,3996,1181,2815,3996,337,0.02252252252252252,0.738988988988989,0.0012512512512512512,0.2955455455455455,0.7044544544544544,0.045295295295295294
1435,26.0,488,14104,14592,25,622,19746,5613,14133,19746,1430,0.024713866099463182,0.7142712448090752,0.001266079205915122,0.2842601033120632,0.7157398966879368,0.031500050643168236
1436,35.0,165,6357,6522,40,217,8652,2504,6148,8652,693,0.019070735090152564,0.734743411927878,0.004623208506703652,0.28941285251964866,0.7105871474803513,0.025080906148867314
1437,,90,1921,2011,13,167,2784,766,2018,2784,183,0.032327586206896554,0.6900143678160919,0.004669540229885058,0.27514367816091956,0.7248563218390804,0.059985632183908046
1438,23.0,72,2132,2204,2,67,2922,845,2077,2922,216,0.024640657084188913,0.729637234770705,0.0006844626967830253,0.2891854893908282,0.7108145106091718,0.02292950034223135
1439,14.0,1399,17459,18858,96,1189,25876,7154,18722,25876,1361,0.054065543360643065,0.6747178852991189,0.0037100015458339775,0.2764724068635029,0.7235275931364972,0.04594991497913124
1440,23.0,1033,33710,34743,42,857,44716,13388,31328,44716,3497,0.02310135074693622,0.7538688612577154,0.000939261114589856,0.2994006619554522,0.7005993380445478,0.0191653994096073
1441,15.0,73,1689,1762,0,56,2322,734,1588,2322,109,0.031438415159345395,0.727390180878553,0.0,0.3161068044788975,0.6838931955211025,0.024117140396210164
1442,,1608,39038,40646,302,1817,53795,15467,38328,53795,4165,0.029891253833999442,0.7256808253555163,0.005613904637977507,0.2875174272701924,0.7124825727298076,0.03377637326889116
1443,14.0,168,2077,2245,4,161,3090,840,2250,3090,160,0.05436893203883495,0.672168284789644,0.0012944983818770227,0.27184466019417475,0.7281553398058253,0.05210355987055016
1444,26.0,144,4251,4395,7,244,5787,1556,4231,5787,438,0.024883359253499222,0.7345775012960083,0.0012096077414895455,0.2688785208225333,0.7311214791774667,0.042163469846207016
1445,24.0,139,3292,3431,12,147,4444,1322,3122,4444,288,0.031278127812781276,0.7407740774077408,0.0027002700270027003,0.2974797479747975,0.7025202520252025,0.033078307830783076
1446,17.0,79,1772,1851,1,168,2613,696,1917,2613,174,0.030233448143895905,0.6781477229238423,0.0003827018752391887,0.2663605051664753,0.7336394948335246,0.0642939150401837
1447,15.0,36,2811,2847,8,58,3691,1076,2615,3691,346,0.009753454348415064,0.7615822270387429,0.002167434299647792,0.291519913302628,0.708480086697372,0.01571389867244649
1448,25.0,437,6555,6992,13,361,9506,2544,6962,9506,785,0.045970965705869976,0.6895644855880496,0.001367557332211235,0.26762045024195247,0.7323795497580475,0.03797601514832737
1449,42.0,137,2668,2805,22,100,3817,1093,2724,3817,261,0.035892061828661254,0.6989782551742206,0.005763688760806916,0.28635053707099817,0.7136494629290019,0.026198585276395073
1450,,1627,43944,45571,115,1352,58793,17551,41242,58793,4306,0.02767336247512459,0.7474359192420866,0.0019560151718742026,0.29852193288316636,0.7014780671168336,0.022995934890208018
1451,27.0,164,3111,3275,0,146,4365,1272,3093,4365,295,0.03757159221076747,0.7127147766323024,0.0,0.2914089347079038,0.7085910652920963,0.03344788087056128
1452,13.0,1238,14479,15717,35,1948,22210,5684,16528,22212,1687,0.05573563839366109,0.6518548532324869,0.0015757248334233747,0.25589771294795605,0.744102287052044,0.0877003421573924
1453,23.0,702,6129,6831,66,643,9484,2622,6862,9484,428,0.07401940109658373,0.6462463095740194,0.006959088991986504,0.2764656263180093,0.7235343736819907,0.067798397300717
1454,23.0,89,2795,2884,19,263,4246,1075,3171,4246,327,0.0209609043805935,0.6582666038624588,0.004474799811587376,0.2531794630240226,0.7468205369759774,0.06194065002355158
1455,23.0,90,3792,3882,0,130,4982,1453,3529,4982,351,0.018065034122842234,0.7611401043757527,0.0,0.29164993978321957,0.7083500602167804,0.02609393817743878
1456,23.0,4848,138115,142963,367,6054,183403,54284,129119,183403,11588,0.02643359159882881,0.7530683794703468,0.0020010577798618345,0.29598207226708395,0.704017927732916,0.03300927465744835
1457,36.0,636,15497,16133,135,677,21482,6102,15380,21482,1624,0.029606181919746764,0.7213946559910623,0.006284331067870776,0.2840517642677591,0.715948235732241,0.03151475654035937
1458,,260,7926,8186,40,496,11197,3116,8081,11197,828,0.023220505492542644,0.7078681789765116,0.003572385460391176,0.27828882736447264,0.7217111726355274,0.044297579708850586
1459,35.0,832,22576,23408,203,1157,30825,8887,21938,30825,2273,0.026991078669910788,0.7323925385239254,0.006585563665855636,0.28830494728304945,0.7116950527169505,0.037534468775344686
1460,14.0,651,6475,7126,54,724,10659,2629,8030,10659,630,0.06107514776245426,0.607467867529787,0.0050661412890515055,0.24664602683178535,0.7533539731682146,0.06792382024580167
1461,25.0,57,2016,2073,1,65,2693,792,1901,2693,259,0.02116598588934274,0.7486075009283327,0.0003713330857779428,0.2940958039361307,0.7059041960638693,0.024136650575566285
1462,14.0,78,3389,3467,16,192,4753,1325,3428,4753,478,0.01641068798653482,0.7130233536713655,0.003366294971596886,0.2787713023353671,0.7212286976646328,0.040395539659162635
1463,14.0,871,110149,111020,664,10994,153394,42337,111057,153394,12153,0.005678188195105415,0.7180789339869877,0.0043287221142939095,0.2760016689049115,0.7239983310950885,0.07167164295865548
1464,,5731,193455,199186,2508,11373,268770,75999,192774,268773,21181,0.021322826325560974,0.7197709591365204,0.009331294438057395,0.28276277751113393,0.7172372224888661,0.04231451819937271
1465,14.0,99,2229,2328,6,135,3099,882,2217,3099,217,0.031945788964181994,0.7192642787996127,0.001936108422071636,0.2846079380445305,0.7153920619554696,0.04356243949661181
1466,35.0,467,17331,17798,30,809,22878,6729,16149,22878,1743,0.02041262348107352,0.7575399947547863,0.0013113034356150013,0.2941253606084448,0.7058746393915553,0.03536148264708454
1467,16.0,212,7719,7931,64,1255,11242,2968,8274,11242,685,0.01885785447429283,0.6866215975805017,0.005692937199786515,0.2640099626400996,0.7359900373599004,0.11163494040206369
1468,14.0,3135,45380,48515,164,3677,68425,18647,49778,68425,4346,0.04581658750456705,0.6632078918523931,0.0023967848008768725,0.27251735476799416,0.7274826452320059,0.053737668980635735
1469,16.0,284,6670,6954,14,262,9517,2723,6794,9517,765,0.029841336555637282,0.700851108542608,0.0014710518020384575,0.28611957549648,0.71388042450352,0.027529683723862563
1470,,416,8562,8978,40,622,12361,3437,8924,12361,894,0.03365423509424804,0.6926624059542108,0.003235984143677696,0.278051937545506,0.7219480624544939,0.050319553434188175
1471,,2481,171474,173955,102,7117,230025,66797,163229,230026,20385,0.010785737264483146,0.7454548616243382,0.0004434281342109153,0.2903889125577109,0.7096110874422892,0.030939980697834157
1472,,41417,763611,805028,4643,44626,1102422,307343,795079,1102422,71632,0.03756909785907756,0.692666692065289,0.004211635834553374,0.2787888848372039,0.7212111151627961,0.04047996139409409
1473,35.0,146,2522,2668,20,165,4087,1015,3072,4087,238,0.03572302422314656,0.6170785417176413,0.004893564962074872,0.24834842182529973,0.7516515781747003,0.04037191093711769
1474,24.0,213,20612,20825,93,1108,27699,7845,19854,27699,2128,0.007689808296328387,0.7441423878118344,0.0033575219321997185,0.2832232210549117,0.7167767789450883,0.04000144409545471
1475,17.0,389,5180,5569,25,487,7638,2110,5528,7638,622,0.05092956271275203,0.6781880073317622,0.003273108143493061,0.27625032731081434,0.7237496726891857,0.06376014663524483
1476,,306,8256,8562,34,287,11180,3322,7858,11180,923,0.027370304114490162,0.7384615384615385,0.003041144901610018,0.2971377459749553,0.7028622540250448,0.025670840787119856
1477,14.0,1597,33282,34879,348,1417,45384,13339,32045,45384,2949,0.03518861272695223,0.7333421470121628,0.007667900581702803,0.29391415476820026,0.7060858452317997,0.031222457253657677
1478,,1471,27655,29126,28,1647,39563,11097,28472,39569,2816,0.03717556673153226,0.6989057090146327,0.0007076246556647881,0.28044681442543407,0.7195531855745659,0.04162349313856807
1479,,10491,203921,214412,982,16403,290889,81849,209040,290889,20301,0.03606530326000639,0.7010268521669778,0.003375858145203153,0.2813753699864897,0.7186246300135103,0.05638920687960012
1480,,649,16928,17577,61,1087,23452,6677,16775,23452,1582,0.027673545966228893,0.7218147705952584,0.00260105747910626,0.2847091932457786,0.7152908067542214,0.04634999147194269
1481,,851,19134,19985,266,1421,26899,7371,19528,26899,1660,0.03163686382393398,0.7113275586453028,0.009888843451429421,0.27402505669355737,0.7259749433064426,0.052827242648425594
1482,40.0,188,3623,3811,0,351,5129,1326,3803,5129,363,0.03665431858062,0.7063755117956717,0.0,0.2585299278611815,0.7414700721388184,0.06843439266913628
1483,,103,4306,4409,90,359,6036,1614,4422,6036,497,0.017064280980781974,0.7133863485752153,0.014910536779324055,0.2673956262425447,0.7326043737574552,0.05947647448641485
1484,13.0,27,1775,1802,36,193,2519,653,1866,2519,145,0.01071853910281858,0.7046447002778881,0.014291385470424772,0.259229853116316,0.740770146883684,0.07661770543866614
1485,16.0,217,20306,20523,129,3345,30991,7724,23267,30991,2003,0.007002032848246265,0.6552224839469524,0.004162498789971282,0.24923364847859056,0.7507663515214095,0.10793456164692976
1486,,214,6176,6390,36,521,9233,2396,6837,9233,662,0.02317773204808838,0.6689050146214665,0.003899057727715802,0.25950395321130726,0.7404960467886927,0.05642802989277591
1487,23.0,432,9466,9898,51,510,13210,3710,9500,13210,982,0.03270249810749432,0.7165783497350492,0.0038607115821347464,0.2808478425435276,0.7191521574564723,0.03860711582134747
1488,16.0,0,3231,3231,0,396,4908,1098,3810,4908,312,0.0,0.6583129584352079,0.0,0.2237163814180929,0.7762836185819071,0.08068459657701711
1489,,325,6211,6536,33,247,8584,2464,6120,8584,553,0.03786113699906803,0.7235554520037278,0.0038443616029822927,0.2870456663560112,0.7129543336439889,0.028774464119291705
1490,,319,6415,6734,39,675,9334,2554,6780,9334,623,0.034176130276408825,0.6872723376901649,0.004178272980501393,0.2736233126205271,0.7263766873794729,0.07231626312406257
1491,23.0,288,9108,9396,16,358,12170,3667,8503,12170,1049,0.023664749383730484,0.7483976992604766,0.001314708299096138,0.3013147082990961,0.6986852917009039,0.02941659819227609
1492,25.0,68,1369,1437,1,83,1955,549,1406,1955,186,0.034782608695652174,0.7002557544757033,0.0005115089514066496,0.28081841432225063,0.7191815856777494,0.04245524296675192
1493,,208,3631,3839,94,217,5209,1489,3720,5209,351,0.03993088884622768,0.6970627759646765,0.018045690151660587,0.28585141101938955,0.7141485889806105,0.04165866769053561
1494,,130,2573,2703,14,123,3651,1041,2610,3651,322,0.035606683100520405,0.7047384278279923,0.003834565872363736,0.28512736236647496,0.714872637633525,0.03368940016433854
1495,24.0,916,19792,20708,50,1305,27896,7815,20081,27896,2106,0.032836248924577004,0.7094924003441354,0.0017923716661887008,0.28014769142529394,0.7198523085747061,0.04678090048752509
1496,24.0,97,3724,3821,11,150,4972,1460,3512,4972,372,0.019509251810136765,0.7489943684633951,0.0022123893805309734,0.2936444086886565,0.7063555913113435,0.030168946098149636
1497,16.0,2795,59989,62784,274,2486,81431,24063,57368,81431,5696,0.03432353771905049,0.7366850462354632,0.0033648119266618363,0.29550171310680207,0.7044982868931979,0.030528914049931844
1498,27.0,191,8960,9151,10,180,11480,3426,8054,11480,863,0.016637630662020907,0.7804878048780488,0.0008710801393728223,0.2984320557491289,0.7015679442508711,0.0156794425087108
1499,25.0,871,21730,22601,59,1413,30361,8559,21802,30361,2206,0.028688119627153254,0.7157208260597477,0.0019432825005763973,0.2819077105497184,0.7180922894502816,0.046539969039227955
1500,25.0,130,3644,3774,14,122,5056,1462,3594,5056,403,0.025712025316455698,0.7207278481012658,0.002768987341772152,0.2891613924050633,0.7108386075949367,0.024129746835443038
1501,,76,2173,2249,10,227,3120,802,2318,3120,209,0.02435897435897436,0.6964743589743589,0.003205128205128205,0.257051282051282,0.742948717948718,0.07275641025641026
1502,35.0,192,5508,5700,21,202,7462,2178,5284,7462,519,0.025730367193781828,0.7381399088716162,0.0028142589118198874,0.29187885285446263,0.7081211471455374,0.02707049048512463
1503,,385,9192,9577,4,571,12975,3620,9355,12975,878,0.029672447013487476,0.7084393063583815,0.0003082851637764933,0.2789980732177264,0.7210019267822736,0.044007707129094416
1504,27.0,431,14732,15163,143,527,19728,5891,13837,19728,1362,0.021847120843471207,0.7467558799675588,0.007248580697485807,0.2986111111111111,0.7013888888888888,0.02671330089213301
1505,16.0,106,3186,3292,31,93,4176,1253,2923,4176,251,0.025383141762452106,0.7629310344827587,0.007423371647509579,0.3000478927203065,0.6999521072796935,0.022270114942528736
1506,37.0,269,8076,8345,16,312,10820,3140,7680,10820,829,0.024861367837338263,0.7463955637707949,0.0014787430683918669,0.2902033271719039,0.7097966728280961,0.028835489833641405
1507,16.0,1849,38924,40773,248,1999,54511,15481,39030,54511,3886,0.03391975931463374,0.7140577131221222,0.004549540459723726,0.2839977252297701,0.7160022747702298,0.036671497495918255
1508,14.0,131,2214,2345,13,246,3232,880,2352,3232,204,0.040532178217821783,0.6850247524752475,0.004022277227722772,0.2722772277227723,0.7277227722772277,0.07611386138613861
1509,17.0,444,10713,11157,43,589,15317,4170,11147,15317,1197,0.02898739962133577,0.6994189462688516,0.002807338251615852,0.27224652347065353,0.7277534765293465,0.03845400535352876
1510,42.0,948,21559,22507,76,1147,30237,8635,21602,30237,2413,0.03135231669808513,0.7130006283692165,0.002513476866091213,0.28557727287760026,0.7144227271223997,0.0379336574395608
1511,,42,1734,1776,15,108,2399,643,1756,2399,163,0.017507294706127552,0.7228011671529804,0.006252605252188412,0.2680283451438099,0.7319716548561901,0.045018757815756566
1512,16.0,199,4705,4904,11,215,6539,1829,4710,6539,495,0.030432787888056277,0.7195289799663557,0.0016822144058724576,0.27970637712188406,0.7202936228781159,0.032879645205688944
1513,41.0,192,2280,2472,29,77,3531,958,2573,3531,157,0.05437553101104503,0.6457094307561597,0.00821297082979326,0.2713112432738601,0.7286887567261399,0.021806853582554516
1514,36.0,91,1615,1706,3,111,2408,662,1746,2408,167,0.0377906976744186,0.6706810631229236,0.0012458471760797341,0.2749169435215947,0.7250830564784053,0.04609634551495016
1515,17.0,46,4558,4604,48,395,6450,1712,4738,6450,545,0.007131782945736434,0.7066666666666667,0.0074418604651162795,0.26542635658914726,0.7345736434108527,0.06124031007751938
1516,24.0,738,14282,15020,74,1062,20361,5705,14656,20361,1346,0.036245763960512746,0.7014390255881342,0.003634399096311576,0.28019252492510194,0.7198074750748981,0.05215853838220127
1517,23.0,452,16099,16551,80,636,21420,6268,15152,21420,1373,0.021101774042950515,0.7515873015873016,0.003734827264239029,0.29262371615312793,0.7073762838468721,0.02969187675070028
1518,23.0,77,1729,1806,1,73,2421,702,1719,2421,229,0.03180503923998348,0.7141676992978109,0.0004130524576621231,0.2899628252788104,0.7100371747211895,0.030152829409334985
1519,44.0,298,7900,8198,105,302,10680,3166,7514,10680,844,0.02790262172284644,0.7397003745318352,0.009831460674157303,0.2964419475655431,0.7035580524344569,0.028277153558052433
1520,17.0,328,8474,8807,41,649,11747,3149,8598,11747,806,0.02792202264407934,0.7213756703839278,0.0034902528305099175,0.2680684430067251,0.7319315569932748,0.05524814846343747
1521,,724,20337,21061,67,3014,30123,8232,21891,30123,1493,0.024034790691498192,0.6751319589682303,0.0022242140557049432,0.27327955382929986,0.7267204461707001,0.10005643528201043
1522,23.0,347,914,1327,5,167,1903,439,1465,1904,57,0.18224789915966386,0.4800420168067227,0.0026260504201680674,0.23056722689075632,0.7694327731092437,0.08771008403361344
1523,17.0,246,5583,5829,498,581,10241,2099,8142,10241,454,0.02402109169026462,0.5451616053119812,0.04862806366565765,0.20496045308075383,0.7950395469192462,0.05673274094326726
1524,17.0,77,1741,1818,4,101,2449,693,1756,2449,179,0.03144140465496121,0.7109024091465904,0.0016333197223356473,0.2829726418946509,0.7170273581053491,0.04124132298897509
1525,,1530,27560,29090,224,1147,38143,11052,27092,38144,2556,0.04011115771812081,0.7225251677852349,0.00587248322147651,0.2897441275167785,0.7102558724832215,0.030070260067114093
1526,,141,5904,6045,15,135,7634,2372,5262,7634,636,0.01847000261985853,0.7733822373591827,0.0019648938957296308,0.3107152213780456,0.6892847786219544,0.017684045061566674
1527,24.0,3342,66162,69504,241,3055,91565,26521,65044,91565,5911,0.036498662152569215,0.7225686670671108,0.0026320100475072353,0.2896412384644788,0.7103587615355212,0.03336427674329711
1528,26.0,135,2017,2152,11,171,2976,812,2164,2976,220,0.04536290322580645,0.677755376344086,0.003696236559139785,0.2728494623655914,0.7271505376344086,0.057459677419354836
1529,16.0,202,4422,4624,49,423,6823,1658,5165,6823,372,0.029605745273340173,0.6481020079144072,0.007181591675216181,0.24300161219404953,0.7569983878059504,0.061996189359519276
1530,27.0,3439,59718,63157,1164,4648,89256,23983,65274,89257,5777,0.03852919098782168,0.6690567686568,0.013040993983665147,0.2686960126376643,0.7313039873623357,0.05207434711003059
1531,,226,3921,4147,29,316,5771,1569,4202,5771,403,0.039161323860682724,0.6794316409634379,0.005025125628140704,0.27187662450181943,0.7281233754981805,0.05475654132732629
1532,15.0,753,20818,21571,14,1860,28910,7661,21249,28910,2057,0.026046350743687306,0.7200968523002421,0.00048426150121065375,0.2649948114839156,0.7350051885160844,0.06433759944655829
1533,15.0,648,23351,23999,123,1200,31812,8976,22836,31812,2624,0.02036967182195398,0.7340311832013077,0.0038664654847227462,0.2821576763485477,0.7178423236514523,0.03772161448509996
1534,23.0,614,25420,26034,104,643,33265,10041,23225,33266,2664,0.018457283713100462,0.7641435700114231,0.003126315156616365,0.3018397162267781,0.6981602837732219,0.019329044670233872
1535,27.0,966,19055,20021,219,683,25051,7715,17336,25051,1324,0.038561334876851226,0.7606482775138717,0.008742165981397949,0.30797173765518343,0.6920282623448166,0.02726438066344657
1536,,175,5582,5757,29,209,7513,2205,5308,7513,589,0.023292958871289765,0.7429788366830826,0.003859976041528018,0.293491281778251,0.706508718221749,0.027818448023426062
1537,46.0,112,2411,2523,16,200,3408,953,2455,3408,226,0.03286384976525822,0.7074530516431925,0.004694835680751174,0.2796361502347418,0.7203638497652582,0.05868544600938967
1538,,85,2381,2466,4,149,3310,895,2415,3310,232,0.0256797583081571,0.7193353474320242,0.0012084592145015106,0.270392749244713,0.729607250755287,0.04501510574018127
1539,26.0,159,4673,4832,7,229,6249,1894,4355,6249,425,0.025444071051368217,0.747799647943671,0.0011201792286765883,0.30308849415906547,0.6969115058409345,0.036645863338134105
1540,23.0,224,6236,6460,75,299,8506,2428,6078,8506,616,0.02633435222196097,0.7331295556078062,0.008817305431460146,0.2854455678344698,0.7145544321655302,0.03515165765342111
1541,27.0,2305,49809,52114,176,1734,68833,19765,49068,68833,4675,0.03348684497261488,0.7236209376316592,0.0025569131085380558,0.28714424767190155,0.7128557523280984,0.025191405285255618
1542,24.0,1316,21060,22376,6,1103,30169,8856,21313,30169,2009,0.04362093539726209,0.6980675527859723,0.0001988796446683682,0.29354635553051145,0.7064536444694886,0.03656070801153502
1543,25.0,591,15326,15917,87,735,20846,6098,14748,20846,1495,0.028350762736256356,0.7352009977933417,0.004173462534778854,0.29252614410438454,0.7074738558956155,0.035258562793821356
1544,38.0,3710,69542,73252,1502,2382,106665,27163,79502,106665,5839,0.034781793465522896,0.6519664369755778,0.01408147002296911,0.2546571040172503,0.7453428959827497,0.0223315989312333
1545,25.0,5503,161489,166992,965,6971,216431,64199,152232,216431,16265,0.02542611733069662,0.7461454227906353,0.004458695843016943,0.29662571443092717,0.7033742855690728,0.03220887950432239
1546,15.0,87,2330,2417,2,142,3195,939,2256,3195,237,0.027230046948356807,0.729264475743349,0.0006259780907668231,0.29389671361502345,0.7061032863849765,0.044444444444444446
1547,,173,2391,2564,3,158,3705,935,2770,3705,203,0.04669365721997301,0.6453441295546559,0.0008097165991902834,0.252361673414305,0.747638326585695,0.04264507422402159
1548,17.0,63,2848,2911,3,117,3944,1127,2817,3944,420,0.015973630831643004,0.7221095334685599,0.0007606490872210953,0.2857505070993915,0.7142494929006086,0.02966531440162272
1549,,601,13435,14036,62,700,17847,5491,12356,17847,856,0.03367512747240432,0.7527875833473413,0.003473973216787135,0.3076707569899703,0.6923292430100297,0.0392222782540483
1550,23.0,107,4044,4151,8,148,5296,1552,3744,5296,361,0.020203927492447128,0.763595166163142,0.0015105740181268882,0.2930513595166163,0.7069486404833837,0.027945619335347432
1551,37.0,126,2863,2989,8,140,3937,1166,2771,3937,299,0.03200406400812802,0.7272034544069088,0.002032004064008128,0.2961645923291847,0.7038354076708153,0.03556007112014224
1552,14.0,200,3798,3998,14,252,5620,1507,4113,5620,358,0.03558718861209965,0.6758007117437722,0.002491103202846975,0.26814946619217084,0.7318505338078292,0.044839857651245554
1553,47.0,165,4006,4171,12,383,5692,1608,4084,5692,455,0.02898805340829234,0.7037947997189037,0.0021082220660576245,0.28250175685172174,0.7174982431482783,0.06728742094167252
1554,27.0,274,5093,5367,69,279,7264,2053,5211,7264,563,0.03772026431718062,0.7011288546255506,0.009498898678414096,0.28262665198237885,0.7173733480176211,0.038408590308370044
1555,26.0,499,9554,10053,72,534,13536,3765,9771,13536,963,0.03686465721040189,0.7058215130023641,0.005319148936170213,0.27814716312056736,0.7218528368794326,0.03945035460992908
1556,,460,11513,11973,54,597,16407,4594,11813,16407,1175,0.028036813555189857,0.701712683610654,0.0032912781130005485,0.28000243798378743,0.7199975620162126,0.03638690802706162
1557,,9181,186710,195891,1019,8548,261283,75279,186004,261283,21654,0.03513814522950211,0.7145891619431803,0.0038999858391093184,0.2881128890896078,0.7118871109103921,0.032715484742597105
1558,16.0,220,9210,9430,128,498,12498,3556,8942,12498,855,0.0176028164506321,0.7369179068650984,0.01024163866218595,0.2845255240838534,0.7154744759161465,0.039846375420067214
1559,27.0,356,7397,7753,35,380,10626,2914,7712,10626,836,0.033502729154903065,0.6961227178618483,0.0032938076416337285,0.27423301336344813,0.7257669866365518,0.0357613401091662
1560,14.0,185,7102,7287,40,273,9848,2791,7057,9848,1050,0.0187855402112104,0.721161657189277,0.004061738424045491,0.28340779853777415,0.7165922014622258,0.02772136474411048
1561,17.0,1039,20715,21754,257,1159,29506,8181,21325,29506,2135,0.035213176980953026,0.7020605978445063,0.008710092862468651,0.27726564088659933,0.7227343591134007,0.039280146410899476
1562,23.0,891,16498,17389,94,770,22604,6556,16048,22604,1530,0.03941780215890993,0.7298708193240134,0.0041585560077862325,0.2900371615643249,0.7099628384356751,0.034064767297823394
1563,16.0,592,15243,15835,26,1171,22008,6016,15992,22008,1641,0.026899309342057434,0.6926117775354417,0.0011813885859687386,0.2733551435841512,0.7266448564158487,0.0532079243911305
1564,13.0,155,2162,2317,46,190,3472,888,2584,3472,157,0.044642857142857144,0.6226958525345622,0.013248847926267281,0.2557603686635945,0.7442396313364056,0.054723502304147464
1565,24.0,773,30127,30900,104,1313,40713,11734,28979,40713,3528,0.018986564488001376,0.7399847714489229,0.002554466632279616,0.28821261022277894,0.711787389777221,0.03225014123253015
1566,24.0,117,2865,2982,6,164,3994,1114,2880,3994,309,0.029293940911367052,0.7173259889834752,0.0015022533800701052,0.2789183775663495,0.7210816224336505,0.041061592388582875
1567,24.0,427,15386,15813,8,431,20497,6080,14417,20497,2034,0.020832316924427965,0.7506464360638142,0.00039030101966141384,0.29662877494267453,0.7033712250573254,0.021027467434258672
1568,15.0,203,2730,2933,24,174,3938,1094,2844,3938,299,0.05154900964956831,0.6932453021838497,0.006094464195022855,0.2778059928897918,0.7221940071102082,0.04418486541391569
1569,24.0,188,5650,5838,27,173,7682,2285,5397,7682,577,0.024472793543348085,0.7354855506378547,0.003514709711012757,0.2974485810986722,0.7025514189013278,0.022520177037229888
1570,25.0,588,15215,15803,114,1034,21387,5930,15457,21387,1403,0.027493337073923412,0.7114134754757563,0.005330340861270866,0.2772712395380371,0.7227287604619629,0.048347126759246274
1571,14.0,196,6184,6380,62,769,9340,2363,6977,9340,539,0.020985010706638114,0.6620985010706638,0.006638115631691649,0.2529978586723769,0.7470021413276231,0.0823340471092077
1572,24.0,3276,117446,120722,396,6940,161592,46609,114984,161593,13349,0.02027315539658277,0.7268012847091149,0.0024506012017847306,0.2884345237726882,0.7115654762273118,0.04294740489996473
1573,,97,2089,2186,13,164,2952,833,2119,2952,195,0.032859078590785906,0.7076558265582655,0.004403794037940379,0.2821815718157182,0.7178184281842819,0.05555555555555555
1574,13.0,399,10485,10884,26,346,14312,4059,10253,14312,1428,0.027878703186137506,0.7326020122973729,0.0018166573504751259,0.2836081609837898,0.7163918390162102,0.02417551704863052
1575,24.0,83,3109,3192,5,133,4323,1221,3102,4323,356,0.01919962988665279,0.719176497802452,0.0011566042100393246,0.2824427480916031,0.7175572519083969,0.030765671987046033
1576,,4555,56251,60806,126,4543,82689,22995,59694,82689,5887,0.055085924367207245,0.6802718620372722,0.0015237818815078184,0.2780901933751769,0.7219098066248232,0.05494080228325412
1577,26.0,85,2159,2244,0,64,2916,870,2046,2916,224,0.02914951989026063,0.74039780521262,0.0,0.29835390946502055,0.7016460905349794,0.02194787379972565
1578,25.0,503,12909,13412,81,756,17441,5013,12428,17441,1043,0.02884008944441259,0.7401525141907,0.004644229115303021,0.28742617969153145,0.7125738203084685,0.04334613840949487
1579,23.0,2158,91346,93504,162,4461,122425,34514,87911,122425,9953,0.017627118644067796,0.7461384521135389,0.0013232591382479069,0.281919542577088,0.7180804574229119,0.03643863589953032
1580,,4391,107289,111680,262,10134,155447,42628,112820,155448,10734,0.028247388194122793,0.6901922186197313,0.0016854510833204672,0.27422675106788125,0.7257732489321188,0.06519221861973136
1581,14.0,53,1717,1770,2,107,2532,674,1858,2532,187,0.02093206951026856,0.6781200631911533,0.0007898894154818325,0.26619273301737756,0.7338072669826224,0.04225908372827804
1582,23.0,353,12584,12937,25,462,16789,4931,11858,16789,1370,0.021025671570671273,0.749538388230389,0.0014890702245517898,0.293704211090595,0.7062957889094049,0.027518017749717075
1583,,1203,41677,42880,47,1328,55810,16604,39206,55810,4755,0.021555276832108942,0.7467658125783909,0.0008421429851281132,0.2975094069163232,0.7024905930836768,0.023795018813832645
1584,13.0,1162,23357,24519,492,3688,37808,8776,29032,37808,1512,0.030734236140499364,0.6177793059669912,0.013013118916631402,0.232120186203978,0.767879813796022,0.09754549301735083
1585,,139,3541,3680,37,152,4976,1418,3558,4976,377,0.027934083601286172,0.7116157556270096,0.007435691318327975,0.284967845659164,0.715032154340836,0.03054662379421222
1586,16.0,827,16913,17740,255,806,22494,6820,15735,22555,1188,0.036665927732210155,0.7498559077809799,0.011305697184659722,0.302371979605409,0.697628020394591,0.035734870317002884
1587,,94,2630,2724,6,168,3641,1003,2638,3641,280,0.02581708321889591,0.7223290304861302,0.0016478989288656962,0.2754737709420489,0.7245262290579512,0.046141170008239495
1588,,641,8363,9004,74,720,12532,3459,9073,12532,766,0.0511490584104692,0.667331631024577,0.005904883498244494,0.2760134056814555,0.7239865943185445,0.05745292052345994
1589,,83,4120,4203,25,98,5318,1634,3684,5318,380,0.01560737119217751,0.7747273411056789,0.004701015419330576,0.3072583678074464,0.6927416321925536,0.018427980443775856
1590,17.0,77,1944,2021,5,125,3568,756,2812,3568,227,0.021580717488789238,0.5448430493273543,0.0014013452914798206,0.21188340807174888,0.7881165919282511,0.03503363228699551
1591,,65,1485,1550,4,119,2230,561,1669,2230,158,0.02914798206278027,0.6659192825112108,0.0017937219730941704,0.2515695067264574,0.7484304932735426,0.05336322869955157
1592,27.0,8198,132549,140747,2441,7170,181575,53838,127737,181575,10962,0.045149387305521135,0.7299958694754234,0.013443480655376566,0.2965055762081784,0.7034944237918216,0.039487814952498965
1593,16.0,298,10269,10567,25,502,13704,4018,9686,13704,1051,0.021745475773496788,0.7493432574430823,0.0018242848803269119,0.29319906596614126,0.7068009340338587,0.03663164039696439
1594,,10052,178160,188212,1104,11405,254094,71121,182973,254094,18240,0.03956016277440632,0.7011578392248538,0.00434484875675931,0.2799003518382961,0.7200996481617039,0.04488496383228254
1595,25.0,205,2634,2839,31,152,3821,1094,2727,3821,212,0.05365087673383931,0.6893483381313792,0.008113059408531798,0.28631248364302536,0.7136875163569746,0.03978016226118817
1596,,674,21182,21856,24,971,28561,8390,20171,28561,2331,0.023598613493925284,0.7416406988550821,0.0008403067119498617,0.29375722138580584,0.7062427786141942,0.033997409054304824
1597,,68,2077,2145,16,143,2986,806,2180,2986,220,0.02277294038847957,0.6955793703951775,0.0053583389149363695,0.26992632283991963,0.7300736771600804,0.047890154052243804
1598,48.0,424,16352,16776,22,785,21431,6311,15120,21431,1475,0.019784424431897717,0.7630068592226215,0.0010265503242965798,0.294479958937987,0.7055200410620129,0.03662918202603705
1599,17.0,111,1999,2110,12,119,2823,822,2001,2823,217,0.039319872476089264,0.7081119376549769,0.004250797024442083,0.2911795961742827,0.7088204038257173,0.04215373715905066
1600,27.0,140,3280,3420,46,157,4698,1339,3359,4698,373,0.02979991485738612,0.6981694338016177,0.009791400595998296,0.2850148999574287,0.7149851000425713,0.033418475947211576
1601,26.0,332,6113,6445,46,357,8726,2468,6258,8726,626,0.038047215218886085,0.7005500802200321,0.005271602108640843,0.2828329131331653,0.7171670868668347,0.040912216364886546
1602,27.0,2650,74448,77098,276,2443,100965,28892,72073,100965,7680,0.026246719160104987,0.7373644332194325,0.002733620561580746,0.28615856980141635,0.7138414301985837,0.024196503738919427
1603,27.0,461,10364,10825,97,779,14558,3849,10709,14558,974,0.03166643769748592,0.711910976782525,0.006663003159774694,0.26439071301002887,0.7356092869899712,0.053510097540871
1604,26.0,231,3978,4209,18,190,5735,1575,4160,5735,367,0.04027898866608544,0.6936355710549259,0.003138622493461203,0.2746294681778553,0.7253705318221447,0.03312990409764603
1605,16.0,76,4881,4957,9,318,6635,1980,4655,6635,434,0.01145440844009043,0.7356443104747551,0.0013564431047475508,0.2984174830444612,0.7015825169555389,0.0479276563677468
1606,15.0,59,1649,1708,2,155,2438,710,1728,2438,211,0.02420016406890894,0.6763740771123872,0.0008203445447087777,0.2912223133716161,0.7087776866283839,0.06357670221493027
1607,48.0,229,6566,6795,6,246,9095,2634,6461,9095,654,0.025178669598680595,0.7219351291918636,0.0006597031335898846,0.2896096756459593,0.7103903243540407,0.027047828477185266
1608,15.0,770,66034,66997,288,6377,88835,25005,63841,88846,5799,0.008666681673907661,0.7432411138374265,0.0032415640546563716,0.28144204578709225,0.7185579542129077,0.0717758818629989
1609,17.0,1597,41653,43250,121,2204,57853,16759,41094,57853,4830,0.02760444575043645,0.7199799491815463,0.002091507786977339,0.28968247109052253,0.7103175289094774,0.0380965550619674
1610,17.0,254,8047,8301,7,269,10747,3113,7634,10747,813,0.023634502651902856,0.7487670977947334,0.0006513445612729133,0.2896622313203685,0.7103377686796315,0.02503024099748767
1611,23.0,2363,4294,6657,76,370,8852,2512,6340,8852,485,0.2669453230908269,0.4850881156800723,0.00858563036601898,0.28377767736104836,0.7162223226389517,0.041798463624039765
1612,48.0,5389,141765,147154,91,3227,189082,56049,133033,189082,14650,0.02850086205984705,0.7497540749516083,0.00048127267534720387,0.29642694703885086,0.7035730529611491,0.017066669487312384
1613,33.0,181,5584,5765,9,211,7556,2257,5299,7556,599,0.023954473266278455,0.7390153520381154,0.0011911064055055585,0.2987030174695606,0.7012969825304394,0.02792482795129698
1614,15.0,728,9621,10349,24,859,14198,3952,10246,14198,1150,0.051274827440484574,0.6776306522045359,0.0016903789266093816,0.27834906324834485,0.7216509367516551,0.06050147908156078
1615,,13402,434664,448066,1543,19245,589116,171448,417668,589116,44559,0.0227493396886182,0.7378241297129937,0.0026191785658512077,0.29102587605836544,0.7089741239416346,0.03266759008412605
1616,17.0,968,111766,112734,1852,6859,152888,42487,110401,152888,13042,0.006331432159489299,0.7310318664643399,0.012113442520014651,0.2778962377688242,0.7221037622311758,0.04486290617968709
1617,48.0,98,2211,2309,15,91,2984,882,2102,2984,196,0.03284182305630027,0.7409517426273459,0.005026809651474531,0.2955764075067024,0.7044235924932976,0.03049597855227882
1618,,764,20148,20912,54,1126,29352,7544,21808,29352,2091,0.02602889070591442,0.6864268192968112,0.001839738348323794,0.25701826110656856,0.7429817388934314,0.03836195148541837
1619,,1443,28006,29449,106,1633,39097,11153,27944,39097,2646,0.03690820267539709,0.7163209453410747,0.002711205463334783,0.28526485408087576,0.7147351459191242,0.04176791058137453
1620,27.0,882,20832,21714,31,970,28652,8370,20282,28652,2061,0.030783191400251292,0.7270696635487924,0.001081948904090465,0.2921262041044255,0.7078737958955745,0.03385453022476616
1621,15.0,599,16164,16763,69,1194,24307,6436,17871,24307,1933,0.024643106923931377,0.6649936232361048,0.0028386884436582055,0.2647796930925248,0.7352203069074752,0.049121652198955035
1622,17.0,174,3055,3229,3,152,4345,1320,3025,4345,278,0.04004602991944764,0.7031070195627158,0.0006904487917146145,0.3037974683544304,0.6962025316455697,0.034982738780207134
1623,,356,6705,7061,43,534,9475,2637,6840,9477,605,0.03756463015722275,0.7075023741690408,0.00453730083359713,0.27825261158594494,0.7217473884140551,0.056346945235834126
1624,24.0,28,3728,3756,3,159,5032,1413,3619,5032,412,0.005564387917329093,0.7408585055643879,0.0005961844197138314,0.2808028616852146,0.7191971383147854,0.031597774244833066
1625,16.0,34,1991,2025,6,75,2645,770,1875,2645,212,0.01285444234404537,0.7527410207939509,0.002268431001890359,0.29111531190926276,0.7088846880907372,0.02835538752362949
1626,,1031,22913,23944,91,1425,32220,8960,23260,32220,2398,0.031998758535071385,0.7111421477343265,0.002824332712600869,0.2780881440099317,0.7219118559900682,0.04422718808193669
1627,23.0,8796,178975,187771,1100,9617,246641,71700,174941,246641,17156,0.03566317035691552,0.7256498311310772,0.004459923532583796,0.29070592480568924,0.7092940751943108,0.03899189510259851
1628,23.0,1392,50868,52260,224,1800,69470,19815,49655,69470,6251,0.020037426227148408,0.7322297394558802,0.0032244134158629623,0.28523103497912766,0.7147689650208723,0.025910464948898804
1629,44.0,62,2003,2065,5,112,2725,792,1933,2725,193,0.022752293577981652,0.7350458715596331,0.001834862385321101,0.2906422018348624,0.7093577981651377,0.04110091743119266
1630,15.0,22,1515,1537,0,92,2112,630,1482,2112,167,0.010416666666666666,0.7173295454545454,0.0,0.29829545454545453,0.7017045454545454,0.043560606060606064
1631,34.0,220,3488,3708,8,147,4875,1393,3482,4875,305,0.04512820512820513,0.7154871794871794,0.001641025641025641,0.28574358974358977,0.7142564102564103,0.030153846153846153
1632,23.0,491,6671,7162,117,436,9874,2701,7173,9874,672,0.04972655458780636,0.6756127202754709,0.011849301195057726,0.2735466882722301,0.72645331172777,0.044156370265343324
1633,17.0,196,3603,3799,35,206,5015,1399,3616,5015,343,0.039082751744765706,0.718444666001994,0.006979062811565304,0.278963110667996,0.7210368893320039,0.04107676969092722
1634,,112,2869,2981,11,111,3959,1120,2839,3959,329,0.02828997221520586,0.7246779489770144,0.0027784794139934328,0.2828997221520586,0.7171002778479414,0.028037383177570093
1635,27.0,201,3335,3536,1,116,4520,1327,3193,4520,339,0.04446902654867257,0.7378318584070797,0.00022123893805309734,0.29358407079646015,0.7064159292035398,0.02566371681415929
1636,24.0,98,1548,1646,4,86,2368,605,1763,2368,139,0.041385135135135136,0.6537162162162162,0.0016891891891891893,0.25548986486486486,0.7445101351351351,0.036317567567567564
1637,16.0,498,10557,11055,33,795,14708,4280,10428,14708,992,0.0338591242861028,0.7177726407397335,0.0022436769105248842,0.29099809627413653,0.7090019037258635,0.05405221648082676
1638,25.0,900,34638,35538,85,1317,46231,13798,32433,46231,3568,0.019467456901213473,0.7492375246047025,0.0018385931517812724,0.29845774480327053,0.7015422551967294,0.028487378598775714
1639,,1484,39149,40633,102,2336,54868,15453,39415,54868,4172,0.027046730334621273,0.7135124298315958,0.0018590070715170956,0.28163957133483997,0.71836042866516,0.04257490704964642
1640,13.0,316,18384,18700,100,566,24935,7015,17920,24935,2122,0.012672949669139764,0.7372769199919792,0.0040104271104872665,0.28133146180068175,0.7186685381993182,0.02269901744535793
1641,,127,6150,6335,152,818,9229,2361,6868,9229,383,0.013760970852746777,0.6663777223967927,0.016469823382815038,0.2558240329396468,0.7441759670603533,0.08863365478383357
1642,36.0,316,33950,34266,4,942,43329,12484,30845,43329,3220,0.007293036996007293,0.7835398924507836,9.231692400009232e-05,0.2881211198042881,0.7118788801957119,0.02174063560202174
1643,,1184,17023,18207,275,1073,25662,6916,18782,25698,1528,0.046073624406568606,0.6624250914468052,0.010701221884971593,0.2691260020235038,0.7308739979764962,0.0417542221184528
1644,,2391,20336,22727,156,1463,31431,8604,22827,31431,2283,0.07607139448315357,0.6470045496484362,0.0049632528395533075,0.2737424835353632,0.7262575164646369,0.04654640323247749
1645,,79,1611,1690,1,61,2313,640,1673,2313,175,0.03415477734543882,0.6964980544747081,0.00043233895373973193,0.27669693039342846,0.7233030696065715,0.02637267617812365
1646,23.0,92,2501,2593,1,121,3411,972,2439,3411,242,0.026971562591615362,0.7332160656698915,0.0002931691586045148,0.2849604221635884,0.7150395778364116,0.035473468191146294
1647,,1022,41223,42245,99,1924,54702,16089,38613,54702,4076,0.018683046323717596,0.7535921904135132,0.0018098058571898651,0.2941208730942196,0.7058791269057804,0.035172388578114146
1648,25.0,581,9214,9795,198,637,13647,3644,10003,13647,695,0.042573459368359344,0.6751667033047556,0.014508683227082875,0.26701839232065655,0.7329816076793434,0.046676925331574706
1649,,31,44992,45023,73,2417,59403,16898,42505,59403,5265,0.0005218591653620187,0.7574028247731596,0.0012288941635944313,0.28446374762217397,0.715536252377826,0.04068818073161288
1650,25.0,84,1576,1660,14,150,2440,620,1820,2440,149,0.03442622950819672,0.6459016393442623,0.005737704918032787,0.2540983606557377,0.7459016393442623,0.06147540983606557
1651,14.0,255,6426,6681,1,352,9278,2668,6610,9278,734,0.027484371631817203,0.6926061651217935,0.00010778184953653804,0.28756197456348354,0.7124380254365165,0.03793921103686139
1652,,95,1618,1713,8,164,2409,623,1786,2409,136,0.039435450394354504,0.6716479867164799,0.0033208800332088003,0.25861353258613534,0.7413864674138647,0.06807804068078041
1653,,302,1336,1638,3,293,2470,611,1859,2470,103,0.12226720647773279,0.5408906882591094,0.0012145748987854252,0.24736842105263157,0.7526315789473684,0.11862348178137652
1654,,154,2466,2620,2,161,3545,1008,2537,3545,254,0.04344146685472496,0.6956276445698166,0.0005641748942172073,0.2843441466854725,0.7156558533145275,0.04541607898448519
1655,40.0,104,2609,2713,22,126,3693,1015,2678,3693,264,0.028161386406715408,0.7064717032223125,0.005957216355266721,0.27484430002707827,0.7251556999729217,0.03411860276198213
1656,25.0,737,16884,17621,91,1151,25276,6818,18458,25276,1830,0.029158094635227092,0.6679854407342934,0.0036002532046209845,0.2697420477923722,0.7302579522076278,0.04553726855515113
1657,26.0,2771,57255,60026,203,2887,77461,22831,54630,77461,5095,0.03577284052620028,0.7391461509662928,0.0026206736293102337,0.29474187010237407,0.7052581298976259,0.03727036831437756
1658,,96,6636,6732,5,372,9121,2594,6527,9121,746,0.010525161714724262,0.7275518035303147,0.000548185505975222,0.2843986404999452,0.7156013595000548,0.04078500164455652
1659,,351,6913,7264,16,504,9850,2771,7079,9850,647,0.03563451776649746,0.7018274111675127,0.0016243654822335025,0.2813197969543147,0.7186802030456853,0.05116751269035533
1660,25.0,124,4739,4863,3,157,6356,1872,4484,6356,526,0.019509125235997484,0.7455947136563876,0.0004719949653870359,0.2945248584015104,0.7054751415984896,0.024701069855254876
1661,,11077,139873,150950,1045,7752,203411,57311,146101,203412,15165,0.05445598096474151,0.6876339645645292,0.005137356694786935,0.2817483727607024,0.7182516272392976,0.03810984602678308
1662,,384,6986,7370,49,604,10523,2680,7843,10523,748,0.036491494820868574,0.6638791219234059,0.004656466787037917,0.25468022427064524,0.7453197757293547,0.05739808039532453
1663,26.0,76,2108,2184,0,100,2915,823,2092,2915,260,0.02607204116638079,0.723156089193825,0.0,0.2823327615780446,0.7176672384219555,0.03430531732418525
1664,17.0,794,27047,27841,233,1138,36763,10552,26211,36763,3174,0.021597802138019203,0.7357125370617197,0.006337894078285233,0.2870277180861192,0.7129722819138808,0.030955036313684955
1665,25.0,1514,28088,29602,213,1692,39248,11263,27985,39248,2545,0.03857521402364451,0.7156543008560946,0.005427028128821851,0.2869700366897676,0.7130299633102324,0.04311047696697921
1666,27.0,743,11791,12534,34,696,16950,4801,12149,16950,1265,0.04383480825958702,0.6956342182890856,0.002005899705014749,0.2832448377581121,0.716755162241888,0.04106194690265487
1667,,1007,28247,29254,122,2064,38953,10852,28101,38953,2747,0.02585166739403897,0.7251559571791646,0.003131979565116936,0.2785921495135163,0.7214078504864837,0.052986932970502915
1668,33.0,106,2802,2908,0,205,3887,1110,2777,3887,266,0.02727038847440185,0.7208644198610754,0.0,0.2855672755338307,0.7144327244661692,0.052739902238229996
1669,,226,4681,4907,34,264,6661,1848,4813,6661,505,0.03392883951358655,0.7027473352349497,0.005104338687884702,0.2774358204473803,0.7225641795526198,0.03963368863534004
1670,15.0,847,9978,10825,16,754,14819,4120,10699,14819,892,0.05715635333018422,0.6733247857480262,0.001079694986166408,0.2780214589378501,0.72197854106215,0.050880626223091974
1671,,224,6551,6775,37,385,9118,2630,6488,9118,664,0.024566790962930466,0.7184689624917745,0.004057907435841193,0.2884404474665497,0.7115595525334503,0.04222417196753674
1672,27.0,720,20606,21326,280,1708,28514,7564,20950,28514,1876,0.025250754015571298,0.7226625517289752,0.009819737672722172,0.2652731991302518,0.7347268008697482,0.059900399803605245
1673,38.0,450,14865,15315,102,540,19447,5870,13581,19451,1445,0.023135057323530925,0.7642280602539715,0.00524394632666701,0.30178396997583673,0.6982160300241633,0.02776206878823711
1674,15.0,294,8094,8388,47,822,12242,3038,9204,12242,723,0.024015683711811796,0.6611664760660023,0.0038392419539290965,0.2481620650220552,0.7518379349779448,0.06714589119424931
1675,,232,2688,2920,30,144,4010,1101,2909,4010,226,0.05785536159600998,0.6703241895261846,0.007481296758104738,0.2745635910224439,0.7254364089775561,0.035910224438902745
1676,17.0,278,7985,8263,2,322,11263,3139,8124,11263,1096,0.024682589008257125,0.7089585368019178,0.00017757258279321673,0.27870016869395364,0.7212998313060464,0.028589185829707892
1677,24.0,399,8174,8573,21,525,11674,3259,8415,11674,841,0.034178516361144426,0.7001884529724174,0.001798869282165496,0.2791673805036834,0.7208326194963166,0.044971732054137396
1678,25.0,51,1961,2012,12,98,2725,778,1947,2725,239,0.01871559633027523,0.7196330275229358,0.004403669724770643,0.28550458715596333,0.7144954128440367,0.03596330275229358
1679,24.0,5794,122455,128249,897,5291,170325,49303,121022,170325,13330,0.03401731982973727,0.718949067958315,0.005266402465874064,0.2894642595038896,0.7105357404961103,0.03106414208131513
1680,,560,39561,40121,551,2672,55285,15363,39922,55285,4890,0.010129329836302794,0.7155828886678123,0.009966537035362214,0.27788731120557114,0.7221126887944289,0.048331373790359046
1681,15.0,91,2980,3071,11,200,4168,1202,2966,4168,337,0.021833013435700575,0.7149712092130518,0.00263915547024952,0.2883877159309021,0.7116122840690979,0.04798464491362764
1682,,112,3479,3591,10,114,4628,1367,3261,4628,344,0.024200518582541054,0.7517286084701815,0.00216076058772688,0.2953759723422645,0.7046240276577356,0.024632670700086432
1683,,233,7785,8018,21,241,10385,3037,7348,10385,804,0.022436206066441984,0.7496389022628791,0.0020221473278767455,0.2924410207029369,0.707558979297063,0.023206547905633125
1684,,2652,50931,53583,190,3490,71905,20378,51527,71905,4795,0.03688199707947987,0.7083095751338572,0.002642375356372992,0.2834017105903623,0.7165982894096378,0.04853626312495654
1685,13.0,691,5845,6536,32,1406,12213,2268,9945,12213,263,0.056579055105215756,0.47858838942110865,0.0026201588471301074,0.18570375829034635,0.8142962417096536,0.1151232293457791
1686,,1373,23518,24891,174,2424,34609,9537,25072,34609,3020,0.039671761680487735,0.6795342252015372,0.005027593978444913,0.2755641596116617,0.7244358403883383,0.07003958507902569
1687,,439,8613,9052,85,329,11894,3433,8461,11894,939,0.0369093660669245,0.7241466285522112,0.007146460400201783,0.28863292416344377,0.7113670758365562,0.02766100554901631
1688,16.0,183,4710,4893,84,344,6608,1828,4780,6608,473,0.027693704600484263,0.712772397094431,0.012711864406779662,0.27663438256658596,0.7233656174334141,0.05205811138014528
1689,,530,10964,11494,33,504,15306,4380,10926,15306,1106,0.034626943682216124,0.7163203972298445,0.002156017248137985,0.2861622892983144,0.7138377107016857,0.032928263426107406
1690,,48,1912,1960,0,80,2600,755,1845,2600,241,0.018461538461538463,0.7353846153846154,0.0,0.2903846153846154,0.7096153846153846,0.03076923076923077
1691,15.0,2783,48298,51081,1305,3527,72749,19168,53581,72749,4593,0.03825482137211508,0.6638991601259124,0.017938390905716917,0.2634812849661164,0.7365187150338837,0.04848176607238588
1692,,982,11597,12579,194,652,17809,4578,13231,17809,927,0.055140659217249706,0.6511876017743837,0.010893368521534056,0.2570610365545511,0.742938963445449,0.03661070245381549
1693,,215,5485,5700,26,189,7602,2160,5442,7602,612,0.028282031044461985,0.721520652459879,0.0034201525914233097,0.2841357537490134,0.7158642462509865,0.024861878453038673
1694,15.0,37,1877,1914,10,69,2569,738,1831,2569,212,0.014402491241728299,0.7306344881276762,0.003892565200467108,0.2872713117944726,0.7127286882055275,0.026858699883223043
1695,23.0,337,9377,9714,7,486,12980,3754,9226,12980,824,0.02596302003081664,0.7224191063174114,0.0005392912172573189,0.28921417565485363,0.7107858243451464,0.037442218798151
1696,17.0,251,1805,2056,6,162,2825,816,2009,2825,166,0.0888495575221239,0.6389380530973451,0.0021238938053097347,0.2888495575221239,0.7111504424778761,0.05734513274336283
1697,,286,2648,2934,76,227,4188,1091,3097,4188,223,0.06829035339063992,0.6322827125119389,0.018147086914995225,0.2605062082139446,0.7394937917860553,0.05420248328557784
1698,24.0,76,1961,2037,14,54,2703,786,1917,2703,221,0.028116907140214576,0.7254901960784313,0.005179430262671106,0.290788013318535,0.709211986681465,0.01997780244173141
1699,25.0,12,2575,2587,5,287,3586,1019,2567,3586,368,0.0033463469046291134,0.7180702732849972,0.0013943112102621305,0.2841606246514222,0.7158393753485778,0.08003346346904629
1700,,315,9073,9388,37,323,12271,3489,8782,12271,1068,0.02567027952082145,0.7393855431505175,0.0030152391818107733,0.28432890554966994,0.7156710944503301,0.026322223127699454
1701,,855,18866,19721,57,1078,26313,7540,18773,26313,1943,0.03249344430509634,0.7169840003040322,0.002166229620339756,0.28655037433968,0.71344962566032,0.040968342644320296
1702,,74,2936,3010,40,573,4433,1148,3285,4433,212,0.01669298443491992,0.6623054364989849,0.009023234829686443,0.2589668396120009,0.741033160387999,0.1292578389352583
1703,13.0,63,3214,3277,22,286,4579,1240,3339,4579,334,0.013758462546407512,0.7018999781611706,0.0048045424765232585,0.27080148504040186,0.7291985149595982,0.062459052194802356
1704,,428,16014,16442,17,495,21412,6329,15083,21412,1597,0.019988791331963386,0.7478983747431347,0.0007939473192602279,0.29558191668223427,0.7044180833177658,0.023117877825518402
1705,13.0,58,1717,1775,16,174,2604,644,1960,2604,176,0.02227342549923195,0.6593701996927803,0.006144393241167435,0.24731182795698925,0.7526881720430108,0.06682027649769585
1706,16.0,455,37376,37831,73,3733,52339,14431,37908,52339,4367,0.008693326200347733,0.7141137583828503,0.0013947534343415045,0.27572173713674314,0.7242782628632568,0.07132348726571008
1707,14.0,6211,139355,145566,1043,10867,198525,55118,143407,198525,13928,0.03128573227553205,0.7019518952273014,0.005253746379549175,0.2776375771313437,0.7223624228686564,0.054738697896990304
1708,,146,3254,3400,9,164,4635,1300,3335,4635,387,0.03149946062567422,0.702049622437972,0.001941747572815534,0.28047464940668826,0.7195253505933118,0.035382955771305284
1709,15.0,163,2960,3123,1,139,4252,1238,3014,4252,346,0.0383349012229539,0.6961429915333961,0.00023518344308560678,0.29115710253998117,0.7088428974600188,0.032690498588899344
1710,23.0,3048,102747,105795,256,4848,135606,40279,95327,135606,9089,0.022476881553913544,0.757687712933056,0.0018878220727696414,0.29702962995737653,0.7029703700426235,0.03575063050307509
1711,16.0,759,8700,9459,23,611,12695,3643,9052,12695,774,0.05978731784166995,0.6853091768412761,0.0018117369042930287,0.28696337140606537,0.7130366285939346,0.048129184718393066
1712,25.0,131,1572,1703,6,125,2854,629,2225,2854,160,0.04590049053959355,0.5508058864751226,0.002102312543798178,0.22039243167484232,0.7796075683251577,0.04379817799579538
1713,13.0,137,3024,3161,12,152,4085,1234,2851,4085,284,0.03353733170134639,0.7402692778457772,0.002937576499388005,0.3020807833537332,0.6979192166462669,0.037209302325581395
1714,,144,3907,4051,13,237,5669,1525,4144,5669,379,0.025401305344858,0.689186805433057,0.0022931733991885693,0.2690068795201976,0.7309931204798025,0.04180631504674546
1715,,96,2094,2190,16,83,2906,831,2075,2906,216,0.03303509979353063,0.7205781142463867,0.0055058499655884375,0.28596008258774946,0.7140399174122505,0.02856159669649002
1716,,393,8157,8550,12,347,11282,3294,7988,11282,1048,0.034834249246587484,0.7230101045913845,0.0010636411983690835,0.29196950895231344,0.7080304910476866,0.030756957986172666
1717,47.0,302,5824,6126,18,334,7813,2245,5568,7813,463,0.03865352617432484,0.7454242928452579,0.00230385255343658,0.28734161013695125,0.7126583898630487,0.042749264047100985
1718,34.0,121,2386,2507,9,187,3415,979,2436,3415,218,0.03543191800878477,0.6986822840409956,0.0026354319180087846,0.2866764275256223,0.7133235724743777,0.0547584187408492
1719,26.0,164,3368,3532,7,194,4902,1342,3560,4902,337,0.03345573235414117,0.6870665034679723,0.0014279885760913912,0.273765809873521,0.7262341901264789,0.039575683394532844
1720,23.0,1470,35251,36721,53,1919,48151,13844,34307,48151,3437,0.030528960976926752,0.7320927914269694,0.0011007040352225292,0.28751220120039045,0.7124877987996096,0.03985379327532138
1721,,2705,20316,23021,97,1376,30854,8818,22036,30854,1980,0.08767096648732742,0.658455953847151,0.0031438387243145137,0.28579762753613797,0.7142023724638621,0.04459713489336877
1722,14.0,7115,165229,172383,1122,13729,234621,65646,169021,234667,16425,0.030319559205171584,0.7040998521308919,0.004781243208461352,0.27974107991323877,0.7202589200867613,0.05850417826111042
1723,,367,15065,15432,16,343,19941,5718,14223,19941,1701,0.018404292663356903,0.7554786620530565,0.0008023669825986661,0.2867459004061983,0.7132540995938017,0.017200742189458905
1724,,651,11386,12037,35,798,16177,4536,11641,16177,1140,0.040242319342276074,0.7038387834579959,0.0021635655560363477,0.2803980960623107,0.7196019039376893,0.049329294677628734
1725,26.0,935,18040,18975,73,1112,25608,7195,18413,25608,1925,0.03651202749140894,0.7044673539518901,0.002850671665104655,0.28096688534832864,0.7190331146516713,0.043423930021868166
1726,23.0,1954,35364,37318,240,1960,49671,14350,35321,49671,3527,0.03933884963056915,0.7119647279096455,0.004831793199251072,0.288900968371887,0.7110990316281129,0.03945964446055042
1727,38.0,3209,72775,75984,223,4871,101420,28285,73135,101420,6856,0.03164070203115756,0.7175606389272333,0.0021987773614671664,0.2788897653322816,0.7211102346677184,0.04802800236639716
1728,24.0,121,4831,4952,16,190,6427,1901,4526,6427,474,0.018826824334837403,0.7516726310875992,0.0024894974327057725,0.2957834137233546,0.7042165862766454,0.02956278201338105
1729,25.0,787,16873,17660,180,995,23388,6628,16760,23388,1547,0.033649734906789804,0.7214383444501453,0.007696254489481785,0.2833931930904737,0.7166068069095263,0.04254318453907987
1730,17.0,298,5729,6027,20,426,8236,2307,5929,8236,510,0.036182612918892666,0.6956046624575036,0.0024283632831471587,0.28011170471102476,0.7198882952889752,0.05172413793103448
1731,,178,4332,4510,52,207,6102,1736,4366,6102,447,0.02917076368403802,0.7099311701081613,0.008521796132415601,0.28449688626679775,0.7155031137332022,0.03392330383480826
1732,,102,2061,2163,16,72,2952,827,2125,2952,212,0.034552845528455285,0.698170731707317,0.005420054200542005,0.2801490514905149,0.7198509485094851,0.024390243902439025
1733,15.0,558,8891,9449,44,917,14428,3768,10660,14428,745,0.03867479900194067,0.6162323260327142,0.003049625727751594,0.2611588577765456,0.7388411422234544,0.06355697255336845
1734,,112,2193,2305,3,111,3024,861,2163,3024,229,0.037037037037037035,0.7251984126984127,0.000992063492063492,0.2847222222222222,0.7152777777777778,0.03670634920634921
1735,,698,8352,9050,67,646,12570,3451,9119,12570,849,0.055529037390612566,0.6644391408114558,0.005330151153540175,0.2745425616547335,0.7254574383452665,0.05139220365950676
1736,26.0,288,10639,10927,43,669,14505,4070,10461,14531,993,0.019819695822723832,0.7321588328401348,0.0029591906957539054,0.2800908402725208,0.7199091597274792,0.0460395017548689
1737,17.0,667,14695,15362,16,834,20378,5865,14513,20378,1649,0.0327313769751693,0.7211208165668859,0.000785160467170478,0.2878103837471783,0.7121896162528216,0.04092648935126116
1738,36.0,290,2136,2426,35,185,3252,925,2327,3252,125,0.08917589175891759,0.6568265682656826,0.01076260762607626,0.284440344403444,0.715559655596556,0.05688806888068881
1739,,665,17202,17867,56,1479,24448,6741,17707,24448,1699,0.0272005890052356,0.7036158376963351,0.0022905759162303663,0.2757280759162304,0.7242719240837696,0.060495746073298426
1740,16.0,3969,59852,63821,136,4595,88700,24563,64137,88700,6172,0.044746335963923335,0.6747688838782413,0.0015332581736189402,0.27692220969560316,0.7230777903043969,0.05180383314543405
1741,36.0,139,3834,3973,0,117,5169,1544,3625,5169,489,0.026891081447088412,0.7417295414973882,0.0,0.2987038111820468,0.7012961888179532,0.022634939059779455
1742,,110,2379,2489,30,83,3217,957,2260,3217,197,0.034193347839602116,0.7395088591855766,0.009325458501709667,0.2974821262045384,0.7025178737954616,0.025800435188063412
1743,33.0,123,2651,2774,5,153,3706,1056,2650,3706,280,0.033189422558014034,0.7153264975715057,0.0013491635186184566,0.28494333513221803,0.715056664867782,0.04128440366972477
1744,24.0,166,6711,6877,72,389,9181,2596,6585,9181,640,0.018080819082888576,0.7309661256943688,0.007842282975710707,0.2827578695131249,0.717242130486875,0.04237011218821479
1745,33.0,143,5383,5526,3,310,7159,2072,5087,7159,507,0.01997485682357871,0.7519206593099594,0.00041905294035479815,0.28942589747171393,0.7105741025282861,0.04330213716999581
1746,,311,4687,4998,13,312,6798,1781,5017,6798,402,0.045748749632244776,0.6894674904383642,0.0019123271550456017,0.2619888202412474,0.7380111797587525,0.04589585172109444
1747,36.0,1431,30393,31824,168,1711,43552,12000,31552,43552,2769,0.032857274063188835,0.6978554371785451,0.003857457751653196,0.27553269654665685,0.7244673034533431,0.03928637031594416
1748,,50,2890,2940,21,192,4177,1114,3063,4177,291,0.011970313622216903,0.691884127364137,0.005027531721331099,0.2666985875029926,0.7333014124970074,0.045966004309312906
1749,23.0,116,2101,2217,8,167,3178,840,2338,3178,191,0.03650094398993078,0.6611076148521082,0.0025173064820641915,0.2643171806167401,0.73568281938326,0.05254877281308999
1750,,4,2223,2227,26,458,3371,860,2511,3371,152,0.0011865915158706616,0.6594482349451202,0.0077128448531593,0.25511717591219224,0.7448828240878078,0.13586472856719076
1751,25.0,140,2527,2667,14,166,3676,999,2677,3676,230,0.03808487486398259,0.6874319912948857,0.003808487486398259,0.2717627856365615,0.7282372143634385,0.04515778019586507
1752,13.0,192,1912,2104,50,498,3540,801,2739,3540,145,0.05423728813559322,0.5401129943502825,0.014124293785310734,0.22627118644067798,0.773728813559322,0.14067796610169492
1753,24.0,266,8944,9210,14,529,12077,3412,8665,12077,857,0.022025337418233006,0.7405812701829925,0.001159228285170158,0.2825204935000414,0.7174795064999586,0.043802268775358116
1754,,272,1956,2228,28,185,3939,705,3234,3939,104,0.06905305915206905,0.49657273419649656,0.007108403148007108,0.178979436405179,0.821020563594821,0.046966235085046965
1755,27.0,111,5579,5690,55,193,7708,2092,5616,7708,715,0.014400622729631551,0.7237934613388687,0.007135443694862481,0.27140633108458745,0.7285936689154126,0.02503892060197198
1756,37.0,539,18311,18850,115,607,24807,7314,17493,24807,2207,0.021727738138428668,0.7381384286693272,0.004635788285564558,0.2948361349619059,0.7051638650380941,0.024468899907284233
1757,,832,24696,25528,61,1861,34639,9909,24730,34639,2934,0.024019169144605793,0.7129536072057507,0.0017610208146886458,0.28606484020901296,0.713935159790987,0.053725569444845404
1758,,273,4966,5239,6,406,7254,2001,5253,7254,456,0.03763440860215054,0.6845878136200717,0.0008271298593879239,0.2758478081058726,0.7241521918941274,0.05596912048524952
1759,17.0,729,24334,25063,116,1225,32395,9524,22871,32395,2195,0.02250347275814169,0.7511653032875444,0.00358079950609662,0.29399598703503627,0.7060040129649637,0.03781447754283068
1760,,353,6696,7049,68,249,9259,2633,6626,9259,540,0.038125067501890056,0.7231882492709796,0.007344205637757857,0.2843719624149476,0.7156280375850523,0.026892752997083918
1761,16.0,1572,35562,37134,150,2028,50227,14183,36044,50227,3806,0.03129790749995023,0.7080255639397137,0.0029864415553387622,0.2823780038624644,0.7176219961375356,0.04037668982818006
1762,24.0,1190,103067,104257,459,5623,138750,40754,97996,138750,8228,0.008576576576576577,0.7428252252252252,0.003308108108108108,0.2937225225225225,0.7062774774774775,0.040526126126126126
1763,27.0,364,13734,14098,48,733,18218,5250,12968,18218,1357,0.019980239323745746,0.7538697990997915,0.002634756833900538,0.28817652870787136,0.7118234712921286,0.04023493248435613
1764,26.0,133,3793,3926,34,150,5294,1501,3793,5294,489,0.025122780506233473,0.7164714771439366,0.006422364941443143,0.28352852285606345,0.7164714771439366,0.028333962976955042
1765,23.0,133,7656,7789,11,330,10386,2933,7453,10386,875,0.012805699980743308,0.7371461582900057,0.0010591180435201232,0.2823993837858656,0.7176006162141344,0.0317735413056037
1766,45.0,347,8928,9275,18,603,12651,3417,9234,12651,820,0.02742866176586831,0.7057149632440123,0.0014228124258951862,0.2700972255157695,0.7299027744842305,0.047664216267488735
1767,17.0,1708,169554,171262,1123,8108,228718,65293,163425,228718,20010,0.007467711330109567,0.7413233763848932,0.004909976477583749,0.285473814916185,0.714526185083815,0.03544976783637493
1768,25.0,126,2276,2402,1,83,3120,933,2187,3120,269,0.04038461538461539,0.7294871794871794,0.0003205128205128205,0.29903846153846153,0.7009615384615384,0.0266025641025641
1769,,726,24729,25455,63,677,33496,9884,23612,33496,2937,0.021674229758777166,0.7382672557917364,0.001880821590637688,0.2950800095533795,0.7049199904466205,0.020211368521614523
1770,16.0,190,11461,11651,23,421,15691,4474,11217,15691,1660,0.012108852208272259,0.7304187113632018,0.0014658084252119048,0.2851316041042636,0.7148683958957364,0.026830667261487477
1771,25.0,102,3145,3247,39,102,4359,1239,3120,4359,357,0.02339986235375086,0.7214957559073182,0.008947006194081212,0.2842395044735031,0.7157604955264969,0.02339986235375086
1772,24.0,482,63421,63903,191,3326,85541,24058,61483,85541,6882,0.005634724868776376,0.7414105516652834,0.0022328474065068213,0.2812452508153985,0.7187547491846016,0.03888193965466852
1773,17.0,1740,7156,8896,46,613,12218,3307,8911,12218,615,0.1424128335243084,0.5856932394827304,0.0037649369782288425,0.2706662301522344,0.7293337698477655,0.05017187755770175
1774,,85,2192,2277,4,134,3027,799,2228,3027,220,0.028080607862570203,0.7241493227618103,0.0013214403700033035,0.2639577139081599,0.7360422860918401,0.04426825239511067
1775,23.0,5724,110546,116270,436,5577,152200,44454,107746,152200,11014,0.037608409986859395,0.7263206307490144,0.002864651773981603,0.2920762155059133,0.7079237844940868,0.03664257555847569
1776,,587,18797,19384,94,835,25061,7364,17697,25061,1547,0.023422848250269343,0.7500498782969555,0.0037508479310482423,0.29384302302382187,0.7061569769761781,0.03331870236622641
1777,14.0,150,16588,16738,52,833,22381,6413,15968,22381,1952,0.0067021133997587235,0.741164380501318,0.0023233993119163576,0.28653768821768466,0.7134623117823153,0.037219069746660116
1778,25.0,102,2371,2473,6,158,3426,937,2489,3426,226,0.0297723292469352,0.6920607122008173,0.0017513134851138354,0.27349678925861065,0.7265032107413893,0.04611792177466433
1779,35.0,324,10340,10664,36,573,13892,4177,9715,13892,922,0.023322775698243592,0.7443132738266628,0.002591419522027066,0.30067664843075154,0.6993233515692485,0.041246760725597464
1780,,523,20153,20676,13,1196,28077,8140,19937,28077,2223,0.018627346226448696,0.7177761156818748,0.00046301243010293125,0.28991701392598923,0.7100829860740108,0.04259714356946967
1781,,1166,36660,37826,98,1605,49817,14396,35421,49817,4058,0.023405664732922497,0.7358933697332236,0.0019671999518236748,0.2889776582291186,0.7110223417708814,0.03221791757833671
1782,38.0,2285,65843,68128,359,2978,89051,25794,63257,89051,7741,0.025659453571548887,0.7393852960662991,0.004031397738374639,0.28965424307419346,0.7103457569258066,0.03344151104423308
1783,,479,4152,4631,66,495,8484,1500,6984,8484,184,0.056459217350306456,0.4893917963224894,0.007779349363507779,0.1768033946251768,0.8231966053748232,0.05834512022630835
1784,37.0,339,5658,5997,24,137,7462,2325,5137,7462,464,0.04543017957652104,0.7582417582417582,0.0032162958992227285,0.31157866523720185,0.6884213347627982,0.01835968909139641
1785,,559,17998,18557,134,784,24934,7060,17874,24934,2195,0.022419186652763295,0.7218256196358386,0.005374187855939681,0.2831475094248817,0.7168524905751184,0.031443009545199324
1786,,489,14352,14841,1,1043,20069,5725,14344,20069,1554,0.02436593751557128,0.7151327918680552,4.982809307887787e-05,0.2852658328765758,0.7147341671234242,0.05197070108126962
1787,23.0,744,10695,11439,47,717,17985,3970,14015,17985,787,0.041367806505421184,0.5946622185154296,0.002613288851820962,0.22073950514317486,0.7792604948568251,0.039866555462885735
1788,,751,22366,23117,133,725,30571,8823,21748,30571,2326,0.024565764940630008,0.7316083870334631,0.00435052827843381,0.2886068496287331,0.7113931503712669,0.023715285728304603
1789,,63,2855,2918,11,262,4025,1084,2941,4025,283,0.01565217391304348,0.7093167701863354,0.002732919254658385,0.26931677018633543,0.7306832298136646,0.06509316770186335
1790,45.0,718,22938,23656,26,1214,31523,9035,22488,31523,2593,0.022777019953684613,0.7276591694952892,0.0008247945944231197,0.2866161215620341,0.7133838784379659,0.038511562985756434
1791,16.0,5242,54054,59296,491,3097,80751,22247,58504,80751,6362,0.06491560476031256,0.6693910911319984,0.006080420056717564,0.2755012321828832,0.7244987678171169,0.0383524662233285
1792,24.0,1338,37293,38631,108,1797,51056,14621,36435,51056,4337,0.02620651833281103,0.7304332497649639,0.0021153243497336258,0.2863718270134754,0.7136281729865246,0.03519664681917894
1793,26.0,1189,29245,30434,95,1859,40232,11167,29065,40232,2796,0.029553589182740106,0.7269089282163452,0.002361304434281169,0.27756512229071384,0.7224348777092862,0.04620699940345993
1794,25.0,4507,96712,101219,458,4428,135241,38641,96600,135241,9997,0.03332569265237613,0.715108583935345,0.0033865469790965758,0.28571956729098424,0.7142804327090158,0.03274155026951886
1795,,9659,200691,210350,1549,12942,292661,78814,213847,292661,17790,0.033004055887186884,0.6857456237763145,0.005292813186587895,0.2693013418255251,0.7306986581744749,0.044221812950820234
1796,,471,7733,8204,36,417,10908,3162,7746,10908,806,0.04317931793179318,0.7089292262559589,0.0033003300330033004,0.28987898789878985,0.7101210121012101,0.03822882288228823
1797,40.0,2191,57718,59909,231,2462,77032,23066,53966,77032,5437,0.02844272510125662,0.7492730293903832,0.0029987537646692284,0.2994340014539412,0.7005659985460588,0.031960743587080696
1798,,1171,20045,21216,46,2152,29640,8200,21440,29640,2138,0.039507422402159244,0.6762820512820513,0.0015519568151147098,0.2766531713900135,0.7233468286099866,0.07260458839406207
1799,,107,2430,2537,0,222,3392,1012,2380,3392,176,0.03154481132075472,0.7163915094339622,0.0,0.2983490566037736,0.7016509433962265,0.06544811320754718
1800,17.0,19,11455,11474,27,396,15014,4298,10716,15014,1329,0.0012654855468229652,0.7629545757293194,0.001798321566537898,0.2862661515918476,0.7137338484081523,0.02637538297588917
1801,25.0,2012,65281,67293,319,3444,89565,25523,64042,89565,6860,0.02246413219449562,0.7288673030759784,0.0035616591302406074,0.28496622564617874,0.7150337743538212,0.0384525205158265
1802,24.0,198,5848,6046,9,260,7834,2277,5557,7834,600,0.025274444728108247,0.7464896604544294,0.001148838396732193,0.29065611437324484,0.7093438856267552,0.033188664794485574
1803,,4103,89086,93189,171,4106,123236,35811,87425,123236,9221,0.03329384270829952,0.722889415430556,0.001387581550845532,0.2905887889902301,0.7094112110097699,0.03331818624427927
1804,36.0,952,20176,21128,99,964,28116,8021,20095,28116,1963,0.03385972400056907,0.7175985204154218,0.0035211267605633804,0.28528240147958456,0.7147175985204154,0.03428652724427372
1805,,1921,32204,34125,152,3051,48327,12759,35568,48327,3179,0.039750036211641526,0.6663769735344631,0.0031452397210668982,0.2640139052703458,0.7359860947296543,0.0631324104537836
1806,15.0,133,4065,4198,14,177,5632,1626,4006,5632,493,0.02361505681818182,0.7217684659090909,0.0024857954545454545,0.28870738636363635,0.7112926136363636,0.031427556818181816
1807,,95,2522,2617,11,114,3710,964,2746,3710,265,0.025606469002695417,0.6797843665768194,0.0029649595687331535,0.2598382749326146,0.7401617250673854,0.030727762803234502
1808,14.0,830,19049,19879,73,972,26663,7441,19222,26663,2055,0.031129280276037955,0.7144357349135506,0.0027378764580129767,0.2790758729325282,0.7209241270674718,0.03645501256422758
1809,,82,2848,2930,0,163,3876,1081,2795,3876,357,0.021155830753353973,0.7347781217750258,0.0,0.2788957688338493,0.7211042311661506,0.04205366357069144
1810,16.0,280,9496,9776,39,465,12817,3728,9089,12817,968,0.02184598580010923,0.740891004135133,0.0030428337364437857,0.29086369665288286,0.7091363033471171,0.03627994070375283
1811,,170,2786,2956,8,94,3917,1136,2781,3917,354,0.04340056165432729,0.7112586162879755,0.0020423793719683433,0.2900178708195047,0.7099821291804953,0.023997957620628032
1812,27.0,256,5245,5501,24,1291,8416,2116,6300,8416,419,0.030418250950570342,0.623217680608365,0.0028517110266159697,0.251425855513308,0.748574144486692,0.15339828897338403
1813,27.0,1299,16625,17924,29,661,22939,6785,16154,22939,1074,0.05662844936570906,0.7247482453463534,0.0012642225031605564,0.29578447186015083,0.7042155281398491,0.028815554296176816
1814,23.0,164,14292,14456,85,2205,20551,5562,14989,20551,924,0.007980146951486546,0.6954406111624738,0.004136051773636319,0.27064376429370834,0.7293562357062917,0.10729404895138922
1815,24.0,171,7994,8165,23,349,10656,3143,7513,10656,929,0.016047297297297296,0.7501876876876877,0.0021584084084084083,0.2949512012012012,0.7050487987987988,0.0327515015015015
1816,15.0,134,3975,4109,23,480,5504,1588,3916,5504,242,0.02434593023255814,0.7222020348837209,0.0041787790697674415,0.28851744186046513,0.7114825581395349,0.0872093023255814
1817,35.0,290,11377,11667,53,412,14744,4515,10229,14744,894,0.019669017905588716,0.7716359196961475,0.003594682582745524,0.30622626153011395,0.6937737384698861,0.027943570265870864
1818,26.0,147,4091,4241,25,130,5427,1643,3784,5427,339,0.027086788280818133,0.75382347521651,0.004606596646397641,0.302745531601253,0.697254468398747,0.023954302561267734
1819,,72,7616,7688,14,461,10241,2893,7348,10241,818,0.007030563421540865,0.7436773752563226,0.001367053998632946,0.2824919441460795,0.7175080558539205,0.04501513524069915
1820,,93,2439,2532,2,226,3515,960,2555,3515,215,0.026458036984352774,0.6938833570412518,0.0005689900426742532,0.27311522048364156,0.7268847795163584,0.06429587482219061
1821,27.0,688,22246,22934,97,1196,30515,8704,21811,30515,2420,0.02254628871047026,0.7290185154841881,0.0031787645420285108,0.2852367688022284,0.7147632311977716,0.03919383909552679
1822,16.0,5,18838,18843,6,183,24356,7359,16997,24356,2322,0.00020528822466743307,0.7734439152570208,0.0002463458696009197,0.302143209065528,0.697856790934472,0.007513549022828051
1823,27.0,224,4505,4729,63,313,6558,1844,4714,6558,457,0.034156755108264714,0.6869472400121989,0.00960658737419945,0.2811832875876792,0.7188167124123208,0.047727965843244895
1824,34.0,89,4011,4100,0,154,5409,1568,3841,5409,445,0.016454058051395822,0.7415418746533555,0.0,0.28988722499537806,0.7101127750046219,0.02847106674061749
1825,33.0,3404,53416,56820,135,3452,75752,21823,53937,75760,5922,0.04493136219640972,0.7050686378035903,0.0017819429778247096,0.2880543822597677,0.7119456177402324,0.045564941921858504
1826,,164,4526,4690,9,189,6176,1824,4352,6176,480,0.02655440414507772,0.7328367875647669,0.0014572538860103627,0.29533678756476683,0.7046632124352331,0.030602331606217618
1827,25.0,234,5991,6225,38,300,8163,2330,5833,8163,573,0.02866593164277839,0.7339213524439544,0.0046551512924170035,0.28543427661398996,0.7145657233860101,0.036751194413818446
1828,25.0,369,4819,5188,185,534,7555,1973,5582,7555,379,0.04884182660489742,0.6378557246856387,0.024487094639311716,0.26115155526141626,0.7388484447385837,0.07068166776968894
1829,,100,1885,1985,30,404,2835,512,2323,2835,132,0.03527336860670194,0.6649029982363316,0.010582010582010581,0.18059964726631395,0.819400352733686,0.14250440917107585
1830,27.0,672,16482,17154,67,1186,22884,6286,16598,22884,1559,0.029365495542737284,0.7202412165705296,0.0029278098234574376,0.27468973955602166,0.7253102604439783,0.05182660374060479
1831,26.0,356,6893,7249,164,551,10099,2713,7386,10099,615,0.03525101495197544,0.6825428260223785,0.016239231607089812,0.26864045945143084,0.7313595405485692,0.05455985741162491
1832,44.0,125,3719,3844,6,167,5033,1518,3515,5033,380,0.02483608185972581,0.7389231074905623,0.001192131929266839,0.3016093781045102,0.6983906218954897,0.03318100536459368
1833,,102,2196,2298,7,96,2989,879,2110,2989,221,0.03412512546002008,0.7346938775510204,0.00234192037470726,0.2940782870525259,0.7059217129474741,0.03211776513884242
1834,38.0,48857,603762,652619,5526,34563,848669,247824,600845,848669,48436,0.05756896976324103,0.7114222388233811,0.006511372513901179,0.29201490805013497,0.707985091949865,0.04072612526202795
1835,23.0,752,15207,15959,67,810,21856,6118,15738,21856,1572,0.034407027818448024,0.6957814787701317,0.003065519765739385,0.27992313323572476,0.7200768667642753,0.03706076134699854
1836,16.0,1928,16864,18792,93,2194,26331,7146,19185,26331,1539,0.07322167787019103,0.6404618130720443,0.003531958527970833,0.2713911359234363,0.7286088640765638,0.08332383882116137
1837,,263,3205,3468,53,289,5353,1219,4134,5353,131,0.04913132822716234,0.5987296842891836,0.009900990099009901,0.22772277227722773,0.7722772277227723,0.0539884177096955
1838,39.0,303,4101,4404,42,217,6229,1616,4613,6229,348,0.04864344196500241,0.6583721303580029,0.006742655321881522,0.25943169048001286,0.7405683095199872,0.03483705249638786
1839,,293,3115,3408,21,261,5710,1124,4586,5710,229,0.05131348511383538,0.5455341506129597,0.0036777583187390544,0.1968476357267951,0.8031523642732049,0.0457092819614711
1840,23.0,165,3702,3867,9,198,5147,1489,3658,5147,401,0.0320575092286769,0.7192539343306781,0.0017485914124732854,0.2892947347969691,0.7107052652030309,0.03846901107441228
1841,14.0,2377,94929,97306,214,4662,130153,37407,92746,130153,10773,0.018263121095940932,0.7293646708105076,0.0016442187271903067,0.2874078968598496,0.7125921031401504,0.03581938180449164
1842,,1600,32900,34500,396,2299,46861,12771,34090,46861,2960,0.03414353086788587,0.7020763534709034,0.008450523889801755,0.27252939544610655,0.7274706045538935,0.04905998591579352
1843,27.0,132,7066,7198,9,249,9330,2768,6562,9330,750,0.01414790996784566,0.757341907824223,0.0009646302250803858,0.29667738478027866,0.7033226152197213,0.026688102893890675
1844,,126,1834,1960,8,266,2815,625,2190,2815,151,0.044760213143872116,0.6515097690941385,0.002841918294849023,0.22202486678507993,0.7779751332149201,0.09449378330373001
1845,17.0,3747,62531,66278,422,7089,89825,22277,67548,89825,4599,0.04171444475368773,0.6961424993042026,0.0046980239354300025,0.24800445310325633,0.7519955468967436,0.07892012246033955
1846,24.0,92,2837,2929,3,88,3742,1154,2588,3742,264,0.024585783003741316,0.7581507215392838,0.0008017103153393907,0.3083912346338856,0.6916087653661144,0.02351683591662213
1847,23.0,58,1413,1471,0,157,2068,509,1559,2068,92,0.02804642166344294,0.6832688588007737,0.0,0.24613152804642166,0.7538684719535783,0.07591876208897486
1848,16.0,270,14004,14274,34,1520,20889,5316,15573,20889,1095,0.012925463162429988,0.6704006893580353,0.0016276509167504427,0.2544880080425104,0.7455119919574896,0.07276557039590215
1849,,1207,54194,55401,311,4295,77709,20785,56924,77709,5899,0.015532306425253188,0.6973966979371758,0.004002110437658444,0.2674722361631214,0.7325277638368786,0.05527030331107079
1850,,154,3711,3865,15,135,5041,1496,3545,5041,365,0.030549494147986512,0.7361634596310256,0.0029756000793493354,0.2967665145804404,0.7032334854195597,0.026780400714144018
1851,48.0,2154,43983,46137,303,1581,60181,17661,42520,60181,4644,0.03579202738405809,0.7308452833950915,0.005034811651517921,0.29346471477708913,0.7065352852229109,0.026270749904454896
1852,,2006,53757,55763,241,1791,72740,21321,51419,72740,5197,0.027577673907066263,0.739029419851526,0.0033131701952158372,0.29311245532031893,0.7068875446796811,0.024621941160296947
1853,25.0,147,2385,2532,4,85,3443,1076,2367,3443,232,0.04269532384548359,0.6927098460644786,0.0011617775196049957,0.31251815277374384,0.6874818472262562,0.024687772291606156
1854,,464,11489,11953,36,604,15875,4467,11408,15875,1220,0.029228346456692915,0.7237165354330709,0.002267716535433071,0.2813858267716535,0.7186141732283464,0.03804724409448819
1855,27.0,172,5196,5368,7,264,7137,1994,5143,7137,502,0.024099761804679837,0.7280369903320723,0.000980804259492784,0.2793890990612302,0.7206109009387698,0.036990332072299285
1856,44.0,267,7271,7538,25,309,9889,2781,7108,9889,863,0.026999696632622104,0.7352614015572859,0.002528061482455253,0.2812215593083224,0.7187784406916776,0.031246839923146932
1857,13.0,131,3475,3606,25,407,5013,1337,3676,5013,235,0.026132056652702972,0.6931976860163575,0.004987033712347895,0.26670656293636547,0.7332934370636346,0.08118890883702373
1858,,101,3316,3417,9,103,4407,1230,3177,4407,339,0.02291808486498752,0.7524393011118675,0.0020422055820285907,0.27910142954390743,0.7208985704560926,0.02337190832766054
1859,,305,5746,6051,2,286,7959,2270,5689,7959,652,0.038321397160447294,0.7219499937178038,0.00025128785023244125,0.28521171001382084,0.7147882899861792,0.0359341625832391
1860,23.0,8678,207247,215925,1294,7540,276717,82288,194429,276717,20344,0.031360559705402996,0.7489492875392549,0.0046762576928775605,0.29737240574305157,0.7026275942569484,0.027248054871944982
1861,17.0,4390,52199,56589,555,3434,77822,21615,56207,77822,5810,0.0564107835830485,0.6707486314923801,0.007131659427925265,0.27774922258487317,0.7222507774151268,0.04412633959548714
1862,23.0,218,5795,6013,9,175,7848,2306,5542,7848,666,0.027777777777777776,0.7384046890927625,0.0011467889908256881,0.29383282364933744,0.7061671763506626,0.0222986748216106
1863,,25,3062,3087,25,309,4349,1182,3167,4349,353,0.005748447919061853,0.7040699011266958,0.005748447919061853,0.2717866176132444,0.7282133823867556,0.07105081627960451
1864,,1200,26434,27634,71,1239,36270,10454,25816,36270,2686,0.033085194375516956,0.7288116901020126,0.0019575406672180866,0.28822718500137856,0.7117728149986214,0.03416046319272126
1865,,631,17238,17869,37,792,23394,6851,16543,23394,1834,0.02697272804992733,0.7368556040010259,0.0015816021202017612,0.292852868256818,0.707147131743182,0.03385483457296743
1866,,98,2533,2631,2,173,3601,1031,2570,3601,339,0.027214662593723966,0.7034157178561511,0.0005554012774229381,0.28630935851152456,0.7136906414884754,0.04804221049708415
1867,,218,3286,3504,6,218,4725,1324,3401,4725,323,0.04613756613756614,0.6954497354497354,0.0012698412698412698,0.2802116402116402,0.7197883597883598,0.04613756613756614
1868,24.0,323,13682,14005,68,836,19130,5445,13685,19130,1387,0.016884474647151072,0.7152117093570308,0.0035546262415054888,0.2846314688970204,0.7153685311029796,0.04370099320439101
1869,,5709,97230,102939,898,6600,143297,39289,104008,143297,10744,0.03984033161894527,0.6785208343510332,0.0062667048158719305,0.2741788034641339,0.7258211965358661,0.04605818684271129
1870,24.0,1177,17815,18992,48,2574,24718,5887,18831,24718,1092,0.047617121126304715,0.720729832510721,0.0019419046848450521,0.23816651832672547,0.7618334816732746,0.10413463872481592
1871,,253,6223,6476,2,363,9072,2619,6453,9072,433,0.02788800705467372,0.6859567901234568,0.0002204585537918871,0.28869047619047616,0.7113095238095238,0.040013227513227514
1872,26.0,84,2449,2533,0,143,3401,977,2424,3401,279,0.02469861805351367,0.7200823287268451,0.0,0.28726845045574834,0.7127315495442517,0.04204645692443399
1873,39.0,1274,50874,52148,105,2159,68415,20082,48333,68415,5635,0.01862164729956881,0.7436088577066433,0.0015347511510633632,0.29353212014909014,0.7064678798509099,0.031557407001388586
1874,24.0,1564,45386,46950,107,2155,61764,17736,44028,61764,4805,0.02532219415840943,0.7348293504306715,0.001732400751246681,0.28715756751505733,0.7128424324849427,0.034890874943332685
1875,26.0,403,6655,7058,32,481,9791,2666,7125,9791,668,0.04116024920845675,0.679705852313349,0.0032683076294556224,0.2722908793790216,0.7277091206209785,0.049126749055254826
1876,,117,2297,2414,14,111,3277,882,2395,3277,191,0.03570338724443088,0.7009459871833994,0.0042722001830942935,0.2691486115349405,0.7308513884650595,0.03387244430881904
1877,,670,12929,13599,34,457,17590,5200,12390,17590,1412,0.03808982376350199,0.7350198976691302,0.0019329164297896533,0.2956225127913587,0.7043774872086412,0.025980670835702102
1878,16.0,18,10515,10533,41,1748,14746,3946,10800,14746,588,0.0012206700122067001,0.7130747321307473,0.00278041502780415,0.26759799267597995,0.73240200732402,0.11854062118540622
1879,17.0,30,7757,7787,10,261,10263,3020,7243,10263,1025,0.0029231218941829875,0.7558218844392478,0.0009743739647276625,0.29426093734775405,0.705739062652246,0.02543116047939199
1880,23.0,165,1652,1817,12,54,2437,700,1737,2437,194,0.06770619614279852,0.6778826425933525,0.004924086992203529,0.2872384078785392,0.7127615921214608,0.02215839146491588
1881,17.0,994,14112,15106,95,1449,20441,5615,14826,20441,1347,0.048627757937478595,0.6903771831123722,0.004647522136881757,0.27469301893253756,0.7253069810674625,0.07088694290885965
1882,25.0,406,9630,10036,22,436,12998,3831,9167,12998,816,0.031235574703800586,0.7408832128019696,0.0016925680873980612,0.2947376519464533,0.7052623480535467,0.033543622095707035
1883,,443,10006,10449,26,403,14054,4048,10006,14054,1215,0.03152127508182724,0.7119681229543191,0.0018500071154119824,0.28803187704568095,0.7119681229543191,0.028675110288885728
1884,14.0,306,1838,2144,34,178,3464,789,2675,3464,82,0.08833718244803695,0.5306004618937644,0.009815242494226328,0.22777136258660508,0.7722286374133949,0.05138568129330254
1885,36.0,5166,76588,81754,395,6340,112808,31043,81765,112808,7925,0.04579462449471668,0.6789234806042125,0.003501524714559251,0.275184384086235,0.724815615913765,0.05620168782355861
1886,15.0,772,17304,18076,46,845,23589,6919,16670,23589,1766,0.032727118572215864,0.7335622535927763,0.0019500614693289246,0.29331468057145277,0.7066853194285472,0.035821781338759594
1887,,241,2151,2392,0,99,3152,926,2226,3152,240,0.07645939086294416,0.6824238578680203,0.0,0.29378172588832485,0.7062182741116751,0.03140862944162436
1888,24.0,400,4702,5102,58,193,6855,1985,4870,6855,474,0.058351568198395334,0.6859226841721371,0.008460977388767324,0.2895696571845368,0.7104303428154631,0.028154631655725747
1889,26.0,79,1592,1671,2,77,2185,631,1554,2185,141,0.036155606407322655,0.728604118993135,0.0009153318077803204,0.28878718535469106,0.7112128146453089,0.035240274599542334
1890,15.0,183,8718,8901,17,627,13573,3243,10330,13573,866,0.013482649377440507,0.6423045752597067,0.0012524865541884624,0.23893022913136375,0.7610697708686363,0.046194651145656816
1891,,1033,15808,16841,214,1273,23472,6208,17264,23472,1270,0.04400988411724608,0.6734832992501704,0.009117246080436264,0.26448534423994546,0.7355146557600545,0.0542348329925017
1892,14.0,575,7818,8393,59,778,11543,3147,8396,11543,768,0.04981373992896128,0.6772935978515118,0.005111322879667331,0.27263276444598455,0.7273672355540154,0.06740015593866412
1893,,23,2459,2482,27,256,3553,913,2640,3553,206,0.00647340275823248,0.6920911905432029,0.007599211933577259,0.25696594427244585,0.7430340557275542,0.07205178722206586
1894,,247,3780,4027,10,581,5658,1319,4339,5658,294,0.043655001767408975,0.6680805938494168,0.0017674089784376105,0.23312124425592082,0.7668787557440792,0.10268646164722517
1895,,94,2618,2712,0,105,3583,1025,2558,3583,312,0.026234998604521352,0.7306726207089032,0.0,0.28607312308121685,0.7139268769187831,0.02930505163271002
1896,23.0,78,4215,4293,9,176,5649,1629,4020,5649,481,0.013807753584705257,0.7461497610196495,0.0015932023366967605,0.28836962294211366,0.7116303770578863,0.031155956806514427
1897,17.0,88,9706,9794,8,719,13465,3733,9732,13465,1305,0.006535462309691794,0.7208317861121426,0.0005941329372447085,0.2772372818418121,0.7227627181581879,0.053397697734868174
1898,,492,17219,17711,6,732,22761,6749,16012,22761,1611,0.021615921971793857,0.7565133342120294,0.00026360880453407144,0.2965159703000747,0.7034840296999253,0.03216027415315671
1899,34.0,98,1966,2064,28,83,2820,767,2053,2820,165,0.03475177304964539,0.6971631205673758,0.009929078014184398,0.27198581560283686,0.7280141843971631,0.029432624113475178
1900,,1267,29454,30721,147,1371,41961,11602,30359,41961,3010,0.030194704606658563,0.701937513405305,0.0035032530206620433,0.27649484044708184,0.7235051595529182,0.032673196539643956
1901,26.0,1414,39119,40533,383,2718,53876,14700,39188,53888,2920,0.026239608076009502,0.7259315617577197,0.007107333729216152,0.27278800475059384,0.7272119952494062,0.05043794536817102
1902,25.0,530,18175,18705,238,1195,25897,7096,18801,25897,2110,0.02046569100668031,0.7018187434838012,0.00919025369733946,0.274008572421516,0.725991427578484,0.046144341043364095
1903,16.0,146,3029,3175,18,196,4163,1207,2956,4163,290,0.03507086235887581,0.7276002882536632,0.004323804948354552,0.28993514292577466,0.7100648570742253,0.04708143165986068
1904,14.0,296,2440,2736,14,276,4160,1027,3133,4160,233,0.07115384615384615,0.5865384615384616,0.0033653846153846156,0.246875,0.753125,0.06634615384615385
1905,25.0,1942,29097,40328,636,2150,65183,11762,53421,65183,2640,0.02979304419864075,0.44638939600816163,0.00975714526793796,0.1804458217633432,0.8195541782366568,0.032984060261111024
1906,,1124,34168,35292,97,1291,47241,13582,33659,47241,3623,0.023792891767744122,0.7232700408543427,0.0020533011578925085,0.28750449821129953,0.7124955017887005,0.027327956647827098
1907,15.0,836,2600,3436,14,561,5035,1320,3715,5035,273,0.1660377358490566,0.5163853028798411,0.0027805362462760674,0.26216484607745777,0.7378351539225422,0.11142005958291956
1908,,290,9991,10281,12,484,13623,3891,9732,13623,1070,0.02128752844454232,0.733392057549732,0.0008808632459810614,0.28561990750935917,0.7143800924906408,0.035528150921236144
1909,,312,7533,7845,16,419,10498,2996,7502,10498,767,0.029719946656506,0.7175652505239093,0.0015240998285387694,0.28538769289388455,0.7146123071061155,0.03991236425985902
1910,,614,23700,26590,241,852,33973,9259,24751,34010,2046,0.01805351367244928,0.69685386650985,0.0070861511320199945,0.2722434578065275,0.7277565421934725,0.025051455454278154
1911,25.0,68,2493,2561,0,93,3528,980,2548,3528,285,0.01927437641723356,0.7066326530612245,0.0,0.2777777777777778,0.7222222222222222,0.026360544217687076
1912,26.0,232,5172,5404,31,335,7508,2037,5471,7508,463,0.03090037293553543,0.688865210442195,0.004128929142248269,0.2713106020245072,0.7286893979754928,0.04461907298881193
1913,17.0,808,14593,15401,175,816,20741,5786,14955,20741,1418,0.03895665589894412,0.7035822766501133,0.008437394532568343,0.27896437008823105,0.721035629911769,0.039342365363290104
1914,14.0,337,45384,45721,297,1554,59931,17210,42721,59931,5836,0.005623133269927083,0.7572708614907143,0.004955699053911999,0.2871635714404899,0.7128364285595101,0.025929819292186015
1915,45.0,3521,97098,100619,426,3940,130044,38685,91359,130044,9039,0.027075451385684846,0.7466549783150318,0.0032758143397619266,0.29747623881147917,0.7025237611885208,0.030297437790286364
1916,16.0,51,6247,6298,36,798,8765,2340,6425,8765,454,0.005818596691386195,0.7127210496292071,0.0041072447233314316,0.2669709070165431,0.733029092983457,0.09104392470051341
1917,,301,14328,14629,26,805,19756,5441,14315,19756,1506,0.015235877708038064,0.7252480259161773,0.0013160558817574407,0.27541000202470134,0.7245899979752987,0.04074711480056692
1918,,1910,39143,41053,44,1988,54302,15647,38655,54302,4290,0.035173658428787155,0.7208390114544584,0.0008102832308202276,0.2881477661964569,0.7118522338035431,0.03661006961069574
1919,16.0,172,6152,6324,12,186,8180,2425,5755,8180,645,0.021026894865525673,0.7520782396088019,0.001466992665036675,0.29645476772616136,0.7035452322738386,0.02273838630806846
1920,24.0,190,2782,2972,26,92,4255,1078,3177,4255,214,0.04465334900117509,0.6538190364277321,0.006110458284371328,0.25334900117508813,0.7466509988249118,0.021621621621621623
1921,45.0,127,3318,3445,12,279,4586,1270,3316,4586,314,0.027692978630614914,0.7235063235935456,0.0026166593981683385,0.2769297863061492,0.7230702136938508,0.06083733100741387
1922,,274,11375,11649,29,567,15050,4351,10699,15050,1141,0.018205980066445183,0.7558139534883721,0.0019269102990033223,0.2891029900332226,0.7108970099667774,0.037674418604651164
1923,,1678,35164,36842,311,1887,50104,14103,36001,50104,3528,0.033490340092607374,0.7018202139549736,0.00620708925435095,0.28147453297141944,0.7185254670285806,0.037661663739422
1924,48.0,183,6376,6559,35,375,8497,2483,6014,8497,528,0.021537013063434154,0.7503824879369189,0.00411910085912675,0.2922207838060492,0.7077792161939508,0.044133223490643754
1925,42.0,51,1590,1641,0,82,2187,607,1580,2187,160,0.023319615912208505,0.7270233196159122,0.0,0.27754915409236397,0.7224508459076361,0.037494284407864654
1926,33.0,326,7792,8118,37,395,10862,3111,7751,10862,835,0.030012888970723624,0.717363284846253,0.003406370834100534,0.2864113422942368,0.7135886577057632,0.03636531025593813
1927,16.0,9,8864,8873,91,1264,12477,3266,9211,12477,616,0.000721327242125511,0.7104271860222809,0.0072934198926023885,0.2617616414202132,0.7382383585797868,0.10130640378296064
1928,24.0,2968,64406,67374,791,4105,91365,25693,65672,91365,6189,0.03248508728725442,0.7049307721775296,0.008657582225140919,0.28121271821813604,0.7187872817818639,0.04492967766650249
1929,,416,4264,4680,36,260,6251,1772,4479,6251,413,0.06654935210366342,0.68213085906255,0.005759078547432411,0.2834746440569509,0.7165253559430491,0.041593345064789636
1930,,97,5615,5712,21,497,7648,2048,5600,7648,555,0.01268305439330544,0.734178870292887,0.0027458158995815897,0.26778242677824265,0.7322175732217573,0.06498430962343096
1931,27.0,194,4751,4945,1,231,6296,2086,4210,6296,388,0.030813214739517154,0.7546060991105463,0.0001588310038119441,0.33132147395171535,0.6686785260482846,0.036689961880559084
1932,,210,6160,6370,43,363,8448,2427,6021,8448,572,0.024857954545454544,0.7291666666666666,0.005089962121212121,0.2872869318181818,0.7127130681818182,0.04296875
1933,,198,9931,10129,35,409,13743,3838,9905,13743,1172,0.014407334643091027,0.7226224259623081,0.0025467510732736665,0.2792694462635524,0.7207305537364477,0.029760605399112277
1934,38.0,29726,532654,562380,2528,29012,749044,212746,536298,749044,50944,0.03968525213472106,0.7111117637949173,0.0033749686266761367,0.2840233684536556,0.7159766315463444,0.038732037103294335
1935,24.0,127,3342,3469,2,160,4647,1341,3306,4647,349,0.02732945986658059,0.7191736604260813,0.00043038519474930065,0.28857327307940606,0.7114267269205939,0.03443081557994405
1936,23.0,3011,75370,78381,547,6252,108737,30187,78550,108737,7352,0.02769066647047463,0.6931403294186891,0.005030486402972309,0.27761479533185573,0.7223852046681443,0.057496528320626836
1937,15.0,180,4660,4840,5,243,6524,1842,4682,6524,484,0.027590435315757205,0.7142857142857143,0.0007664009809932557,0.28234212139791537,0.7176578786020846,0.037247087676272224
1938,14.0,2480,28092,30572,285,1784,41698,11639,30059,41698,2661,0.059475274593505684,0.6737013765648232,0.006834860185140774,0.2791260971749245,0.7208739028250756,0.042783826562425055
1939,,107,2151,2258,1,113,2973,823,2150,2973,231,0.035990581903800875,0.7235116044399597,0.0003363605785401951,0.27682475613858054,0.7231752438614194,0.03800874537504204
1940,17.0,1651,30314,31965,554,2650,46359,12269,34090,46359,2640,0.035613365258094436,0.6538967622252422,0.011950214629306068,0.26465195539161757,0.7353480446083824,0.057162579002998336
1941,23.0,0,6562,6562,72,269,8837,2523,6314,8837,848,0.0,0.7425596922032364,0.00814756138961186,0.2855041303609822,0.7144958696390178,0.03044019463618875
1942,14.0,81,1722,1803,12,74,2395,694,1701,2395,188,0.03382045929018789,0.7189979123173278,0.005010438413361169,0.2897703549060543,0.7102296450939457,0.030897703549060542
1943,14.0,122,1697,1819,19,115,2515,697,1818,2515,179,0.04850894632206759,0.6747514910536779,0.0075546719681908545,0.27713717693836976,0.7228628230616302,0.04572564612326044
1944,15.0,243,6308,6551,42,572,8982,2460,6522,8982,691,0.027054108216432865,0.70229347584057,0.004676018704074816,0.2738810955243821,0.7261189044756179,0.06368292139835226
1945,15.0,703,5555,6258,54,648,8585,2360,6225,8585,399,0.08188701223063483,0.6470588235294118,0.006290040768782761,0.2748980780430984,0.7251019219569016,0.07548048922539313
1946,15.0,309,3143,3452,8,304,4739,1298,3441,4739,275,0.0652036294576915,0.6632200886262924,0.0016881198565098122,0.273897446718717,0.7261025532812829,0.06414855454737287
1947,25.0,501,7611,8112,36,899,11572,2967,8605,11572,639,0.04329415831316972,0.6577082613204286,0.0031109574835810577,0.25639474593847217,0.7436052540615278,0.07768752160387142
1948,16.0,52,1828,1880,15,43,2436,746,1690,2436,231,0.021346469622331693,0.7504105090311987,0.006157635467980296,0.30623973727422005,0.69376026272578,0.017651888341543513
1949,,1926,40572,42498,247,2714,58766,15680,43086,58766,4306,0.03277405302385733,0.6903992104277984,0.00420311064220808,0.2668209508899704,0.7331790491100296,0.046183167137460436
1950,16.0,45,3427,3472,10,248,4787,1327,3460,4787,428,0.009400459578023814,0.7158972216419469,0.0020889910173386254,0.2772091080008356,0.7227908919991644,0.051806977229997914
1951,25.0,1126,19130,20256,96,1523,27979,7636,20343,27979,1922,0.04024446906608528,0.6837270810250545,0.0034311447871618,0.27291897494549483,0.7270810250545051,0.054433682404660635
1952,23.0,717,56661,57378,436,3010,79568,21471,58097,79568,5632,0.00901116026543334,0.7121078825658557,0.005479589784838126,0.26984466117031974,0.7301553388296803,0.03782927810174945
1953,27.0,18,1904,1922,0,75,2493,732,1761,2493,191,0.007220216606498195,0.7637384677095869,0.0,0.29362214199759323,0.7063778580024067,0.030084235860409144
1954,24.0,3301,45561,49837,349,1585,64862,17058,48004,65062,3622,0.05073622083551074,0.7002705112046971,0.005364114229504165,0.2621806891887738,0.7378193108112262,0.02436137837754757
1955,24.0,107,3099,3206,16,123,4444,1228,3216,4444,323,0.024077407740774076,0.6973447344734474,0.0036003600360036,0.2763276327632763,0.7236723672367237,0.02767776777677768
1956,17.0,109,1757,1885,15,93,2577,729,1848,2577,174,0.042297244858362434,0.6818005432673652,0.005820721769499418,0.2828870779976717,0.7171129220023282,0.03608847497089639
1957,23.0,161,4105,4266,1,199,5659,1622,4037,5659,452,0.028450256229015727,0.7253931790068917,0.00017670966601873123,0.28662307828238204,0.7133769217176179,0.03516522353772751
1958,15.0,178,3013,3191,24,165,4225,1176,3049,4225,280,0.0421301775147929,0.7131360946745562,0.005680473372781065,0.2783431952662722,0.7216568047337278,0.03905325443786982
1959,23.0,1686,38974,40660,148,2155,55466,15268,40198,55466,4107,0.030396999963941875,0.7026646954891285,0.002668301301698338,0.2752677315833123,0.7247322684166877,0.038852630440269716
1960,15.0,713,17489,18202,82,827,23812,7023,16789,23812,1743,0.029942885939862253,0.7344616159919368,0.0034436418612464304,0.2949353267260205,0.7050646732739795,0.03473038803964388
1961,13.0,453,5725,6178,43,94,8679,2332,6347,8679,664,0.05219495333563775,0.6596382071667243,0.004954487844221684,0.26869455006337134,0.7313054499366286,0.010830740868763683
1962,24.0,73,1666,1739,9,73,2303,672,1631,2303,168,0.0316977854971776,0.723404255319149,0.0039079461571862786,0.2917933130699088,0.7082066869300911,0.0316977854971776
1963,,70,2538,2608,6,65,3527,1008,2519,3527,329,0.019846895378508648,0.7195917210093564,0.001701162461015027,0.2857952934505245,0.7142047065494754,0.01842925999432946
1964,27.0,930,22176,23106,18,709,30122,8790,21332,30122,2410,0.03087444392802603,0.7362060952128012,0.0005975698824779231,0.29181329261005245,0.7081867073899476,0.023537613704269305
1965,23.0,2759,68297,71056,377,3117,92619,27082,65537,92619,6056,0.029788704261544608,0.737397294291668,0.00407043911076561,0.2924022068905948,0.7075977931094052,0.03365400187866421
1966,17.0,96,3580,3676,26,346,5145,1380,3765,5145,413,0.018658892128279883,0.6958211856171039,0.005053449951409135,0.26822157434402333,0.7317784256559767,0.06724975704567542
1967,,169,3505,3674,18,181,5005,1402,3603,5005,389,0.033766233766233764,0.7002997002997003,0.0035964035964035964,0.2801198801198801,0.7198801198801199,0.036163836163836165
1968,,313,7929,8242,65,407,11191,3165,8026,11191,927,0.02796890358323653,0.7085157716021804,0.005808238763291931,0.2828165490125994,0.7171834509874006,0.03636851041015102
1969,23.0,1169,10494,11663,216,1913,16376,4096,12280,16376,409,0.07138495359062041,0.6408158280410357,0.013190034196384953,0.2501221299462628,0.7498778700537372,0.11681729360039081
1970,27.0,144,3421,3565,30,277,5233,1291,3942,5233,334,0.0275176762851137,0.6537359067456526,0.005732849226065355,0.24670361169501243,0.7532963883049876,0.052933307854003436
1971,26.0,1832,33570,35402,74,1549,47301,13546,33763,47309,3612,0.03872413282884863,0.7095901414107252,0.001564184404658733,0.2863302965609081,0.713669703439092,0.03274218436238348
1972,24.0,2913,66379,69292,189,3510,93599,26234,67365,93599,6807,0.031122127373155697,0.7091849271893931,0.002019252342439556,0.28028077223047254,0.7197192277695275,0.03750040064530604
1973,17.0,345,4827,5172,36,517,7202,1966,5236,7202,437,0.04790336017772841,0.6702304915301305,0.004998611496806442,0.27297972785337404,0.7270202721466259,0.07178561510691475
1974,17.0,679,5574,6253,3,563,8463,2408,6055,8463,478,0.08023159636062861,0.6586316908897554,0.0003544842254519674,0.28453267162944584,0.7154673283705542,0.06652487297648588
1975,17.0,989,21054,22043,311,1475,29885,8299,21586,29885,1981,0.033093525179856115,0.7045005855780492,0.010406558474150911,0.2776978417266187,0.7223021582733813,0.04935586414589259
1976,23.0,692,17889,18581,123,793,24827,7061,17766,24827,1955,0.027872880331896725,0.720546179562573,0.004954283642808233,0.2844081040802352,0.7155918959197648,0.03194103194103194
1977,,344,3769,4113,5,482,5658,1515,4143,5658,347,0.0607988688582538,0.6661364439731354,0.0008837044892188052,0.26776246023329797,0.732237539766702,0.08518911276069283
1978,25.0,217,6901,7118,9,357,9326,2766,6560,9326,693,0.023268282221745658,0.739974265494317,0.0009650439631138752,0.29659017799699766,0.7034098220030024,0.038280077203517046
1979,26.0,1168,27093,28261,129,1177,36527,10927,25600,36527,2648,0.03197634626440715,0.741725299093821,0.003531634133654557,0.29914857502669256,0.7008514249733074,0.032222739343499326
1980,17.0,365,8811,9176,47,478,12126,3520,8606,12126,917,0.030100610258947717,0.7266204849084612,0.003875968992248062,0.29028533729176975,0.7097146627082302,0.039419429325416463
1981,13.0,12,2486,2498,27,320,3631,909,2722,3631,187,0.0033048746901679976,0.6846598733131368,0.007435968052877995,0.25034425778022584,0.7496557422197742,0.08812999173781327
1982,36.0,297,4438,4735,53,434,6844,1774,5070,6844,373,0.043395675043834014,0.6484511981297487,0.0077440093512565755,0.2592051431911163,0.7407948568088837,0.06341320864991233
1983,,485,13882,14367,25,819,19400,5297,14103,19400,1545,0.025,0.7155670103092784,0.001288659793814433,0.27304123711340206,0.7269587628865979,0.04221649484536082
1984,14.0,1256,24917,26173,56,1520,35100,9933,25167,35100,2461,0.035783475783475786,0.7098860398860399,0.0015954415954415955,0.282991452991453,0.717008547008547,0.043304843304843306
1985,40.0,1147,30071,31218,76,1907,41400,11942,29458,41400,2887,0.027705314009661836,0.7263526570048309,0.0018357487922705314,0.28845410628019325,0.7115458937198068,0.04606280193236715
1986,13.0,395,3746,4141,21,405,5800,1605,4195,5800,367,0.06810344827586207,0.6458620689655172,0.003620689655172414,0.2767241379310345,0.7232758620689655,0.06982758620689655
1987,14.0,1000,8219,9219,1,588,12992,3383,9609,12992,913,0.0769704433497537,0.6326200738916257,7.69704433497537e-05,0.26039100985221675,0.7396089901477833,0.04525862068965517
1988,37.0,3429,67827,71256,843,3239,94167,27199,66968,94167,6122,0.03641403039281277,0.7202841759852178,0.008952180700245308,0.2888379156179978,0.7111620843820022,0.034396338420040994
1989,24.0,540,14723,15263,75,542,19942,5914,14028,19942,1646,0.027078527730418214,0.7382910440276803,0.003760906629224752,0.2965600240698024,0.7034399759301976,0.027178818573864207
1990,17.0,1830,35344,37174,305,2433,50460,14118,36342,50460,3546,0.03626634958382877,0.7004359889021007,0.0060443915973047956,0.2797859690844233,0.7202140309155767,0.04821640903686088
1991,17.0,110,2577,2687,0,66,3691,985,2706,3691,242,0.029802221620157138,0.698184773774045,0.0,0.2668653481441344,0.7331346518558656,0.017881332972094283
1992,,550,9671,10221,87,776,14378,3768,10610,14378,952,0.03825288635415218,0.6726248435109194,0.0060509111142022535,0.26206704687717347,0.7379329531228266,0.053971345110585614
1993,25.0,401,13989,14390,5,302,18518,5570,12948,18518,1630,0.02165460632897721,0.7554271519602549,0.0002700075602116859,0.30078842207581813,0.6992115779241819,0.01630845663678583
1994,,258,1913,2171,10,90,2851,812,2039,2851,190,0.09049456331111891,0.6709926341634515,0.00350754121360926,0.2848123465450719,0.7151876534549281,0.03156787092248334
1995,13.0,275,2684,2959,28,439,4159,906,3253,4159,224,0.06612166386150517,0.6453474392882904,0.006732387593171436,0.2178408271219043,0.7821591728780957,0.10555421976436644
1996,24.0,221,6054,6275,9,176,8140,2401,5739,8140,688,0.027149877149877148,0.7437346437346437,0.0011056511056511057,0.29496314496314496,0.705036855036855,0.021621621621621623
1997,24.0,0,2418,2418,1,101,3203,945,2258,3203,340,0.0,0.7549172650640025,0.00031220730565095225,0.2950359038401499,0.7049640961598501,0.031532937870746174
1998,33.0,39,2409,2448,5,135,3215,957,2258,3215,201,0.012130637636080872,0.7493001555209954,0.0015552099533437014,0.29766718506998446,0.7023328149300155,0.041990668740279936
1999,16.0,797,15006,15803,425,746,21591,5852,15739,21591,1610,0.03691352878514196,0.6950118104765874,0.019684127645778333,0.2710388587837525,0.7289611412162476,0.03455143346764856
2000,26.0,1021,7784,8805,172,1232,12619,3191,9428,12619,380,0.08090973928203503,0.6168476107457009,0.013630240114113639,0.2528726523496315,0.7471273476503685,0.09763055709644188
2001,23.0,1319,30712,32031,253,1484,42605,12123,30482,42605,3626,0.030958807651684076,0.7208543598169229,0.005938270156084967,0.2845440675976998,0.7154559324023002,0.034831592536087315
2002,16.0,66,5351,5417,19,430,7599,2006,5593,7599,676,0.008685353335965259,0.7041716015265167,0.0025003289906566652,0.2639821029082774,0.7360178970917226,0.05658639294644032
2003,26.0,3747,63758,67505,558,3533,90590,25364,65226,90590,6616,0.041362181256209295,0.7038083673694668,0.006159620267137653,0.27998675350480184,0.7200132464951982,0.038999889612540015
2004,26.0,14524,274272,288796,1918,15406,397230,110768,286462,397230,29818,0.03656320016111573,0.6904614455101579,0.004828436925710546,0.2788510434760718,0.7211489565239282,0.03878357626563955
2005,15.0,8,1788,1796,21,160,2504,651,1853,2504,209,0.003194888178913738,0.7140575079872205,0.008386581469648562,0.25998402555910544,0.7400159744408946,0.06389776357827476
2006,15.0,248,2009,2257,8,286,3167,827,2340,3167,167,0.07830754657404483,0.6343542784970003,0.0025260498894853173,0.26113040732554466,0.7388695926744553,0.0903062835491001
2007,,537,7756,8293,32,597,11238,3167,8071,11238,810,0.04778430325680726,0.6901583911728065,0.0028474817583199856,0.2818117102687311,0.7181882897312689,0.053123331553657234
2008,23.0,543,10203,10746,16,707,14601,4172,10429,14601,954,0.037189233614136015,0.6987877542634067,0.0010958153551126634,0.285733853845627,0.714266146154373,0.048421341004040816
2009,26.0,1323,50201,51524,131,2577,69317,19718,49599,69317,6464,0.01908622704387091,0.7242234949579468,0.001889868286278979,0.2844612432736558,0.7155387567263441,0.03717702728046511
2010,25.0,159,4246,4405,40,352,6367,1679,4688,6367,425,0.024972514528035183,0.6668760797863986,0.006282393591958536,0.26370347102245956,0.7362965289775404,0.055285063609235116
2011,,79,1787,1866,25,87,2646,716,1930,2646,181,0.02985638699924414,0.6753590325018897,0.00944822373393802,0.2705971277399849,0.7294028722600151,0.032879818594104306
2012,16.0,17,1476,1493,0,115,2058,580,1478,2058,182,0.00826044703595724,0.717201166180758,0.0,0.2818270165208941,0.718172983479106,0.05587949465500486
2013,33.0,147,3764,3911,37,160,5266,1506,3760,5266,443,0.027914925939992404,0.7147740220281048,0.007026205848841625,0.28598556779339157,0.7140144322066084,0.030383592859855677
2014,,85,1580,1665,9,98,2270,633,1637,2270,178,0.037444933920704845,0.6960352422907489,0.003964757709251102,0.2788546255506608,0.7211453744493392,0.04317180616740088
2015,27.0,71,1598,1669,4,59,2411,663,1748,2411,146,0.029448361675653255,0.6627955205309001,0.0016590626296142678,0.2749896308585649,0.7250103691414351,0.024471173786810452
2016,25.0,583,17031,17614,64,643,23158,6565,16593,23158,1674,0.02517488556870196,0.7354262026081699,0.0027636238017099924,0.2834873477847828,0.7165126522152172,0.02776578288280508
2017,37.0,133,3213,3346,3,167,4367,1301,3066,4367,322,0.030455690405312572,0.7357453629493932,0.0006869704602702084,0.297916189603847,0.702083810396153,0.038241355621708266
2018,,805,20763,21568,65,1262,28006,8151,19855,28006,1569,0.028743840605584516,0.7413768478183247,0.0023209312290223523,0.291044776119403,0.7089552238805971,0.04506177247732629
2019,,884,19177,20061,106,901,27804,7477,20327,27804,1968,0.031793986476765936,0.689720903467127,0.0038124010933678607,0.26891814127463676,0.7310818587253632,0.03240540929362681
2020,17.0,15,2255,2270,51,260,3319,861,2458,3319,148,0.004519433564326604,0.6794215125037661,0.015366074118710455,0.2594154865923471,0.7405845134076529,0.0783368484483278
2021,,113,4160,4273,15,178,5553,1580,3973,5553,429,0.020349360705924725,0.7491446065189987,0.002701242571582928,0.2845308842067351,0.7154691157932649,0.03205474518278408
2022,16.0,118,2026,2144,5,218,3015,760,2255,3015,125,0.03913764510779436,0.6719734660033168,0.001658374792703151,0.25207296849087896,0.7479270315091211,0.07230514096185738
2023,,10,8828,8838,25,391,11716,3292,8424,11716,1043,0.0008535336292249915,0.7534994878798225,0.0021338340730624786,0.2809832707408672,0.7190167292591328,0.033373164902697164
2024,17.0,214,2958,3172,17,206,4249,1223,3026,4249,298,0.05036479171569781,0.696163803247823,0.004000941397975994,0.287832431160273,0.712167568839727,0.04848199576370911
2025,,531,6784,7315,11,313,9668,2736,6932,9668,695,0.054923458833264376,0.701696317749276,0.0011377741001241208,0.2829954489035995,0.7170045510964005,0.032374844848986346
2026,24.0,610,12071,12681,26,652,17158,4821,12337,17158,1167,0.03555192912926915,0.7035202238023079,0.0015153281268213078,0.28097680382328943,0.7190231961767106,0.037999766872595875
2027,33.0,646,15430,16076,38,878,21100,6157,14943,21100,1559,0.03061611374407583,0.7312796208530805,0.0018009478672985782,0.2918009478672986,0.7081990521327014,0.04161137440758294
2028,,27,2941,2968,23,65,4019,1141,2878,4019,365,0.006718089076884797,0.7317740731525255,0.005722816621050012,0.2839014680268724,0.7160985319731277,0.01617317740731525
2029,37.0,281,7542,7823,27,400,10534,2947,7587,10534,930,0.026675526865388266,0.7159673438389975,0.002563128915891399,0.2797607746345168,0.7202392253654832,0.03797228023542814
2030,17.0,6065,105251,111316,775,8732,157366,41317,116049,157366,9292,0.038540726713521344,0.6688293532275078,0.0049248249304169895,0.26255353761295325,0.7374464623870468,0.05548847908696923
2031,27.0,240,5087,5327,64,246,7151,1990,5161,7151,504,0.033561739616836804,0.7113690392952035,0.008949797231156482,0.27828275765627186,0.7217172423437281,0.03440078310725773
2032,,143,2365,2508,49,102,3415,916,2499,3415,217,0.04187408491947291,0.6925329428989752,0.014348462664714495,0.2682284040995608,0.7317715959004393,0.02986822840409956
2033,13.0,415,10265,10680,70,620,14747,4113,10634,14747,1159,0.028141316878009085,0.6960737777175019,0.004746728148097918,0.27890418390181054,0.7210958160981895,0.04204244931172442
2034,17.0,823,11388,12211,100,628,16329,4733,11596,16329,1290,0.05040112682956703,0.6974095168105824,0.006124073733847756,0.28985240982301425,0.7101475901769857,0.038459183048563904
2035,,95,3839,3934,7,115,5183,1476,3707,5183,458,0.018329153000192937,0.7406907196604283,0.0013505691684352692,0.28477715608720816,0.7152228439127918,0.022187922052865135
2036,,194,3293,3487,23,212,4902,1322,3580,4902,328,0.039575683394532844,0.6717666258669931,0.004691962464300286,0.2696858425132599,0.7303141574867401,0.04324765401876785
2037,16.0,36,1898,1934,4,79,2635,759,1876,2635,197,0.01366223908918406,0.720303605313093,0.0015180265654648956,0.28804554079696393,0.711954459203036,0.029981024667931688
2038,,797,7302,8099,43,1225,11641,3146,8495,11641,405,0.06846490851301434,0.6272656988231251,0.003693840735332016,0.27025169658964004,0.7297483034103599,0.10523150932050511
2039,,1651,44319,45970,98,2043,61895,17202,44693,61895,4739,0.026674206317150014,0.7160352209386864,0.0015833266015025447,0.27792228774537525,0.7220777122546248,0.03300751272316019
2040,,320,13430,13750,40,1322,18726,5296,13430,18726,1507,0.017088539997863934,0.7171846630353519,0.0021360674997329917,0.28281533696464806,0.7171846630353519,0.07059703086617537
2041,25.0,564,9520,10084,78,775,14054,3872,10182,14054,931,0.04013092358047531,0.6773872207200797,0.005550021346235947,0.2755087519567383,0.7244912480432617,0.05514444286324178
2042,,150,6525,6675,6,242,8609,2583,6026,8609,670,0.017423626437449182,0.7579277500290393,0.0006969450574979672,0.3000348472528749,0.6999651527471251,0.02811011731908468
2043,15.0,115,1366,1481,4,139,2107,583,1524,2107,140,0.054579971523493115,0.6483151400094922,0.0018984337921214998,0.27669672520170857,0.7233032747982914,0.06597057427622212
2044,,1283,29237,30520,209,1604,41835,11532,30303,41835,2924,0.0306681008724752,0.6988645870682443,0.0049958168997251105,0.2756543564001434,0.7243456435998565,0.038341101948129556
2045,15.0,889,8415,9304,33,680,12849,3501,9348,12849,864,0.06918826367810725,0.6549147793602615,0.0025682932523931824,0.2724725659584403,0.7275274340415596,0.05292240641295042
2046,16.0,14,3772,3786,54,517,5422,1458,3964,5422,363,0.0025820730357801547,0.6956842493544817,0.009959424566580598,0.26890446329767614,0.7310955367023239,0.09535226853559572
2047,27.0,391,9317,9708,51,520,13011,3635,9376,13011,1013,0.030051494888940128,0.7160863884405503,0.003919760202905234,0.2793789870109907,0.7206210129890093,0.039966182460994544
2048,15.0,518,8562,9080,41,1493,12727,2888,9839,12727,715,0.04070087216154632,0.6727429873497289,0.0032214976035200753,0.22691914826746287,0.7730808517325372,0.11730965663549933
2049,15.0,3202,34643,37845,98,2821,51527,14276,37251,51527,3268,0.06214217788732121,0.6723271294661052,0.00190191550061133,0.2770586294564015,0.7229413705435985,0.054747996196169
2050,,116,7109,7225,24,195,9327,2794,6533,9327,876,0.01243701082877667,0.7621957757049427,0.002573174654229656,0.2995604159965691,0.7004395840034309,0.020907044065615953
2051,27.0,114,2618,2732,5,109,3602,1061,2541,3602,307,0.03164908384230983,0.7268184342032205,0.00138811771238201,0.29455857856746254,0.7054414214325375,0.03026096612992782
2052,15.0,69,3528,3597,8,240,4762,1346,3416,4762,340,0.014489710205795885,0.740865182696346,0.0016799664006719867,0.28265434691306174,0.7173456530869382,0.0503989920201596
2053,26.0,171,4505,4676,3,156,6182,1931,4251,6182,296,0.027660951148495632,0.7287285668068586,0.00048527984471044967,0.3123584600452928,0.6876415399547072,0.025234551924943383
2054,,98,3220,3318,18,108,4346,1291,3055,4346,365,0.022549470777726646,0.7409111826967326,0.0041417395306028535,0.2970547630004602,0.7029452369995398,0.024850437183617118
2055,,1080,33403,34483,80,1393,45195,13238,31957,45195,3485,0.023896448722203784,0.7390861820997898,0.001770107312755836,0.2929085075782719,0.7070914924217281,0.03082199358336099
2056,16.0,235,5852,6087,17,407,8400,2344,6056,8400,574,0.027976190476190477,0.6966666666666667,0.0020238095238095236,0.27904761904761904,0.7209523809523809,0.048452380952380955
2057,25.0,673,15157,15830,32,888,21063,6025,15038,21063,1461,0.03195176375635,0.7196030954754783,0.0015192517685040118,0.28604662203864595,0.713953377961354,0.042159236575986324
2058,24.0,423,8152,8575,46,354,11305,3251,8054,11305,791,0.03741707209199469,0.7210968597965502,0.004068996019460416,0.2875718708536046,0.7124281291463954,0.03131357806280407
2059,,589,8079,8668,47,642,11807,3370,8437,11807,808,0.04988566104853053,0.6842551029050563,0.003980689421529601,0.2854239010756331,0.7145760989243669,0.05437452358770221
2060,,391,9127,9518,46,493,13171,3651,9520,13171,1046,0.029686432313415837,0.6929618100372029,0.0034925214486371575,0.2771999088907448,0.7228000911092551,0.03743071900387214
2061,,41,1540,1581,3,44,2112,594,1518,2112,194,0.019412878787878788,0.7291666666666666,0.0014204545454545455,0.28125,0.71875,0.020833333333333332
2062,,25,4713,4738,23,285,6275,1823,4452,6275,473,0.00398406374501992,0.7510756972111554,0.0036653386454183266,0.2905179282868526,0.7094820717131474,0.04541832669322709
2063,17.0,2397,79776,82173,254,4570,111889,31231,80658,111889,8692,0.02142301745479895,0.7129923406232963,0.0022701069810258383,0.27912484694652734,0.7208751530534726,0.040844050800346775
2064,15.0,168,2016,2184,1,236,2982,791,2191,2982,181,0.056338028169014086,0.676056338028169,0.00033534540576794097,0.2652582159624413,0.7347417840375586,0.07914151576123407
2065,17.0,83,2478,2561,16,225,3472,950,2522,3472,210,0.02390552995391705,0.7137096774193549,0.004608294930875576,0.2736175115207373,0.7263824884792627,0.06480414746543779
2066,,1012,60558,61570,115,3546,82582,23466,59116,82582,6629,0.012254486449831683,0.7333075004238212,0.0013925552783899638,0.2841539318495556,0.7158460681504444,0.04293913927974619
2067,,47,1927,1974,0,87,2587,770,1817,2587,194,0.01816776188635485,0.7448782373405489,0.0,0.29764205643602626,0.7023579435639737,0.03362968689601856
2068,,24,2043,2067,16,166,2911,771,2140,2911,217,0.008244589488148402,0.7018206801786327,0.005496392992098935,0.2648574373067674,0.7351425626932325,0.05702507729302645
2069,,19288,317200,336488,2816,18576,466512,127300,339212,466512,31017,0.041345131529306856,0.6799396371368797,0.006036286312034846,0.2728761532393593,0.7271238467606407,0.03981891141063895
2070,15.0,113,2213,2326,12,87,3199,860,2339,3199,215,0.03532353860581432,0.6917786808377618,0.003751172241325414,0.26883401062832135,0.7311659893716786,0.027195998749609252
2071,17.0,264,4290,4554,27,454,6472,1696,4776,6472,381,0.0407911001236094,0.6628553770086527,0.004171817058096415,0.2620519159456119,0.7379480840543882,0.07014833127317677
2072,26.0,6791,129151,135942,1577,5807,177274,50985,126289,177274,12618,0.03830793009691213,0.7285388720286111,0.008895833568374381,0.2876056274467773,0.7123943725532227,0.03275720071753331
2073,24.0,11878,272530,284408,855,16605,386942,106859,280083,386942,26745,0.030697107059972813,0.7043174429242626,0.002209633485121801,0.2761628357738369,0.7238371642261631,0.04291340821104972
2074,26.0,1296,15695,16991,82,1187,22729,6379,16351,22730,1446,0.05701715794104707,0.6904971403431588,0.003607567091948966,0.28064232292124947,0.7193576770787505,0.05222173339199296
2075,,189,2992,3181,29,270,4678,1173,3505,4678,280,0.0404018811457888,0.6395895681915349,0.006199230440359128,0.2507481829841813,0.7492518170158188,0.05771697306541257
2076,,74,1966,2040,6,188,3022,736,2286,3022,189,0.024487094639311716,0.6505625413633356,0.001985440105890139,0.24354731965585705,0.7564526803441429,0.062210456651224356
2077,39.0,1376,41620,42996,135,2287,56324,15654,40670,56324,3830,0.024430083090689583,0.7389389958099567,0.002396846814856899,0.2779277039982956,0.7220722960017044,0.04060436048576095
2078,25.0,115,3025,3140,7,163,4211,1196,3015,4211,326,0.027309427689384946,0.7183566848729518,0.0016623129897886488,0.2840180479696034,0.7159819520303966,0.03870814533364996
2079,14.0,87,4091,4178,47,316,5744,1502,4242,5744,383,0.015146239554317549,0.7122214484679665,0.008182451253481894,0.2614902506963788,0.7385097493036211,0.05501392757660167
2080,,11339,203178,214517,403,11273,289034,82214,206820,289034,23416,0.039230678743677215,0.7029553616529544,0.0013942996325691788,0.2844440446452666,0.7155559553547334,0.03900233190558896
2081,39.0,2148,51584,53733,217,2862,70945,20397,50548,70945,4724,0.030276975121573048,0.7270984565508493,0.003058707449432659,0.2875044048206357,0.7124955951793643,0.0403411093100289
2082,,57,1252,1309,15,120,1874,508,1366,1874,132,0.030416221985058698,0.6680896478121665,0.0080042689434365,0.2710779082177161,0.7289220917822838,0.064034151547492
2083,,318,4864,5182,78,308,7577,1884,5693,7577,378,0.04196911706480137,0.6419427213936915,0.010294311732875809,0.2486472218556157,0.7513527781443843,0.040649333509304476
2084,43.0,1161,30235,31396,173,1942,41187,11803,29384,41187,2556,0.02818850608201617,0.7340908539102143,0.004200354480782771,0.2865710054143298,0.7134289945856702,0.0471508000097118
2085,,1553,27633,29186,259,1611,39784,10920,28864,39784,2718,0.039035793283732155,0.6945757088276694,0.006510154836115021,0.27448220390106576,0.7255177960989343,0.04049366579529459
2086,40.0,4333,111020,115353,498,5916,154194,43936,110259,154195,11445,0.02810078147799864,0.7199974058821622,0.0032296767080644637,0.2849379033042576,0.7150620966957424,0.03836700282110315
2087,,431,10026,10457,75,459,13410,3884,9526,13410,967,0.03214019388516033,0.7476510067114094,0.005592841163310962,0.289634601043997,0.710365398956003,0.03422818791946309
2088,,100,2924,3024,0,86,3917,1173,2744,3917,300,0.02552974214960429,0.7464896604544294,0.0,0.2994638754148583,0.7005361245851417,0.02195557824865969
2089,15.0,103,2273,2376,16,149,3278,883,2395,3278,234,0.03142159853569249,0.6934106162294081,0.004881025015253203,0.26937156802928613,0.7306284319707138,0.045454545454545456
2090,34.0,18607,454552,473159,994,25787,632258,179679,452579,632258,44810,0.02942944177851447,0.7189343590749346,0.0015721430175656141,0.2841862024679798,0.7158137975320201,0.04078556538628218
2091,,493,11463,11956,209,903,16374,4525,11849,16374,1215,0.030108708928789543,0.7000732869182851,0.012764138267985831,0.2763527543666789,0.7236472456333212,0.0551484060095273
2092,,678,15582,16260,58,719,21368,6156,15212,21368,1625,0.03172968925496069,0.7292212654436541,0.0027143391988019468,0.2880943466866342,0.7119056533133657,0.03364844627480344
2093,13.0,30,3460,3490,18,44,4544,1336,3208,4544,499,0.006602112676056338,0.761443661971831,0.003961267605633803,0.29401408450704225,0.7059859154929577,0.009683098591549295
2094,24.0,4414,106715,111129,380,8353,149733,41600,108133,149733,10419,0.029479139535039035,0.7127019427915022,0.002537850707592849,0.27782786693648026,0.7221721330635197,0.05578596568558701
2095,16.0,1356,30032,31388,233,1180,41398,11850,29548,41398,2593,0.03275520556548626,0.7254456737040437,0.005628291221798154,0.2862457123532538,0.7137542876467462,0.028503792453741728
2096,43.0,66,1739,1805,2,76,2369,702,1667,2369,207,0.027859856479527226,0.7340650063317856,0.0008442380751371887,0.2963275643731532,0.7036724356268468,0.03208104685521317
2097,27.0,1240,21085,22325,108,1155,30015,8330,21685,30015,2323,0.041312676994835915,0.7024820922871897,0.003598200899550225,0.277527902715309,0.722472097284691,0.0384807596201899
2098,16.0,1258,23831,25089,55,1452,33799,9337,24462,33799,2144,0.037220036095742474,0.7050800319536081,0.00162726707890766,0.27625077665019676,0.7237492233498033,0.042959850883162225
2099,24.0,600,21828,22428,88,2406,30808,8476,22332,30808,2458,0.019475460919241756,0.7085172682420151,0.002856400934822124,0.2751233445858219,0.7248766554141781,0.07809659828615943
2100,23.0,127,2949,3076,22,172,4124,1166,2958,4124,297,0.030795344325897187,0.715082444228904,0.00533462657613967,0.2827352085354025,0.7172647914645974,0.041707080504364696
2101,23.0,472,53159,53631,207,2264,69775,20609,49166,69775,5361,0.006764600501612325,0.7618631314940881,0.00296667860981727,0.2953636689358653,0.7046363310641347,0.032447151558581154
2102,46.0,2693,20150,22843,1226,1780,30454,8519,21935,30454,898,0.08842844946476654,0.6616536415577593,0.040257437446640836,0.2797333683588363,0.7202666316411637,0.05844880803835292
2103,17.0,1077,15180,16257,97,559,21799,6180,15619,21799,1233,0.049405936052112485,0.6963622184503876,0.004449745401165191,0.28349924308454516,0.7165007569154548,0.025643378136611772
2104,,1088,27098,28186,389,1688,36481,10879,25602,36481,1104,0.029823743866670322,0.7427976206792577,0.010663084893506208,0.298210027137414,0.701789972862586,0.04627066144020175
2105,,152,4307,4459,15,194,5924,1714,4210,5924,374,0.025658338960162053,0.7270425388251182,0.0025320729237002025,0.28933153274814316,0.7106684672518568,0.03274814314652262
2106,23.0,810,21210,22044,71,1231,29918,8209,21709,29918,2037,0.0270740022728792,0.7089377632194666,0.0023731532856474365,0.2743833143926733,0.7256166856073267,0.04114579851594358
2107,25.0,243,3183,3426,88,180,5035,1274,3761,5035,223,0.048262164846077454,0.6321747765640516,0.01747765640516385,0.25302879841112214,0.7469712015888779,0.03574975173783516
2108,34.0,407,6784,7191,44,336,9579,2699,6880,9579,709,0.04248877753418937,0.7082158889236873,0.0045933813550475,0.2817621881198455,0.7182378118801545,0.035076730347635456
2109,16.0,569,16553,17122,217,437,23452,6490,16962,23452,1679,0.024262323042810847,0.7058246631417363,0.009252942179771448,0.2767354596622889,0.723264540337711,0.018633805219171073
2110,15.0,1224,33794,35018,47,1574,45281,13065,32216,45281,3181,0.02703120514122921,0.7463174399858661,0.0010379629425145203,0.28853161370111086,0.7114683862988892,0.034760716415273514
2111,,567,11880,12447,92,587,16564,4599,11965,16564,1152,0.03423086211060131,0.7172180632697416,0.005554213957981164,0.2776503260082106,0.7223496739917894,0.03543829992755373
2112,17.0,106,7327,7433,0,491,9830,2719,7111,9830,827,0.010783316378433367,0.7453713123092574,0.0,0.2766022380467955,0.7233977619532045,0.04994913530010173
2113,,550,7597,8147,18,430,11646,3063,8583,11646,851,0.047226515541816935,0.6523269792203331,0.0015455950540958269,0.2630087583719732,0.7369912416280268,0.03692254851451142
2114,14.0,123,1413,1536,19,134,2160,576,1584,2160,138,0.05694444444444444,0.6541666666666667,0.008796296296296297,0.26666666666666666,0.7333333333333333,0.062037037037037036
2115,,73,2797,2870,9,151,3732,1115,2617,3732,282,0.019560557341907824,0.7494640943193998,0.002411575562700965,0.2987674169346195,0.7012325830653805,0.04046087888531619
2116,40.0,49,2130,2179,10,143,2823,758,2065,2823,208,0.017357421183138506,0.7545164718384697,0.003542330853701736,0.2685086787105916,0.7314913212894084,0.05065533120793482
2117,33.0,3619,72088,75707,239,4672,99578,28730,70848,99578,6747,0.036343369017252804,0.7239350057241559,0.002400128542449135,0.2885175440358312,0.7114824559641688,0.046917993934403185
2118,14.0,292,5173,5465,25,119,7196,2111,5085,7196,590,0.0405780989438577,0.7188715953307393,0.0034741523068371315,0.2933574207893274,0.7066425792106726,0.016536964980544747
2119,17.0,73,1662,1735,1,126,2366,638,1728,2366,146,0.03085376162299239,0.702451394759087,0.00042265426880811494,0.2696534234995773,0.7303465765004227,0.05325443786982249
2120,,280,1242,1522,11,104,2113,605,1508,2113,144,0.13251301467108376,0.587789872219593,0.005205868433506862,0.2863227638428774,0.7136772361571225,0.04921911973497397
2121,24.0,3157,69350,72507,294,3828,97461,27325,70136,97461,7277,0.03239244415715004,0.7115666779532326,0.0030165912518853697,0.28036855767948204,0.7196314423205179,0.039277249361282976
2122,14.0,135,3124,3259,0,112,4181,1230,2951,4181,314,0.03228892609423583,0.7471896675436498,0.0,0.2941879933030376,0.7058120066969624,0.026787849796699355
2123,,214,3961,4175,26,330,5786,1626,4160,5786,420,0.03698582786035257,0.6845834773591427,0.004493605254061528,0.28102315935015554,0.7189768406498445,0.057034220532319393
2124,,72,2452,2524,23,85,3280,948,2332,3280,215,0.02195121951219512,0.7475609756097561,0.00701219512195122,0.2890243902439024,0.7109756097560975,0.025914634146341462
2125,26.0,335,15941,16276,3,810,21373,6066,15307,21373,1610,0.01567398119122257,0.7458475646844149,0.0001403640106676648,0.2838160295700182,0.7161839704299817,0.0378982828802695
2126,,131,3082,3213,11,211,4292,1210,3082,4292,304,0.030521901211556384,0.7180801491146319,0.0025629077353215286,0.28191985088536814,0.7180801491146319,0.04916123019571295
2127,,163,6711,6874,0,253,8963,2621,6342,8963,708,0.018185875264978245,0.7487448398973557,0.0,0.2924244114693741,0.7075755885306259,0.028227156086131876
2128,26.0,686,15598,16284,22,657,21348,6257,15091,21348,1672,0.032134157766535505,0.7306539254262694,0.001030541502716882,0.2930953719317969,0.7069046280682031,0.030775716694772345
2129,,90,1898,1988,6,91,2667,742,1925,2667,203,0.03374578177727784,0.7116610423697037,0.0022497187851518562,0.2782152230971129,0.7217847769028871,0.03412073490813648
2130,25.0,394,3217,3611,211,270,6230,1215,5015,6230,125,0.06324237560192617,0.5163723916532905,0.033868378812199035,0.19502407704654895,0.804975922953451,0.04333868378812199
2131,24.0,2371,38544,40915,201,2325,54903,15454,39449,54903,3839,0.04318525399340655,0.7020381399923501,0.0036610021310310914,0.28147824344753475,0.7185217565524653,0.042347412709688
2132,34.0,3142,66263,69405,590,2594,90828,26443,64385,90828,6728,0.03459285682829084,0.7295437530277007,0.006495794248469635,0.29113269035980094,0.7088673096401991,0.028559475051746157
2133,16.0,342,3348,3690,49,238,5090,1385,3705,5090,376,0.06719056974459725,0.6577603143418468,0.00962671905697446,0.27210216110019647,0.7278978388998035,0.04675834970530452
2134,,383,14307,14690,39,604,19511,5536,13975,19511,1506,0.019629952334580494,0.7332786633181282,0.0019988724309363947,0.2837373789144585,0.7162626210855415,0.03095689610988673
2135,,548,24324,25317,129,2535,35083,9490,25593,35083,2320,0.01562010090357153,0.6933272525154633,0.0036769945557677507,0.27050138243593763,0.7294986175640623,0.07225721859590115
2136,14.0,483,20658,21141,59,1554,28560,8035,20525,28560,2408,0.016911764705882352,0.7233193277310924,0.002065826330532213,0.2813375350140056,0.7186624649859944,0.054411764705882354
2137,16.0,244,6229,6473,37,319,8927,2463,6464,8927,653,0.02733281057466114,0.6977708076621485,0.0041447294723871405,0.27590455920241963,0.7240954407975804,0.03573428923490534
2138,14.0,9,1993,2002,6,393,2843,725,2118,2843,148,0.0031656700668308124,0.7010200492437566,0.002110446711220542,0.2550123109391488,0.7449876890608512,0.13823425958494548
2139,,6023,170668,176691,966,6820,219991,75142,144849,219991,11398,0.027378392752430782,0.7757953734470956,0.004391088726356987,0.3415685187121291,0.6584314812878709,0.03100126823370047
2140,23.0,47,1557,1604,5,47,2079,589,1490,2079,194,0.022607022607022607,0.7489177489177489,0.002405002405002405,0.2833092833092833,0.7166907166907167,0.022607022607022607
2141,24.0,242,6905,7147,44,411,10532,2665,7867,10532,713,0.022977592100265856,0.6556209646790733,0.004177744018230156,0.25303835928598556,0.7469616407140144,0.03902392707937714
2142,17.0,640,50459,51505,335,8135,76167,19129,57042,76171,3734,0.008402147799031128,0.6624437121739245,0.004397999238555356,0.25113232069947883,0.7488676793005212,0.10679917553924723
2143,,129,2589,2718,14,235,3890,1036,2854,3890,242,0.033161953727506424,0.6655526992287918,0.0035989717223650387,0.26632390745501283,0.7336760925449871,0.060411311053984576
2144,13.0,2762,24181,26943,150,2524,38172,9972,28200,38172,2269,0.07235670124698731,0.6334747982814628,0.00392958189248664,0.26123860421251177,0.7387613957874882,0.06612176464424185
2145,15.0,515,2784,3299,2,427,4815,1329,3486,4815,171,0.10695742471443406,0.5781931464174455,0.0004153686396677051,0.27601246105919003,0.7239875389408099,0.08868120456905504
2146,26.0,130,4079,4209,21,146,5535,1549,3986,5535,449,0.023486901535682024,0.7369467028003613,0.003794037940379404,0.2798554652213189,0.7201445347786811,0.026377597109304426
2147,14.0,455,9688,10143,115,713,13923,3680,10243,13923,1017,0.032679738562091505,0.6958270487682252,0.008259714142067083,0.26431085254614667,0.7356891474538534,0.051210227680815915
2148,27.0,403,9717,10120,42,444,13228,3861,9367,13228,976,0.03046567886301784,0.7345781675234352,0.0031750831569398244,0.29188085878439674,0.7081191412156033,0.03356516480193529
2149,16.0,110,3057,3167,21,150,4149,1204,2945,4149,266,0.02651241262954929,0.7368040491684743,0.005061460592913955,0.29019040732706675,0.7098095926729332,0.036153289949385395
2150,23.0,339,9355,9694,45,293,12665,3725,8940,12665,1006,0.026766679826292935,0.7386498223450454,0.0035530990919857876,0.29411764705882354,0.7058823529411765,0.023134622976707462
2151,16.0,193,6598,6791,4,256,8891,2616,6275,8891,712,0.0217073445056799,0.7420987515465077,0.0004498931503767855,0.2942301203464177,0.7057698796535823,0.028793161624114272
2152,24.0,96,2225,2321,0,123,3095,890,2205,3095,216,0.031017770597738286,0.7189014539579968,0.0,0.2875605815831987,0.7124394184168013,0.03974151857835218
2153,38.0,255,8620,8875,34,491,11789,3346,8443,11789,914,0.02163033336160828,0.731190092459072,0.002884044448214437,0.2838239036389855,0.7161760963610145,0.04164899482568496
2154,,285,6350,6635,15,486,8846,2346,6500,8846,696,0.032217951616549854,0.7178385711055845,0.0016956816640289396,0.26520461225412617,0.7347953877458738,0.05494008591453765
2155,24.0,1047,32049,33096,8,906,42298,12549,29749,42298,3602,0.02475294340157927,0.75769539930966,0.00018913423802543856,0.2966806941226536,0.7033193058773465,0.021419452456380918
2156,,59,1506,1565,0,115,2085,566,1519,2085,165,0.028297362110311752,0.7223021582733813,0.0,0.27146282973621105,0.728537170263789,0.05515587529976019
2157,26.0,9298,209888,219186,1298,11454,302599,83747,218852,302599,24641,0.030727133929722174,0.6936176259670389,0.004289505252826347,0.27675901110049933,0.7232409888995006,0.037852074858145596
2158,17.0,118,2776,2894,15,102,3778,1123,2655,3778,268,0.03123345685547909,0.7347803070407624,0.003970354685018529,0.2972472207517205,0.7027527792482795,0.026998411858125994
2159,17.0,344,11711,12055,24,740,16071,4531,11540,16071,1253,0.021405015244850972,0.7287038765478191,0.0014933731566175099,0.2819364071930807,0.7180635928069193,0.04604567232903989
2160,,4976,34501,39477,576,2609,54132,15009,39123,54132,4242,0.09192344639030518,0.6373494421044853,0.010640656173797385,0.2772666814453558,0.7227333185546442,0.04819699992610656
2161,,314,7927,8241,7,502,11081,3208,7873,11081,802,0.028336792708239328,0.7153686490388954,0.0006317119393556538,0.28950455735041963,0.7104954426495803,0.045302770508076885
2162,15.0,1829,41158,42987,395,3624,58843,16898,41945,58843,2549,0.031082711622452967,0.6994544805669324,0.006712778070458678,0.2871709464167361,0.712829053583264,0.06158761449960063
2163,15.0,761,17334,18095,111,1119,25166,6816,18350,25166,1673,0.030239211634745293,0.6887864579194151,0.004410712866566002,0.27084161169832316,0.7291583883016769,0.04446475403321942
2164,14.0,146,4481,4627,26,166,6044,1782,4262,6044,472,0.024156187954996692,0.7413964262078094,0.004301786896095301,0.2948378557246856,0.7051621442753143,0.02746525479814692
2165,27.0,114,2835,2949,0,33,3962,1125,2837,3962,337,0.028773346794548207,0.715547703180212,0.0,0.2839475012619889,0.7160524987380111,0.008329126703685007
2166,,0,2020,2020,2,107,2667,795,1872,2667,241,0.0,0.7574053243344582,0.0007499062617172854,0.2980877390326209,0.7019122609673791,0.04011998500187477
2167,25.0,85,2102,2187,6,85,2899,827,2072,2899,233,0.029320455329423938,0.7250776129699896,0.002069679199724043,0.28527078302863057,0.7147292169713695,0.029320455329423938
2168,14.0,776,21316,22092,34,1003,28774,8404,20375,28779,2029,0.026964105771569546,0.740678967302547,0.0011814170054553668,0.2920184857013795,0.7079815142986206,0.03485180166093332
2169,37.0,415,9450,9865,33,719,13263,3875,9388,13263,667,0.03129005504033778,0.7125084822438362,0.0024881248586292692,0.29216617658146726,0.7078338234185327,0.054210962828922564
2170,15.0,132,2819,2951,7,206,4095,1122,2973,4095,317,0.03223443223443224,0.6884004884004884,0.0017094017094017094,0.273992673992674,0.726007326007326,0.05030525030525031
2171,17.0,660,10198,10858,38,760,14468,4072,10396,14468,959,0.04561791539950235,0.7048659109759469,0.0026264860381531654,0.2814487144042024,0.7185512855957976,0.05252972076306331
2172,17.0,367,7506,7873,28,477,10731,2990,7741,10731,791,0.034199981362407976,0.6994688286273414,0.002609262883235486,0.2786320007455037,0.7213679992544964,0.04445065697511882
2173,,130,1897,2027,20,107,2840,779,2061,2840,172,0.045774647887323945,0.6679577464788733,0.007042253521126761,0.27429577464788735,0.7257042253521127,0.03767605633802817
2174,25.0,66,1995,2061,11,78,2751,800,1951,2751,257,0.023991275899672846,0.7251908396946565,0.003998545983278807,0.2908033442384587,0.7091966557615412,0.028353326063249727
2175,23.0,190,12063,12253,27,963,16793,4616,12177,16793,1075,0.011314238075388556,0.7183350205442744,0.0016078127791341631,0.2748764366104925,0.7251235633895076,0.05734532245578515
2176,15.0,205,12516,12721,108,704,17489,4753,12736,17489,1344,0.0117216536108411,0.7156498370404254,0.0061753101949797015,0.27177082737720853,0.7282291726227915,0.04025387386357139
2177,16.0,161,11613,11774,42,583,15640,4398,11242,15640,1411,0.010294117647058823,0.7425191815856778,0.0026854219948849105,0.2812020460358056,0.7187979539641943,0.03727621483375959
2178,,215,3437,3652,84,280,5114,1408,3706,5114,369,0.04204145482987876,0.6720766523269457,0.016425498631208447,0.27532264372311305,0.724677356276887,0.05475166210402816
2179,15.0,2160,39071,41231,229,1813,54344,15478,38866,54344,3772,0.039746798174591494,0.718957014573826,0.004213896658324746,0.28481525099366994,0.71518474900633,0.03336154865302517
2180,16.0,1297,33593,34890,102,1574,46063,13037,33026,46063,3755,0.028157089203916377,0.729283806960033,0.0022143585958361374,0.2830254217050561,0.7169745782949439,0.034170592449471376
2181,16.0,123,3598,3721,9,357,5203,1296,3907,5203,365,0.023640207572554296,0.6915241206995963,0.0017297712857966558,0.24908706515471843,0.7509129348452815,0.06861426100326734
2182,,472,17887,18359,81,899,24343,7075,17268,24343,2192,0.019389557573018936,0.734790288789385,0.0033274452614714704,0.2906379657396377,0.7093620342603624,0.03693053444522039
2183,,83,2207,2290,9,113,2963,862,2101,2963,207,0.0280121498481269,0.7448531893351333,0.0030374620317246033,0.29092136348295644,0.7090786365170435,0.03813702328720891
2184,25.0,231,4365,4596,27,423,6317,1727,4590,6317,392,0.03656799113503245,0.6909925597593795,0.00427418078201678,0.2733892670571474,0.7266107329428526,0.06696216558492955
2185,15.0,636,36692,37328,265,2766,51889,14060,37829,51889,4320,0.012256933068665805,0.7071248241438455,0.005107055445277419,0.27096301720981325,0.7290369827901867,0.05330609570429185
2186,23.0,3358,119155,122513,490,9152,169483,47440,122043,169483,13087,0.01981319660378917,0.7030498634081295,0.002891145424614858,0.2799100794769977,0.7200899205230024,0.053999516175663634
2187,37.0,221,7460,7681,28,389,10120,2812,7308,10120,705,0.02183794466403162,0.7371541501976284,0.002766798418972332,0.27786561264822135,0.7221343873517787,0.03843873517786561
2188,14.0,6760,93427,100187,1126,7775,140958,38086,102872,140958,9321,0.04795754763830361,0.6628002667461229,0.007988195065196725,0.27019395848408745,0.7298060415159126,0.05515827409582996
2189,,476,11913,12389,3,631,16540,4856,11684,16540,1312,0.028778718258766628,0.7202539298669891,0.00018137847642079807,0.2935912938331318,0.7064087061668682,0.03814993954050786
2190,14.0,166,7260,7426,20,220,9883,2790,7093,9883,916,0.016796519275523628,0.7345947586765152,0.0020236770211474247,0.28230294445006576,0.7176970555499342,0.022260447232621675
2191,,85,1620,1705,9,161,2435,649,1786,2435,148,0.03490759753593429,0.6652977412731006,0.003696098562628337,0.26652977412731005,0.73347022587269,0.06611909650924025
2192,,216,5655,5871,17,251,7894,2240,5654,7894,583,0.027362553838358245,0.716366860907018,0.002153534329870788,0.2837598175829744,0.7162401824170256,0.03179630098809222
2193,,5023,113909,118932,225,6035,156785,45437,111348,156785,11732,0.03203750358771566,0.7265299614121249,0.001435086264629907,0.2898045093599515,0.7101954906400485,0.03849220269796218
2194,,631,7087,7718,41,867,10890,2953,7937,10890,655,0.05794306703397613,0.6507805325987144,0.0037649219467401286,0.2711662075298439,0.7288337924701561,0.07961432506887052
2195,25.0,109,4270,4379,3,195,5616,1678,3938,5616,411,0.01940883190883191,0.7603276353276354,0.0005341880341880342,0.2987891737891738,0.7012108262108262,0.034722222222222224
2196,,2509,72566,75075,1621,9821,109830,27799,82031,109830,3801,0.022844395884548847,0.6607120094691796,0.014759173267777474,0.2531093508148958,0.7468906491851043,0.08942001274697259
2197,14.0,79,1902,1981,11,75,2740,773,1967,2740,216,0.028832116788321167,0.6941605839416058,0.0040145985401459855,0.2821167883211679,0.7178832116788321,0.02737226277372263
2198,,92,1750,1842,2,16,2410,726,1684,2410,200,0.038174273858921165,0.7261410788381742,0.0008298755186721991,0.3012448132780083,0.6987551867219917,0.006639004149377593
2199,,51,1759,1810,1,79,2384,692,1692,2384,163,0.02139261744966443,0.7378355704697986,0.00041946308724832214,0.2902684563758389,0.709731543624161,0.03313758389261745
2200,,86,3158,3244,20,136,4340,1226,3114,4340,425,0.019815668202764977,0.7276497695852534,0.004608294930875576,0.2824884792626728,0.7175115207373272,0.03133640552995392
2201,24.0,449,17721,18170,91,336,22622,7037,15585,22622,1475,0.019847935637874636,0.7833524887277871,0.004022632835293078,0.3110688710105207,0.6889311289894793,0.014852798161082132
2202,26.0,93,7494,7587,28,332,9969,2901,7068,9969,771,0.009328919650917845,0.7517303641287992,0.00280870699167419,0.2910021065302438,0.7089978934697563,0.033303240044136824
2203,17.0,175,3219,3394,12,176,4561,1303,3258,4561,344,0.03836877877658408,0.7057662793247095,0.00263100197325148,0.28568296426222317,0.7143170357377768,0.03858802894102171
2204,25.0,114,1559,1673,4,93,2411,635,1776,2411,185,0.04728328494400664,0.646619659892161,0.0016590626296142678,0.26337619245126503,0.7366238075487349,0.038573206138531727
2205,38.0,269,7044,7313,68,476,9634,2779,6855,9634,621,0.027921943118123314,0.7311604733236454,0.007058335063317417,0.28845754619057506,0.7115424538094249,0.049408345443221924
2206,27.0,178,4619,4797,12,210,6442,1862,4580,6442,539,0.027631170443961503,0.7170133498913381,0.0018627755355479665,0.2890406705991928,0.7109593294008072,0.032598571872089414
2207,,108,4820,4928,8,162,6521,1868,4653,6521,593,0.01656187701272811,0.7391504370495323,0.0012268057046465265,0.286459132034964,0.713540867965036,0.024842815519092162
2208,23.0,111,3454,3565,5,167,4699,1416,3283,4699,367,0.023622047244094488,0.7350500106405619,0.0010640561821664183,0.3013407107895297,0.6986592892104703,0.03553947648435837
2209,23.0,104,4110,4214,4,144,5453,1611,3842,5453,348,0.01907207041995232,0.7537135521731158,0.0007335411699981661,0.2954337062167614,0.7045662937832385,0.026407482119933982
2210,37.0,236,6499,6735,49,272,8751,2581,6170,8751,653,0.02696834647468861,0.7426579819449206,0.005599360073134499,0.2949377214032682,0.7050622785967318,0.031082162038624156
2211,23.0,38,1660,1698,8,90,2235,630,1605,2235,175,0.017002237136465325,0.7427293064876958,0.0035794183445190158,0.28187919463087246,0.7181208053691275,0.040268456375838924
2212,,32728,430215,462943,7305,32896,627835,175507,452328,627835,39525,0.05212834582334531,0.6852357705448088,0.011635222630149641,0.27954319208072187,0.7204568079192781,0.05239593205221117
2213,23.0,241,7964,8205,0,373,10827,3265,7562,10827,830,0.022259166897570886,0.7355684861919276,0.0,0.3015609125334811,0.6984390874665188,0.03445090976263046
2214,23.0,186,11897,12083,79,838,16069,4530,11539,16069,1051,0.0115750824569046,0.7403696558591076,0.0049162984628788355,0.28190926628912816,0.7180907337108718,0.052150102682183085
2215,26.0,171,4795,4966,11,170,6528,1921,4607,6528,538,0.02619485294117647,0.7345281862745098,0.0016850490196078432,0.2942708333333333,0.7057291666666666,0.026041666666666668
2216,,2286,56240,58526,392,2743,78707,22263,56444,78707,6123,0.029044430609729756,0.7145488965403332,0.004980497287407727,0.2828592120141792,0.7171407879858208,0.03485077566163111
2217,40.0,90,2462,2552,9,55,3386,987,2399,3386,327,0.026580035440047254,0.7271116361488482,0.0026580035440047253,0.29149438865918487,0.7085056113408151,0.016243354991139988
2218,16.0,206,6237,6443,27,286,8635,2454,6181,8635,862,0.02385639837869137,0.7222929936305732,0.0031268094962362478,0.28419224088013895,0.715807759119861,0.033121019108280254
2219,17.0,406,6306,6712,17,379,9294,2629,6666,9295,759,0.043679397525551375,0.6784292630446477,0.001828940290478752,0.2828402366863905,0.7171597633136094,0.040774610005379235
2220,,803,11532,12335,48,719,17514,4672,12842,17514,1298,0.04584903505766815,0.658444672833162,0.0027406646111682084,0.2667580221537056,0.7332419778462944,0.04105287198812379
2221,24.0,3194,46170,49364,203,2736,65897,18762,47135,65897,4336,0.048469581316296646,0.7006388758213575,0.0030805651243607447,0.2847170584396862,0.7152829415603138,0.04151934078941378
2222,16.0,564,6937,7501,146,1288,10918,2902,8016,10918,419,0.05165781278622458,0.635372778897234,0.013372412529767357,0.26579959699578676,0.7342004030042132,0.11797032423520791
2223,15.0,393,4081,4474,64,604,6547,1649,4898,6547,479,0.060027493508477164,0.6233389338628379,0.009775469680769817,0.2518710859935849,0.7481289140064151,0.09225599511226516
2224,17.0,12,4068,4080,6,304,5597,1496,4101,5597,319,0.0021440057173485795,0.7268179381811685,0.0010720028586742897,0.26728604609612294,0.7327139539038771,0.05431481150616402
2225,,535,12091,12626,233,2417,18193,4672,13521,18193,609,0.02940691474743033,0.6645962732919255,0.01280712361897433,0.25680206672896166,0.7431979332710383,0.13285329522343758
2226,,292,5433,5725,83,284,7735,2130,5605,7735,463,0.037750484809308336,0.7023917259211376,0.010730446024563672,0.27537168713639304,0.724628312863607,0.03671622495151907
2227,,1876,35758,37634,220,2537,50201,14409,35792,50201,3753,0.03736977351048784,0.7122965677974542,0.004382382821059342,0.28702615485747296,0.712973845142527,0.05053684189557977
2228,16.0,58,1948,2006,7,52,2679,758,1921,2679,250,0.021649869354236656,0.727136991414707,0.0026129152668906306,0.28294139604329976,0.7170586039567003,0.01941022769690183
2229,,6382,123934,130316,1966,4805,169166,49833,119333,169166,8608,0.037726257049288864,0.7326176654883368,0.011621720676731732,0.29458047125308867,0.7054195287469113,0.02840405282385349
2230,15.0,858,8934,9792,38,626,13120,3720,9400,13120,1061,0.06539634146341464,0.6809451219512195,0.002896341463414634,0.28353658536585363,0.7164634146341463,0.04771341463414634
2231,23.0,513,17648,18161,39,908,23263,6942,16321,23263,1595,0.02205218587456476,0.7586295834587112,0.0016764819670721748,0.2984137901388471,0.7015862098611529,0.03903193913080858
2232,,166,2893,3059,14,126,4056,1182,2874,4056,334,0.040927021696252466,0.7132642998027613,0.0034516765285996054,0.29142011834319526,0.7085798816568047,0.03106508875739645
2233,25.0,617,18646,19263,68,801,25955,7163,18792,25955,1712,0.023771912926218455,0.7183972259680216,0.0026199190907339625,0.2759776536312849,0.7240223463687151,0.030861105759969178
2234,27.0,84,2651,2735,12,49,3491,1048,2443,3491,271,0.024061873388713836,0.7593812661128616,0.0034374104841019765,0.3002005156115726,0.6997994843884274,0.01403609281008307
2235,27.0,339,6932,7271,19,243,10203,2903,7301,10204,311,0.033222265778126224,0.6793414347314779,0.001862014896119169,0.28449627597020777,0.7155037240297922,0.023814190513524108
2236,38.0,371,5192,5563,19,448,8228,1996,6232,8228,420,0.04508993680116675,0.6310160427807486,0.0023091881380651433,0.24258629071463297,0.757413709285367,0.05444822557122023
2237,,101,2050,2151,57,130,3229,799,2430,3229,155,0.03127903375658098,0.6348714772375348,0.017652524001238772,0.24744502942087335,0.7525549705791267,0.04026014245896562
2238,17.0,166,7105,7271,3,258,9473,2824,6649,9473,717,0.01752348780745276,0.7500263907948908,0.0003166895386889053,0.29811041908582286,0.7018895809141771,0.027235300327245856
2239,17.0,1413,25719,27132,12,1784,36072,10356,25716,36072,2835,0.03917165668662675,0.7129906852960746,0.00033266799733865603,0.2870924817032601,0.7129075182967398,0.049456642271013526
2240,,106,2421,2527,18,105,3521,937,2584,3521,270,0.030105083783016188,0.687588753195115,0.005112184038625391,0.2661175802328884,0.7338824197671117,0.02982107355864811
2241,,234,4932,5166,13,218,6852,2021,4831,6852,549,0.03415061295971979,0.7197898423817863,0.0018972562755399883,0.29495037945125513,0.7050496205487449,0.03181552831290134
2242,15.0,67,1493,1560,0,127,2115,564,1551,2115,169,0.03167848699763593,0.7059101654846336,0.0,0.26666666666666666,0.7333333333333333,0.06004728132387707
2243,,1,2132,2133,1,218,2912,833,2079,2912,204,0.00034340659340659343,0.7321428571428571,0.00034340659340659343,0.2860576923076923,0.7139423076923077,0.07486263736263736
2244,23.0,4229,62255,66484,883,3882,88480,24931,63549,88480,5510,0.04779611211573237,0.7036053345388789,0.009979656419529838,0.28176989150090415,0.7182301084990959,0.043874321880651
2245,27.0,192,6733,6925,10,489,9391,2678,6713,9391,779,0.020445107017357043,0.7169630497284635,0.0010648493238206793,0.2851666489191779,0.714833351080822,0.05207113193483122
2246,,1727,22805,24532,92,1796,33757,9198,24559,33757,2361,0.05115975945729775,0.6755635868116242,0.002725360665935954,0.2724768196225968,0.7275231803774032,0.053203779956749714
2247,25.0,590,10693,11283,86,612,15223,4303,10920,15223,998,0.03875714379557249,0.702423963739079,0.005649346383761414,0.28266438941076005,0.71733561058924,0.040202325428627735
2248,23.0,93,1437,1530,5,211,2887,491,2396,2887,100,0.03221337028056807,0.49774852788361623,0.0017319016279875303,0.17007273986837548,0.8299272601316245,0.07308624870107377
2249,,192,3974,4166,4,202,5648,1608,4040,5648,440,0.0339943342776204,0.7036118980169972,0.000708215297450425,0.2847025495750708,0.7152974504249292,0.03576487252124646
2250,24.0,910,22552,23462,34,1276,31252,8842,22410,31252,2434,0.029118136439267885,0.7216178164597465,0.0010879303724561629,0.28292589274286445,0.7170741072571355,0.04082938691923717
2251,,433,11006,11439,64,506,15237,4389,10848,15237,1270,0.02841766751985299,0.7223206667979261,0.0042003018966988255,0.2880488285095491,0.7119511714904508,0.033208636870775084
2252,16.0,5232,84724,89956,1615,6635,123158,34433,88725,123158,6979,0.042482014972636775,0.6879293265561311,0.013113236655353286,0.2795839490735478,0.7204160509264522,0.05387388557787558
2253,15.0,627,49662,50289,149,2206,67231,19110,48121,67231,6369,0.009326054944891493,0.7386770983623626,0.002216239532358585,0.2842438755931044,0.7157561244068956,0.03281224435156401
2254,,116,1947,2063,14,50,2697,806,1891,2697,205,0.043010752688172046,0.7219132369299222,0.005190952910641453,0.2988505747126437,0.7011494252873564,0.01853911753800519
2255,,540,30288,30828,143,1681,40878,11729,29149,40878,3741,0.013210039630118891,0.7409364450315573,0.003498214198346299,0.2869269533734527,0.7130730466265472,0.04112236410783306
2256,23.0,2362,29228,31590,203,1712,42520,11857,30663,42520,3040,0.05555032925682032,0.6873941674506114,0.004774223894637817,0.27885700846660394,0.721142991533396,0.04026340545625588
2257,16.0,5790,101589,107379,986,7664,146988,40765,106223,146988,9217,0.03939097069148502,0.6911380520858845,0.006708030587530955,0.2773355648080115,0.7226644351919884,0.0521403107736686
2258,,186,8415,8601,67,381,11883,3214,8669,11883,1039,0.01565261297652108,0.7081545064377682,0.005638306824875873,0.2704704199276277,0.7295295800723723,0.03206261045190609
2259,,275,3657,3932,11,301,5188,1421,3767,5188,249,0.05300693909020817,0.7048959136468774,0.002120277563608327,0.2739013107170393,0.7260986892829607,0.05801850424055513
2260,46.0,214,6551,6765,23,154,8553,2621,5932,8553,577,0.02502046065707939,0.7659300830118088,0.002689114930433766,0.3064421840289957,0.6935578159710043,0.01800537822986087
2261,,221,4970,5191,15,327,7244,2011,5233,7244,531,0.030508006626173385,0.6860850358917725,0.0020706791827719492,0.27760905577029266,0.7223909442297074,0.04514080618442849
2262,34.0,2029,43012,45041,101,2875,60480,17416,43064,60480,4392,0.033548280423280424,0.7111772486772486,0.001669973544973545,0.287962962962963,0.712037037037037,0.04753637566137566
2263,,246,3830,4076,31,333,5837,1510,4327,5837,429,0.042144937467877334,0.6561589857803666,0.005310947404488607,0.2586945348637999,0.7413054651362001,0.057049854377248584
2264,37.0,101,3364,3465,13,173,4557,1314,3243,4557,348,0.02216370419135396,0.738204959403116,0.0028527540048277375,0.28834759710335744,0.7116524028966426,0.03796357252578451
2265,17.0,232,5423,5655,26,292,7447,2116,5331,7447,583,0.03115348462468108,0.7282127031019202,0.0034913387941452934,0.28414126493890157,0.7158587350610984,0.03921042030347791
2266,25.0,462,13252,13714,233,524,17837,5288,12549,17837,1226,0.025901216572293547,0.7429500476537534,0.013062734764814711,0.29646240959802656,0.7035375904019734,0.029377137410999607
2267,,470,25565,26035,32,1153,34410,9859,24551,34410,2942,0.013658820110433014,0.7429526300494043,0.0009299622202848009,0.2865155478058704,0.7134844521941296,0.033507701249636736
2268,16.0,547,11629,12176,77,448,16156,4669,11487,16156,1266,0.033857390443179,0.7197945035899975,0.004766031195840554,0.2889948006932409,0.7110051993067591,0.02772963604852686
2269,34.0,448,13086,13534,67,1052,18574,5125,13449,18574,1479,0.024119737267147626,0.7045332184774415,0.003607192850220739,0.275923333692258,0.724076666307742,0.0566383116183913
2270,13.0,1662,35494,37156,175,2023,50049,14865,35184,50049,3623,0.033207456692441406,0.7091849987012727,0.003496573358109053,0.2970089312473776,0.7029910687526224,0.040420388019740655
2271,,81,2109,2190,34,108,3053,831,2222,3053,215,0.02653128070750082,0.690795938421225,0.011136586963642319,0.27219128725843433,0.7278087127415657,0.03537504094333443
2272,27.0,2192,52983,55175,252,2362,71158,20924,50234,71158,4638,0.030804688158745326,0.7445824784282864,0.003541414879563788,0.2940498608729869,0.7059501391270131,0.03319373787908598
2273,15.0,487,23882,24369,82,1485,32981,9270,23711,32981,2548,0.014766077438525212,0.7241138837512507,0.0024862799793820686,0.2810709196203875,0.7189290803796125,0.04502592401685819
2274,,78,2360,2438,34,81,3251,917,2334,3251,241,0.023992617656105813,0.7259304829283297,0.010458320516764073,0.2820670562903722,0.7179329437096278,0.024915410642879113
2275,24.0,183,4788,4971,5,179,6192,1901,4291,6192,404,0.029554263565891473,0.7732558139534884,0.0008074935400516795,0.3070090439276486,0.6929909560723514,0.02890826873385013
2276,43.0,157,4876,5033,12,184,6553,1812,4741,6553,401,0.02395849229360598,0.7440866778574698,0.0018312223409125592,0.27651457347779645,0.7234854265222036,0.02807874256065924
2277,,288,4759,5047,19,273,6838,1938,4900,6838,568,0.04211757823925124,0.6959637320854051,0.002778590231061714,0.28341620356829483,0.7165837964317052,0.039923954372623575
2278,27.0,71,2337,2408,3,115,3172,947,2225,3172,248,0.022383354350567465,0.7367591424968474,0.0009457755359394704,0.2985498108448928,0.7014501891551072,0.0362547288776797
2279,23.0,64,3038,3102,1,97,3912,1184,2728,3912,305,0.016359918200409,0.7765848670756647,0.0002556237218813906,0.30265848670756645,0.6973415132924335,0.02479550102249489
2280,13.0,142,2858,3000,34,148,4143,1150,2993,4143,252,0.03427468018344195,0.6898382814385711,0.008206613565049481,0.27757663528843834,0.7224233647115617,0.03572290610668598
2281,14.0,5047,104861,109908,1557,7275,153790,41946,111844,153790,11484,0.03281747837960856,0.6818453735613499,0.010124195331295924,0.272748553221926,0.727251446778074,0.047304766239677484
2282,,252,5317,5569,12,263,7594,2125,5469,7594,623,0.033184092704766924,0.7001580194890703,0.0015801948907031868,0.27982617856202263,0.7201738214379774,0.03463260468791151
2283,,514,8549,9063,20,487,12357,3368,8989,12357,763,0.04159585659949826,0.6918345876830946,0.0016185158209921502,0.2725580642550781,0.7274419357449219,0.039410860241158856
2284,13.0,67,3112,3179,22,109,4337,1229,3108,4337,399,0.015448466682038276,0.7175466912612405,0.005072630850818538,0.28337560525709016,0.7166243947429098,0.02513258012451003
2285,,490,10981,11471,35,453,15310,4375,10935,15310,960,0.03200522534291313,0.7172436316133246,0.0022860875244937948,0.28576094056172435,0.7142390594382756,0.02958850424559112
2286,14.0,205,4822,5027,37,174,6904,1881,5023,6904,510,0.02969293163383546,0.6984356894553881,0.005359212050984936,0.27245075318655854,0.7275492468134415,0.025202780996523753
2287,,285,7189,7474,5,312,10086,2902,7184,10086,777,0.02825698988697204,0.7127701764822526,0.00049573666468372,0.2877255601824311,0.7122744398175689,0.030933967876264127
2288,25.0,520,27612,28132,112,1260,37396,10437,26959,37396,3147,0.013905230505936464,0.7383677398652262,0.002994972724355546,0.27909402075088247,0.7209059792491176,0.03369344314899989
2289,13.0,21,1740,1761,12,191,2438,686,1752,2438,144,0.008613617719442166,0.7136997538966365,0.004922067268252666,0.28137817883511074,0.7186218211648893,0.07834290401968827
2290,25.0,197,4517,5610,57,314,7468,1807,5661,7468,396,0.02637921799678629,0.6048473486877344,0.0076325656132833425,0.24196572040707018,0.7580342795929298,0.042046063202999466
2291,,230,8010,8240,29,214,10563,3203,7360,10563,810,0.02177411720155259,0.7583072990627663,0.0027454321688914133,0.30322824955031713,0.6967717504496829,0.020259396004922842
2292,23.0,1166,23780,24946,108,1934,34222,9483,24739,34222,2626,0.03407164981590789,0.6948746420431301,0.0031558646484717433,0.27710244871719947,0.7228975512828005,0.05651335398281807
2293,,574,8529,9103,25,397,11974,3457,8517,11974,781,0.04793719726073158,0.7122933021546685,0.0020878570235510273,0.288708869216636,0.7112911307833639,0.033155169533990315
2294,25.0,1112,39534,40646,71,1204,52676,15312,37364,52676,4399,0.02111018300554332,0.7505125673931202,0.0013478624041309134,0.29068266383172603,0.709317336168274,0.02285670893765662
2295,26.0,35,1438,1473,1,87,1969,550,1419,1969,186,0.017775520568816656,0.7303199593702387,0.0005078720162519045,0.27932960893854747,0.7206703910614525,0.04418486541391569
2296,23.0,317,8130,8447,49,568,11612,3210,8402,11612,851,0.027299345504650362,0.7001377884946607,0.0042197726489838095,0.276438167413021,0.723561832586979,0.04891491560454702
2297,14.0,403,5173,5576,36,859,8088,2041,6047,8088,377,0.049826904055390704,0.6395895153313551,0.004451038575667656,0.25234915924826906,0.7476508407517309,0.10620672601384767
2298,27.0,122,3309,3431,59,209,4711,1270,3441,4711,334,0.02589683718955636,0.7023986414773933,0.012523880280195288,0.26958182976013584,0.7304181702398641,0.04436425387391212
2299,15.0,197,5292,5489,3,258,7265,2117,5148,7265,606,0.027116311080523054,0.7284239504473503,0.00041293874741913283,0.29139710942876806,0.7086028905712319,0.035512732278045425
2300,,122,3240,3362,7,160,4424,1287,3137,4424,353,0.027576853526220614,0.7323688969258589,0.0015822784810126582,0.2909132007233273,0.7090867992766727,0.03616636528028933
2301,24.0,471,11497,11968,57,676,15949,4572,11377,15949,1121,0.029531632077246222,0.7208602420214434,0.0035738917800489057,0.28666374067339645,0.7133362593266035,0.042385102514264215
2302,24.0,1412,27332,28744,181,1530,38122,10943,27179,38122,2632,0.03703898011646818,0.7169613346623996,0.004747914590000525,0.2870520959026284,0.7129479040973716,0.04013430565028068
2303,17.0,487,8869,9356,13,554,12607,3633,8974,12607,888,0.03862933291028794,0.7034980566352027,0.0010311731577694932,0.2881732370905053,0.7118267629094948,0.04394384072340763
2304,17.0,192,4415,4607,24,581,6513,1781,4732,6513,510,0.02947950253339475,0.6778750191923845,0.0036849378166743437,0.27345309381237526,0.7265469061876247,0.08920620297865807
2305,17.0,6348,126018,132366,448,7669,175272,50236,125037,175273,12062,0.03621778596817536,0.7189812463984755,0.0025560126203123127,0.2866157365937709,0.7133842634062292,0.043754599966908767
2306,25.0,1164,32929,34093,133,1934,44675,12876,31799,44675,3309,0.026054840514829324,0.7370789031897034,0.0029770565193060995,0.28821488528259653,0.7117851147174035,0.043290430889759375
2307,25.0,3435,82158,85593,227,4034,114632,32982,81650,114632,8863,0.029965454672342802,0.7167108660757904,0.0019802498429757833,0.2877207062600321,0.7122792937399679,0.035190871658873614
2308,24.0,3345,85397,88742,537,3681,119509,33726,85783,119509,9126,0.027989523801554693,0.7145654302186446,0.004493385435406538,0.2822046875130743,0.7177953124869256,0.030801027537674986
2309,17.0,268,4799,5067,16,157,6417,1864,4553,6417,459,0.04176406420445691,0.7478572541686146,0.0024933769674302633,0.2904784167056257,0.7095215832943743,0.02446626149290946
2310,,3082,92892,95974,184,4132,123453,36804,86649,123453,8544,0.024964966424469232,0.752448300162815,0.0014904457566847302,0.2981215523316566,0.7018784476683434,0.03347022753598535
2311,24.0,849,19465,20314,119,1097,26645,7662,18983,26645,1826,0.0318633890035654,0.7305310564833928,0.004466128729592794,0.28755864139613435,0.7124413586038656,0.041170951398010885
2312,16.0,1640,22746,24386,130,2295,34462,9235,25227,34462,1993,0.04758864836631652,0.6600313388659973,0.003772270907086066,0.2679763217456909,0.7320236782543091,0.06659509024432708
2313,,390,11484,11874,34,530,15464,4539,10925,15464,1309,0.025219865494050697,0.7426280393171236,0.002198654940506984,0.29352043455768234,0.7064795654423176,0.0342731505431971
2314,24.0,119,3310,3429,28,271,4710,1218,3492,4710,355,0.02526539278131635,0.70276008492569,0.0059447983014862,0.2585987261146497,0.7414012738853503,0.05753715498938429
2315,23.0,3,4309,4312,6,177,5710,1637,4073,5710,510,0.0005253940455341507,0.7546409807355516,0.0010507880910683013,0.28669001751313483,0.7133099824868652,0.030998248686514886
2316,,1492,24566,26058,130,1646,35683,9816,25867,35683,2448,0.041812627862007117,0.6884510831488384,0.003643191435697671,0.2750889779446795,0.7249110220553204,0.04612840848583359
2317,33.0,251,6004,6255,15,395,8668,2394,6274,8668,622,0.028957083525611445,0.6926626672819566,0.0017305029995385325,0.27618827872634977,0.7238117212736502,0.045569912321181356
2318,16.0,94,2807,2901,5,150,3867,1122,2745,3867,238,0.02430824928885441,0.725885699508663,0.0012929919834497026,0.29014740108611325,0.7098525989138867,0.038789759503491075
2319,17.0,2,2423,2425,1,73,3238,935,2303,3238,387,0.0006176652254478073,0.7483014206300185,0.00030883261272390367,0.2887584928968499,0.71124150710315,0.022544780728844967
2320,,822,37643,38465,882,2578,53151,14022,39129,53151,2389,0.015465372241350115,0.7082275027751124,0.016594231529039907,0.2638144155331038,0.7361855844668962,0.048503320727737956
2321,17.0,1119,31409,32528,84,1643,42047,12416,29631,42047,2770,0.02661307584369872,0.7469974076628535,0.001997764406497491,0.29528860560801007,0.7047113943919899,0.039075320474706875
2322,,1982,40253,42235,116,2215,56574,15919,40655,56574,3810,0.03503376109166755,0.71151058790257,0.0020504118499664156,0.28138367447944285,0.7186163255205571,0.03915226075582423
2323,15.0,117,2342,2459,18,205,3360,953,2407,3360,259,0.03482142857142857,0.6970238095238095,0.005357142857142857,0.2836309523809524,0.7163690476190476,0.06101190476190476
2324,,156,6962,7118,19,252,9694,2733,6961,9694,879,0.016092428306168763,0.7181761914586342,0.0019599752424179907,0.281926965133072,0.718073034866928,0.025995461109964927
2325,17.0,1111,35900,37011,100,2256,49632,14131,35501,49632,4233,0.022384751773049646,0.7233236621534493,0.002014829142488717,0.2847155061250806,0.7152844938749194,0.045454545454545456
2326,27.0,185,2151,2336,54,172,4015,838,3177,4015,117,0.0460772104607721,0.5357409713574097,0.013449564134495641,0.2087173100871731,0.7912826899128269,0.042839352428393526
2327,,165,3137,3302,39,172,4692,1241,3451,4692,334,0.03516624040920716,0.6685848252344416,0.008312020460358057,0.2644927536231884,0.7355072463768116,0.03665814151747655
2328,39.0,343,10601,10944,53,390,14441,4209,10232,14441,1281,0.02375181774115366,0.7340904369503497,0.0036701059483415276,0.2914618101239526,0.7085381898760473,0.027006439997230108
2329,15.0,3876,103423,107354,735,7562,145965,39961,106004,145965,9933,0.02655431096495735,0.7085465693830713,0.005035453704655225,0.2737711095125544,0.7262288904874457,0.05180694001986778
2330,,233,9764,9997,10,328,12711,3857,8854,12711,937,0.0183305798127606,0.7681535677759421,0.000786720163637794,0.3034379671150972,0.6965620328849028,0.025804421367319644
2331,27.0,84,2115,2199,0,157,3066,831,2235,3066,214,0.0273972602739726,0.6898238747553816,0.0,0.2710371819960861,0.7289628180039139,0.05120678408349641
2332,23.0,1685,38383,40068,210,2147,54265,15068,39197,54265,3573,0.031051322215055743,0.707325163549249,0.0038698977241315765,0.27767437574864096,0.722325624251359,0.03956509720814521
2333,,75,1698,1773,6,95,2424,690,1734,2424,175,0.03094059405940594,0.7004950495049505,0.0024752475247524753,0.28465346534653463,0.7153465346534653,0.039191419141914194
2334,16.0,146,3277,3423,0,158,4662,1299,3363,4662,351,0.03131703131703132,0.7029172029172029,0.0,0.27863577863577865,0.7213642213642214,0.03389103389103389
2335,,9400,139756,149156,925,12107,203136,57340,145796,203136,13747,0.04627441713925646,0.6879922810333964,0.004553599558916194,0.2822739445494644,0.7177260554505356,0.059600464713295526
2336,24.0,36,2148,2184,6,107,2933,833,2100,2933,254,0.012274122059324924,0.7323559495397204,0.002045687009887487,0.2840095465393795,0.7159904534606205,0.036481418342993524
2337,,298,7262,7560,30,243,10037,2848,7189,10037,858,0.029690146458105013,0.7235229650293913,0.002988940918601176,0.28375012453920495,0.7162498754607951,0.02421042144066952
2338,,364,5476,5840,34,377,8079,2245,5834,8079,537,0.04505508107439039,0.6778066592400049,0.004208441638816686,0.27788092585716057,0.7221190741428395,0.04666419111276148
2339,,85,1913,1998,4,68,2613,755,1858,2613,196,0.032529659395331034,0.732108687332568,0.0015308075009567547,0.2889399158055874,0.7110600841944126,0.02602372751626483
2340,26.0,51,1977,2028,4,75,2639,777,1862,2639,180,0.019325502084122773,0.7491474043198181,0.0015157256536566881,0.29442970822281167,0.7055702917771883,0.028419856006062904
2341,,593,21817,22410,30,1018,28749,8404,20345,28749,2011,0.020626804410588194,0.7588785696893805,0.0010435145570280705,0.2923232112421302,0.7076767887578699,0.035409927301819195
2342,36.0,87,2602,2689,11,309,3620,860,2760,3620,207,0.024033149171270717,0.7187845303867403,0.0030386740331491712,0.23756906077348067,0.7624309392265194,0.08535911602209945
2343,,609,13574,14183,31,818,19113,5593,13520,19113,1228,0.03186312980693769,0.7101972479464239,0.001621932715952493,0.29262805420394494,0.707371945796055,0.04279809553706901
2344,,2361,33954,36315,166,1744,49163,14002,35161,49163,3548,0.04802392042796412,0.690641335964038,0.0033765229949352157,0.2848076805727885,0.7151923194272115,0.035473831946789255
2345,25.0,388,7642,8030,22,602,11242,2919,8323,11242,614,0.03451343177370575,0.6797722825120085,0.0019569471624266144,0.25965130759651306,0.7403486924034869,0.053549190535491904
2346,24.0,87,2045,2132,0,131,2944,809,2135,2944,227,0.029551630434782608,0.6946331521739131,0.0,0.2747961956521739,0.725203804347826,0.044497282608695655
2347,38.0,66,1815,1881,4,99,2517,747,1770,2517,192,0.026221692491060787,0.7210965435041716,0.0015891934843067143,0.2967818831942789,0.7032181168057211,0.03933253873659118
2348,33.0,857,26626,27483,91,995,35858,10190,25668,35858,2491,0.023899827095766636,0.7425400189636902,0.0025377879413241117,0.2841764738691505,0.7158235261308494,0.027748340677115287
2349,24.0,393,7193,7586,59,530,10260,2886,7374,10260,667,0.038304093567251465,0.7010721247563353,0.005750487329434698,0.28128654970760236,0.7187134502923976,0.05165692007797271
2350,24.0,1193,45585,46778,102,2105,60842,17779,43063,60842,4560,0.019608165412050887,0.7492357253213241,0.001676473488708458,0.2922159034877223,0.7077840965122777,0.03459781072285592
2351,16.0,554,9271,10155,85,746,13945,3716,10231,13947,862,0.0397218039721804,0.6647307664730766,0.006094500609450061,0.26643722664372266,0.7335627733562773,0.05348820534882053
2352,15.0,115,1974,2089,21,152,2980,773,2207,2980,167,0.03859060402684564,0.6624161073825503,0.007046979865771812,0.2593959731543624,0.7406040268456375,0.05100671140939597
2353,25.0,882,16303,17185,97,1280,24701,6592,18109,24701,1620,0.03570705639447796,0.660013764624914,0.0039269665195741064,0.26687178656734545,0.7331282134326546,0.051819764382008825
2354,16.0,2569,36832,39401,139,3083,53282,15202,38080,53282,3702,0.04821515708869787,0.691265342892534,0.0026087609323974326,0.2853121129086746,0.7146878870913254,0.057861942119289814
2355,25.0,123,2626,2749,7,104,3588,1048,2540,3588,281,0.034280936454849496,0.7318840579710145,0.0019509476031215162,0.29208472686733555,0.7079152731326644,0.028985507246376812
2356,16.0,112,2614,2726,28,152,3680,1032,2648,3680,244,0.030434782608695653,0.7103260869565218,0.007608695652173913,0.28043478260869564,0.7195652173913043,0.041304347826086954
2357,25.0,1737,33009,34746,210,2129,46410,13165,33245,46410,3320,0.03742727860374919,0.7112475759534583,0.004524886877828055,0.2836673130790778,0.7163326869209222,0.04587373410902822
2358,15.0,195,6615,6810,159,494,9528,2496,7032,9528,739,0.020465994962216624,0.6942695214105793,0.016687657430730477,0.2619647355163728,0.7380352644836272,0.05184718723761545
2359,33.0,484,15318,15802,50,695,20054,5944,14110,20054,1324,0.024134835942954024,0.7638376383763837,0.0024932681759250023,0.2963997207539643,0.7036002792460357,0.034656427645357535
2360,,575,16767,17342,118,1024,22986,6569,16417,22986,1817,0.02501522665970591,0.7294440093970243,0.005133559557991821,0.28578265030888367,0.7142173496911163,0.04454885582528496
2361,44.0,295,10640,10935,42,526,14530,4175,10355,14530,1123,0.020302821748107363,0.7322780454232622,0.0028905712319339297,0.2873365450791466,0.7126634549208534,0.03620096352374398
2362,25.0,444,8787,9231,35,448,12298,3435,8863,12298,888,0.03610343145226866,0.7145064238087494,0.002845991218084241,0.27931370954626766,0.7206862904537323,0.03642868759147829
2363,,193,6197,6390,12,332,8344,2367,5977,8344,652,0.02313039309683605,0.7426893576222435,0.0014381591562799617,0.28367689357622244,0.7163231064237776,0.03978906999041227
2364,27.0,564,11922,12486,72,459,16533,4834,11699,16533,1226,0.03411359099981855,0.7211032480493559,0.004354926510615134,0.29238492711546604,0.707615072884534,0.027762656505171474
2365,15.0,202,1960,2162,3,173,3122,761,2361,3122,163,0.0647021140294683,0.6278026905829597,0.0009609224855861628,0.24375400384368995,0.75624599615631,0.05541319666880205
2366,25.0,275,7046,7321,17,407,9836,2824,7012,9836,685,0.027958519723464824,0.7163481089873932,0.0017283448556323709,0.28710858072387146,0.7128914192761285,0.04137860919072794
2367,23.0,1011,15749,16760,86,1059,22645,6347,16298,22645,1570,0.04464561713402517,0.6954736144844337,0.003797747847206889,0.2802826230956061,0.7197173769043939,0.046765290351070875
2368,13.0,155,10691,10846,26,654,14544,4033,10511,14544,1045,0.010657315731573157,0.7350797579757976,0.0017876787678767878,0.2772964796479648,0.7227035203520352,0.04496699669966997
2369,26.0,221,4160,4381,59,220,5819,1672,4147,5819,325,0.03797903419831586,0.7148994672624163,0.010139199175116,0.28733459357277885,0.7126654064272212,0.03780718336483932
2370,,448,10230,10678,10,407,14444,4102,10342,14444,1081,0.031016338964275823,0.7082525616172806,0.0006923289947382996,0.2839933536416505,0.7160066463583495,0.028177790085848795
2371,,1450,44688,46138,121,1662,60091,17493,42598,60091,4575,0.024130069394751295,0.743672097319066,0.0020136126874240735,0.2911084854637134,0.7088915145362866,0.02765805195453562
2372,,626,7385,8011,56,460,11658,3077,8581,11658,770,0.05369703208097444,0.633470578143764,0.004803568365071196,0.26393892605935837,0.7360610739406416,0.039457882998799106
2373,26.0,159,4636,4795,28,306,6355,1831,4524,6355,441,0.025019669551534226,0.7295043273013375,0.004405979543666404,0.2881195908733281,0.7118804091266719,0.048151062155782846
2374,,27420,408118,435538,6296,21370,578411,166517,411897,578414,29681,0.047405491568323035,0.7055811235551007,0.010884937086585042,0.2878854937812709,0.7121145062187292,0.03694585539077547
2375,23.0,2364,38087,40451,268,2513,55941,14891,41050,55941,3720,0.04225880838740816,0.6808423160115121,0.004790761695357609,0.26619116569242596,0.733808834307574,0.044922328882215194
2376,26.0,5480,131245,136725,257,7812,179648,52320,127328,179648,11831,0.03050409690060563,0.7305675543284645,0.0014305753473459208,0.2912361952262202,0.7087638047737799,0.04348503740648379
2377,15.0,577,15023,15600,37,522,20974,5975,14999,20974,1833,0.02751025078668828,0.7162677600839135,0.0017640888719366835,0.28487651377896445,0.7151234862210356,0.02488795651759321
2378,25.0,599,16552,17151,55,810,23289,6597,16692,23289,1723,0.025720297135986947,0.7107217999914123,0.002361629954055563,0.2832667783073554,0.7167332216926446,0.03478036841427283
2379,17.0,1262,17901,19163,70,1705,26875,7192,19683,26875,1753,0.046958139534883724,0.6660837209302326,0.0026046511627906975,0.2676093023255814,0.7323906976744186,0.06344186046511628
2380,,2126,41960,44086,173,1740,56843,16679,40164,56843,3893,0.037401263128265576,0.7381735657864644,0.003043470612036662,0.293422233168552,0.706577766831448,0.03061062927713175
2381,,362,11238,11600,33,841,15665,4455,11210,15665,1360,0.023108841366102778,0.7173954676029365,0.0021066070858601978,0.2843919565911267,0.7156080434088733,0.05368656240025534
2382,,2146,57936,60082,360,4278,80639,22744,57895,80639,5980,0.026612433189895708,0.7184612904425898,0.00446434107565818,0.2820471484021379,0.717952851597862,0.053051253115738044
2383,14.0,218,2211,2429,9,113,3210,917,2293,3210,216,0.06791277258566979,0.688785046728972,0.002803738317757009,0.2856697819314642,0.7143302180685358,0.03520249221183801
2384,16.0,167,32596,32763,31,1871,44047,12692,31355,44047,3637,0.003791404635957046,0.7400276976865621,0.0007037936749381342,0.2881467523327355,0.7118532476672645,0.04247735373578223
2385,33.0,118,1793,1911,2,109,2602,753,1849,2602,169,0.045349730976172176,0.6890853189853958,0.0007686395080707148,0.28939277478862413,0.7106072252113759,0.04189085318985396
2386,,1510,36340,37850,209,1494,49349,14314,35035,49349,3813,0.030598391051490405,0.7363877687491135,0.004235141542888407,0.2900565361000223,0.7099434638999778,0.030274169689355406
2387,,2843,71275,74118,155,4417,98831,28300,70531,98831,6778,0.028766277787333934,0.7211806012283595,0.001568333822383665,0.2863474011190821,0.7136525988809179,0.044692454796571926
2388,,512,8625,9137,146,372,12341,3423,8918,12341,861,0.04148772384733814,0.6988898792642412,0.011830483753342516,0.2773681225184345,0.7226318774815655,0.030143424357831617
2389,16.0,64,3161,3225,8,216,4394,1210,3184,4394,366,0.01456531634046427,0.719390077378243,0.0018206645425580337,0.2753755120619026,0.7246244879380974,0.04915794264906691
2390,,74,6508,6582,13,818,9504,2496,7008,9504,615,0.007786195286195286,0.6847643097643098,0.001367845117845118,0.26262626262626265,0.7373737373737373,0.08606902356902357
2391,33.0,575,19487,20062,37,1259,26834,7755,19079,26834,2059,0.021428039054930313,0.7262055601103078,0.0013788477304911679,0.28899903107997316,0.7110009689200268,0.04691808899157785
2392,13.0,12965,13420,26385,137,2746,35924,9929,25995,35924,1138,0.36090079055784435,0.3735664179935419,0.003813606502616635,0.2763890435363545,0.7236109564636455,0.07643914931522103
2393,16.0,1292,97914,99206,606,9758,136228,38235,97993,136228,11115,0.009484100184983997,0.7187509175793523,0.004448424699768036,0.2806691722700179,0.7193308277299821,0.07162991455501072
2394,26.0,120,3264,3384,28,213,4648,1305,3343,4648,337,0.025817555938037865,0.7022375215146299,0.006024096385542169,0.2807659208261618,0.7192340791738382,0.04582616179001721
2395,23.0,1855,43225,45080,329,1986,59077,16961,42116,59077,4059,0.031399698698308984,0.7316722243851245,0.005569003165360462,0.28709988658868935,0.7129001134113107,0.03361714372767744
2396,16.0,376,4435,4811,38,212,6824,1807,5017,6824,409,0.05509964830011723,0.6499120750293084,0.005568581477139508,0.2648007033997655,0.7351992966002344,0.031066822977725676
2397,23.0,42,2917,2959,2,98,3783,1100,2683,3783,254,0.011102299762093577,0.7710811525244515,0.000528680941052075,0.2907745175786413,0.7092254824213587,0.02590536611155168
2398,,75,2731,2806,3,119,3711,1061,2650,3711,313,0.02021018593371059,0.7359202371328483,0.0008084074373484236,0.2859067636755592,0.7140932363244409,0.032066828348154136
2399,25.0,212,6050,6262,8,311,8271,2432,5839,8271,609,0.02563172530528352,0.7314714061177608,0.0009672349171805102,0.2940394148228751,0.7059605851771249,0.03760125740539234
2400,15.0,116,2817,2933,9,150,4098,1125,2976,4101,237,0.028285783955132895,0.6869056327724945,0.0021945866861741038,0.274323335771763,0.7256766642282371,0.036576444769568395
2401,37.0,233,5327,5560,11,326,7708,2153,5555,7708,558,0.0302283341982356,0.6911001556824079,0.001427088738972496,0.2793201868188895,0.7206798131811105,0.04229372080954852
2402,27.0,1366,16838,18204,947,1479,25785,6867,18918,25785,1309,0.052976536746170255,0.6530153189839054,0.036726779135156096,0.2663176265270506,0.7336823734729494,0.05735892961023851
2403,17.0,49,1766,1815,6,77,2414,686,1728,2414,176,0.020298260149130075,0.7315658657829329,0.0024855012427506215,0.28417564208782103,0.7158243579121789,0.03189726594863297
2404,25.0,559,6160,6719,58,581,9178,2574,6604,9178,541,0.060906515580736544,0.6711701895837873,0.006319459577249945,0.2804532577903683,0.7195467422096318,0.06330355197210721
2405,,608,12169,12777,81,780,17187,4960,12227,17187,1352,0.03537557456216908,0.708035142840519,0.004712864374236341,0.28859021353348463,0.7114097864665154,0.04538313841857217
2406,,2701,76157,78858,354,4925,104455,29899,74556,104455,6883,0.025858024986836436,0.7290890814226222,0.0033890191948686035,0.28623809295869035,0.7137619070413097,0.047149490211095685
2407,,642,12028,12670,51,577,16714,4864,11850,16714,1230,0.03841091300705995,0.7196362330980016,0.003051334210841211,0.2910135215986598,0.7089864784013402,0.03452195764030155
2408,33.0,240,3224,3464,14,325,4681,1244,3437,4681,302,0.05127109591967528,0.6887417218543046,0.002990813928647725,0.26575518051698355,0.7342448194830165,0.06942960905789361
2409,27.0,68,1683,1751,12,82,2467,666,1801,2467,183,0.027563842723956223,0.6822051074179165,0.004864207539521687,0.26996351844345357,0.7300364815565464,0.033238751520064856
2410,23.0,685,24300,24985,48,1424,33285,9562,23723,33285,2563,0.020579840769115218,0.7300585849481749,0.0014420910319963948,0.2872765509989485,0.7127234490010516,0.042782033949226375
2411,,362,4737,5099,17,378,6977,1974,5003,6977,564,0.05188476422531174,0.6789451053461373,0.0024365773254980652,0.2829296259137165,0.7170703740862835,0.05417801347283933
2412,15.0,39,2034,2073,8,126,3080,825,2255,3080,260,0.012662337662337663,0.6603896103896104,0.0025974025974025974,0.26785714285714285,0.7321428571428571,0.04090909090909091
2413,27.0,946,98139,99085,738,4974,134391,37731,96660,134391,11695,0.007039161848635698,0.7302497935129585,0.005491439158872246,0.28075540772819607,0.7192445922718039,0.03701140701386253
2414,33.0,343,13615,13958,45,819,18504,5569,12935,18504,892,0.018536532641591007,0.7357868568958064,0.0024319066147859923,0.3009619541720709,0.699038045827929,0.04426070038910506
2415,23.0,261,5025,5286,15,341,7278,1907,5371,7278,581,0.03586150041220115,0.690436933223413,0.002061005770816158,0.26202253366309425,0.7379774663369058,0.04685353118988733
2416,36.0,129,2760,2889,10,170,3958,1073,2885,3958,306,0.0325922182920667,0.697321879737241,0.0025265285497726125,0.2710965133906013,0.7289034866093986,0.04295098534613441
2417,25.0,230,5074,5304,5,295,7027,2017,5010,7027,526,0.03273089511882738,0.7220720079692614,0.0007115411982353779,0.2870357193681514,0.7129642806318486,0.04198093069588729
2418,,368,5944,6312,25,340,8366,2441,5925,8366,624,0.04398756873057614,0.7104948601482189,0.002988285919196749,0.29177623715037054,0.7082237628496294,0.040640688501075786
2419,27.0,696,16089,16785,70,655,22164,6465,15699,22164,1529,0.03140227395776936,0.7259068760151597,0.003158274679660711,0.2916892257715214,0.7083107742284787,0.029552427359682366
2420,,439,10469,10908,54,511,14406,4127,10279,14406,879,0.030473413855338055,0.7267110926003054,0.003748438150770512,0.28647785644870194,0.7135221435512981,0.03547133138969873
2421,24.0,457,11354,11811,59,470,15727,4463,11264,15727,1341,0.029058307369491956,0.7219431550836142,0.003751510141794366,0.2837794875055637,0.7162205124944363,0.02988491129903987
2422,,37,2311,2348,3,83,3058,893,2165,3058,260,0.01209941137998692,0.7557226945716154,0.0009810333551340746,0.2920209287115762,0.7079790712884239,0.02714192282537606
2423,16.0,1668,61063,62731,230,4307,84555,23951,60604,84555,6426,0.019726805038140855,0.7221690024244575,0.0027201229968659454,0.2832594169475489,0.716740583052451,0.0509372597717462
2424,36.0,204,3236,3440,36,166,4611,1324,3287,4611,277,0.04424202992843201,0.7018000433745392,0.007807417046193884,0.2871394491433529,0.7128605508566471,0.03600086749078291
2425,,1574,40937,42511,97,1793,57452,16329,41123,57452,5100,0.02739678340179628,0.7125426442943674,0.0016883659402631762,0.2842198705005918,0.7157801294994082,0.031208661143215206
2426,25.0,315,8939,9254,11,316,12107,3496,8611,12107,894,0.026018006112166515,0.7383331956719253,0.0009085652928058148,0.28875856942264805,0.7112414305773519,0.026100602956967044
2427,,2894,135373,138267,401,13079,191902,53509,138393,191902,13414,0.015080614063428208,0.7054277704244875,0.00208960823753791,0.27883503038008983,0.7211649696199102,0.0681545788996467
2428,17.0,251,7398,7649,2,163,10207,2967,7240,10207,843,0.024590966983442736,0.7247967081414716,0.00019594396002743216,0.2906828647006956,0.7093171352993044,0.01596943274223572
2429,26.0,468,15164,15632,52,1060,21320,5657,15663,21320,1577,0.02195121951219512,0.7112570356472796,0.0024390243902439024,0.2653377110694184,0.7346622889305816,0.04971857410881801
2430,,313,4245,4558,6,513,6364,1777,4587,6364,344,0.04918290383406662,0.6670333123821496,0.0009428032683846638,0.27922690131992456,0.7207730986800754,0.08060967944688875
2431,33.0,1131,17086,18217,70,1246,24424,7009,17415,24424,1844,0.046306911234850964,0.6995578119882083,0.002866033409760891,0.2869718309859155,0.7130281690140845,0.05101539469374386
2432,13.0,343,3586,3929,13,354,5482,1423,4059,5482,361,0.06256840569135352,0.6541408245165998,0.0023713973002553812,0.25957679678949286,0.7404232032105071,0.06457497263772345
2433,,77,2015,2092,10,164,2789,767,2022,2789,207,0.027608461814270346,0.722481176048763,0.0035855145213338113,0.27500896378630335,0.7249910362136966,0.05880243814987451
2434,,1195,23312,24507,94,1592,34186,9177,25009,34186,2399,0.03495582987187738,0.6819165740361551,0.0027496636049844964,0.2684432223717311,0.7315567776282689,0.046568770841865094
2435,33.0,4115,73908,78023,572,5040,105922,29622,76300,105922,7264,0.03884934196861842,0.6977587281206926,0.005400200147278186,0.27965861671796227,0.7203413832820377,0.047582183115877724
2436,14.0,274,2960,3234,15,231,4407,1222,3185,4407,289,0.062173814386203764,0.6716587247560699,0.0034036759700476512,0.27728613569321536,0.7227138643067846,0.05241660993873383
2437,23.0,904,26602,30375,216,1901,41644,10409,31242,41651,2464,0.021704160764447433,0.6386881467431754,0.005185949917168855,0.24990996614727137,0.7500900338527287,0.04564116107656479
2438,,536,14055,14591,45,1169,19631,5511,14120,19631,1324,0.027303754266211604,0.715959451887321,0.002292292802200601,0.28072945850950026,0.7192705414904997,0.05954867301716672
2439,,55,2125,2180,6,78,2828,824,2004,2828,224,0.019448373408769447,0.7514144271570015,0.0021216407355021216,0.2913719943422914,0.7086280056577087,0.027581329561527583
2440,14.0,1,2201,2202,17,96,2963,814,2149,2963,241,0.0003374957813027337,0.7428282146473169,0.005737428282146473,0.27472156598042524,0.7252784340195747,0.03239959500506244
2441,,172,2408,2580,25,145,3457,956,2501,3457,196,0.049754122071159965,0.6965577089962395,0.007231703789412786,0.2765403529071449,0.723459647092855,0.04194388197859416
2442,26.0,1378,31962,33340,180,1482,43815,12325,31497,43822,2922,0.03144539272511524,0.7293596823513304,0.00410752590023276,0.2812514262242709,0.7187485737757291,0.03381862991191639
2443,,675,10644,11319,141,766,15098,4183,10915,15098,1061,0.044707908332229436,0.7049940389455557,0.009338985296065704,0.27705656378328253,0.7229434362167174,0.05073519671479666
2444,33.0,1784,37120,38904,204,4096,53861,14836,39025,53861,3692,0.033122296281168195,0.6891814114108539,0.003787527153227753,0.2754497688494458,0.7245502311505542,0.07604760401774939
2445,24.0,278,3941,4219,9,318,5834,1653,4181,5834,390,0.04765169694892012,0.6755227973945834,0.0015426808364758314,0.28333904696606105,0.716660953033939,0.054508056222146044
2446,14.0,55,3747,3802,6,201,5062,1413,3649,5062,389,0.010865270644014224,0.7402212564203872,0.001185302252074279,0.2791386803634927,0.7208613196365073,0.039707625444488345
2447,16.0,1804,23775,25579,259,1306,34646,9788,24858,34646,2803,0.05206950297292617,0.6862264042025054,0.007475610460081972,0.2825145759972291,0.7174854240027709,0.03769554926975697
2448,16.0,836,21399,22235,55,1126,29234,8667,20567,29234,2310,0.028596839296709312,0.7319901484572757,0.0018813710063624546,0.2964698638571526,0.7035301361428473,0.03851679551207498
2449,,352,12088,12440,53,631,16266,4575,11691,16266,923,0.021640231157014633,0.743145210869298,0.003258330259436862,0.2812615271117669,0.7187384728882331,0.03879257346612566
2450,,132,6868,7000,37,263,9606,2631,6975,9606,756,0.013741411617738912,0.7149698105350822,0.003851759317093483,0.27389131792629606,0.7261086820737039,0.027378721632313138
2451,,1117,23437,24554,84,1736,33563,9423,24140,33563,2350,0.0332806960045288,0.6982987218067515,0.0025027560110836337,0.28075559395763194,0.7192444060423681,0.051723624229061765
2452,17.0,70,13495,13565,18,1502,19317,5096,14221,19317,1759,0.0036237511000672983,0.698607444220117,0.0009318217114458767,0.26380908008489934,0.7361909199151007,0.0777553450328726
2453,,20,12958,12978,48,123,16859,4934,11925,16859,1644,0.0011863099827985053,0.7686102378551516,0.0028471439587164126,0.29266267275639124,0.7073373272436088,0.007295806394210807
2454,24.0,346,11314,11660,2,372,14841,4482,10359,14841,1123,0.02331379287110033,0.7623475507041304,0.00013476180850347013,0.3020012128562765,0.6979987871437234,0.025065696381645443
2455,,562,8513,9075,61,1764,13179,3366,9813,13179,639,0.04264359966613552,0.645951893163366,0.004628575764473784,0.25540632824948784,0.7445936717505122,0.13384930571363532
2456,24.0,247,6106,6353,3,268,8347,2448,5899,8347,708,0.029591469989217682,0.7315203066970168,0.0003594105666706601,0.29327902240325865,0.7067209775967414,0.032107343955912304
2457,23.0,93,3510,3603,5,262,4832,1369,3463,4832,419,0.019246688741721855,0.7264072847682119,0.0010347682119205299,0.28331953642384106,0.7166804635761589,0.05422185430463576
2458,40.0,1177,29591,30768,61,1771,40685,11910,28775,40685,3245,0.028929580926631438,0.7273196509770186,0.0014993240752119946,0.2927368809143419,0.7072631190856581,0.04352955634754824
2459,27.0,12376,221609,233985,2366,13494,323544,88045,235499,323544,20530,0.03825136612021858,0.6849423880523205,0.007312761170041787,0.2721268204633682,0.7278731795366318,0.04170684667309547
2460,14.0,75,1611,1686,3,96,2467,641,1826,2467,166,0.030401297122010538,0.6530198621807863,0.0012160518848804217,0.25982975273611675,0.7401702472638833,0.03891366031617349
2461,13.0,9,5077,5086,5,79,6407,1943,4464,6407,579,0.001404713594506009,0.7924145465896676,0.0007803964413922273,0.3032620571250195,0.6967379428749805,0.01233026377399719
2462,,977,28674,29651,94,1207,39125,11388,27737,39125,2919,0.024971246006389777,0.7328817891373802,0.002402555910543131,0.2910670926517572,0.7089329073482428,0.030849840255591055
2463,,40,2233,2273,0,91,2909,902,2007,2909,199,0.013750429700928154,0.7676177380543142,0.0,0.3100721897559299,0.6899278102440701,0.03128222756961155
2464,,598,15346,15944,4,830,21072,6123,14949,21072,1604,0.0283788914198937,0.7282649962034928,0.00018982536066818528,0.2905751708428246,0.7094248291571754,0.03938876233864844
2465,14.0,285,4014,4299,17,212,5803,1659,4144,5803,465,0.04911252800275719,0.6917111838704119,0.002929519214199552,0.2858866103739445,0.7141133896260555,0.036532827847665
2466,15.0,1010,16509,17519,75,972,24419,6673,17746,24419,1607,0.04136123510381261,0.6760719112166755,0.00307137884434252,0.27327081371063516,0.7267291862893649,0.03980506982267906
2467,25.0,163,7453,7616,12,423,10131,2871,7260,10131,853,0.016089231072944427,0.7356628170960419,0.0011844832691738228,0.28338762214983715,0.7166123778501629,0.041753035238377256
2468,,4975,89864,94839,1530,4810,127278,35869,91409,127278,7782,0.03908766636810761,0.7060450352771099,0.012020930561448168,0.2818161819010355,0.7181838180989645,0.037791291503637706
2469,15.0,503,8516,9019,89,475,12192,3278,8914,12192,734,0.04125656167979003,0.698490813648294,0.0072998687664042,0.26886482939632544,0.7311351706036745,0.03895997375328084
2470,16.0,388,12229,12617,14,778,16522,4850,11672,16522,1146,0.023483839728846385,0.7401646289795424,0.0008473550417624985,0.29354799661057984,0.7064520033894202,0.04708873017794456
2471,23.0,1277,30153,31430,170,1960,42146,11787,30359,42146,2990,0.03029943529635078,0.715441560290419,0.004033597494424145,0.2796706686281023,0.7203293313718977,0.0465050064063019
2472,23.0,1135,22497,23632,171,1386,31726,8865,22861,31726,2339,0.035775074071739264,0.7091029439576373,0.005389901027548383,0.27942381642816616,0.7205761835718338,0.04368656622328689
2473,,643,10574,11217,76,334,15195,4244,10952,15196,1042,0.042313766780731774,0.6958410107923138,0.005001316135825217,0.2792840221110819,0.7207159778889182,0.021979468281126614
2474,36.0,983,21358,22341,132,912,29169,8628,20541,29169,2119,0.033700161129966745,0.7322157084576091,0.004525352257533683,0.2957934793787926,0.7042065206212075,0.03126607014295999
2475,15.0,64,8392,8456,85,406,11607,3207,8400,11607,949,0.0055139140174032914,0.7230119755320066,0.007323167054363746,0.276298785215818,0.7237012147841819,0.03497889204790213
2476,35.0,461,7291,7752,134,624,11160,2939,8221,11160,471,0.041308243727598566,0.6533154121863799,0.012007168458781362,0.26335125448028673,0.7366487455197133,0.05591397849462366
2477,25.0,498,17867,18365,147,940,25010,6888,18122,25010,2041,0.01991203518592563,0.7143942423030788,0.005877648940423831,0.2754098360655738,0.7245901639344262,0.03758496601359456
2478,15.0,635,10494,11129,60,696,15308,4251,11057,15308,910,0.041481578259733476,0.6855239090671544,0.003919519205644107,0.27769793571988505,0.722302064280115,0.045466422785471645
2479,37.0,9648,157796,167444,716,6239,216465,63783,152682,216465,13897,0.044570715820109484,0.7289677315039382,0.003307694084494029,0.29465733490402607,0.705342665095974,0.028822211442958445
2480,,2944,57604,60548,176,3130,80330,22942,57388,80330,6039,0.036648823602639116,0.7170919955184862,0.0021909622805925556,0.28559691273496823,0.7144030872650318,0.03896427237644715
2481,14.0,427,16588,17015,32,556,22881,6405,16476,22881,2347,0.018661771775709105,0.7249683143219265,0.001398540273589441,0.2799265766356366,0.7200734233643634,0.024299637253616536
2482,16.0,122,7572,7694,37,395,10360,2892,7468,10360,987,0.011776061776061776,0.7308880308880309,0.0035714285714285713,0.27915057915057917,0.7208494208494208,0.03812741312741313
2483,16.0,629,19846,20475,43,1192,27364,7829,19535,27364,2054,0.022986405496272476,0.7252594649904984,0.0015714076889343663,0.2861058324806315,0.7138941675193685,0.04356088291185499
2484,,1031,11734,12765,27,833,17185,4912,12273,17185,1119,0.059994180971777715,0.6828047716031422,0.001571137620017457,0.28583066627873144,0.7141693337212686,0.048472505091649694
2485,,177,2230,2407,35,151,3457,942,2515,3457,203,0.051200462829042524,0.6450679780156204,0.0101243853051779,0.27249059878507376,0.7275094012149262,0.04367949088805322
2486,17.0,716,22871,23587,68,945,30920,9004,21916,30920,2269,0.02315653298835705,0.7396830530401035,0.0021992238033635187,0.29120310478654593,0.7087968952134541,0.0305627425614489
2487,,98,1636,1734,30,79,2387,678,1709,2387,159,0.04105571847507331,0.6853791369920402,0.012568077084206116,0.28403854210305823,0.7159614578969418,0.03309593632174277
2488,,6787,200745,207532,788,8742,267525,78804,188721,267525,18832,0.025369591626950752,0.7503784693019344,0.0029455191103635175,0.2945668629100084,0.7054331370899916,0.03267731987664704
2489,,1217,36345,37562,116,1263,50143,14009,36134,50143,4189,0.024270586123686256,0.7248269947948867,0.002313383722553497,0.2793809704245857,0.7206190295754143,0.02518796242745747
2490,,715,13188,13903,87,650,18174,5341,12833,18174,1134,0.03934191702432046,0.7256520303730604,0.004787058435127105,0.2938813689886651,0.7061186310113349,0.0357653791130186
2491,15.0,1946,42956,44902,300,2616,60635,17098,43537,60635,4298,0.03209367527005855,0.7084357219427724,0.004947637503092273,0.28198235342623895,0.718017646573761,0.043143399026964624
2492,24.0,363,6525,6888,46,419,9356,2623,6733,9356,745,0.038798631893971786,0.6974134245404019,0.004916631038905515,0.28035485250106884,0.7196451474989312,0.044784095767421976
2493,24.0,1085,18146,19231,68,1122,26147,7220,18927,26147,1649,0.04149615634680843,0.693999311584503,0.00260068076643592,0.2761311049068727,0.7238688950931274,0.04291123264619268
2494,39.0,995,39482,40477,148,1169,52590,15319,37271,52590,4241,0.01891994675793877,0.7507510933637573,0.0028142232363567218,0.29129111998478796,0.708708880015212,0.022228560562844647
2495,,20,14268,14288,11,758,19077,5438,13639,19077,1817,0.0010483828694239136,0.7479163390470199,0.0005766105781831525,0.2850553021963621,0.7149446978036379,0.03973371075116633
2496,,190,4296,4486,6,237,5936,1717,4219,5936,444,0.032008086253369275,0.7237196765498652,0.0010107816711590297,0.28925202156334234,0.7107479784366577,0.03992587601078167
2497,,119,3131,3250,8,133,4362,1237,3126,4363,281,0.027274810909924365,0.7176254870501948,0.0018336007334402934,0.2835205134082054,0.7164794865917946,0.03048361219344488
2498,23.0,2957,64316,67273,339,3087,89808,25850,63958,89808,6106,0.03292579725636914,0.7161500089078924,0.0037747194013896313,0.28783627293782293,0.7121637270621771,0.034373329770176375
2499,14.0,1427,27126,28553,169,1041,37772,10714,27058,37772,2780,0.0377793074234883,0.7181510113311448,0.004474213703272265,0.2836492640050831,0.7163507359949168,0.027560097426665254
2500,23.0,2961,84358,87319,299,5051,117028,33803,83226,117029,9708,0.025301421015303898,0.7208298797733895,0.0025549222842201507,0.28884293636619984,0.7111570636338002,0.043160242333096926
2501,15.0,1138,27714,28852,18,1504,38980,10937,28043,38980,3210,0.029194458696767574,0.7109799897383273,0.0004617752693689071,0.2805797845048743,0.7194202154951257,0.03858388917393535
2502,36.0,255,13318,13573,6,336,16619,5248,11371,16619,950,0.015343883506829532,0.8013719237017871,0.00036103255310187133,0.31578313977977013,0.6842168602202299,0.020217822973704797
2503,43.0,194,4778,4972,4,299,6784,1842,4942,6784,572,0.028596698113207548,0.7043042452830188,0.0005896226415094339,0.27152122641509435,0.7284787735849056,0.04407429245283019
2504,,2293,82901,85194,322,3533,113721,32521,81208,113729,8296,0.020161963966974124,0.7289345725364683,0.002831291930817997,0.28595169218053446,0.7140483078194656,0.0310650757502484
2505,33.0,289,5039,5328,23,331,7547,2068,5479,7547,538,0.03829336160063601,0.6676825228567643,0.0030475685702928317,0.2740161653637207,0.7259838346362794,0.043858486815953356
2506,,1792,60352,62144,708,4190,86015,24060,61958,86018,6957,0.02083284893859425,0.7016205910390848,0.008230835406542817,0.2797088981375991,0.7202911018624009,0.04871073496244972
2507,15.0,124,4903,5027,76,218,6506,1890,4616,6506,361,0.019059329849369814,0.7536120504150016,0.01168152474638795,0.29050107592991087,0.7094989240700892,0.03350753150937596
2508,,623,17924,18547,76,814,23702,7149,16553,23702,1590,0.026284701712935617,0.7562231035355667,0.003206480465783478,0.30162011644586956,0.6983798835541305,0.034343093409838835
2509,36.0,427,20279,20706,41,1572,28333,7792,20541,28333,2343,0.0150707655384181,0.7157378322097907,0.0014470758479511524,0.2750150001764727,0.7249849998235274,0.055483005682419796
2510,16.0,43,26673,26716,2,119,33293,10178,23115,33293,3011,0.0012915627909770822,0.8011594028774818,6.007268795242243e-05,0.30570990898987777,0.6942900910101223,0.0035743249331691347
2511,,1167,20604,21771,93,1013,28502,8371,20131,28502,1785,0.04094449512314925,0.7228966388323627,0.0032629289172689635,0.29369868781138164,0.7063013121886184,0.03554136551820925
2512,,528,15343,15871,67,562,21537,6050,15487,21537,1630,0.024515949296559408,0.7124019129869527,0.0031109253842225007,0.28091191902307655,0.7190880809769234,0.02609462784974695
2513,23.0,150,4755,4905,4,208,6575,1897,4678,6575,482,0.022813688212927757,0.7231939163498099,0.0006083650190114068,0.28851711026615967,0.7114828897338403,0.03163498098859316
2514,14.0,1301,26792,28093,210,1852,37263,10565,26698,37263,2534,0.03491398974854413,0.7189973968816252,0.005635617100072458,0.28352521267745484,0.7164747873225451,0.049700775568258054
2515,15.0,223,5673,5896,32,287,7933,2251,5682,7933,593,0.028110424807765034,0.7151140804235472,0.0040337829320559685,0.28375141812681204,0.716248581873188,0.03617799067187697
2516,25.0,160,5214,5374,61,292,7324,2002,5322,7324,584,0.02184598580010923,0.7119060622610596,0.008328782086291644,0.2733478973238667,0.7266521026761332,0.03986892408519935
2517,43.0,619,15011,15630,111,886,20533,5962,14571,20533,1424,0.03014659328885209,0.7310670627769932,0.005405931914479131,0.2903618565236449,0.7096381434763551,0.043150051137193786
2518,23.0,488,12174,12662,19,728,17348,4737,12611,17348,1186,0.02813004380908462,0.7017523633848283,0.001095227115517639,0.2730574129582661,0.7269425870417339,0.04196449158404427
2519,14.0,11,4939,5890,79,974,8300,1857,6443,8300,347,0.001325301204819277,0.5950602409638555,0.009518072289156626,0.22373493975903613,0.7762650602409639,0.11734939759036145
2520,,650,14496,15146,95,1074,21361,5838,15526,21364,1114,0.030425014042314173,0.6785246208575173,0.004446732821568994,0.2732634338138925,0.7267365661861075,0.05027148474068527
2521,,9110,189556,198666,1248,10141,269650,75054,194596,269650,18300,0.03378453550899314,0.7029705173372891,0.004628221768959762,0.27833858705729647,0.7216614129427035,0.037608010383830895
2522,,1249,29454,30703,227,1283,41117,11687,29430,41117,3228,0.030376729819782573,0.7163460369190359,0.005520830799912445,0.284237663253642,0.7157623367463579,0.031203638397743025
2523,24.0,887,27793,28680,37,1506,38781,11045,27736,38781,3032,0.02287202496067662,0.7166653773755189,0.000954075449317965,0.2848044145328898,0.7151955854671102,0.03883344936953663
2524,,79,2588,2667,3,154,3562,983,2579,3562,242,0.022178551375631666,0.7265581134194273,0.0008422234699606962,0.2759685569904548,0.7240314430095453,0.043234138124649074
2525,26.0,46,1526,1572,0,90,2092,591,1501,2092,151,0.02198852772466539,0.7294455066921606,0.0,0.28250478011472274,0.7174952198852772,0.043021032504780114
2526,,1084,22806,23890,8,958,31598,9175,22423,31598,2146,0.03430596873219824,0.7217545414266726,0.0002531805810494335,0.29036647889106904,0.709633521108931,0.030318374580669664
2527,14.0,1479,21127,22606,155,1779,31230,8779,22451,31230,2351,0.0473583093179635,0.676496958053154,0.004963176432917067,0.28110790906179955,0.7188920909382005,0.05696445725264169
2528,16.0,322,6999,7321,15,207,9580,2828,6752,9580,981,0.03361169102296451,0.7305845511482255,0.0015657620041753654,0.29519832985386224,0.7048016701461378,0.021607515657620043
2529,,84,2925,3009,12,227,4136,1156,2980,4136,337,0.020309477756286266,0.7072050290135397,0.0029013539651837525,0.27949709864603484,0.7205029013539652,0.054883945841392646
2530,24.0,417,10913,11330,37,783,15118,4309,10809,15118,1145,0.027583013626141024,0.7218547426908322,0.0024474136790580765,0.2850244741367906,0.7149755258632094,0.051792565154120916
2531,16.0,347,5907,6254,28,698,8868,2462,6406,8868,701,0.03912945421741092,0.6661028416779432,0.0031574199368516014,0.27762742444745153,0.7223725755525485,0.07870996842580064
2532,27.0,2379,50436,52815,247,3139,70811,20144,50667,70811,4645,0.03359647512392142,0.7122622191467427,0.003488158619423536,0.2844755758286142,0.7155244241713858,0.044329270875993844
2533,24.0,28639,375993,404632,1931,19772,542072,151148,390989,542137,37085,0.05282613066438926,0.693538718073107,0.0035618303122642433,0.27880037702647115,0.7211996229735288,0.03647048624240736
2534,24.0,572,16531,17103,56,787,22446,6369,16077,22446,1645,0.025483382339837834,0.7364786598948587,0.002494876592711396,0.2837476610531943,0.7162523389468056,0.03506192640114052
2535,,191,4340,4531,2,325,6163,1656,4507,6163,446,0.03099140029206555,0.7042024987830602,0.00032451728054518905,0.2687003082914165,0.7312996917085834,0.052734058088593216
2536,23.0,207,3030,3237,5,206,4697,1142,3555,4697,211,0.04407068341494571,0.645092612305727,0.0010645092612305727,0.2431339152650628,0.7568660847349372,0.043857781562699594
2537,24.0,297,6390,6687,39,372,9477,2664,6813,9477,673,0.03133903133903134,0.674264007597341,0.00411522633744856,0.28110161443494774,0.7188983855650523,0.03925292814181703
2538,,7734,180580,188314,4604,33108,282073,70652,211421,282073,16085,0.02741843423510935,0.6401888872738617,0.01632201593204596,0.2504741680345159,0.7495258319654841,0.11737387130281877
2539,17.0,44,2311,2355,15,281,3384,934,2450,3384,200,0.013002364066193853,0.682919621749409,0.004432624113475178,0.2760047281323877,0.7239952718676123,0.08303782505910165
2540,16.0,1845,23677,25522,115,1524,35558,9744,25814,35558,2307,0.05188705776477867,0.6658698464480567,0.003234152652005175,0.2740311603577254,0.7259688396422745,0.042859553405703354
2541,16.0,282,23832,24114,34,1112,32002,9104,22898,32002,2938,0.008811949253171678,0.7447034560339979,0.0010624335979001313,0.28448221986125866,0.7155177801387413,0.03474782826073371
2542,17.0,3752,83523,87275,512,8149,122448,32574,89875,122449,8000,0.030641328226445295,0.6821043863159356,0.0041813326364445605,0.2660209556631741,0.7339790443368259,0.06655015557497407
2543,16.0,1072,102342,103414,121,7251,139466,39137,100329,139466,12125,0.007686461216353807,0.7338132591455983,0.0008675949693832188,0.2806203662541408,0.7193796337458592,0.05199116630576628
2544,16.0,2181,32983,35164,189,1963,47268,13434,33834,47268,3531,0.04614115257679614,0.6977870864009478,0.003998476770753999,0.2842091901497842,0.7157908098502158,0.04152915291529153
2545,15.0,397,5962,6359,417,528,9181,2461,6720,9181,572,0.04324147696329376,0.6493845986276005,0.045419888900991176,0.2680535889336674,0.7319464110663326,0.05751007515521185
2546,24.0,13777,198322,212099,1429,11174,306274,79300,226974,306274,17015,0.044982597282172174,0.6475312955066378,0.004665756805997245,0.2589184847554804,0.7410815152445196,0.036483671483704135
2547,,5763,113612,119375,330,7595,157261,45258,112003,157261,10640,0.03664608517051272,0.7224423092820216,0.0020984223679106706,0.287789089475458,0.712210910524542,0.04829550874024711
2548,24.0,4,2679,2683,9,131,3668,1036,2632,3668,348,0.0010905125408942203,0.7303707742639041,0.0024536532170119957,0.2824427480916031,0.7175572519083969,0.03571428571428571
2549,23.0,323,8867,9190,74,414,12495,3454,9041,12495,969,0.02585034013605442,0.7096438575430172,0.005922368947579032,0.27643057222889156,0.7235694277711084,0.033133253301320525
2550,14.0,1351,19181,20732,169,1270,29056,7787,21269,29056,2071,0.04649642070484582,0.6601390418502202,0.005816354625550661,0.26799972466960353,0.7320002753303965,0.04370870044052864
2551,,2059,52218,54277,244,2245,72942,20533,52410,72943,5747,0.028227520118448653,0.7158740386329051,0.003345077663380996,0.2814937691073852,0.7185062308926148,0.030777456370042363
2552,24.0,129,4178,4307,40,355,5984,1607,4377,5984,412,0.021557486631016042,0.6981951871657754,0.0066844919786096255,0.2685494652406417,0.7314505347593583,0.05932486631016043
2553,25.0,931,33327,34258,170,1344,46269,12880,33389,46269,3329,0.020121463614947373,0.720287881735071,0.0036741662884436665,0.27837212820679075,0.7216278717932093,0.029047526421578162
2554,,191,8766,8957,67,1270,13676,3286,10390,13676,672,0.013966071950862826,0.6409768938286049,0.004899093302135127,0.240274934191284,0.759725065808716,0.09286341035390465
2555,17.0,715,14432,15147,166,606,20363,5632,14732,20364,1363,0.035110980161068554,0.7087016303280299,0.008151640149283048,0.2765664898841092,0.7234335101158907,0.02975839717147908
2556,15.0,186,3049,3235,6,148,4393,1283,3110,4393,346,0.04234008650125199,0.694058729797405,0.0013658092419758707,0.2920555429091737,0.7079444570908263,0.033689961302071476
2557,,325,10937,11262,30,372,14518,4279,10239,14518,1183,0.022386003581760572,0.7533406805345089,0.002066400330624053,0.29473756715801075,0.7052624328419893,0.025623364099738255
2558,17.0,369,10746,11115,35,577,14902,4182,10720,14902,1106,0.024761776942692257,0.7211112602335257,0.0023486780297946584,0.2806334720171789,0.7193665279828211,0.038719634948329085
2559,,91,3886,3977,25,140,5038,1560,3478,5038,332,0.018062723302897977,0.7713378324732036,0.004962286621675268,0.30964668519253674,0.6903533148074633,0.027788805081381502
2560,42.0,227,4943,5170,21,459,7068,1958,5110,7068,479,0.0321165817770232,0.6993491794001132,0.0029711375212224107,0.27702320316921336,0.7229767968307866,0.06494057724957555
2561,,359,14396,14755,39,1552,20351,5355,14996,20351,1504,0.01764041079062454,0.7073853864674955,0.001916367746056705,0.2631320328239399,0.7368679671760602,0.076261608766154
2562,,929,22334,23263,121,1882,31817,8400,23417,31817,2320,0.029198227362730617,0.7019517867806518,0.0038029983970833204,0.2640098060785115,0.7359901939214886,0.059150768457114124
2563,27.0,242,5545,5787,24,272,7663,2200,5463,7663,575,0.031580321023098004,0.7236069424507373,0.003131932663447736,0.2870938274827091,0.7129061725172908,0.03549523685240767
2564,,1947,49468,51415,435,4832,72217,19931,52286,72217,4057,0.026960410983563426,0.6849910685849592,0.006023512469363169,0.27598764833764905,0.724012351662351,0.06690945345278812
2565,24.0,200,6056,6256,14,249,8097,2434,5663,8097,643,0.02470050636038039,0.7479313325923181,0.0017290354452266271,0.3006051624058293,0.6993948375941706,0.030752130418673584
2566,,1979,30813,32792,84,2058,45329,12497,32832,45329,3050,0.0436585850118026,0.6797635068057977,0.001853118312779898,0.2756954708905998,0.7243045291094001,0.0454013986631075
2567,15.0,103,1956,2059,6,162,2835,772,2063,2835,206,0.036331569664902995,0.68994708994709,0.0021164021164021165,0.272310405643739,0.727689594356261,0.05714285714285714
2568,,258,5947,6205,2,341,8327,2404,5923,8327,684,0.030983547496097035,0.7141827789119731,0.00024018253872943438,0.2886994115527801,0.7113005884472199,0.04095112285336856
2569,,796,15802,16598,155,1072,23076,6455,16621,23076,1238,0.03449471312185821,0.6847807245623159,0.00671693534408043,0.2797278557808979,0.7202721442191021,0.04645519154099497
2570,23.0,2882,84809,87691,406,3795,116459,33327,83133,116460,9375,0.024746694143912073,0.7282242830156277,0.0034861755109050316,0.28616692426584234,0.7138330757341577,0.03258629572385369
2571,,316,5612,5928,39,229,8592,2225,6367,8592,449,0.03677839851024209,0.6531657355679702,0.004539106145251397,0.25896182495344505,0.7410381750465549,0.02665270018621974
2572,,11345,185653,196998,753,11952,264462,75638,188824,264462,19371,0.04289841262638867,0.7020025561328281,0.0028472899698255326,0.2860070633966317,0.7139929366033684,0.045193638405517614
2573,26.0,1359,36651,38010,75,1634,50423,14514,35909,50423,3680,0.02695198619677528,0.7268706740971382,0.0014874164567756777,0.28784483271522915,0.7121551672847708,0.0324058465382861
2574,23.0,1019,33850,34869,43,804,50418,12928,37490,50418,3405,0.020211035741203538,0.6713872029830616,0.0008528700067436233,0.2564163592367805,0.7435836407632195,0.015946685707485423
2575,43.0,693,18299,18992,34,1156,24948,7000,17948,24948,1771,0.027777777777777776,0.7334856501523168,0.0013628346961680295,0.28058361391694725,0.7194163860830527,0.046336379669713004
2576,17.0,290,90547,90837,1740,3967,123340,33774,89572,123346,10704,0.002351109886011707,0.734089471892076,0.014106659316070242,0.2738151216902048,0.7261848783097952,0.03216156178554635
2577,13.0,433,7377,7810,36,430,10730,2993,7737,10730,744,0.040354147250698975,0.6875116495806151,0.0033550792171481826,0.27893755824790306,0.7210624417520969,0.04007455731593663
2578,,216,6345,6561,41,289,8577,2456,6121,8577,634,0.025183630640083946,0.7397691500524659,0.004780226186312231,0.2863472076483619,0.7136527923516381,0.03369476506937157
2579,42.0,573,10813,11386,67,372,14439,4338,10101,14439,950,0.03968418865572408,0.7488745758016483,0.004640210540896184,0.3004363183045917,0.6995636816954083,0.02576355703303553
2580,17.0,5828,136331,142159,486,5803,182687,54112,128575,182687,12623,0.03190155840317045,0.7462545227629771,0.002660287814677563,0.29620060540706233,0.7037993945929376,0.031764712322168515
2581,35.0,401,6748,7149,158,455,9990,2734,7256,9990,691,0.04014014014014014,0.6754754754754755,0.015815815815815815,0.2736736736736737,0.7263263263263263,0.045545545545545546
2582,,1,1658,1659,8,91,2223,577,1646,2223,211,0.000449842555105713,0.7458389563652722,0.003598740440845704,0.2595591542959964,0.7404408457040036,0.04093567251461988
2583,24.0,179,23553,23732,190,1394,32555,8920,23635,32555,2605,0.005498387344493933,0.723483335893104,0.0058362770695745666,0.27399784979265857,0.7260021502073414,0.042819843342036555
2584,17.0,237,8164,8401,89,320,11203,3197,8006,11203,848,0.021155047755065607,0.7287333749888423,0.007944300633758814,0.28536999018120146,0.7146300098187985,0.028563777559582254
2585,36.0,625,15394,16019,38,664,21118,6036,15082,21118,1529,0.02959560564447391,0.7289516052656502,0.0017994128231840136,0.28582252107207123,0.7141774789279288,0.03144237143668908
2586,16.0,7569,179513,187082,388,8011,243763,72226,171579,243805,17978,0.031045302598388055,0.7362974508316072,0.0015914357785935481,0.2962449498574681,0.7037550501425319,0.03285822686163122
2587,34.0,1959,44527,46486,222,2696,60726,17027,43699,60726,3902,0.03225965813654777,0.7332444093139676,0.003655765240588875,0.2803906069887692,0.7196093930112307,0.04439614003886309
2588,15.0,14939,200209,215148,3589,17434,301045,82938,218107,301045,19248,0.049623810393794945,0.6650467538075703,0.011921805710109784,0.275500340480659,0.7244996595193409,0.05791160789915129
2589,16.0,68,3040,3108,3,90,3969,1211,2758,3969,307,0.017132779037540943,0.7659360040312422,0.0007558578987150416,0.30511463844797176,0.6948853615520282,0.022675736961451247
2590,41.0,463,9104,9567,43,463,12926,3634,9292,12926,969,0.03581927897261334,0.7043168807055546,0.003326628500696271,0.28113879003558717,0.7188612099644128,0.03581927897261334
2591,24.0,370,8157,8527,55,429,11532,3239,8293,11532,832,0.032084634061741245,0.7073361082206036,0.004769337495664239,0.2808706208810267,0.7191293791189733,0.03720083246618106
2592,17.0,35,2192,2227,11,188,2966,811,2155,2966,187,0.011800404585300068,0.7390424814565071,0.0037086985839514496,0.2734322319622387,0.7265677680377612,0.0633850303438975
2593,15.0,911,14698,15609,64,1257,21265,5927,15338,21265,1376,0.04284034798965436,0.6911826945685399,0.0030096402539383964,0.2787209028920762,0.7212790971079238,0.059111215612508816
2594,,475,8474,8949,15,506,12135,3535,8600,12135,982,0.03914297486608982,0.6983106716110424,0.0012360939431396785,0.2913061392665843,0.7086938607334158,0.041697569015245156
2595,,142,1756,1898,20,254,2780,720,2060,2780,96,0.05107913669064748,0.6316546762589929,0.007194244604316547,0.2589928057553957,0.7410071942446043,0.09136690647482014
2596,25.0,75,3626,3701,2,101,4723,1408,3315,4723,403,0.01587973745500741,0.767732373491425,0.0004234596654668643,0.29811560448867247,0.7018843955113275,0.021384713106076647
2597,27.0,111,4766,4877,0,175,6317,1879,4438,6317,498,0.01757163210384676,0.754472059521925,0.0,0.2974513218299826,0.7025486781700174,0.027703023587145797
2598,13.0,167,6581,6748,16,362,9123,2628,6495,9123,602,0.018305382001534583,0.7213635865395155,0.0017538090540392415,0.2880631371259454,0.7119368628740546,0.03967992984763784
2599,,252,6175,6427,2,267,8608,2452,6156,8608,774,0.029275092936802975,0.7173559479553904,0.00023234200743494423,0.28485130111524165,0.7151486988847584,0.031017657992565055
2600,,79,1961,2040,0,184,2907,821,2086,2907,255,0.02717578259373925,0.674578603371173,0.0,0.282421740626075,0.717578259373925,0.06329549363605091
2601,23.0,2440,43790,46230,174,3244,62328,17267,45061,62328,4187,0.039147734565524325,0.7025734822230779,0.002791682710820177,0.2770343986651264,0.7229656013348735,0.052047233987934795
2602,16.0,162,4915,5077,9,248,6671,1915,4756,6671,494,0.024284215260080948,0.7367710987857893,0.001349123070004497,0.2870634087842902,0.7129365912157097,0.03717583570679059
2603,,444,7410,7854,123,574,10619,2886,7733,10619,743,0.041811846689895474,0.6978058197570393,0.011583011583011582,0.27177700348432055,0.7282229965156795,0.05405405405405406
2604,17.0,286,8804,9090,147,735,12371,3382,8989,12371,837,0.023118583784657667,0.7116643763640773,0.011882628728477892,0.2733812949640288,0.7266187050359713,0.05941314364238946
2605,44.0,338,5172,5510,57,417,7851,2007,5844,7851,471,0.04305184052986881,0.6587695834925488,0.0072602216278181125,0.25563622468475355,0.7443637753152464,0.05311425296140619
2606,35.0,66,1653,1719,11,149,2322,594,1728,2322,142,0.028423772609819122,0.7118863049095607,0.004737295434969853,0.2558139534883721,0.7441860465116279,0.06416881998277348
2607,17.0,121,4034,4155,6,151,5476,1573,3903,5476,490,0.022096420745069394,0.7366691015339664,0.001095690284879474,0.2872534696859021,0.7127465303140978,0.027574872169466764
2608,26.0,213,4166,4379,15,268,6642,1599,5043,6642,342,0.032068654019873535,0.6272207166516109,0.002258355916892502,0.24074074074074073,0.7592592592592593,0.04034929238181271
2609,,1606,38851,40457,257,1178,51503,15088,36415,51503,3271,0.03118264955439489,0.7543444071219152,0.00499000058249034,0.2929538085160088,0.7070461914839912,0.022872454031803973
2610,16.0,37,4542,4579,4,838,6597,1719,4878,6597,482,0.0056086099742307105,0.6884947703501592,0.0006063362134303471,0.2605729877216917,0.7394270122783083,0.1270274367136577
2611,,1883,36972,38855,243,1789,50888,14808,36080,50888,3554,0.037002829743750985,0.7265367080647697,0.004775192579783053,0.2909919823927056,0.7090080176072945,0.03515563590630404
2612,24.0,6862,155796,162687,1348,8108,215443,62200,153243,215443,15844,0.03185065191257084,0.723142548144985,0.006256875368426916,0.28870745394373454,0.7112925460562655,0.037634084189321536
2613,23.0,251,5035,5286,11,412,7412,1924,5488,7412,618,0.03386400431732326,0.6793038316243929,0.0014840798704803021,0.259579060982191,0.7404209390178089,0.05558553696708041
2614,14.0,66,3194,3260,6,194,4470,1185,3285,4470,430,0.01476510067114094,0.7145413870246085,0.0013422818791946308,0.2651006711409396,0.7348993288590604,0.043400447427293064
2615,27.0,3775,49359,53134,402,3242,72077,20171,51906,72077,4926,0.05237454389056148,0.6848093011640329,0.005577368647418732,0.27985349001762005,0.72014650998238,0.044979674514755055
2616,,687,51342,52029,268,3574,70022,19600,50422,70022,5518,0.009811202193596298,0.7332267001799434,0.0038273685413155864,0.27991202764845335,0.7200879723515466,0.05104110136814144
2617,14.0,236,3978,4214,24,174,5734,1609,4125,5734,436,0.041158004883153125,0.6937565399372166,0.004185559818625741,0.2806069061737007,0.7193930938262992,0.030345308685036623
2618,17.0,12,2338,2350,28,119,3815,880,2935,3815,243,0.003145478374836173,0.6128440366972477,0.007339449541284404,0.2306684141546527,0.7693315858453473,0.031192660550458717
2619,14.0,161,3276,3437,12,177,5074,1223,3851,5074,359,0.03173039022467481,0.6456444619629483,0.002364998029168309,0.24103271580607016,0.7589672841939299,0.03488372093023256
2620,,164,5424,5588,24,235,7277,2121,5156,7277,540,0.02253675965370345,0.7453620997663872,0.003298062388346846,0.29146626357015254,0.7085337364298475,0.032293527552562866
2621,15.0,1238,3171,4409,74,683,6944,1647,5297,6944,138,0.17828341013824886,0.4566532258064516,0.01065668202764977,0.2371831797235023,0.7628168202764977,0.09835829493087557
2622,,23,1594,1617,5,135,2222,582,1640,2222,174,0.010351035103510351,0.7173717371737174,0.0022502250225022503,0.2619261926192619,0.738073807380738,0.06075607560756076
2623,,302,25250,25552,83,2186,34391,9595,24796,34391,1830,0.008781367218167543,0.7342037160885115,0.0024134221162513446,0.2789974121136344,0.7210025878863656,0.06356314151958362
2624,17.0,393,9742,10135,5,521,13653,3999,9654,13653,853,0.02878488244341903,0.7135428111037867,0.0003662198784150004,0.29290265875631727,0.7070973412436827,0.03816011133084304
2625,14.0,434,5789,6223,42,355,8495,2375,6120,8495,552,0.051088875809299585,0.68145968216598,0.00494408475573867,0.279576221306651,0.7204237786933491,0.04178928781636257
2626,,23717,387638,411355,4824,23301,569750,155528,414222,569750,38855,0.04162702939885915,0.6803650724001755,0.008466871434839842,0.2729758666081615,0.7270241333918386,0.04089688459850812
2627,41.0,318,8286,8604,5,412,11357,3319,8038,11357,955,0.028000352205688122,0.7295940829444395,0.000440257110152329,0.29224266971911594,0.7077573302808841,0.036277185876551904
2628,,276,4245,4521,93,1370,7473,1720,5753,7473,402,0.03693295865114412,0.5680449618627057,0.012444801284624649,0.2301619162317677,0.7698380837682323,0.1833266425799545
2629,33.0,157,2853,3010,2,195,4184,1125,3059,4184,220,0.037523900573613767,0.6818833652007649,0.0004780114722753346,0.2688814531548757,0.7311185468451242,0.04660611854684513
2630,27.0,4366,51809,56175,470,3460,74615,21577,53038,74615,5224,0.05851370367888494,0.6943510018092877,0.006299001541245058,0.2891777792669034,0.7108222207330965,0.04637137304831468
2631,16.0,1404,40320,41724,49,1882,54544,15824,38720,54544,4444,0.025740686418304487,0.7392197125256673,0.0008983572895277207,0.29011440305074804,0.709885596949252,0.03450425344675858
2632,23.0,911,23221,24132,94,1234,31824,9267,22557,31824,2496,0.028626194067370537,0.7296694318753142,0.0029537456008044242,0.2911953242835596,0.7088046757164405,0.03877576671694319
2633,,97,2685,2782,9,314,3894,1029,2865,3894,274,0.024910118130457112,0.689522342064715,0.0023112480739599386,0.2642526964560863,0.7357473035439137,0.08063687724704674
2634,24.0,2413,60592,63005,271,2869,82312,23812,58500,82312,5983,0.029315288171833997,0.7361259597628536,0.003292351054524249,0.28928953251044803,0.7107104674895519,0.03485518514918846
2635,33.0,1493,28185,29678,41,1411,39877,11380,28497,39877,2827,0.03744012839481405,0.7067984050956692,0.0010281615969104999,0.2853775359229631,0.7146224640770369,0.03538380520099305
2636,,132,3288,3420,15,79,4604,1309,3295,4604,392,0.028670721112076455,0.7141615986099045,0.003258036490008688,0.28431798436142486,0.7156820156385751,0.017158992180712426
2637,,279,4140,4419,2,282,6098,1654,4444,6098,377,0.04575270580518203,0.6789111183994753,0.00032797638570022957,0.27123647097408987,0.7287635290259101,0.046244670383732374
2638,23.0,167,12416,12583,30,419,15877,4902,10975,15877,1265,0.010518359891667191,0.78201171505952,0.0018895257290420105,0.3087485041254645,0.6912514958745355,0.026390376015620078
2639,,3349,44020,47369,1821,2309,63814,17989,45825,63814,2782,0.052480646879994985,0.6898172814742847,0.02853605791832513,0.28189738928761715,0.7181026107123829,0.03618328266524587
2640,16.0,195,4328,4523,12,239,5903,1745,4158,5903,391,0.033034050482805354,0.7331865153311875,0.002032864645095714,0.29561240047433507,0.7043875995256649,0.04048788751482297
2641,27.0,217,6058,6275,12,342,8284,2361,5923,8284,554,0.02619507484307098,0.7312892322549494,0.0014485755673587638,0.2850072428778368,0.7149927571221633,0.04128440366972477
2642,25.0,687,24267,24954,26,828,33541,9544,23997,33541,3511,0.02048239468113652,0.7235025789332459,0.0007751706866223428,0.28454727050475537,0.7154527294952446,0.02468620494320384
2643,25.0,5852,70879,88173,5808,4935,125576,28270,97314,125584,4802,0.04659829277614983,0.5643951458784559,0.04624792967256976,0.22510829405019747,0.7748917059498025,0.03929640718562874
2644,16.0,128,2181,2309,2,243,3241,859,2382,3241,225,0.03949398333847578,0.6729404504782475,0.000617093489663684,0.2650416538105523,0.7349583461894477,0.07497685899413761
2645,,130,3073,3203,6,198,4275,1257,3018,4275,321,0.0304093567251462,0.7188304093567252,0.0014035087719298245,0.29403508771929826,0.7059649122807018,0.04631578947368421
2646,43.0,1023,21895,22918,191,1215,30671,8717,21954,30671,1928,0.033353982589416714,0.7138665188614652,0.006227380913566561,0.28420983991392523,0.7157901600860748,0.03961396759153598
2647,15.0,1871,36296,38167,985,1471,50033,14853,35180,50033,3532,0.037395319089401,0.7254412088021905,0.019687006575660065,0.29686406971398877,0.7031359302860112,0.029400595606899445
2648,,4940,127374,132314,1144,7778,180773,49957,130816,180773,11738,0.02732708977557489,0.7046074358449548,0.006328378684869975,0.27635211010493826,0.7236478898950618,0.04302633689765618
2649,,177,10079,10256,13,635,13313,3891,9422,13313,1030,0.013295275294824608,0.7570795463081199,0.0009764891459475701,0.29227071283707656,0.7077292871629235,0.047697739052054385
2650,17.0,109,2611,2720,5,130,3549,1039,2510,3549,237,0.03071287686672302,0.7357001972386588,0.0014088475626937165,0.2927585235277543,0.7072414764722457,0.03663003663003663
2651,16.0,1294,16501,17795,83,883,23789,6492,17297,23789,1565,0.05439488839379545,0.6936399176089789,0.003489007524486107,0.27289923914414227,0.7271007608558577,0.03711799571230401
2652,37.0,2752,54265,57017,758,3144,76797,21581,55216,76797,5180,0.03583473312759613,0.7066031225178067,0.00987017722046434,0.2810135812596846,0.7189864187403153,0.04093909918356186
2653,,1422,25407,26829,174,1910,36923,10222,26701,36923,1788,0.038512580234542154,0.688107683557674,0.004712509817728787,0.2768464100966877,0.7231535899033122,0.05172927443598841
2654,14.0,399,1753,2152,0,386,3369,857,2512,3369,152,0.11843276936776491,0.5203324428613832,0.0,0.25437815375482337,0.7456218462451766,0.11457405758385278
2655,33.0,1575,28558,30133,262,1214,40698,11463,29235,40698,2492,0.03869969040247678,0.7017052435009091,0.00643766278441201,0.28166003243402626,0.7183399675659737,0.029829475649909086
2656,,3111,79956,83067,411,3354,109604,31557,78053,109610,8565,0.02838244685703859,0.7294589909679774,0.0037496578779308456,0.28790256363470484,0.7120974363652951,0.03059939786515829
2657,17.0,103,2242,2345,0,74,3003,918,2085,3003,222,0.034299034299034296,0.7465867465867466,0.0,0.30569430569430567,0.6943056943056943,0.024642024642024644
2658,16.0,821,17805,18626,68,912,24672,6913,17759,24672,1841,0.03327658884565499,0.7216682879377432,0.0027561608300907914,0.2801961738002594,0.7198038261997406,0.03696498054474708
2659,13.0,1691,34114,35805,46,1777,47877,13514,34363,47877,3251,0.0353196733295737,0.7125342022265388,0.0009607953714727322,0.28226497065396744,0.7177350293460325,0.037115942937109674
2660,14.0,344,9371,9715,5,433,12900,3781,9119,12900,1026,0.02666666666666667,0.7264341085271317,0.0003875968992248062,0.29310077519379846,0.7068992248062016,0.03356589147286822
2661,,34,3071,3105,24,152,4276,1165,3111,4276,317,0.007951356407857811,0.7181945743685687,0.005612722170252572,0.2724508886810103,0.7275491113189897,0.03554724041159962
2662,16.0,186,3273,3459,4,165,4685,1339,3346,4685,288,0.03970117395944504,0.6986125933831376,0.0008537886872998933,0.28580576307363925,0.7141942369263607,0.035218783351120594
2663,,214,9087,9301,23,486,12579,3497,9082,12579,943,0.01701248111932586,0.7223944669687574,0.0018284442324509103,0.27800302090786233,0.7219969790921377,0.03863582160744097
2664,26.0,133,2812,2945,8,141,3788,1087,2701,3788,233,0.035110876451953536,0.7423442449841605,0.0021119324181626186,0.28695881731784584,0.7130411826821542,0.037222808870116156
2665,,620,15198,15818,71,661,21372,6044,15328,21372,1667,0.029009919520868427,0.7111173498034812,0.0033221036870671908,0.2827999251356916,0.7172000748643085,0.03092831742466779
2666,23.0,127,3980,4107,11,117,5379,1598,3781,5379,477,0.023610336493772078,0.7399144822457706,0.002044989775051125,0.29708124186651796,0.702918758133482,0.021751254880089235
2667,23.0,40,15063,15103,153,668,19862,5721,14141,19862,1684,0.002013895881582922,0.7583828416070889,0.007703151747054677,0.28803745846339746,0.7119625415366025,0.0336320612224348
2668,17.0,570,11973,12543,169,564,16526,4755,11771,16526,1214,0.03449110492557183,0.7244947355681955,0.010226310056880067,0.2877284279317439,0.7122715720682561,0.034128040663197384
2669,35.0,82,2232,2314,21,88,3012,905,2107,3012,237,0.027224435590969456,0.7410358565737052,0.0069721115537848604,0.300464807436919,0.699535192563081,0.029216467463479414
2670,,277,4699,4976,31,346,6800,1885,4915,6800,465,0.04073529411764706,0.6910294117647059,0.0045588235294117645,0.2772058823529412,0.7227941176470588,0.05088235294117647
2671,24.0,80,2127,2207,12,106,3071,813,2258,3071,231,0.026050146532074242,0.6926082709215239,0.0039075219798111365,0.2647346141322045,0.7352653858677956,0.03451644415499837
2672,,593,10093,10686,145,626,15046,4165,10881,15046,873,0.03941246843014755,0.6708095174797288,0.009637112853914661,0.2768177588727901,0.7231822411272099,0.04160574239000399
2673,25.0,876,9651,10527,86,696,13872,3994,9878,13872,807,0.06314878892733564,0.6957179930795848,0.006199538638985006,0.2879181084198385,0.7120818915801614,0.050173010380622836
2674,27.0,137,2643,2780,4,77,4213,1075,3138,4213,246,0.03251839544267743,0.6273439354379302,0.0009494422027059103,0.25516259197721336,0.7448374080227866,0.018276762402088774
2675,16.0,1071,19182,20253,82,1518,28198,7559,20639,28198,2097,0.037981417121781685,0.6802610114192496,0.002908007660117739,0.2680686573515852,0.7319313426484148,0.053833605220228384
2676,,3121,70778,73899,847,3729,99756,28008,71748,99756,8060,0.031286338666345885,0.7095112073459241,0.008490717350334817,0.28076506676290147,0.7192349332370985,0.037381210152772765
2677,35.0,80,2300,2380,7,148,3244,891,2353,3244,229,0.02466091245376079,0.7090012330456227,0.002157829839704069,0.2746609124537608,0.7253390875462392,0.04562268803945746
2678,17.0,343,10717,11060,36,537,14821,4162,10659,14821,1217,0.023142837865191283,0.7230956075838337,0.0024289858983874233,0.28081775858579044,0.7191822414142096,0.03623237298427907
2679,17.0,331,18373,18704,90,1173,25187,6979,18208,25187,1980,0.013141700083376345,0.729463612180887,0.003573271925993568,0.2770873863501012,0.7229126136498988,0.04657164410211617
2680,36.0,80,1643,1723,12,73,2354,636,1718,2354,187,0.033984706881903144,0.6979609175870858,0.005097706032285472,0.27017841971113,0.72982158028887,0.031011045029736617
2681,25.0,94,2119,2213,15,97,3138,832,2306,3138,198,0.02995538559592097,0.6752708731676227,0.004780114722753346,0.2651370299553856,0.7348629700446144,0.030911408540471638
2682,,5,6213,6218,24,334,8259,2345,5914,8259,742,0.0006054001695120475,0.7522702506356702,0.002905920813657828,0.28393267950115025,0.7160673204988497,0.04044073132340477
2683,17.0,1497,14906,16403,1107,2958,26044,6231,19813,26044,1017,0.05747964982337583,0.57233911841499,0.042504991552756874,0.23924896329288894,0.7607510367071111,0.11357702349869452
2684,16.0,167,4058,4225,15,296,5702,1556,4146,5702,365,0.02928796913363732,0.7116801122413189,0.002630655910206945,0.2728867064188004,0.7271132935811996,0.05191160996141705
2685,,145,2853,2998,4,333,4115,1134,2981,4115,266,0.03523693803159174,0.6933171324422843,0.0009720534629404617,0.2755771567436209,0.7244228432563791,0.08092345078979343
2686,,274,2730,3004,92,156,4392,1168,3224,4392,205,0.06238615664845173,0.6215846994535519,0.020947176684881604,0.2659380692167577,0.7340619307832422,0.03551912568306011
2687,24.0,7,1699,1706,0,170,2378,675,1703,2378,233,0.002943650126156434,0.7144659377628259,0.0,0.283851976450799,0.716148023549201,0.07148864592094197
2688,27.0,119,2386,2505,11,130,3415,935,2480,3415,235,0.034846266471449484,0.6986822840409956,0.00322108345534407,0.27379209370424595,0.726207906295754,0.03806734992679356
2689,25.0,127,6235,6362,1,230,8196,2392,5804,8196,677,0.015495363591996096,0.7607369448511468,0.00012201073694485115,0.29184968277208395,0.7081503172279161,0.028062469497315765
2690,,316,33950,34266,4,942,43329,12484,30845,43329,3220,0.007293036996007293,0.7835398924507836,9.231692400009232e-05,0.2881211198042881,0.7118788801957119,0.02174063560202174
2691,,840,28564,29404,71,1447,38489,11286,27203,38489,3051,0.021824417366000676,0.7421341162410039,0.0018446828964119619,0.2932266361817662,0.7067733638182337,0.037595157057860686
2692,17.0,206,6746,6952,16,272,9115,2656,6459,9115,781,0.022600109709270434,0.74009873834339,0.001755348326933626,0.2913878222709819,0.7086121777290181,0.02984092155787164
2693,,431,14328,14759,20,482,18837,5604,13233,18837,1313,0.022880501141370708,0.7606306736741519,0.0010617401921749748,0.2974996018474279,0.702500398152572,0.025587938631416892
2694,15.0,439,13769,14208,115,948,19835,5367,14468,19835,1830,0.022132593899672297,0.6941769599193345,0.005797832114948324,0.27058230400806654,0.7294176959919334,0.04779430299974792
2695,35.0,4861,108382,113243,329,5338,146279,43035,103244,146279,10158,0.033231017439277,0.7409265854975765,0.002249126668899842,0.2941980735443912,0.7058019264556088,0.03649190929661811
2696,15.0,15,1802,1817,9,120,2482,709,1773,2482,233,0.0060435132957292505,0.726027397260274,0.0036261079774375505,0.28565672844480255,0.7143432715551974,0.048348106365834004
2697,,151,2874,3025,4,148,4091,1151,2940,4091,274,0.03691029088242483,0.7025177218284038,0.0009777560498655585,0.2813493033488145,0.7186506966511855,0.03617697384502567
2698,23.0,784,38939,39723,143,997,49319,15335,33984,49319,3625,0.01589651047263732,0.7895334455280926,0.0028994910683509396,0.3109349337983333,0.6890650662016667,0.02021533283318802
2699,27.0,28418,921234,949652,3275,39489,1238264,364895,873369,1238264,106892,0.02294987175594219,0.7439722062500403,0.0026448317967735476,0.29468271709425453,0.7053172829057455,0.03189061460237881
2700,38.0,559,6739,7298,12,388,9381,2819,6562,9381,609,0.05958853000746189,0.7183669118430871,0.0012791813239526704,0.3005010126852148,0.6994989873147852,0.04136019614113634
2701,,61,1470,1531,0,86,2040,590,1450,2040,188,0.029901960784313727,0.7205882352941176,0.0,0.28921568627450983,0.7107843137254902,0.04215686274509804
2702,45.0,51,1821,1872,14,71,2477,718,1759,2477,213,0.020589422688736373,0.7351635042389988,0.005651998385143318,0.2898667743237788,0.7101332256762213,0.02866370609608397
2703,40.0,103,2932,3035,8,201,4158,1184,2974,4158,336,0.02477152477152477,0.7051467051467052,0.001924001924001924,0.28475228475228476,0.7152477152477152,0.048340548340548344
2704,,152,2403,2555,5,149,3684,1060,2624,3684,145,0.04125950054288816,0.6522801302931596,0.0013572204125950054,0.28773072747014117,0.7122692725298588,0.04044516829533116
2705,,2146,41511,43657,493,2682,60289,16556,43733,60289,4324,0.035595216374463,0.6885335633365954,0.008177279437376636,0.27461062548723647,0.7253893745127635,0.04448572708122543
2706,14.0,5256,93311,98567,225,4706,132408,38307,94101,132408,11349,0.03969548667754214,0.7047232795601475,0.0016992930940728658,0.28931031357621895,0.710689686423781,0.035541659114252916
2707,17.0,81,1520,1601,4,128,2182,574,1608,2182,178,0.03712190650779102,0.696608615948671,0.0018331805682859762,0.26306141154903756,0.7369385884509624,0.05866177818515124
2708,16.0,186,3473,3659,49,243,5032,1396,3636,5032,303,0.03696343402225755,0.6901828298887123,0.009737678855325914,0.2774244833068362,0.7225755166931638,0.04829093799682035
2709,14.0,338,7718,8056,6,380,10633,3024,7609,10633,809,0.03178783033950908,0.7258534750305652,0.0005642810119439481,0.2843976300197498,0.7156023699802502,0.03573779742311671
2710,15.0,97,2166,2263,13,110,3031,864,2167,3031,248,0.032002639392939625,0.7146156384031672,0.004289013526888816,0.28505443747937975,0.7149455625206202,0.036291652919828436
2711,38.0,667,16979,17646,62,689,22721,6660,16061,22721,1681,0.029356102284230447,0.7472822499009727,0.002728753135865499,0.2931209013687778,0.7068790986312222,0.030324369525989173
2712,,554,12353,12907,75,1350,18024,4923,13101,18024,1234,0.030736795383932536,0.685363959165557,0.004161118508655127,0.2731358189081225,0.7268641810918774,0.07490013315579228
2713,24.0,67,1679,1746,16,85,2368,675,1693,2368,162,0.028293918918918918,0.7090371621621622,0.006756756756756757,0.28505067567567566,0.7149493243243243,0.03589527027027027
2714,,262,1555,1817,19,303,2741,598,2143,2741,126,0.09558555271798613,0.5673112002918643,0.006931776723823422,0.21816855162349508,0.781831448376505,0.1105435972272893
2715,,134,7367,7501,4,162,9682,2803,6879,9682,823,0.013840115678578806,0.7608965089857468,0.0004131377814501136,0.2895063003511671,0.7104936996488329,0.0167320801487296
2716,,70,2472,2542,0,135,3407,953,2454,3407,249,0.02054593484003522,0.725565013208101,0.0,0.27971822717933664,0.7202817728206633,0.03962430290578221
2717,,60,2238,2298,4,57,2887,894,1993,2887,231,0.020782819535850365,0.7751991686872186,0.0013855213023900243,0.3096640110841704,0.6903359889158296,0.019743678559057846
2718,,73,2286,2359,6,117,3146,869,2277,3146,234,0.023204068658614112,0.7266369993642721,0.0019071837253655435,0.2762237762237762,0.7237762237762237,0.0371900826446281
2719,,177,3313,3490,12,251,5212,1277,3935,5212,319,0.033960092095165005,0.6356485034535687,0.0023023791250959325,0.24501151189562548,0.7549884881043745,0.048158096699923256
2720,,54,1895,1949,0,237,2749,810,1939,2749,193,0.019643506729719897,0.6893415787559113,0.0,0.2946526009457985,0.7053473990542015,0.08621316842488178
2721,,65,1551,1616,0,30,2308,651,1657,2308,178,0.028162911611785094,0.6720103986135182,0.0,0.2820623916811092,0.7179376083188909,0.012998266897746967
2722,48.0,273,9058,9331,32,351,11929,3641,8288,11929,828,0.02288540531477911,0.7593260122390812,0.0026825383519155,0.3052225668538855,0.6947774331461145,0.029424092547573142
2723,,228,4334,4562,54,299,6492,1695,4797,6492,397,0.03512014787430684,0.6675908810844116,0.00831792975970425,0.261090573012939,0.738909426987061,0.04605668515095502
2724,17.0,30,1712,1742,13,130,2427,655,1772,2427,164,0.012360939431396786,0.7053976102183765,0.005356407086938607,0.2698805109188298,0.7301194890811702,0.053564070869386075
2725,26.0,118,2807,2925,20,205,3957,1120,2837,3957,303,0.02982057113975234,0.7093757897397018,0.005054334091483447,0.28304270912307306,0.716957290876927,0.051806924437705335
2726,25.0,8197,194516,202713,922,9942,267359,76817,190542,267359,18392,0.030659151178752165,0.7275461084160249,0.003448546710602598,0.2873178011587416,0.7126821988412584,0.03718595596183409
2727,45.0,1367,36683,38050,105,1389,48786,14614,34174,48788,3334,0.028019185045502992,0.7518857096007215,0.0021521685660408295,0.2995408707059113,0.7004591292940887,0.02847011560219726
2728,24.0,26848,548243,575091,6327,34316,786798,218972,567826,786798,53350,0.034123116733901206,0.6968027371701504,0.008041454096222918,0.27830777404111345,0.7216922259588865,0.04361475245234482
2729,41.0,822,20567,21389,95,586,27105,8174,18931,27105,1929,0.03032650802434975,0.7587898911639919,0.003504888396974728,0.3015679763881203,0.6984320236118797,0.02161962737502306
2730,25.0,1921,40013,41934,169,2645,56357,15981,40376,56357,3985,0.03408627144808986,0.7099916603083911,0.0029987401742463224,0.28356725872562416,0.7164327412743758,0.0469329453306599
2731,17.0,696,19029,19725,33,586,26016,7476,18540,26016,2359,0.026752767527675275,0.7314345018450185,0.001268450184501845,0.2873616236162362,0.7126383763837638,0.02252460024600246
2732,24.0,2102,76671,78773,220,2984,102506,30086,72420,102506,9118,0.020506116715119115,0.7479659727235479,0.0021462158312684134,0.2935047704524613,0.7064952295475386,0.0291104910932043
2733,,90,1873,1963,14,98,2583,716,1867,2583,177,0.03484320557491289,0.7251258226867983,0.005420054200542005,0.2771970576848626,0.7228029423151374,0.037940379403794036
2734,,111,3506,3617,22,129,4829,1402,3427,4829,381,0.022986125491820254,0.7260302340028991,0.004555808656036446,0.29032926071650444,0.7096707392834956,0.026713605301304618
2735,13.0,244,3072,3316,18,418,4631,1275,3356,4631,347,0.052688404232347226,0.6633556467285684,0.003886849492550205,0.2753185057223062,0.7246814942776938,0.09026128266033254
2736,44.0,532,15913,16445,45,1323,22269,6196,16073,22269,1934,0.023889712155911805,0.7145808074004221,0.0020207463289775023,0.2782343167632134,0.7217656832367866,0.059409942071938567
2737,,134,3111,3245,6,190,4554,1296,3258,4554,289,0.029424681598594644,0.6831357048748353,0.0013175230566534915,0.2845849802371542,0.7154150197628458,0.041721563460693896
2738,,854,17980,18834,69,665,24825,7249,17576,24825,1558,0.03440080563947633,0.724269889224572,0.0027794561933534743,0.2920040281973817,0.7079959718026183,0.02678751258811682
2739,26.0,120,4031,4151,18,161,5372,1628,3744,5372,442,0.022338049143708117,0.7503723008190618,0.0033507073715562173,0.30305286671630677,0.6969471332836932,0.029970215934475054
2740,23.0,121,4224,4345,9,379,5725,1464,4261,5725,404,0.0211353711790393,0.7378165938864629,0.0015720524017467249,0.25572052401746725,0.7442794759825327,0.06620087336244541
2741,,310,8476,8786,45,392,11685,3341,8344,11685,800,0.026529738981600343,0.7253744116388532,0.0038510911424903724,0.2859221223791185,0.7140778776208815,0.033547282841249464
2742,25.0,455,7803,8258,35,540,13602,2855,10747,13602,659,0.033450963093662696,0.5736656374062638,0.0025731510072048228,0.2098956035877077,0.7901043964122924,0.03970004411116013
2743,24.0,441,12130,12571,27,542,16763,4804,11959,16763,1409,0.026307940106186242,0.7236174909025831,0.0016106902105828312,0.28658354709777484,0.7134164529022251,0.03233311459762572
2744,,48,1333,1381,5,57,2306,546,1760,2306,151,0.020815264527320035,0.5780572419774501,0.002168256721595837,0.2367736339982654,0.7632263660017347,0.024718126626192542
2745,42.0,559,10411,10970,30,547,14390,4190,10200,14390,963,0.038846421125781794,0.723488533703961,0.0020847810979847115,0.29117442668519805,0.7088255733148019,0.038012508686587905
2746,23.0,6192,75467,81659,430,5344,112554,30278,82276,112554,5802,0.05501359347513193,0.670495939726709,0.003820388435773051,0.26900865362403825,0.7309913463759617,0.04747943209481671
2747,26.0,1780,47711,49491,170,2488,65608,18637,46971,65608,4842,0.02713083770271918,0.7272131447384466,0.0025911474210462138,0.28406596756493113,0.7159340324350689,0.037922204609194
2748,15.0,151,2956,3107,35,214,4116,1165,2951,4116,297,0.03668610301263363,0.718172983479106,0.008503401360544218,0.28304178814382897,0.716958211856171,0.051992225461613216
2749,,187,7656,7843,1,249,10067,3139,6928,10067,772,0.018575543856163702,0.7605046190523492,9.933445912387007e-05,0.31181086718982814,0.6881891328101718,0.024734280321843646
2750,,1977,83373,85350,102,2607,108419,32713,75706,108419,8097,0.01823481124157205,0.7689888303710605,0.0009407945101873288,0.30172755697802045,0.6982724430219795,0.024045600863317314
2751,,359,7419,7778,65,402,11054,2953,8101,11054,696,0.03247693142753754,0.6711597611724263,0.005880224353175321,0.2671431156142573,0.7328568843857427,0.03636692599963814
2752,17.0,225,4535,4760,25,364,6615,1815,4800,6615,481,0.034013605442176874,0.6855631141345427,0.003779289493575208,0.2743764172335601,0.7256235827664399,0.05502645502645503
2753,15.0,1122,26311,27433,193,2719,38202,10095,28107,38202,2637,0.029370190042406156,0.6887335741584211,0.0050520915135333225,0.26425318046175594,0.7357468195382441,0.07117428406889692
2754,17.0,1071,21629,22700,131,1001,30088,8608,21482,30090,2453,0.03559322033898305,0.7188102359587903,0.004353605849119309,0.2860751080093054,0.7139248919906945,0.033266866068461284
2755,,1446,32742,34188,122,1554,45248,13152,32096,45248,3633,0.031957213578500704,0.7236120933521923,0.002696251768033946,0.29066478076379065,0.7093352192362093,0.0343440594059406
2756,16.0,2118,48731,50849,5335,6780,76642,18048,58598,76646,5045,0.02763353599665997,0.6357931268428881,0.06960571980272943,0.23547217075907417,0.7645278292409258,0.08845862797797667
2757,34.0,562,11328,11890,85,471,15720,4592,11128,15720,1261,0.03575063613231552,0.7206106870229008,0.005407124681933842,0.2921119592875318,0.7078880407124682,0.029961832061068703
2758,,2316,24476,26792,111,1042,38330,9960,28370,38330,2168,0.06042264544743021,0.6385598747717193,0.002895903991651448,0.2598486824941299,0.74015131750587,0.02718497260631359
2759,25.0,7355,138961,146316,462,7467,193942,55617,138325,193942,12825,0.037923709150158295,0.7165080281733714,0.002382155489785606,0.28677130276061913,0.7132286972393809,0.03850120139010632
2760,27.0,415,10819,11234,29,578,14550,4331,10219,14550,1065,0.02852233676975945,0.7435738831615121,0.001993127147766323,0.2976632302405498,0.7023367697594501,0.03972508591065292
2761,14.0,830,13020,13850,88,1747,19565,5133,14432,19565,1249,0.042422693585484283,0.6654740608228981,0.0044978277536417074,0.26235624840276,0.7376437515972399,0.08929210324559161
2762,16.0,1011,21020,22031,88,1427,29398,8262,21136,29398,2119,0.03439009456425607,0.7150146268453637,0.002993400911626641,0.28103952649840125,0.7189604735015988,0.048540717055582015
2763,25.0,1263,27653,28916,127,1704,37892,10916,26976,37892,2722,0.03333157394700728,0.7297846511136915,0.003351630951124248,0.2880819170273409,0.7119180829726591,0.04496991449382456
2764,23.0,1119,27985,29104,88,1272,37884,11182,26702,37884,2603,0.02953753563509661,0.7387023545560131,0.0023228803716608595,0.29516418540808786,0.7048358145919121,0.033576179917643334
2765,17.0,82,2235,2317,13,182,3118,825,2293,3118,222,0.026298909557408594,0.7168056446440025,0.004169339320076972,0.2645926876202694,0.7354073123797306,0.058370750481077614
2766,17.0,2181,52446,54627,227,3073,71918,21105,50813,71918,5169,0.03032620484440613,0.7292471981979477,0.003156372535387525,0.2934592174420868,0.7065407825579132,0.042729219388748296
2767,,86,1883,1969,20,81,2707,751,1956,2707,184,0.03176948651643886,0.6956039896564462,0.007388252678241596,0.27742888806797195,0.722571111932028,0.029922423346878464
2768,17.0,567,9549,10116,53,408,13468,3860,9608,13468,905,0.0420997920997921,0.709013959013959,0.003935253935253936,0.2866052866052866,0.7133947133947134,0.030294030294030293
2769,,224,5335,5559,48,314,7606,2103,5503,7606,524,0.02945043386799895,0.7014199316329214,0.006310807257428346,0.27649224296607944,0.7235077570339206,0.041283197475677096
2770,,206,3229,3435,91,206,4907,1316,3591,4907,281,0.04198084369268392,0.6580395353576524,0.018544935805991442,0.268188302425107,0.7318116975748931,0.04198084369268392
2771,14.0,600,7372,7972,52,523,10876,3051,7825,10876,738,0.055167340934166975,0.6778227289444648,0.004781169547627804,0.28052592865023906,0.7194740713497609,0.048087532180948876
2772,,1706,48134,49840,110,2439,65209,19083,46126,65209,4458,0.026162032848226473,0.7381496419205937,0.0016868837123709918,0.29264365348341487,0.7073563465165852,0.037402812495207716
2773,,810,13679,14489,246,1397,21693,5431,16262,21693,1348,0.03733923385423869,0.6305720739409026,0.01134006361499101,0.2503572581016918,0.7496427418983083,0.06439865394366846
2774,24.0,133,4626,4759,11,106,6134,1856,4278,6134,499,0.021682425823280078,0.7541571568307792,0.0017932833387675252,0.30257580697750247,0.6974241930224976,0.01728073035539615
2775,24.0,1556,38338,39941,296,1952,52948,15432,37516,52948,3621,0.029387323411649166,0.7240688977865075,0.005590390571881846,0.29145576792324546,0.7085442320767545,0.03686635944700461
2776,23.0,29,7546,7575,39,530,10100,2768,7332,10100,709,0.0028712871287128712,0.7471287128712871,0.0038613861386138613,0.2740594059405941,0.7259405940594059,0.05247524752475247
2777,17.0,314,5778,6092,36,534,8725,2188,6537,8725,596,0.03598853868194842,0.6622349570200573,0.004126074498567335,0.25077363896848137,0.7492263610315186,0.06120343839541547
2778,13.0,89,2068,2157,23,227,2966,854,2112,2966,247,0.030006743088334457,0.6972353337828725,0.0077545515846257585,0.28792987188132163,0.7120701281186783,0.076534052596089
2779,34.0,167,4704,4871,47,296,6502,1759,4743,6502,459,0.02568440479852353,0.7234697016302676,0.00722854506305752,0.27053214395570596,0.7294678560442941,0.04552445401414949
2780,15.0,1460,46478,47938,146,4155,65255,17628,47627,65255,3871,0.022373764462493295,0.7122519347176461,0.0022373764462493297,0.2701402191402958,0.7298597808597043,0.06367328174086277
2781,23.0,671,16740,17411,175,1078,23824,6553,17271,23824,1797,0.028164875755540632,0.7026527871054399,0.007345533915379449,0.27505876427132303,0.724941235728677,0.04524848891873741
2782,24.0,187,6407,6594,10,473,8999,2486,6513,8999,653,0.020780086676297365,0.7119679964440493,0.00111123458162018,0.27625291699077675,0.7237470830092233,0.05256139571063451
2783,40.0,1733,58823,60556,217,2562,78211,22817,55394,78211,5685,0.02215800846428252,0.752106481185511,0.00277454578000537,0.29173645650867525,0.7082635434913247,0.03275754049941824
2784,16.0,448,9341,9789,19,836,13658,3613,10045,13658,922,0.03280128862205301,0.6839215112022258,0.001391126079953141,0.26453360667740516,0.7354663933225948,0.0612095475179382
2785,14.0,230,11083,11313,60,1207,15621,4289,11332,15621,1066,0.014723769284936943,0.7094936303693745,0.003840983291722681,0.2745662889699763,0.7254337110300236,0.07726778055182126
2786,17.0,336,9243,9579,10,410,12473,3584,8889,12473,1025,0.026938186482802853,0.7410406477992464,0.0008017317405596087,0.28734065581656376,0.7126593441834362,0.032871001362943957
2787,14.0,105,1703,1808,9,104,2548,680,1868,2548,177,0.04120879120879121,0.6683673469387755,0.003532182103610675,0.2668759811616955,0.7331240188383046,0.04081632653061224
2788,,2935,50643,53578,402,3177,75234,20334,54900,75234,4713,0.039011617088018716,0.6731398038121063,0.005343328814100008,0.2702767365818646,0.7297232634181354,0.042228247866656035
2789,25.0,2093,13606,15699,129,785,20865,5941,14924,20865,1438,0.10031152647975078,0.6520968128444764,0.006182602444284687,0.28473520249221185,0.7152647975077882,0.0376228133237479
2790,24.0,8158,203972,212130,871,10232,282197,80849,201348,282197,19140,0.028908882801730706,0.7228000297664398,0.0030864963128594564,0.2864984390337247,0.7135015609662754,0.03625835852259238
2791,26.0,1995,39419,41414,143,2101,54651,15861,38790,54651,3821,0.036504364055552505,0.7212859782986588,0.0026166035388190518,0.29022341768677606,0.7097765823132239,0.038443944301110686
2792,16.0,8280,197025,205305,921,10017,270743,77809,192934,270743,18714,0.030582508135021034,0.7277196455679371,0.003401749999076615,0.28739062505771157,0.7126093749422885,0.03699818647204175
2793,23.0,89,3937,4026,2,298,5351,1549,3802,5351,404,0.01663240515791441,0.7357503270416744,0.00037376191366099795,0.2894786021304429,0.7105213978695571,0.055690525135488694
2794,27.0,292,8982,9274,16,471,12505,3572,8933,12505,958,0.023350659736105558,0.7182726909236306,0.0012794882047181128,0.2856457417033187,0.7143542582966813,0.03766493402638944
2795,,237,5466,5703,24,237,7585,2197,5388,7585,556,0.03124588002636783,0.7206328279499011,0.0031641397495056033,0.2896506262359921,0.7103493737640079,0.03124588002636783
2796,24.0,757,17834,18591,99,935,24774,7029,17745,24774,1809,0.030556228303866957,0.7198676031323161,0.003996124969726326,0.28372487285056913,0.7162751271494309,0.03774118026963752
2797,16.0,8214,118307,126521,473,8765,172360,47393,124967,172360,12066,0.04765606869343235,0.686394755163611,0.002744256207936876,0.27496518913901136,0.7250348108609886,0.0508528660942214
2798,14.0,238,3812,4050,4,328,5866,1541,4325,5866,380,0.0405727923627685,0.6498465734742584,0.0006818956699624957,0.26270030685305146,0.7372996931469485,0.05591544493692465
2799,13.0,220,11307,11527,43,434,15391,4421,10970,15391,1422,0.014294067961795855,0.734650120200117,0.00279384055616919,0.2872457929959067,0.7127542070040933,0.02819829770645182
2800,,13346,279324,292670,1891,12632,392243,111131,281119,392250,26806,0.034024219247928617,0.7121070745697897,0.004820905035054174,0.28331676226896113,0.7166832377310389,0.03220395156150414
2801,,90,3691,3781,0,203,5074,1517,3557,5074,467,0.017737485218762318,0.7274339771383523,0.0,0.29897516752069375,0.7010248324793062,0.040007883326763895
2802,16.0,123,7622,7745,18,309,10439,2902,7537,10439,818,0.01178273781013507,0.7301465657630041,0.0017243030941661078,0.27799597662611364,0.7220040233738864,0.029600536449851517
2803,26.0,7075,168990,176065,756,8259,232225,66750,165475,232225,17427,0.030466142749488643,0.7276994294326623,0.0032554634513941223,0.2874367531488858,0.7125632468511143,0.03556464635590483
2804,33.0,842,15270,16112,142,1219,22236,6188,16048,22236,1376,0.03786652275589135,0.6867242309767944,0.006386040654794028,0.2782874617737003,0.7217125382262997,0.05482101097319662
2805,23.0,1186,24968,26154,171,1257,34302,10134,24168,34302,2518,0.0345752434260393,0.7278875867296367,0.004985132062270421,0.2954346685324471,0.704565331467553,0.03664509358054924
2806,15.0,105,1996,2101,1,115,2819,781,2038,2819,214,0.03724725079815538,0.7080525008868394,0.000354735721887194,0.27704859879389854,0.7229514012061015,0.04079460801702731
2807,,169,3309,3478,8,314,4666,1333,3333,4666,307,0.03621945992284612,0.7091727389627089,0.0017145306472353193,0.28568366909558507,0.7143163309044149,0.06729532790398629
2808,25.0,23,2008,2031,3,70,2620,772,1848,2620,234,0.008778625954198474,0.766412213740458,0.0011450381679389313,0.29465648854961835,0.7053435114503817,0.026717557251908396
2809,,342,6152,6494,25,640,8941,2477,6464,8941,595,0.038250754949110836,0.6880662118331283,0.002796107817917459,0.27703836259926184,0.7229616374007382,0.07158036013868695
2810,25.0,1312,38833,40145,76,2122,52177,15593,36584,52177,3775,0.025145178910247812,0.744255131571382,0.0014565804856545989,0.2988481514843705,0.7011518485156295,0.04066926040209288
2811,27.0,511,9170,9681,12,661,13511,3617,9894,13511,911,0.037821034712456514,0.6787062393605211,0.0008881651987269632,0.26770779364961883,0.7322922063503812,0.04892309969654356
2812,33.0,2128,43102,45230,207,2213,60269,17007,43262,60269,4342,0.035308367485772124,0.7151603643664238,0.0034346015364449386,0.2821848711609617,0.7178151288390383,0.036718711111848545
2813,23.0,2543,90386,92929,407,3952,119734,35728,84007,119735,8149,0.021238568505449536,0.7548837015074957,0.003399173174092788,0.29839228295819936,0.7016077170418007,0.03300622207374619
2814,47.0,59,2424,2483,8,101,3229,945,2284,3229,279,0.018271910808299784,0.7506968101579437,0.0024775472282440383,0.292660266336327,0.707339733663673,0.03127903375658098
2815,23.0,96,1673,1769,0,167,2483,671,1812,2483,186,0.038662907772855415,0.6737817156665324,0.0,0.270237615787354,0.7297623842126459,0.06725734997986307
2816,26.0,82,2290,2372,8,121,3144,868,2276,3144,233,0.02608142493638677,0.7283715012722646,0.002544529262086514,0.27608142493638677,0.7239185750636132,0.03848600508905852
2817,15.0,219,4066,4285,131,325,6041,1586,4455,6041,355,0.03625227611322629,0.6730673729514981,0.02168515146498924,0.2625393146829995,0.7374606853170005,0.05379903989405727
2818,23.0,19,2648,2667,14,142,3597,1025,2572,3597,358,0.0052821795941062,0.7361690297470114,0.003892132332499305,0.2849596886294134,0.7150403113705865,0.03947734222963581
2819,25.0,2518,54152,56670,191,2815,77576,21427,56149,77576,5625,0.032458492317211506,0.6980509435908013,0.002462101680932247,0.27620655872950395,0.723793441270496,0.036286995978137566
2820,15.0,495,18394,18889,58,694,24918,7052,17866,24918,2231,0.019865157717312787,0.7381812344489928,0.0023276346416245285,0.28300826711614097,0.7169917328838591,0.02785135243599005
2821,16.0,4420,29791,34211,128,3741,47531,13063,34468,47531,2611,0.09299194210094465,0.6267698975405525,0.002692979318760388,0.27483116282005426,0.7251688371799457,0.0787065283709579
2822,16.0,960,19112,20072,200,1318,26936,7641,19295,26936,1850,0.03564003564003564,0.7095337095337095,0.007425007425007425,0.28367240867240867,0.7163275913275913,0.04893079893079893
2823,40.0,2195,37315,39510,325,2356,53298,14714,38587,53301,3213,0.04118121611226806,0.7000806739085571,0.0060974465769872985,0.2760548582578188,0.7239451417421812,0.04420179733963715
2824,16.0,859,21375,22234,26,1304,29630,8436,21194,29630,2091,0.028990887613904826,0.7213972325345933,0.0008774890313871076,0.28471144110698615,0.7152885588930138,0.044009449881876474
2825,,403,10396,10799,126,775,14535,3984,10551,14535,946,0.027726178190574477,0.7152390780873753,0.0086687306501548,0.2740970072239422,0.7259029927760577,0.053319573443412455
2826,16.0,1623,21023,22646,138,1496,31099,8633,22466,31099,2036,0.05218817325315927,0.6760024438084826,0.004437441718383227,0.27759735039711886,0.7224026496028811,0.04810444065725586
2827,26.0,6720,132576,139296,859,7304,185794,52385,133409,185794,11887,0.03616909049807852,0.7135644853978061,0.004623400109799025,0.2819520544258695,0.7180479455741305,0.039312356696125816
2828,27.0,1396,28952,30348,122,839,40076,11531,28545,40076,2922,0.03483381575007486,0.7224273879628705,0.0030442159896197224,0.28772831619922146,0.7122716838007785,0.020935223076155304
2829,,991,30263,31254,92,1418,41249,11966,29283,41249,3320,0.024024824844238648,0.7336662706974715,0.00223035709956605,0.2900918810152973,0.7099081189847026,0.03437659094765934
2830,24.0,385,11588,11973,29,248,14921,4601,10320,14921,1161,0.025802560150123985,0.7766235507003552,0.0019435694658534951,0.30835734870317005,0.69164265129683,0.01662086991488506
2831,,272,4378,4650,22,239,6116,1878,4238,6116,370,0.04447351209941138,0.7158273381294964,0.0035971223021582736,0.30706344015696535,0.6929365598430347,0.03907782864617397
2832,15.0,1493,19290,20783,79,1346,27663,7772,19891,27663,1908,0.053971008205906806,0.6973213317427611,0.002855800166287098,0.28095289737194085,0.7190471026280592,0.048657050934461196
2833,16.0,377,18926,19303,71,907,27041,7459,19582,27041,2321,0.013941792093487667,0.6999001516216117,0.0026256425428053697,0.27584039051810216,0.7241596094818978,0.033541658962316485
2834,27.0,40,1942,1982,0,66,2519,764,1755,2519,200,0.015879317189360857,0.7709408495434696,0.0,0.3032949583167924,0.6967050416832076,0.026200873362445413
2835,26.0,443,11617,12060,104,640,16177,4598,11579,16177,1181,0.027384558323545773,0.7181183161278358,0.006428880509365148,0.28423069790443223,0.7157693020955678,0.03956234159609322
2836,13.0,91,2242,2333,12,155,3201,882,2319,3201,239,0.028428616057482037,0.7004061230865355,0.0037488284910965324,0.2755388940955951,0.7244611059044048,0.04842236800999688
2837,,533,8759,9292,114,589,12665,3498,9167,12665,905,0.042084484800631664,0.6915909988156337,0.009001184366363995,0.2761942360836952,0.7238057639163048,0.04650611922621398
2838,,304,5949,6253,6,300,9078,2451,6627,9078,621,0.03348755232430051,0.6553205551883675,0.0006609385327164573,0.2699933906146728,0.7300066093853271,0.03304692663582287
2839,,113,2204,2317,11,126,3078,929,2149,3078,210,0.036712150747238464,0.7160493827160493,0.0035737491877842753,0.301819363222872,0.698180636777128,0.04093567251461988
2840,,310,9889,10199,48,659,13467,3785,9682,13467,957,0.02301923219722284,0.7343135070914086,0.0035642682111828917,0.2810573995693176,0.7189426004306824,0.048934432316031784
2841,,826,14598,15424,112,1972,21379,4745,16634,21379,1136,0.038636044716778145,0.6828195893166191,0.005238785724308901,0.2219467701950512,0.7780532298049487,0.09224004864586743
2842,26.0,294,5574,5868,24,365,8780,2212,6568,8780,513,0.03348519362186788,0.6348519362186789,0.002733485193621868,0.2519362186788155,0.7480637813211846,0.041571753986332574
2843,36.0,92,3040,3132,20,142,4141,1216,2925,4141,319,0.022216855831924655,0.7341221927070756,0.004829751267809708,0.2936488770828302,0.7063511229171697,0.03429123400144893
2844,26.0,70,2105,2175,13,104,2942,839,2103,2942,233,0.02379333786539769,0.7154996600951734,0.004418762746430999,0.2851801495581237,0.7148198504418762,0.03535010197144799
2845,27.0,846,20219,21065,475,1142,29396,7916,21480,29396,1852,0.028779425772213908,0.687814668662403,0.016158661042318685,0.2692883385494625,0.7307116614505375,0.03884882296911144
2846,,65,2043,2108,1,107,2762,795,1967,2762,229,0.023533671252715424,0.7396813902968863,0.0003620564808110065,0.28783490224475017,0.7121650977552498,0.0387400434467777
2847,17.0,26,8038,8064,154,480,10989,2986,8003,10989,650,0.002366002366002366,0.7314587314587314,0.014014014014014014,0.27172627172627173,0.7282737282737283,0.04368004368004368
2848,35.0,4038,119111,123149,1446,4232,160459,47097,113362,160459,12680,0.025165307025470682,0.7423142360353735,0.009011647835272562,0.2935142310496762,0.7064857689503238,0.02637433861609508
2849,,13356,366255,379611,1754,18820,493552,145683,347869,493552,35886,0.02706097837715175,0.7420798618990502,0.0035538301941841995,0.2951725451421532,0.7048274548578468,0.038131747009433656
2850,,3203,45937,49140,312,3334,66076,18655,47421,66076,4435,0.048474483927598525,0.6952146013681215,0.0047218354621950485,0.28232641201041225,0.7176735879895878,0.05045704945819965
2851,17.0,196,4727,4923,15,322,6749,1857,4892,6749,457,0.02904133945769744,0.7004000592680397,0.002222551489109498,0.2751518743517558,0.7248481256482442,0.047710771966217216
2852,14.0,284,20050,20334,20,1601,27392,7738,19654,27392,2361,0.010367990654205607,0.7319655373831776,0.0007301401869158878,0.282491238317757,0.717508761682243,0.05844772196261682
2853,15.0,665,43805,44470,302,2265,59427,16980,42447,59427,5248,0.011190199740858532,0.737122856613997,0.005081865145472596,0.2857287091725983,0.7142712908274017,0.03811398859104447
2854,23.0,207,4863,5070,13,248,6685,1886,4799,6685,493,0.030964846671652953,0.7274495138369484,0.0019446522064323112,0.2821241585639491,0.7178758414360509,0.03709798055347793
2855,,200,4071,4271,8,307,5997,1617,4380,5997,417,0.03335000833750208,0.678839419709855,0.0013340003335000834,0.2696348174087044,0.7303651825912957,0.0511922627980657
2856,17.0,3857,50281,54138,443,3314,74762,20469,54293,74762,3919,0.051590380139643136,0.6725475508948396,0.00592547015863674,0.2737888231989513,0.7262111768010486,0.04432733206709291
2857,,4440,67665,72105,942,5250,102155,27638,74517,102155,7017,0.04346336449512995,0.662375801478146,0.009221281386128922,0.2705496549361265,0.7294503450638735,0.05139249180167393
2858,15.0,687,13615,14302,136,1135,19781,5345,14436,19781,1174,0.034730296749405996,0.688286739800819,0.0068752843637834285,0.2702087862089884,0.7297912137910115,0.057378292300692586
2859,,203,5463,5666,12,190,7558,2103,5455,7558,594,0.026858957396136543,0.7228102672664726,0.0015877216194760519,0.2782482138131781,0.7217517861868219,0.025138925641704155
2860,14.0,120,2262,2382,30,108,3308,908,2400,3308,241,0.036275695284159616,0.6837968561064087,0.009068923821039904,0.27448609431680776,0.7255139056831923,0.032648125755743655
2861,,67,1787,1854,4,78,2474,701,1773,2474,161,0.027081649151172192,0.7223120452708165,0.0016168148746968471,0.28334680679062246,0.7166531932093775,0.03152789005658852
2862,26.0,174,3575,3749,10,113,5109,1454,3655,5109,359,0.03405754550792719,0.6997455470737913,0.0019573302016050106,0.2845958113133686,0.7154041886866315,0.022117831278136622
2863,25.0,2916,86959,89875,209,4458,120227,34152,86075,120227,9806,0.024254119291007844,0.7232901095427816,0.001738378234506392,0.2840626481572359,0.7159373518427641,0.03707985726999759
2864,41.0,1935,37214,39149,286,1780,51452,14757,36695,51452,3622,0.03760786752701547,0.7232760631267978,0.005558578869626059,0.2868110083184327,0.7131889916815672,0.034595351006763586
2865,,2083,50526,52609,205,2600,71240,19730,51510,71240,5384,0.02923919146546884,0.7092363840539023,0.0028775968556990455,0.2769511510387423,0.7230488489612578,0.0364963503649635
2866,17.0,1327,29123,30450,105,1993,40802,11610,29192,40802,2418,0.03252291554335572,0.7137640311749424,0.0025734032645458554,0.2845448752512132,0.7154551247487868,0.04884564482133229
2867,,96,12508,12604,12,1316,17146,4355,12791,17146,1214,0.005598973521521055,0.729499591741514,0.0006998716901901318,0.2539951008981687,0.7460048991018313,0.07675259535751779
2868,25.0,3,2858,2861,5,140,3736,1076,2660,3736,318,0.0008029978586723769,0.7649892933618844,0.0013383297644539614,0.2880085653104925,0.7119914346895075,0.03747323340471092
2869,33.0,878,8994,9872,54,701,13258,3720,9538,13258,769,0.0662241665409564,0.6783828631769497,0.004073012520742193,0.2805853069844622,0.7194146930155378,0.05287373661185699
2870,36.0,273,5684,5957,9,266,7921,2305,5616,7921,566,0.034465345284686276,0.7175861633632117,0.0011362201742204268,0.2909986112864537,0.7090013887135462,0.033581618482514834
2871,33.0,10864,196659,207523,772,9993,272709,79812,192897,272709,20096,0.03983733576816313,0.7211313157981585,0.0028308563340410475,0.2926636084617669,0.707336391538233,0.03664345511149247
2872,25.0,307,6201,6508,81,451,8975,2571,6404,8975,595,0.03420612813370474,0.6909192200557103,0.009025069637883009,0.2864623955431755,0.7135376044568245,0.05025069637883008
2873,25.0,1753,36524,38277,112,1521,49994,14612,35382,49994,3780,0.03506420770492459,0.7305676681201744,0.0022402688322598714,0.29227507300876104,0.7077249269912389,0.03042365083810057
2874,27.0,591,7306,7897,111,651,11378,3170,8208,11378,388,0.051942344876076636,0.6421163649147478,0.009755668834593074,0.278607839690631,0.7213921603093689,0.05721567938126208
2875,35.0,718,15864,16582,60,749,21793,6410,15383,21793,1400,0.03294635892258982,0.7279401642729316,0.0027531776258431606,0.29413114302757765,0.7058688569724223,0.03436883402927546
2876,16.0,643,11251,11894,40,1264,16290,4552,11738,16290,1001,0.03947206875383671,0.6906691221608349,0.0024554941682013503,0.2794352363413137,0.7205647636586863,0.07759361571516267
2877,14.0,64,2091,2155,5,63,2850,798,2052,2850,261,0.02245614035087719,0.7336842105263158,0.0017543859649122807,0.28,0.72,0.022105263157894735
2878,36.0,399,11504,11903,8,658,15298,4525,10773,15298,1052,0.026081840763498496,0.7519937246698915,0.0005229441757092431,0.2957902993855406,0.7042097006144594,0.04301215845208524
2879,14.0,829,19919,20748,70,3563,30029,7928,22101,30029,2053,0.027606646907988943,0.6633254520630057,0.0023310799560424924,0.2640114555929268,0.7359885444070732,0.11865196976256286
2880,23.0,3986,104038,108024,440,5242,144170,41331,102839,144170,10045,0.027647915655129363,0.7216341818686273,0.0030519525560102657,0.28668238884650066,0.7133176111534993,0.03635985295137684
2881,24.0,274,1725,1999,21,152,2906,745,2161,2906,161,0.09428768066070199,0.5935994494150034,0.0072264280798348245,0.25636613902271166,0.7436338609772883,0.05230557467309016
2882,13.0,217,3295,3512,13,187,4785,1362,3423,4785,352,0.04535005224660397,0.6886102403343782,0.002716823406478579,0.2846394984326019,0.7153605015673982,0.03908045977011494
2883,,374,3289,3670,83,710,5419,1089,4330,5419,110,0.06901642369440857,0.6069385495478871,0.015316479055176233,0.2009595866396014,0.7990404133603985,0.13102048348403764
2884,25.0,423,8349,8772,95,611,12252,3285,8967,12252,904,0.034524975514201764,0.681439764936337,0.007753836108390467,0.26811949069539665,0.7318805093046034,0.04986940907606921
2885,16.0,499,5093,5592,363,461,8197,2023,6174,8197,367,0.06087593021837258,0.6213248749542516,0.04428449432719288,0.24679760888129804,0.753202391118702,0.05624008783701354
2886,,159,5545,5704,48,238,7514,2126,5388,7514,564,0.021160500399254725,0.7379558158104871,0.006388075592227841,0.2829385147724248,0.7170614852275752,0.03167420814479638
2887,23.0,61,1863,1924,5,124,2643,742,1901,2643,192,0.0230798335225123,0.7048808172531215,0.0018917896329928112,0.28074158153613316,0.7192584184638668,0.04691638289822172
2888,,344,8328,8672,55,577,11836,3249,8587,11836,763,0.029063872930043935,0.7036160865157147,0.004646840148698885,0.27450152078404866,0.7254984792159513,0.04874957755998648
2889,,59,1722,1781,2,90,2382,714,1668,2382,187,0.02476910159529807,0.7229219143576826,0.0008396305625524769,0.29974811083123426,0.7002518891687658,0.037783375314861464
2890,25.0,828,35929,36757,194,1837,48260,13671,34589,48260,3389,0.017157065893079155,0.7444881889763779,0.004019892250310816,0.28327807708246994,0.71672192291753,0.038064649813510154
2891,23.0,101,2700,2801,19,106,3621,1080,2541,3621,241,0.027892847279756973,0.7456503728251864,0.005247169290251312,0.2982601491300746,0.7017398508699254,0.02927368130350732
2892,26.0,4571,90309,94880,368,5071,126227,35375,90860,126235,10392,0.036210242801124885,0.7154038103537054,0.0029151978452885492,0.28023131461163703,0.719768685388363,0.040171109438745196
2893,25.0,268,7039,7307,13,475,9901,2723,7178,9901,725,0.02706797293202707,0.710938289061711,0.001312998687001313,0.27502272497727503,0.724977275022725,0.04797495202504797
2894,15.0,4005,45409,49414,377,5723,71288,18186,53102,71288,2411,0.056180563348670186,0.6369795758051846,0.005288407586129503,0.2551060487038492,0.7448939512961509,0.08027999102233195
2895,,1412,20469,21881,48,2638,30656,8390,22266,30656,1974,0.04605949895615866,0.6676996346555324,0.0015657620041753654,0.2736821503131524,0.7263178496868476,0.0860516701461378
2896,15.0,23,4202,4225,21,409,5724,1605,4119,5724,369,0.004018169112508735,0.7341020265548568,0.003668763102725367,0.280398322851153,0.7196016771488469,0.07145352900069882
2897,,1,16015,16016,11,710,21169,6125,15044,21169,2135,4.723888705182106e-05,0.7565307761349143,0.0005196277575700316,0.289338183192404,0.710661816807596,0.03353960980679295
2898,,130,2674,2804,7,118,3665,1069,2596,3665,323,0.03547066848567531,0.7296043656207367,0.0019099590723055935,0.2916780354706685,0.7083219645293315,0.03219645293315143
2899,,508,13789,14297,72,1889,20245,5357,14888,20245,1474,0.025092615460607558,0.6811064460360583,0.003556433687330205,0.2646085453198321,0.735391454680168,0.09330698938009385
2900,,35,1727,1762,1,145,2423,709,1714,2423,190,0.014444903012794058,0.7127527858027239,0.0004127115146512588,0.2926124638877425,0.7073875361122576,0.05984316962443252
2901,23.0,311,6128,6439,21,217,8419,2507,5912,8419,670,0.03694025418695807,0.7278774201211545,0.002494357999762442,0.29777883359068774,0.7022211664093123,0.0257750326642119
2902,23.0,71,2401,2472,6,74,3133,941,2192,3133,194,0.022661985317586977,0.7663581232045963,0.001915097350781998,0.3003511011809767,0.6996488988190233,0.023619533992977976
2903,24.0,1722,29201,30923,373,2548,44090,11717,32373,44090,2691,0.03905647539124518,0.6623043774098435,0.008459968246767974,0.2657518711726015,0.7342481288273985,0.057790882286232706
2904,27.0,532,12625,13157,92,491,17578,4980,12598,17578,1194,0.030265104107406987,0.7182273296165662,0.00523381499601775,0.2833086813061782,0.7166913186938219,0.027932643076572988
2905,15.0,440,9722,10162,49,569,13787,3871,9916,13787,1039,0.03191412199898455,0.7051570319866541,0.003554072677159643,0.2807717414956118,0.7192282585043882,0.041270762312323205
2906,,3743,141726,145469,342,5057,184401,55620,128781,184401,13348,0.020298154565322316,0.7685750077277238,0.0018546537166284347,0.30162526233588755,0.6983747376641124,0.027423929371315773
2907,16.0,3973,80864,84837,470,5875,122082,32166,89916,122082,7919,0.03254370013597418,0.6623744696187808,0.0038498713979128784,0.2634786455005652,0.7365213544994348,0.04812339247391098
2908,,400,13247,13647,51,724,17919,5179,12740,17919,1344,0.022322674256375914,0.7392711646855293,0.002846140967687929,0.28902282493442716,0.7109771750655729,0.04040404040404041
2909,15.0,77,2756,2833,5,361,3977,1093,2884,3977,306,0.019361327633894896,0.692984661805381,0.001257229067136032,0.27483027407593663,0.7251697259240634,0.09077193864722152
2910,36.0,122,3811,3933,35,159,5100,1499,3601,5100,396,0.02392156862745098,0.7472549019607844,0.006862745098039216,0.293921568627451,0.706078431372549,0.031176470588235295
2911,13.0,317,7958,8275,59,1853,12969,3156,9813,12969,752,0.024442902305497727,0.6136170868995297,0.004549309892821343,0.2433495257922739,0.7566504742077261,0.14287917341352455
2912,26.0,1622,43072,44694,592,1239,57723,17039,40684,57723,4948,0.02809971761689448,0.7461843632520833,0.010255877206659391,0.29518562791261715,0.7048143720873828,0.021464580842991528
2913,,205,7387,7592,12,296,9845,2868,6977,9845,765,0.020822752666328086,0.7503301168105637,0.0012188928390045707,0.29131538852209243,0.7086846114779076,0.030066023362112747
2914,16.0,1416,19578,20994,165,1404,29809,7988,21821,29809,1827,0.04750243215136368,0.6567815089402529,0.00553524103458687,0.26797275990472674,0.7320272400952732,0.047099869167030094
2915,17.0,1063,24564,25627,176,1820,34529,9792,24737,34529,2293,0.030785716354368792,0.7114020099047178,0.005097164702134438,0.2835877088823887,0.7164122911176113,0.052709316806162934
2916,27.0,270,6188,6458,36,325,8530,2483,6047,8530,681,0.031652989449003514,0.7254396248534584,0.004220398593200469,0.2910902696365768,0.7089097303634232,0.038100820633059786
2917,23.0,73,8353,8426,18,346,11171,3219,7952,11171,1058,0.006534777549010832,0.7477396831080476,0.0016113150120848625,0.28815683466117625,0.7118431653388237,0.030973055232297913
2918,23.0,102,3589,3691,8,129,4875,1360,3515,4875,457,0.020923076923076923,0.7362051282051282,0.001641025641025641,0.27897435897435896,0.721025641025641,0.02646153846153846
2919,,795,16667,17462,279,699,23906,6570,17336,23906,1956,0.03325524972810173,0.6971889902116624,0.011670710281937589,0.274826403413369,0.7251735965866309,0.029239521459047936
2920,26.0,179,3608,3787,7,178,5022,1462,3560,5022,352,0.0356431700517722,0.7184388689765033,0.0013938669852648347,0.2911190760653126,0.7088809239346874,0.03544404619673437
2921,,398,9156,9666,54,535,13195,3690,9505,13195,872,0.030162940507768094,0.6938992042440318,0.004092459264873058,0.279651383099659,0.720348616900341,0.04054566123531641
2922,,358,15610,15968,261,1846,23132,6163,16969,23132,1244,0.015476396334082656,0.6748227563548331,0.011283071070378696,0.26642745979595367,0.7335725402040464,0.07980287048244855
2923,27.0,54,2099,2153,4,66,2813,808,2005,2813,217,0.019196587273373623,0.746178457163171,0.0014219694276573053,0.2872378243867757,0.7127621756132243,0.02346249555634554
2924,24.0,1173,25360,26533,42,1529,35797,10167,25630,35797,2658,0.03276810905941839,0.7084392546861469,0.0011732826773193283,0.2840182138168003,0.7159817861831997,0.04271307651479174
2925,,196,3600,3796,28,106,5003,1475,3528,5003,335,0.03917649410353788,0.7195682590445732,0.0055966420147911256,0.29482310613631824,0.7051768938636818,0.021187287627423546
2926,,84,2526,2610,9,134,3591,989,2602,3591,277,0.023391812865497075,0.7034252297410192,0.002506265664160401,0.2754107490949596,0.7245892509050403,0.037315510999721524
2927,,103,13705,13808,81,1471,19010,5246,13764,19010,815,0.005418200946870068,0.7209363492898474,0.004260915307732772,0.2759600210415571,0.724039978958443,0.07738032614413466
2928,34.0,131,3710,3841,7,129,4900,1511,3389,4900,376,0.026734693877551022,0.7571428571428571,0.0014285714285714286,0.3083673469387755,0.6916326530612245,0.026326530612244898
2929,,114,2465,2579,4,116,3465,993,2472,3465,333,0.0329004329004329,0.7113997113997114,0.0011544011544011544,0.2865800865800866,0.7134199134199134,0.03347763347763348
2930,,660,10436,11096,116,755,15184,4263,10921,15184,1136,0.043466807165437306,0.6873024236037935,0.007639620653319284,0.2807560590094837,0.7192439409905164,0.04972339304531086
2931,15.0,401,39612,40013,133,3336,54416,15079,39337,54416,3937,0.007369156130549838,0.72794766245222,0.0024441340782122905,0.277105998235813,0.722894001764187,0.06130549838282858
2932,15.0,73,5526,5599,12,199,7532,2145,5387,7532,656,0.009691980881571959,0.7336696760488582,0.0015932023366967605,0.28478491768454595,0.715215082315454,0.026420605416887944
2933,24.0,1487,38374,39994,185,1985,51607,14954,36653,51607,3714,0.028813920592167728,0.7435812971108571,0.003584785009785494,0.2897668920882826,0.7102331079117175,0.0384637742941849
2934,17.0,2462,70146,72608,260,4997,97487,27373,70114,97487,7813,0.02525464933786043,0.7195420927918594,0.0026670222696359514,0.280786156102865,0.719213843897135,0.05125811646681096
2935,,97,1953,2050,5,127,2777,798,1979,2777,199,0.03492978033849478,0.7032769175369104,0.0018005041411595247,0.28736046092906015,0.7126395390709399,0.045732805185451926
2936,23.0,1071,123579,124650,277,5651,164363,47064,117301,164365,13446,0.00651598576339245,0.7518571472028717,0.0016852736288139201,0.2863383323700301,0.7136616676299699,0.0343807988318681
2937,,253,9502,9755,56,492,13052,3630,9422,13052,1036,0.019384002451731535,0.7280110327919093,0.004290530186944529,0.2781182960465829,0.7218817039534171,0.03769537235672694
2938,,5451,85191,90642,369,5944,122867,33265,89609,122874,8343,0.044362517701059624,0.6933199863274574,0.003003076322086039,0.27072448198968047,0.7292755180103195,0.04837475788205804
2939,14.0,169,1625,1794,5,101,2569,678,1891,2569,200,0.06578435188789412,0.632541845075905,0.001946282600233554,0.2639159205916699,0.7360840794083301,0.039314908524717786
2940,23.0,210,15564,15774,57,621,20721,5939,14782,20721,1664,0.01013464601129289,0.7511220500941074,0.002750832488779499,0.2866174412431832,0.7133825587568168,0.02996959606196612
2941,,240,4592,4832,13,912,7028,1334,5694,7028,236,0.03414911781445646,0.6533864541832669,0.0018497438816163915,0.18981217985202048,0.8101878201479795,0.12976664769493454
2942,16.0,186,3972,4158,0,230,5616,1604,4012,5616,432,0.03311965811965812,0.7072649572649573,0.0,0.28561253561253563,0.7143874643874644,0.04095441595441596
2943,17.0,268,6615,6883,6,244,9471,2621,6850,9471,780,0.028296906345686833,0.6984478935698448,0.0006335128286347799,0.27673952064195967,0.7232604793580404,0.025762855031147714
2944,24.0,1531,46666,48197,229,2136,64202,18192,46010,64202,5184,0.023846609139902185,0.7268620915236286,0.0035668670757920315,0.2833556587022211,0.7166443412977789,0.03326999158904707
2945,37.0,101,4948,5049,15,209,6581,1932,4649,6581,577,0.015347211669958973,0.751861419237198,0.002279288861875095,0.29357240540951224,0.7064275945904878,0.03175809147545966
2946,25.0,514,10525,11039,48,595,14567,4070,10497,14567,1100,0.035285233747511496,0.7225235120477792,0.0032951191048259765,0.27939864076336923,0.7206013592366307,0.04084574723690534
2947,,284,6356,6640,18,325,8862,2543,6319,8862,688,0.032046941999548634,0.717219589257504,0.002031144211238998,0.2869555405100429,0.7130444594899571,0.0366734371473708
2948,26.0,901,35031,35932,56,1347,46422,13617,32805,46422,3863,0.019408900952134763,0.7546206540002585,0.001206324587480074,0.29333074835207446,0.7066692516479256,0.029016414630993925
2949,17.0,309,6022,6331,68,368,8829,2385,6444,8829,731,0.03499830105334693,0.6820704496545476,0.007701891493940424,0.2701325178389399,0.7298674821610601,0.041680824555442295
2950,23.0,98,2723,2821,0,119,3630,1058,2572,3630,252,0.02699724517906336,0.750137741046832,0.0,0.29146005509641876,0.7085399449035813,0.03278236914600551
2951,40.0,74,2563,2637,8,79,3384,990,2394,3384,254,0.02186761229314421,0.7573877068557919,0.002364066193853428,0.2925531914893617,0.7074468085106383,0.0233451536643026
2952,,165,6288,6453,38,314,8476,2428,6048,8476,516,0.019466729589428976,0.7418593676262388,0.004483246814535158,0.2864558754129306,0.7135441245870694,0.03704577630957999
2953,27.0,328,11119,11447,4,490,14758,4421,10350,14771,1153,0.02220567327872182,0.7527587841039876,0.000270800893642949,0.2993026876988694,0.7006973123011306,0.03317310947126126
2954,26.0,391,9368,9759,70,419,13010,3743,9267,13010,954,0.03005380476556495,0.7200614911606457,0.005380476556495004,0.28770176787086854,0.7122982321291315,0.032205995388162954
2955,13.0,63,1784,1847,33,231,2753,685,2068,2753,197,0.022884126407555393,0.6480203414456956,0.01198692335633854,0.2488194696694515,0.7511805303305485,0.08390846349436978
2956,25.0,119,3748,3867,12,117,5142,1494,3648,5142,408,0.023142746013224427,0.7288992609879424,0.002333722287047841,0.29054842473745623,0.7094515752625438,0.022753792298716453
2957,37.0,187,4605,4792,16,195,6203,1839,4364,6203,472,0.0301467032081251,0.7423827180396583,0.0025793970659358373,0.2964694502660003,0.7035305497339996,0.031436401741093016
2958,24.0,44,2686,2730,0,70,3486,1058,2428,3486,256,0.012621916236374068,0.7705106138841079,0.0,0.30349971313826735,0.6965002868617326,0.020080321285140562
2959,25.0,92,4154,4246,31,130,5571,1620,3951,5571,470,0.01651409082749955,0.7456471010590559,0.005564530604918327,0.29079159935379645,0.7092084006462036,0.023335128343205887
2960,15.0,193,8203,8396,53,510,11353,3157,8196,11353,872,0.01699991191755483,0.7225402977186647,0.004668369593939928,0.27807627939751606,0.7219237206024839,0.04492204703602572
2961,25.0,955,15960,16915,191,1061,23262,6369,16893,23262,1586,0.04105407961482246,0.6860974980655146,0.008210815922964491,0.2737941707505803,0.7262058292494197,0.04561086750924254
2962,,352,5166,5518,17,392,7526,2096,5430,7526,611,0.04677119319691735,0.6864204092479405,0.002258836035078395,0.2785011958543715,0.7214988041456285,0.05208610151474887
2963,27.0,325,4972,5297,29,336,7062,1979,5083,7062,427,0.04602095723591051,0.7040498442367601,0.00410648541489663,0.2802322288303597,0.7197677711696403,0.0475785896346644
2964,17.0,70,5432,5502,0,277,7347,2249,5098,7347,422,0.009527698380291275,0.739349394310603,0.0,0.30611133796107254,0.6938886620389274,0.03770246359058119
2965,23.0,111,3054,3165,7,89,4212,1200,3012,4212,402,0.026353276353276354,0.7250712250712251,0.0016619183285849952,0.2849002849002849,0.7150997150997151,0.021130104463437795
2966,,82,2889,2971,8,67,3768,1118,2650,3768,252,0.02176220806794055,0.76671974522293,0.0021231422505307855,0.29670912951167727,0.7032908704883227,0.01778131634819533
2967,25.0,54,1527,1581,5,72,2082,589,1493,2082,183,0.025936599423631124,0.7334293948126801,0.0024015369836695487,0.2829010566762728,0.7170989433237271,0.0345821325648415
2968,,55,2233,2288,0,70,2860,883,1977,2860,206,0.019230769230769232,0.7807692307692308,0.0,0.30874125874125874,0.6912587412587412,0.024475524475524476
2969,,4082,109722,113859,739,7808,154174,42357,111817,154174,10490,0.026476578411405296,0.711676417554192,0.004793285508581213,0.2747350396305473,0.7252649603694526,0.050644077470909495
2970,33.0,38,1712,1750,1,33,2241,675,1566,2241,186,0.016956715751896476,0.7639446675591254,0.0004462293618920125,0.30120481927710846,0.6987951807228916,0.014725568942436412
2971,16.0,189,3206,3395,0,162,4594,1283,3311,4594,353,0.04114061819764911,0.6978667827601219,0.0,0.2792773182411842,0.7207226817588158,0.035263387026556375
2972,,144,7451,7595,44,723,10680,2808,7872,10680,765,0.01348314606741573,0.6976591760299625,0.004119850187265918,0.26292134831460673,0.7370786516853932,0.06769662921348314
2973,33.0,2041,27944,29985,104,2098,39941,11212,28729,39941,2774,0.051100373050249115,0.6996319571367767,0.002603840664980847,0.28071405322851206,0.7192859467714879,0.05252747803009439
2974,,52,1457,1509,6,60,1963,564,1399,1963,185,0.026490066225165563,0.7422312786551197,0.003056546102903719,0.2873153336729496,0.7126846663270504,0.030565461029037188
2975,,1388,27922,29310,508,2124,40442,11338,29104,40442,3116,0.034320755650066766,0.6904208496117897,0.012561198753770833,0.2803521091934128,0.7196478908065872,0.05251965778151427
2976,26.0,973,15678,16651,174,1147,23746,6311,17435,23746,1370,0.040975322159521606,0.6602375136865156,0.0073275499031415815,0.26577107723406046,0.7342289227659395,0.048302872062663184
2977,24.0,151,6273,6424,29,245,8450,2481,5969,8450,725,0.0178698224852071,0.7423668639053255,0.0034319526627218937,0.2936094674556213,0.7063905325443787,0.028994082840236687
2978,,244,5291,5535,4,281,7224,2097,5127,7224,558,0.033776301218161685,0.7324197120708749,0.0005537098560354374,0.2902823920265781,0.709717607973422,0.03889811738648948
2979,27.0,236,9124,9360,25,427,12190,3520,8670,12190,1004,0.019360131255127155,0.7484823625922887,0.002050861361771944,0.2887612797374898,0.7112387202625102,0.035028712059064805
2980,17.0,513,12071,12584,16,730,16520,4728,11792,16520,1227,0.03105326876513317,0.7306900726392251,0.0009685230024213075,0.28619854721549637,0.7138014527845037,0.04418886198547216
2981,26.0,918,23877,24795,69,1273,33188,9512,23676,33188,2448,0.027660600216945885,0.7194467879956611,0.002079064722188743,0.2866096179341931,0.713390382065807,0.03835723755574304
2982,17.0,206,8248,8454,4,266,10828,3227,7601,10828,915,0.01902475064647211,0.7617288511267085,0.0003694126339120798,0.2980236424085704,0.7019763575914296,0.024565940155153305
2983,24.0,302,4209,4511,145,561,7200,1642,5558,7200,209,0.041944444444444444,0.5845833333333333,0.02013888888888889,0.22805555555555557,0.7719444444444444,0.07791666666666666
2984,15.0,28,3212,3240,44,80,4293,1234,3059,4293,409,0.006522245515956208,0.7481947356161193,0.010249242953645469,0.2874446773817843,0.7125553226182157,0.01863498718844631
2985,25.0,100,6616,6716,8,530,9021,2635,6386,9021,413,0.011085245538188671,0.7333998448065625,0.0008868196430550937,0.2920962199312715,0.7079037800687286,0.058751801352399956
2986,24.0,641,19312,19953,18,903,26205,7593,18612,26205,1874,0.024460980728868535,0.7369585956878458,0.0006868918145392101,0.2897538637664568,0.7102461362335433,0.03445907269605037
2987,34.0,259,11527,11786,90,322,16175,4585,11590,16175,1253,0.016012364760432767,0.7126429675425039,0.0055641421947449764,0.28346213292117467,0.7165378670788254,0.01990726429675425
2988,,161,2071,2232,20,187,3160,822,2338,3160,153,0.050949367088607596,0.6553797468354431,0.006329113924050633,0.260126582278481,0.7398734177215189,0.05917721518987342
2989,,154,5557,5711,2,194,7469,2177,5292,7469,618,0.020618556701030927,0.7440085687508368,0.0002677734636497523,0.2914714151827554,0.7085285848172446,0.025974025974025976
2990,17.0,5547,199446,204993,1557,12370,277833,77407,200426,277833,23798,0.019965230912094675,0.7178628888576951,0.005604085907721545,0.278609812369301,0.7213901876306991,0.044523148798018955
2991,,53,2462,2515,7,410,3728,942,2786,3728,245,0.014216738197424892,0.6604077253218884,0.0018776824034334764,0.2526824034334764,0.7473175965665236,0.10997854077253219
2992,13.0,185,2006,2191,5,1935,4732,826,3906,4732,190,0.039095519864750634,0.4239222316145393,0.0010566356720202875,0.17455621301775148,0.8254437869822485,0.4089180050718512
2993,24.0,58,1680,1738,7,55,2309,648,1661,2309,189,0.025119099177132957,0.7275877003031616,0.0030316154179298397,0.28064097011693373,0.7193590298830662,0.023819835426591596
2994,27.0,1886,39242,41128,351,1513,54671,16035,38636,54671,4390,0.0344972654606647,0.7177845658575844,0.0064202227872180865,0.29329992134769806,0.706700078652302,0.027674635547182237
2995,,1180,19528,20708,35,1354,27758,7807,19951,27758,1923,0.04251026731032495,0.7035088983356149,0.0012608977592045536,0.28125225160314143,0.7187477483968585,0.04877873045608473
2996,17.0,2405,121827,124232,623,10452,167382,46031,121351,167382,12890,0.014368331122820852,0.7278381187941356,0.0037220250684064,0.2750056756401525,0.7249943243598476,0.06244399039323225
2997,,109,9263,9372,112,475,12970,3492,9478,12970,1013,0.008404009252120278,0.7141865844255976,0.008635312259059369,0.269236700077101,0.730763299922899,0.03662297609868928
2998,15.0,544,30321,30865,67,2659,42271,11803,30468,42271,3275,0.012869343048425635,0.717300276785503,0.0015850110004494808,0.27922216176574954,0.7207778382342505,0.06290364552530103
2999,14.0,348,5608,5961,44,447,8185,2255,5930,8185,537,0.042516799022602324,0.6851557727550397,0.005375687232742822,0.27550397067806964,0.7244960293219304,0.05461209529627367
3000,48.0,1935,39789,41724,356,1617,53359,15917,37444,53361,3305,0.036262438859841456,0.7456569404621353,0.006671539139071606,0.29828901257472684,0.7017109874252732,0.030303030303030304
3001,17.0,496,11976,12472,197,491,17172,4861,12311,17172,1298,0.028884230142091776,0.6974143955276031,0.011472163987887259,0.2830771022594922,0.7169228977405078,0.028593058467272305
3002,26.0,159,4611,4770,21,276,6323,1824,4499,6323,522,0.02514629131741262,0.729242448204966,0.0033212082872054404,0.28847066266012966,0.7115293373398703,0.04365016606041436
3003,24.0,553,17619,18172,82,1079,23922,6665,17257,23922,1577,0.023116796254493772,0.736518685728618,0.0034278070395451885,0.27861382827522785,0.7213861717247722,0.04510492433742998
3004,24.0,1301,30268,31569,66,1575,41648,11901,29747,41648,3394,0.03123799462159047,0.7267575873991549,0.0015847099500576258,0.2857520169035728,0.7142479830964272,0.037816941990011524
3005,15.0,576,1646,2222,3,254,3155,813,2342,3155,0,0.18256735340729002,0.5217115689381934,0.0009508716323296355,0.2576862123613312,0.7423137876386687,0.08050713153724247
3006,,345,10261,10606,32,417,14011,4014,9997,14011,1144,0.024623510099207765,0.7323531510955678,0.002283919777317822,0.28648918706730425,0.7135108129326957,0.029762329598172862
3007,,991,28442,29433,230,1642,39706,11211,28495,39706,2881,0.024958444567571653,0.7163149146224752,0.005792575429406135,0.2823502745177051,0.7176497254822949,0.04135395154384728
3008,26.0,154,3516,3670,0,222,5064,1420,3644,5064,369,0.030410742496050552,0.6943127962085308,0.0,0.2804107424960506,0.7195892575039494,0.04383886255924171
3009,24.0,2990,69722,72712,285,4425,98305,27316,70989,98305,8184,0.0304155434616754,0.7092416458979706,0.0028991404302934746,0.2778698947154265,0.7221301052845736,0.045012969838767104
3010,17.0,1526,37880,39406,89,1808,53455,15233,38222,53455,4375,0.028547376297820597,0.7086334299878403,0.0016649518286409128,0.2849686652324385,0.7150313347675615,0.03382284164250304
3011,,367,4855,5222,19,366,7151,1988,5163,7151,485,0.05132149349741295,0.6789260243322612,0.0026569710529995806,0.2780030764927982,0.7219969235072018,0.051181652915676126
3012,16.0,172,9587,9759,55,1060,13644,3297,10347,13644,944,0.012606273819994136,0.7026531808853709,0.004031075930812079,0.24164467897977132,0.7583553210202286,0.07768982703019642
3013,25.0,53,1948,2001,14,41,2606,754,1852,2606,241,0.020337682271680736,0.7475057559478128,0.005372217958557176,0.2893323100537222,0.7106676899462778,0.015732924021488872
3014,15.0,331,5869,6200,39,390,8335,2269,6066,8335,510,0.03971205758848231,0.7041391721655669,0.004679064187162568,0.27222555488902217,0.7277744451109778,0.046790641871625675
3015,,226,6940,7166,2,198,9119,2762,6357,9119,650,0.024783419234565195,0.7610483605658516,0.0002193222941111964,0.30288408816756224,0.6971159118324378,0.021712907117008445
3016,17.0,446,13783,14229,51,764,19194,5306,13888,19194,1433,0.023236428050432426,0.7180889861415025,0.0026570803376055017,0.2764405543398979,0.7235594456601021,0.039804105449619674
3017,,278,8126,8404,73,347,11070,3159,7911,11070,890,0.025112917795844625,0.7340560072267389,0.0065943992773261064,0.28536585365853656,0.7146341463414634,0.03134598012646793
3018,25.0,73,6112,6185,0,77,8143,2274,5869,8143,627,0.00896475500429817,0.7505833230995947,0.0,0.2792582586270416,0.7207417413729583,0.009455974456588481
3019,17.0,28,5834,5862,0,264,7797,2303,5494,7797,756,0.0035911247915865075,0.7482365012184173,0.0,0.29537001410799024,0.7046299858920098,0.03385917660638707
3020,23.0,4657,150645,155302,164,8002,208826,59889,148937,208826,17256,0.022300862919368277,0.7213900567936943,0.0007853428212961988,0.28678900136956126,0.7132109986304387,0.03831898326836697
3021,33.0,3769,51298,55067,827,3606,79185,20375,58814,79189,4242,0.04759499425425248,0.6477919913119247,0.010443369659927515,0.2572958365429542,0.7427041634570458,0.04553662756190885
3022,14.0,6776,52413,59189,261,7553,87216,23444,63772,87216,4697,0.07769216657494038,0.6009562465602641,0.002992570170610897,0.2688038891946432,0.7311961108053568,0.0866010823702073
3023,25.0,106,1535,1641,2,112,2251,593,1658,2251,154,0.047090182141270545,0.6819191470457574,0.000888494002665482,0.26343847179031543,0.7365615282096846,0.04975566414926699
3024,24.0,1985,63714,65699,179,3515,89678,24902,64776,89678,6971,0.022134748767813732,0.7104752559156092,0.0019960302415308103,0.2776823747184371,0.722317625281563,0.03919578937978099
3025,,32,3838,3870,16,68,5192,1445,3747,5192,530,0.0061633281972265025,0.7392141756548536,0.0030816640986132513,0.27831278890600925,0.7216872110939908,0.013097072419106317
3026,17.0,137,3892,4029,8,207,5357,1563,3794,5357,416,0.025574015307074854,0.7265260406944185,0.0014933731566175099,0.291767780474146,0.708232219525854,0.03864103042747807
3027,33.0,6476,175320,181796,572,6916,239643,69215,170428,239643,19123,0.027023530835451066,0.7315882375032862,0.0023868838230200755,0.2888254612068786,0.7111745387931214,0.02885959531469728
3028,17.0,1876,42107,43983,445,2580,59326,16445,42881,59326,4614,0.031621885851060245,0.7097562620099114,0.007500927080875164,0.2771971816741395,0.7228028183258605,0.04348852105316387
3029,,3906,71077,74983,1557,3336,100724,28365,72359,100724,5336,0.03877923831460228,0.705661014256781,0.015458083475636392,0.2816111353798499,0.7183888646201501,0.033120209681903025
3030,,905,22338,23243,259,1621,32389,8516,23873,32389,2119,0.027941585106054524,0.6896785945845811,0.007996542035876377,0.2629287721139893,0.7370712278860106,0.05004785575349656
3031,,205,4005,4210,26,558,6097,1656,4441,6097,256,0.033623093324585865,0.656880432999836,0.0042643923240938165,0.2716089880268985,0.7283910119731015,0.09152041987862883
3032,,847,13263,14110,24,1063,19426,5427,13999,19426,1430,0.04360135900339751,0.6827447750437557,0.0012354576340986307,0.2793678575105529,0.7206321424894472,0.05472047771028518
3033,33.0,1148,25316,26464,126,1493,35320,10121,25199,35320,2323,0.03250283125707814,0.7167610419026048,0.003567383918459796,0.2865515288788222,0.7134484711211778,0.04227066817667044
3034,16.0,2445,34114,36559,194,1978,49716,14026,35690,49716,3979,0.04917933864349505,0.6861774881325932,0.0039021642931852925,0.28212245554750986,0.7178775444524902,0.03978598439134283
3035,24.0,2626,63853,66479,575,3316,87169,24811,62358,87169,6081,0.03012538861292432,0.7325195883857794,0.00659638174121534,0.28463100414138054,0.7153689958586195,0.03804104670238273
3036,,15107,313121,328228,1403,18107,441780,125331,316449,441780,30236,0.03419575354248721,0.7087713341482186,0.003175788854180814,0.28369550454977593,0.7163044954502241,0.04098646385078546
3037,13.0,287,1698,1985,18,203,2769,748,2021,2769,168,0.10364752618273745,0.6132177681473456,0.0065005417118093175,0.2701336222462983,0.7298663777537017,0.07331166486096063
3038,16.0,549,41248,41797,71,1844,55869,15768,40101,55869,5329,0.00982655855662353,0.7382985197515617,0.0012708299772682524,0.2822316490361381,0.7177683509638619,0.03300578138144588
3039,17.0,126,3132,3258,0,147,4357,1268,3089,4357,318,0.02891898095019509,0.7188432407619922,0.0,0.29102593527656645,0.7089740647234336,0.03373881110856094
3040,,39,8347,8386,21,375,11024,3242,7782,11024,1075,0.003537735849056604,0.75716618287373,0.001904934687953556,0.2940856313497823,0.7059143686502177,0.034016690856313495
3041,14.0,24,2278,2302,9,198,3182,800,2382,3182,228,0.00754242614707731,0.715901948460088,0.0028284098051539913,0.251414204902577,0.748585795097423,0.06222501571338781
3042,17.0,207,12677,12884,26,889,17106,5097,12009,17106,745,0.012101017186951947,0.7410849994154098,0.001519934525897346,0.2979656260961066,0.7020343739038933,0.051970068981643865
3043,,302,5097,5399,131,154,7310,1939,5371,7310,506,0.04131326949384405,0.6972640218878249,0.017920656634746922,0.2652530779753762,0.7347469220246238,0.02106703146374829
3044,,774,36946,37720,77,1829,50632,14355,36277,50632,4372,0.015286775161952915,0.7296966345394217,0.0015207773739927318,0.2835163532943593,0.7164836467056407,0.03612340022120398
3045,,1912,60560,62472,129,2925,81386,23943,57443,81386,5871,0.023492984051311037,0.7441083232988475,0.001585039195930504,0.29419064704003145,0.7058093529599685,0.03593984223330794
3046,23.0,6873,133839,140712,927,7015,187992,53401,134591,187992,13338,0.03656006638580365,0.7119398697816929,0.004931060896208349,0.2840599599982978,0.7159400400017022,0.03731541767734797
3047,17.0,1064,65510,66574,279,3893,87545,25270,62275,87545,6516,0.012153749500257011,0.7483008738363127,0.003186932434747844,0.288651550631104,0.711348449368896,0.044468559026786224
3048,,383,8640,9023,74,374,11952,3444,8508,11952,963,0.03204484605087015,0.7228915662650602,0.006191432396251673,0.28815261044176704,0.7118473895582329,0.03129183400267738
3049,,516,14177,14693,77,588,19388,5646,13742,19388,1542,0.026614400660202188,0.7312255003094698,0.003971528780689086,0.2912110583866309,0.7087889416133691,0.030328037961625746
3050,16.0,208,3912,4120,11,171,5549,1554,3995,5549,473,0.03748423139304379,0.7049918904307082,0.0019823391602090466,0.2800504595422599,0.7199495404577402,0.03081636330870427
3051,40.0,2107,62749,64856,411,3957,84806,23939,60867,84806,5936,0.024844940216494117,0.7399122703582294,0.004846355210716223,0.28227955569181423,0.7177204443081857,0.0466594344739759
3052,,1017,22984,24001,192,1421,32586,9108,23478,32586,2647,0.031209721966488677,0.7053335788375376,0.00589210090222795,0.2795065365494384,0.7204934634505616,0.04360768428159332
3053,,122,4863,4985,103,441,7145,1832,5313,7145,426,0.01707487753673898,0.6806158152554234,0.014415675297410778,0.25640307907627713,0.7435969209237229,0.06172148355493352
3054,33.0,311,10540,10851,37,704,14306,3827,10479,14306,1061,0.021739130434782608,0.7367538095903816,0.0025863274150705997,0.2675101356074374,0.7324898643925626,0.04921012162728925
3055,26.0,708,17253,17961,76,1238,24479,6495,17984,24479,1807,0.02892275011234119,0.7048082029494669,0.0031047019894603536,0.2653294660729605,0.7346705339270395,0.0505739613546305
3056,35.0,298,13281,13579,6,378,17426,5123,12303,17426,1390,0.017100883736944794,0.7621370366119592,0.00034431309537472744,0.29398599793412145,0.7060140020658786,0.021691725008607828
3057,35.0,26163,461806,487969,3087,23105,635087,186364,448728,635092,41522,0.04119560630585805,0.7271481927027895,0.004860713093536055,0.2934440994375618,0.7065559005624382,0.036380555887965835
3058,26.0,616,13521,14137,148,660,19591,5386,14205,19591,1603,0.031443009545199324,0.6901638507477924,0.0075544893063141235,0.27492215813383697,0.7250778418661631,0.033688938798427846
3059,14.0,139,1461,1600,20,80,2139,627,1512,2139,175,0.06498363721365123,0.6830294530154277,0.009350163627863487,0.29312762973352036,0.7068723702664796,0.03740065451145395
3060,35.0,836,20691,21527,105,1398,28738,7739,20999,28738,1950,0.029090402950796856,0.7199874730322221,0.003653698935207739,0.26929501009116846,0.7307049899088315,0.048646391537337325
3061,17.0,673,10182,10855,11,545,14813,4190,10623,14813,1240,0.04543306555052994,0.6873692027273341,0.0007425909673935057,0.28285965030716265,0.7171403496928374,0.03679200702086006
3062,,804,14964,15768,71,983,21031,5925,15106,21031,1658,0.03822928058580191,0.7115210879178355,0.0033759688079501686,0.2817269744662641,0.718273025533736,0.04674052589035234
3063,,3228,38700,41928,754,2929,57234,16040,41194,57234,3749,0.05640004193311668,0.6761715064472167,0.013173987489953524,0.28025299647062935,0.7197470035293706,0.051175874480204074
3064,26.0,186,3977,4163,12,187,5675,1562,4113,5675,477,0.032775330396475774,0.7007929515418502,0.0021145374449339205,0.27524229074889867,0.7247577092511013,0.03295154185022026
3065,,592,38888,39480,180,6250,57040,15027,42013,57040,3972,0.010378681626928472,0.6817671809256662,0.003155680224403927,0.2634467040673212,0.7365532959326788,0.10957223001402525
3066,27.0,1656,23571,25227,145,1397,33146,9440,23706,33146,2178,0.0499607795812466,0.7111265311048091,0.004374585168647801,0.2848005792554154,0.7151994207445845,0.042146865383455016
3067,,190,6918,7108,14,341,9569,2749,6820,9569,860,0.01985578430347999,0.7229595569024977,0.001463057790782736,0.2872818476329815,0.7127181523670185,0.03563590761835093
3068,,2468,75531,77999,75,3550,100836,29734,71102,100836,7524,0.024475385774921653,0.7490479590622396,0.0007437819826252529,0.29487484628505695,0.7051251537149431,0.035205680510928636
3069,26.0,839,19637,20476,90,726,26908,7852,19056,26908,2047,0.031180318121004906,0.7297829641742233,0.003344730191764531,0.2918091273970566,0.7081908726029433,0.02698082354690055
3070,16.0,2947,7439,10386,58,800,14156,3922,10234,14156,753,0.2081802769143826,0.5255015541113309,0.004097202599604408,0.2770556654422153,0.7229443345577847,0.05651313930488839
3071,24.0,408,9673,10081,34,544,13452,3821,9631,13452,977,0.030330062444246207,0.7190752304490039,0.002527505203687184,0.28404698186143323,0.7159530181385667,0.040440083258994945
3072,,686,22259,22945,85,656,30159,8674,21485,30159,2877,0.022746112271627043,0.7380549752975895,0.002818395835405683,0.28760900560363406,0.7123909943963659,0.021751384329719157
3073,27.0,274,5743,6017,8,261,7840,2293,5547,7840,557,0.03494897959183674,0.7325255102040816,0.0010204081632653062,0.2924744897959184,0.7075255102040816,0.03329081632653061
3074,,1744,443816,445560,1399,25853,599718,169668,430050,599718,48717,0.0029080334423845873,0.7400411526750906,0.002332763065307361,0.28291296909547486,0.7170870309045251,0.0431085943726885
3075,,18419,339069,357488,1675,16106,488123,136387,351736,488123,33966,0.037734341549158716,0.6946384415403495,0.0034315121393583173,0.2794111320302465,0.7205888679697535,0.032995781800898544
3076,,1072,31287,32359,152,4658,47421,11731,35690,47421,2911,0.022606018430653085,0.6597709875371671,0.0032053309715105124,0.24737985280782776,0.7526201471921723,0.09822652411378925
3077,17.0,1171,22169,23340,108,1683,32277,8831,23446,32277,2199,0.036279703813861267,0.6868358273693342,0.003346035876940236,0.273600396567215,0.726399603432785,0.052142392415652015
3078,,113,3180,3293,44,189,4407,1294,3113,4407,284,0.02564102564102564,0.7215793056501021,0.009984116178806445,0.2936237803494441,0.706376219650556,0.04288631722260041
3079,25.0,55,1513,1568,5,94,2117,592,1525,2117,184,0.025980160604629193,0.7146905999055266,0.0023618327822390174,0.2796410014170997,0.7203589985829003,0.044402456306093525
3080,27.0,139,4599,4738,4,360,6226,1636,4590,6226,389,0.022325730806296178,0.7386765178284613,0.00064246707356248,0.2627690330870543,0.7372309669129458,0.05782203662062319
3081,,1480,18152,19632,70,1436,26907,7627,19280,26907,2002,0.0550042739807485,0.674619987363883,0.0026015534990894563,0.28345783625078974,0.7165421637492102,0.05336901178132085
3082,33.0,1983,48590,50573,438,2612,66838,19096,47742,66838,4854,0.029668751309135523,0.7269816571411473,0.006553158382955803,0.2857057362578174,0.7142942637421826,0.03907956551662228
3083,13.0,401,6270,6671,24,445,9319,2554,6765,9319,718,0.04303036806524305,0.6728189719927031,0.002575383624852452,0.2740637407447151,0.7259362592552849,0.04775190471080588
3084,,442,9359,9801,62,408,12913,3657,9256,12913,847,0.03422907147835515,0.724773484085805,0.004801362967552079,0.28320297374738634,0.7167970262526137,0.031596065980020134
3085,14.0,5975,35162,41137,870,3626,58547,15605,42942,58547,2921,0.10205475942405247,0.6005773139528926,0.01485985618392061,0.2665379951150358,0.7334620048849643,0.061933147727466824
3086,16.0,301,4479,4780,58,206,6621,1825,4796,6621,451,0.04546141066304184,0.676483914816493,0.008760006041383477,0.27563812112973873,0.7243618788702613,0.031113124905603383
3087,23.0,1459,35306,36765,173,2174,49800,13565,36235,49800,3215,0.02929718875502008,0.7089558232931726,0.0034738955823293174,0.2723895582329317,0.7276104417670682,0.04365461847389558
3088,,650,21927,22577,162,1153,29098,8560,20538,29098,1969,0.02233830503814695,0.7535569454945357,0.0055673929479689325,0.29417829404082757,0.7058217059591725,0.03962471647535913
3089,,145,2323,2468,64,229,3510,918,2592,3510,223,0.04131054131054131,0.6618233618233619,0.018233618233618232,0.26153846153846155,0.7384615384615385,0.06524216524216524
3090,16.0,1349,30771,32120,209,2637,44057,12031,32026,44057,2868,0.030619424836007898,0.6984361168486279,0.004743854552057562,0.27307805797035656,0.7269219420296434,0.05985427968313775
3091,17.0,9669,167887,177556,908,8561,233621,68646,164977,233623,16601,0.041387192185700895,0.7186235944234942,0.0038866036306356823,0.2938323709566267,0.7061676290433733,0.036644508460211535
3092,46.0,95,2139,2234,2,94,2959,846,2113,2959,148,0.032105441027374115,0.7228793511321392,0.0006759040216289286,0.28590740114903684,0.7140925988509632,0.031767489016559645
3093,,119,2316,2435,20,137,3267,918,2349,3267,206,0.03642485460667279,0.7089072543617998,0.006121824303642486,0.2809917355371901,0.71900826446281,0.041934496479951025
3094,24.0,26256,429285,455541,5477,33117,627633,171619,456076,627695,40809,0.04182923235010634,0.6839069930459857,0.008725575319223508,0.2734114498283402,0.7265885501716598,0.052759700172854654
3095,25.0,663,19799,20462,25,768,26623,7856,18767,26623,2084,0.024903279119558277,0.7436802764526913,0.0009390376741914885,0.29508319873793337,0.7049168012620667,0.028847237351162527
3096,,941,20089,21030,89,1395,27973,7611,20362,27973,1888,0.0336395810245594,0.7181567940514068,0.0031816394380295284,0.2720837950881207,0.7279162049118794,0.04986951703428306
3097,,727,9591,10318,76,498,13545,3903,9642,13545,859,0.05367294204503507,0.7080841638981173,0.005610926541159099,0.2881506090808416,0.7118493909191583,0.03676633444075304
3098,,889,22551,23440,19,797,30975,8759,22216,30975,2791,0.028700564971751413,0.7280387409200969,0.0006133979015334948,0.2827764326069411,0.7172235673930589,0.025730427764326068
3099,17.0,3504,93640,97144,85,5013,125723,37008,88715,125723,9449,0.027870795319869874,0.7448120073494906,0.0006760894983415922,0.2943614135838311,0.7056385864161688,0.03987337241395767
3100,,2952,47185,50137,348,4197,68556,18946,49610,68556,4526,0.04305968842989673,0.688269443958224,0.005076142131979695,0.2763580138864578,0.7236419861135422,0.06122002450551374
3101,24.0,2911,51402,54313,277,2569,72672,20825,51847,72672,5153,0.04005669308674593,0.7073150594451784,0.0038116468516072215,0.28656153676794366,0.7134384632320564,0.035350616468516075
3102,26.0,58,2275,2333,5,158,3169,879,2290,3169,277,0.018302303565793626,0.7178920795203534,0.001577784790154623,0.2773745661091827,0.7226254338908173,0.04985799936888608
3103,,573,10468,11041,57,439,14652,4130,10522,14652,988,0.039107289107289105,0.7144417144417144,0.0038902538902538903,0.28187278187278186,0.7181272181272181,0.029961779961779962
3104,24.0,193,3292,3485,16,168,4660,1347,3313,4660,308,0.04141630901287554,0.7064377682403433,0.0034334763948497852,0.2890557939914163,0.7109442060085837,0.036051502145922745
3105,24.0,296,7760,8056,17,337,10545,3079,7466,10545,749,0.028070175438596492,0.7358937885253675,0.0016121384542437174,0.29198672356567096,0.7080132764343291,0.03195827406353722
3106,,604,8181,8785,91,710,11936,3340,8596,11936,864,0.05060321715817694,0.6854054959785523,0.007623994638069705,0.27982573726541554,0.7201742627345844,0.05948391420911528
3107,23.0,68,2405,2473,1,121,3281,947,2334,3281,250,0.02072538860103627,0.7330082291984151,0.00030478512648582747,0.28863151478207866,0.7113684852179214,0.03687900030478513
3108,25.0,114,3551,3665,6,368,4963,1353,3610,4963,344,0.0229699778359863,0.7154946604876083,0.0012089462018940156,0.27261736852710056,0.7273826314728995,0.07414870038283296
3109,35.0,13550,394094,407644,2251,15426,523277,156781,366496,523277,39297,0.025894507115734114,0.7531269289496767,0.004301736938562176,0.2996137800820598,0.7003862199179403,0.02947960640349184
3110,16.0,43,2237,2280,22,210,3150,857,2293,3150,201,0.013650793650793651,0.7101587301587302,0.006984126984126984,0.27206349206349206,0.7279365079365079,0.06666666666666667
3111,,130,5786,5916,48,828,8416,2155,6261,8416,561,0.015446768060836502,0.6875,0.005703422053231939,0.25605988593155893,0.7439401140684411,0.09838403041825095
3112,27.0,2519,74251,76770,149,3470,100292,29169,71124,100293,7419,0.025116408921858954,0.7403408014517464,0.001485647054131395,0.2908378451138165,0.7091621548861835,0.03459862602574457
3113,,23802,664440,688242,1838,36190,907889,263309,644580,907889,66466,0.026216861312341046,0.7318515809752073,0.002024476560460585,0.29002333985762574,0.7099766601423743,0.03986170115509716
3114,23.0,86,1794,1880,14,73,2459,692,1767,2459,154,0.03497356649044327,0.7295648637657585,0.0056933712891419274,0.2814152094347296,0.7185847905652705,0.029686864579097194
3115,15.0,5862,158919,164781,279,7602,225301,63241,162060,225301,17040,0.026018526327002543,0.7053630476562466,0.0012383433717560064,0.2806956027714036,0.7193043972285964,0.03374152800031957
3116,16.0,41,1794,1835,0,64,2397,675,1722,2397,211,0.017104714226115977,0.7484355444305382,0.0,0.2816020025031289,0.718397997496871,0.026700041718815185
3117,14.0,4497,110190,114687,243,6685,152975,43742,109233,152975,11668,0.0293969602876287,0.7203137767609087,0.0015884948521000164,0.28594214740970747,0.7140578525902925,0.04369995097238111
3118,,189,5858,6047,21,233,7841,2314,5527,7841,595,0.024104068358627728,0.7470985843642393,0.002678229817625303,0.2951154189516643,0.7048845810483356,0.02971559750031884
3119,25.0,2293,39655,41948,188,1869,57055,15973,41082,57055,4537,0.04018929103496626,0.6950311103321356,0.0032950661642275,0.27995793532556307,0.720042064674437,0.032757865217772325
3120,23.0,775,19940,20715,105,911,27076,7860,19216,27076,2184,0.028623134879598167,0.7364455606441128,0.0038779731127197518,0.2902939872950214,0.7097060127049786,0.03364603338750185
3121,17.0,67,5049,5116,46,274,7540,2010,5530,7540,318,0.008885941644562334,0.6696286472148542,0.00610079575596817,0.26657824933687,0.73342175066313,0.0363395225464191
3122,38.0,512,9279,9791,71,506,12821,3729,9092,12821,886,0.03993448248966539,0.7237344980890726,0.005537789563996568,0.2908509476639888,0.7091490523360112,0.039466500272989626
3123,27.0,154,2511,2665,9,134,3494,978,2516,3494,257,0.044075558099599316,0.7186605609616485,0.0025758443045220377,0.2799084144247281,0.7200915855752719,0.0383514596451059
3124,15.0,60,1327,1387,10,125,2020,531,1489,2020,130,0.0297029702970297,0.656930693069307,0.0049504950495049506,0.2628712871287129,0.7371287128712871,0.06188118811881188
3125,14.0,138,2313,2451,11,184,3347,925,2422,3347,232,0.041230953092321485,0.691066626829997,0.0032865252464893933,0.27636689572751716,0.7236331042724828,0.05497460412309531
3126,16.0,2453,58037,60490,472,3584,80566,23043,57523,80566,7285,0.03044708686046223,0.7203659111784128,0.0058585507534195565,0.2860139512945908,0.7139860487054093,0.044485266737829855
3127,,557,18188,18745,291,1318,24950,6853,18097,24950,1769,0.022324649298597194,0.7289779559118237,0.011663326653306614,0.2746693386773547,0.7253306613226453,0.05282565130260521
3128,16.0,208,7394,7602,21,718,10733,2848,7885,10733,844,0.019379483834901706,0.6889033820926116,0.001956582502562191,0.26534985558557717,0.7346501444144228,0.06689648746855492
3129,24.0,271,6732,7003,21,274,9002,2670,6332,9002,566,0.030104421239724507,0.7478338147078427,0.0023328149300155523,0.29660075538769165,0.7033992446123084,0.030437680515441014
3130,,34,8196,8230,0,73,10529,3147,7382,10529,905,0.003229176559977206,0.7784215025168582,0.0,0.29888878336024316,0.7011112166397568,0.006933232025833413
3131,15.0,135,3116,3251,398,1110,5621,1209,4412,5621,290,0.024017078811599358,0.5543497598292119,0.07080590642234477,0.21508628357943427,0.7849137164205657,0.19747375911759474
3132,,1199,34397,35596,126,1324,45645,13455,32218,45673,3285,0.02625183368729884,0.7531145315613164,0.0027587414884067173,0.29459418036914586,0.7054058196308541,0.028988680401988046
3133,35.0,109,1847,1956,17,92,2685,743,1942,2685,169,0.04059590316573557,0.6878957169459963,0.00633147113594041,0.27672253258845436,0.7232774674115456,0.03426443202979516
3134,15.0,442,19040,19482,46,1138,26382,7504,18878,26382,2320,0.016753847320142522,0.7217041922522932,0.001743613069517095,0.28443635812296264,0.7155636418770374,0.04313547115457509
3135,,479,5431,6079,29,266,7979,2114,5903,8017,413,0.059748035424722463,0.6774354496694525,0.0036173132094299613,0.26368965947361855,0.7363103405263814,0.03317949357615068
3136,15.0,3,1692,1695,3,126,2316,611,1705,2316,194,0.0012953367875647669,0.7305699481865285,0.0012953367875647669,0.26381692573402415,0.7361830742659758,0.054404145077720206
3137,,130,6717,6847,21,346,9469,2506,6963,9469,646,0.013729010455169501,0.7093674094413349,0.0022177632273735347,0.26465307846657515,0.7353469215334248,0.03654028936529729
3138,25.0,101,2346,2447,2,144,3330,943,2387,3330,212,0.03033033033033033,0.7045045045045045,0.0006006006006006006,0.2831831831831832,0.7168168168168169,0.043243243243243246
3139,15.0,1917,56014,61251,272,6307,84993,22029,63069,85098,4554,0.022526968906437284,0.6582293355895555,0.003196314837011446,0.25886624832546007,0.74113375167454,0.07411455028320289
3140,13.0,754,9803,10557,31,1642,15326,4021,11305,15326,801,0.049197442254991515,0.6396319979120448,0.0020227065118099963,0.26236460916090304,0.7376353908390969,0.10713819652877463
3141,33.0,882,10562,11444,579,648,16190,4345,11845,16190,921,0.0544780728844966,0.6523780111179741,0.03576281655342804,0.2683755404570723,0.7316244595429278,0.04002470660901791
3142,15.0,287,10348,10635,28,536,14170,4029,10141,14170,1221,0.02025405786873677,0.7302752293577982,0.0019760056457304165,0.284333098094566,0.715666901905434,0.037826393789696544
3143,,221,3696,3917,23,467,5606,1495,4111,5606,346,0.039422047805922227,0.6592936139850161,0.004102747056724938,0.2666785586871209,0.733321441312879,0.08330360328219764
3144,,57,1884,1941,6,312,2954,746,2208,2954,161,0.01929587000677048,0.6377792823290453,0.002031144211238998,0.2525389302640487,0.7474610697359513,0.10561949898442789
3145,33.0,98,2003,2101,3,73,2838,826,2012,2838,237,0.03453136011275546,0.7057787174066243,0.0010570824524312897,0.29105003523608175,0.7089499647639183,0.025722339675828047
3146,,98,2480,2578,5,156,3562,1009,2553,3562,297,0.027512633352049412,0.6962380685008422,0.001403705783267827,0.2832678270634475,0.7167321729365524,0.043795620437956206
3147,,278,6482,6760,23,337,9130,2606,6524,9130,680,0.03044906900328587,0.7099671412924425,0.0025191675794085434,0.2854326396495071,0.7145673603504928,0.036911281489594744
3148,16.0,11,3607,3618,36,187,4884,1335,3549,4884,396,0.0022522522522522522,0.7385339885339886,0.007371007371007371,0.27334152334152334,0.7266584766584766,0.038288288288288286
3149,25.0,58,2091,2149,6,102,2804,835,1969,2804,210,0.020684736091298145,0.7457203994293866,0.0021398002853067048,0.2977888730385164,0.7022111269614836,0.03637660485021398
3150,13.0,590,20333,20923,161,2802,29962,7494,22468,29962,1529,0.019691609371871036,0.6786262599292437,0.0053734730658834525,0.250116814631867,0.7498831853681329,0.093518456711835
3151,,69,4689,4758,5,140,6410,1837,4573,6410,611,0.010764430577223089,0.7315132605304212,0.00078003120124805,0.2865834633385335,0.7134165366614664,0.0218408736349454
3152,16.0,162,2893,3055,15,129,4180,1146,3034,4180,282,0.038755980861244016,0.6921052631578948,0.0035885167464114833,0.27416267942583733,0.7258373205741627,0.030861244019138756
3153,,182,16101,16283,66,665,22055,6233,15822,22055,1623,0.008252097030151893,0.7300385400136024,0.0029925187032418953,0.28261165268646565,0.7173883473135343,0.030151892994785764
3154,17.0,991,22016,23007,58,1556,31216,8723,22493,31216,2170,0.03174654023577653,0.7052793439261917,0.001858021527421835,0.27944003075345974,0.7205599692465402,0.04984623270117888
3155,,250,7753,8003,26,281,10464,3075,7389,10464,865,0.0238914373088685,0.74092125382263,0.002484709480122324,0.2938646788990826,0.7061353211009175,0.026853975535168197
3156,27.0,199,6172,6371,24,387,8697,2372,6325,8697,539,0.022881453374726916,0.7096700011498218,0.0027595722662987236,0.27273772565252385,0.7272622743474761,0.04449810279406692
3157,24.0,675,27984,28659,25,1246,36608,11311,25297,36608,2735,0.018438592657342656,0.7644230769230769,0.0006829108391608391,0.30897618006993005,0.6910238199300699,0.034036276223776224
3158,14.0,76,1854,1930,11,114,2647,724,1923,2647,195,0.02871174914998111,0.7004155647903286,0.00415564790328674,0.2735171892708727,0.7264828107291273,0.043067623724971665
3159,38.0,107,29007,29114,182,1086,39635,11209,28426,39635,3244,0.0026996341617257476,0.7318531600857827,0.004591901097514822,0.2828056011101299,0.71719439888987,0.027400025230225812
3160,,153,2505,2658,1,144,3679,1046,2633,3679,249,0.04158738787714053,0.6808915466159282,0.0002718129926610492,0.28431639032345746,0.7156836096765425,0.03914107094319109
3161,23.0,6109,116508,122617,417,7437,167095,47042,120053,167095,11849,0.03656004069541279,0.6972560519464975,0.0024955863430982375,0.2815284718274036,0.7184715281725964,0.04450761542834914
3162,15.0,171,9130,9301,23,514,12627,3521,9106,12627,1060,0.0135424091233072,0.7230537736596183,0.0018214936247723133,0.2788469153401441,0.7211530846598558,0.040706422744911694
3163,14.0,138,3547,3685,26,501,5407,1384,4023,5407,376,0.025522470871093026,0.6560014795635287,0.004808581468466802,0.2559644904753098,0.7440355095246902,0.09265766598853338
3164,13.0,363,11199,11562,44,1199,16488,4192,12296,16488,1271,0.022016011644832606,0.6792212518195051,0.002668607472100922,0.2542455118874333,0.7457544881125667,0.07271955361475012
3165,27.0,1095,25714,26809,87,1300,36744,10335,26409,36744,2977,0.02980078380143697,0.6998149357718267,0.0023677335075114304,0.28127041149575444,0.7187295885042456,0.03537992597430873
3166,17.0,81,1821,1902,5,163,2587,739,1848,2587,171,0.031310398144569,0.7039041360649401,0.001932740626207963,0.2856590645535369,0.714340935446463,0.06300734441437959
3167,17.0,165,5089,5254,7,515,7059,1975,5084,7059,556,0.02337441563960901,0.7209236435755773,0.0009916418756197763,0.2797846720498654,0.7202153279501345,0.07295650942059782
3168,14.0,523,11840,12363,14,766,16405,4657,11748,16405,1234,0.03188052423041755,0.7217311795184395,0.000853398354160317,0.28387686680889973,0.7161231331911003,0.04669308137762877
3169,25.0,96,33596,33692,277,1127,44966,12887,32079,44966,4246,0.002134946403949651,0.7471422852822133,0.006160209936396388,0.2865943157051995,0.7134056842948006,0.025063381221367254
3170,13.0,55,2016,2071,1,251,2963,785,2178,2963,212,0.018562267971650354,0.6803914951063111,0.0003374957813027337,0.264934188322646,0.7350658116773541,0.08471144110698617
3171,25.0,1092,26028,27120,32,943,36709,10373,26336,36709,3539,0.02974747337165273,0.7090359312430194,0.0008717208314037429,0.28257375575471955,0.7174262442452805,0.02568852325042905
3172,17.0,14,1998,2012,1,113,2761,770,1991,2761,280,0.0050706265845708075,0.723650851140891,0.0003621876131836291,0.2788844621513944,0.7211155378486056,0.04092720028975009
3173,27.0,154,13733,13887,19,639,18305,5321,12984,18305,1497,0.008413001912045888,0.7502321770008195,0.001037967768369298,0.2906856050259492,0.7093143949740508,0.03490849494673586
3174,,5480,97573,103053,548,7805,142103,38853,103250,142103,8967,0.03856357712363567,0.6866357501249094,0.0038563577123635674,0.2734143543767549,0.7265856456232451,0.05492494880474023
3175,15.0,52,2283,2335,11,284,3352,874,2478,3352,236,0.015513126491646777,0.6810859188544153,0.0032816229116945108,0.2607398568019093,0.7392601431980907,0.08472553699284009
3176,27.0,999,15819,16818,63,1036,22622,6333,16289,22622,1551,0.04416055167536027,0.6992750419945186,0.0027848996552028997,0.2799487224825391,0.7200512775174609,0.04579612766333657
3177,,105,3873,3978,9,132,5267,1498,3769,5267,419,0.01993544712359977,0.7353332067590659,0.0017087526105942661,0.28441237896335675,0.7155876210366432,0.025061704955382572
3178,35.0,218,4735,4953,25,128,6260,1874,4386,6260,427,0.034824281150159744,0.7563897763578274,0.003993610223642172,0.29936102236421724,0.7006389776357828,0.020447284345047924
3179,24.0,783,5811,6594,2,609,10300,2288,8012,10300,400,0.07601941747572816,0.5641747572815534,0.0001941747572815534,0.22213592233009707,0.777864077669903,0.05912621359223301
3180,17.0,1115,20347,21462,81,997,28386,8095,20291,28386,1953,0.039279926724441624,0.7167970126118509,0.0028535193405199747,0.28517579088282957,0.7148242091171705,0.03512294793207919
3181,,942,23311,24253,29,1240,32228,9277,22951,32228,2605,0.029229241653220803,0.7233151297008812,0.0008998386496214472,0.2878552811220057,0.7121447188779942,0.03847585950105498
3182,38.0,418,14092,14510,72,392,18614,5331,13283,18614,1373,0.022456215751584827,0.7570645750510369,0.0038680563017083917,0.28639733533899214,0.7136026646610079,0.021059417642634574
3183,,1827,34814,36641,122,2774,49901,13832,36069,49901,3576,0.03661249273561652,0.697661369511633,0.0024448407847538125,0.2771888338911044,0.7228111661088956,0.0555900683353039
3184,,1452,17709,19161,252,1434,26338,7157,19181,26338,1791,0.05512947072670666,0.6723745159085731,0.009567924671577188,0.27173665426380134,0.7282633457361987,0.05444604753587972
3185,23.0,194,2018,2212,49,138,3048,820,2228,3048,145,0.0636482939632546,0.6620734908136483,0.016076115485564306,0.2690288713910761,0.7309711286089239,0.045275590551181105
3186,17.0,228,3247,3475,43,260,4773,1317,3456,4773,323,0.04776869893148963,0.6802849360988896,0.009009009009009009,0.27592708988057824,0.7240729101194218,0.054473077728891685
3187,24.0,99,2756,2855,42,149,4169,1034,3135,4169,268,0.023746701846965697,0.6610698009114896,0.010074358359318782,0.24802110817941952,0.7519788918205804,0.03573998560805949
3188,,3193,79195,82388,371,3865,110471,31875,78596,110471,8199,0.0289035131391949,0.7168849743371564,0.003358347439599533,0.28853726317314043,0.7114627368268596,0.03498655755809217
3189,16.0,94,3166,3260,11,156,4441,1227,3214,4441,350,0.02116640396307138,0.7129024994370637,0.0024769196126998424,0.27628912407115513,0.7237108759288449,0.035127223598288675
3190,14.0,204,17926,18130,157,1201,24606,6901,17705,24606,2132,0.008290660814435503,0.7285214988214257,0.006380557587580265,0.2804600503942128,0.7195399496057872,0.048809233520279605
3191,23.0,358,7886,8244,57,637,11178,2964,8214,11178,799,0.03202719627840401,0.7054929325460726,0.005099302200751476,0.26516371443907677,0.7348362855609233,0.05698693862945071
3192,24.0,2740,61848,64588,212,2401,83898,24503,59395,83898,6170,0.03265870461751174,0.7371808624758636,0.0025268778755155067,0.2920570216214928,0.7079429783785073,0.0286180838637393
3193,34.0,135,3921,4056,22,548,5879,1270,4609,5879,343,0.022963088960707603,0.6669501615921075,0.003742133015819017,0.21602313318591598,0.7839768668140841,0.09321313148494642
3194,16.0,239,10384,10623,46,628,14371,4012,10359,14371,1205,0.016630714633637186,0.7225662793125044,0.0032008906826247303,0.2791733351889221,0.7208266648110778,0.043699116275833276
3195,17.0,440,13848,14288,36,904,18728,5381,13347,18728,1201,0.02349423323366083,0.7394275950448527,0.0019222554463904314,0.28732379325074753,0.7126762067492525,0.04826997009824861
3196,16.0,1973,18026,19999,37,1613,28511,7425,21086,28511,1508,0.06920136087825751,0.6322472028339939,0.0012977447301041702,0.26042580056820175,0.7395741994317983,0.05657465539616288
3197,23.0,563,10330,10893,24,570,14025,4249,9776,14025,1073,0.040142602495543675,0.736541889483066,0.001711229946524064,0.3029590017825312,0.6970409982174688,0.040641711229946524
3198,,646,20108,20754,78,1698,28013,7788,20225,28013,1821,0.023060721807732124,0.7178095884053832,0.002784421518580659,0.2780137793167458,0.7219862206832542,0.06061471459679434
3199,17.0,5243,128371,133614,817,8234,176786,50727,126059,176786,12227,0.02965732580634213,0.7261378163429231,0.004621406672474065,0.2869401423189619,0.7130598576810381,0.04657608634167864
3200,38.0,142,3242,3384,17,111,4430,1246,3184,4430,376,0.032054176072234764,0.7318284424379232,0.003837471783295711,0.2812641083521445,0.7187358916478556,0.02505643340857788
3201,35.0,1290,31922,33212,110,1010,43125,12794,30331,43125,3427,0.02991304347826087,0.7402202898550725,0.0025507246376811595,0.29667246376811596,0.703327536231884,0.023420289855072465
3202,16.0,393,10849,11242,39,584,14827,4337,10490,14827,1086,0.026505699062521076,0.7317056720847104,0.0026303365481891144,0.29250691306400484,0.7074930869359951,0.039387603695960074
3203,17.0,302,6422,6724,5,318,8849,2506,6343,8849,695,0.03412815007345463,0.7257317210984292,0.0005650355972426263,0.2831958413380043,0.7168041586619958,0.03593626398463103
3204,42.0,706,21586,22292,200,1568,30541,8559,21982,30541,2541,0.023116466389443698,0.7067875970007531,0.006548574048001048,0.2802462263842048,0.7197537736157952,0.05134082053632821
3205,39.0,215,5698,5913,38,215,7683,2261,5422,7683,549,0.027983860471170116,0.7416373812312899,0.004945984641416113,0.2942860861642588,0.7057139138357412,0.027983860471170116
3206,27.0,109,3103,3212,0,264,4337,1178,3159,4337,300,0.02513258012451003,0.7154715240949966,0.0,0.27161632464837443,0.7283836753516255,0.06087157020982246
3207,26.0,96,1980,2076,13,163,2822,789,2033,2822,185,0.03401842664776754,0.7016300496102055,0.004606661941885188,0.2795889440113395,0.7204110559886605,0.05776045357902197
3208,13.0,69,2787,2856,15,147,3900,1073,2827,3900,344,0.01769230769230769,0.7146153846153847,0.0038461538461538464,0.2751282051282051,0.7248717948717949,0.03769230769230769
3209,24.0,1900,72138,74631,765,8814,104546,27304,77242,104546,6870,0.018173818223557094,0.6900120521110324,0.007317353126853251,0.2611673330400015,0.7388326669599985,0.08430738622233275
3210,,1337,37381,38718,221,1945,51541,14663,36878,51541,3572,0.025940513377699308,0.7252672629557052,0.004287848508954036,0.28449195785879206,0.715508042141208,0.037736947284685976
3211,14.0,932,13714,14646,185,1277,20321,5562,14759,20321,1365,0.0458638846513459,0.6748683627774223,0.009103882682938831,0.27370700260813935,0.7262929973918606,0.06284139560061021
3212,23.0,213,26543,26756,65,1290,36384,10043,26341,36384,3297,0.005854221635883905,0.7295239665787159,0.0017864995602462621,0.27602792436235707,0.7239720756376429,0.03545514511873351
3213,,254,37743,37997,78,3962,51178,14246,36932,51178,3364,0.0049630700691703465,0.7374848567743952,0.001524092383446012,0.27836179608425493,0.7216382039157451,0.07741607722068077
3214,25.0,18,4730,4748,19,237,6529,1842,4687,6529,632,0.0027569306172461326,0.724460101087456,0.0029100934293153622,0.2821258998315209,0.7178741001684791,0.036299586460407415
3215,33.0,723,16773,17496,106,1094,23873,6644,17229,23873,1745,0.03028525949817786,0.7025928873622921,0.004440162526703807,0.2783060361077368,0.7216939638922633,0.04582582834164119
3216,,89,3039,3128,3,155,4135,1192,2943,4135,295,0.021523579201934703,0.7349455864570738,0.0007255139056831923,0.2882708585247884,0.7117291414752116,0.037484885126964934
3217,17.0,33,2024,2057,2,156,2786,794,1992,2786,223,0.011844938980617373,0.7264895908111989,0.0007178750897343862,0.28499641062455133,0.7150035893754487,0.05599425699928212
3218,14.0,18,1924,1942,27,271,2755,689,2066,2755,171,0.006533575317604356,0.6983666061705989,0.009800362976406534,0.2500907441016334,0.7499092558983667,0.0983666061705989
3219,,90,2054,2144,6,70,2788,827,1961,2788,174,0.032281205164992825,0.736728837876614,0.002152080344332855,0.2966284074605452,0.7033715925394548,0.025107604017216643
3220,,3353,82710,86063,174,4436,115223,32710,82513,115223,8572,0.02910009286340401,0.7178254341581108,0.0015101151679786154,0.28388429393437076,0.7161157060656292,0.038499257960650214
3221,26.0,4895,90502,95405,507,4551,124305,35851,88454,124305,8316,0.03937894694501428,0.7280640360403845,0.004078677446603113,0.2884115683198584,0.7115884316801416,0.03661156027512972
3222,17.0,339,25643,25982,144,3491,35763,9799,25964,35763,1988,0.009479070547772838,0.7170259765679613,0.004026507843301736,0.27399826636467856,0.7260017336353214,0.09761485334004417
3223,23.0,152,3029,3181,21,147,4175,1212,2963,4175,311,0.03640718562874252,0.7255089820359282,0.005029940119760479,0.2902994011976048,0.7097005988023952,0.03520958083832335
3224,13.0,1669,7833,9502,32,1194,13620,3532,10088,13620,718,0.12254038179148312,0.5751101321585903,0.0023494860499265785,0.2593245227606461,0.7406754772393539,0.08766519823788546
3225,40.0,4842,111111,115953,990,4627,146527,43968,102560,146528,7742,0.033044878794496614,0.7582919305525224,0.006756387857610832,0.30006551648831625,0.6999344835116837,0.03157758244158113
3226,,166,3521,3687,6,148,4900,1421,3479,4900,401,0.03387755102040816,0.7185714285714285,0.0012244897959183673,0.29,0.71,0.030204081632653063
3227,,260,6507,6767,10,399,9083,2483,6600,9083,720,0.028624903666189586,0.7163932621380601,0.0011009578333149841,0.2733678300121105,0.7266321699878895,0.043928217549267866
3228,24.0,36,2120,2156,2,74,2767,861,1906,2767,235,0.013010480664980123,0.7661727502710517,0.0007228044813877846,0.3111673292374413,0.6888326707625587,0.02674376581134803
3229,27.0,734,15507,16241,23,1066,22854,6407,16447,22854,1768,0.03211691607596044,0.6785245471252297,0.0010063883784020302,0.28034479740964385,0.7196552025903562,0.04664391353811149
3230,16.0,261,7660,7921,9,450,10545,2968,7577,10545,816,0.024751066856330012,0.7264106211474632,0.0008534850640113798,0.28146040777619724,0.7185395922238027,0.04267425320056899
3231,36.0,348,6751,7099,55,636,9987,2689,7298,9987,704,0.03484529888855512,0.6759787724041254,0.005507159307099229,0.2692500250325423,0.7307499749674577,0.06368278762391108
3232,26.0,898,179722,180620,167,8278,238204,68736,169468,238204,21319,0.0037698779197662506,0.7544877499958019,0.0007010797467716747,0.2885593860724421,0.7114406139275579,0.03475172541183188
3233,44.0,7087,218321,225408,610,8398,294094,87926,206168,294094,25702,0.02409773745809163,0.7423510850272362,0.0020741667630077456,0.2989724373839657,0.7010275626160344,0.028555495861867293
3234,16.0,441,7777,8218,111,1118,11829,3253,8576,11829,423,0.03728125792543748,0.657452024685096,0.009383717981232564,0.27500211344999576,0.7249978865500042,0.09451348381097303
3235,,146,3784,3930,6,199,5289,1518,3771,5289,389,0.02760446209113254,0.7154471544715447,0.0011344299489506524,0.28701077708451506,0.7129892229154849,0.037625259973529966
3236,,244,2989,3235,1,564,4562,1236,3326,4562,224,0.053485313459009205,0.6551950898728628,0.00021920210434020167,0.27093380096448927,0.7290661990355107,0.12362998684787374
3237,27.0,87,1954,2041,9,89,2753,805,1948,2753,191,0.03160188884852888,0.7097711587359244,0.0032691609153650564,0.29240828187431894,0.7075917181256811,0.032328369051943334
3238,16.0,4032,96129,100161,192,5416,132309,38975,93334,132309,10080,0.030474117406979116,0.7265492143391606,0.0014511484479513865,0.29457557686929836,0.7054244231307016,0.04093447913596203
3239,16.0,3578,71599,75177,577,4423,99884,27898,71986,99884,6635,0.03582155300148172,0.7168215129550278,0.005776700973128829,0.2793039926314525,0.7206960073685476,0.044281366385006606
3240,24.0,5487,173361,178848,674,6007,228879,67897,160982,228879,16884,0.023973365839592097,0.757435151324499,0.0029447874204273873,0.2966501950812438,0.7033498049187562,0.026245308656539044
3241,42.0,534,18524,19058,58,342,24713,7260,17453,24713,2231,0.021608060534941124,0.7495650062720026,0.002346942904544167,0.2937725083963906,0.7062274916036094,0.013838870230243192
3242,,13232,188257,201489,657,13774,272845,76888,196023,272911,18773,0.04848467082675304,0.6898109640139093,0.002407378229532705,0.28173287262147734,0.7182671273785227,0.05047066626116206
3243,,1173,24637,25810,217,1272,35487,9856,25631,35487,2737,0.03305435793389128,0.6942542339448249,0.006114915321103503,0.2777355087778623,0.7222644912221377,0.03584411192831178
3244,16.0,936,18146,19082,97,1239,25614,7292,18323,25615,1648,0.03654108920554363,0.7084130392348233,0.0037868436463009956,0.2846769471013078,0.7153230528986921,0.048370095647081786
3245,16.0,384,7016,7400,14,316,9873,2825,7048,9873,794,0.038893953205712546,0.7106249366960397,0.0014180087106249366,0.2861339005368176,0.7138660994631825,0.03200648232553428
3246,24.0,524,18104,18628,67,806,24764,7027,17737,24764,2262,0.021159748021321274,0.7310612178969472,0.002705540300436117,0.2837586819576805,0.7162413180423195,0.032547246002261346
3247,14.0,1080,19704,20784,356,1579,30571,7383,23188,30571,1571,0.03532759805043996,0.6445323999869157,0.01164502306107095,0.24150338556147982,0.7584966144385201,0.05165025677930064
3248,14.0,424,10008,10432,14,618,13982,3984,9998,13982,1080,0.030324703189815477,0.715777428121871,0.0010012873694750393,0.28493777714203977,0.7150622228579603,0.04419968530968388
3249,,424,12694,13118,52,444,17094,5002,12092,17094,1416,0.024804024804024803,0.7425997425997426,0.003042003042003042,0.29261729261729263,0.7073827073827074,0.025974025974025976
3250,43.0,137,4554,4691,8,101,6109,1788,4321,6109,601,0.02242592895727615,0.7454575216893109,0.0013095432967752496,0.2926829268292683,0.7073170731707317,0.016532984121787525
3251,,78,2236,2314,0,72,3102,881,2221,3102,265,0.025145067698259187,0.7208252740167633,0.0,0.28401031592520953,0.7159896840747905,0.02321083172147002
3252,35.0,816,21607,22423,35,829,29017,8636,20381,29017,2420,0.028121446048867904,0.744632456835648,0.0012061894751352656,0.2976186373505187,0.7023813626494814,0.028569459282489575
3253,24.0,260,7080,7340,20,341,9808,2791,7017,9808,782,0.026508972267536703,0.7218597063621534,0.0020391517128874386,0.2845636215334421,0.7154363784665579,0.03476753670473083
3254,26.0,920,10975,11900,995,1432,19209,4394,14815,19209,871,0.04789421625279817,0.5713467645374564,0.05179863605601541,0.22874694153782082,0.7712530584621792,0.07454838877609454
3255,17.0,3993,82036,86029,280,5339,115627,32771,82856,115627,8797,0.034533456718586486,0.7094882683110346,0.002421579734837019,0.2834199624655141,0.7165800375344858,0.04617433644391016
3256,15.0,71,1415,1486,0,33,2065,617,1448,2065,159,0.03438256658595642,0.6852300242130751,0.0,0.29878934624697334,0.7012106537530266,0.015980629539951573
3257,37.0,77,1739,1816,4,79,2330,693,1637,2330,174,0.03304721030042918,0.7463519313304721,0.0017167381974248926,0.2974248927038627,0.7025751072961374,0.03390557939914163
3258,35.0,61,1476,1537,0,67,2133,590,1543,2133,145,0.028598218471636194,0.6919831223628692,0.0,0.27660571964369435,0.7233942803563057,0.031411157993436474
3259,16.0,135,2686,2821,22,161,3732,1063,2669,3732,277,0.03617363344051447,0.7197213290460879,0.005894962486602358,0.28483386923901394,0.7151661307609861,0.04314040728831726
3260,,291,8642,8933,37,380,11610,3400,8210,11610,950,0.025064599483204133,0.7443583118001723,0.0031869078380706286,0.29285099052540914,0.7071490094745909,0.03273040482342808
3261,15.0,155,3005,3160,4,195,4264,1191,3073,4264,293,0.036350844277673544,0.7047373358348968,0.0009380863039399625,0.27931519699812385,0.7206848030018762,0.04573170731707317
3262,23.0,259,6717,6976,27,324,9445,2664,6781,9445,720,0.0274219163578613,0.7111699311805187,0.0028586553732133403,0.28205399682371624,0.7179460031762838,0.034303864478560084
3263,26.0,812,15019,15839,403,1173,22930,5856,17074,22930,1120,0.035412123855211516,0.6549934583515046,0.01757522895769734,0.2553859572612298,0.7446140427387702,0.05115569123419102
3264,,984,24791,25775,191,1303,34588,9829,24759,34588,2432,0.02844917312362669,0.7167514744998266,0.005522146409159246,0.2841737018619174,0.7158262981380825,0.03767202497976177
3265,15.0,157,3149,3306,13,217,4536,1264,3272,4536,332,0.03461199294532628,0.6942239858906526,0.0028659611992945325,0.2786596119929453,0.7213403880070547,0.047839506172839504
3266,25.0,1693,10740,12433,50,1164,17021,4668,12353,17021,913,0.09946536631220257,0.6309852535103695,0.0029375477351506964,0.274249456553669,0.725750543446331,0.0683861112743082
3267,,8658,144769,153427,1044,11573,210003,58157,151846,210003,14038,0.04122798245739347,0.6893663423855849,0.004971357552034971,0.27693413903610903,0.723065860963891,0.055108736541858924
3268,33.0,1583,31671,33254,163,1951,45776,12444,33332,45776,3098,0.0345814400559245,0.6918691017126879,0.003560817895840615,0.27184550856343936,0.7281544914365606,0.04262058720727019
3269,,83,1536,1619,16,137,2242,641,1601,2242,143,0.037020517395182875,0.6851025869759143,0.007136485280999108,0.2859054415700268,0.7140945584299733,0.061106155218554864
3270,,257,4849,5106,152,211,7047,1937,5110,7047,402,0.036469419611182066,0.688094224492692,0.021569462182489004,0.27486873847027105,0.725131261529729,0.029941819213849866
3271,16.0,87,2644,2731,4,426,4403,1072,3331,4403,214,0.019759255053372702,0.6004996593231887,0.0009084714967067908,0.24347036111741993,0.7565296388825801,0.09675221439927323
3272,23.0,480,9344,9824,232,810,13370,3607,9763,13370,800,0.03590127150336574,0.6988780852655199,0.017352281226626777,0.26978309648466714,0.7302169035153329,0.0605833956619297
3273,13.0,1466,27848,29314,295,5590,44635,11021,33614,44635,2258,0.03284418057578134,0.6239050072812815,0.00660916321272544,0.24691385683880362,0.7530861431611964,0.12523804189537358
3274,17.0,527,13302,13829,145,970,18942,5270,13672,18942,872,0.02782177172421075,0.7022489705416535,0.007654946679336924,0.2782177172421075,0.7217822827578925,0.05120895364797804
3275,,571,19387,19958,14,1162,26392,7547,18845,26392,2022,0.02163534404364959,0.7345786602000606,0.0005304637769020915,0.28595786602000606,0.7140421339799939,0.0440284934828736
3276,,3609,96217,99826,737,4601,132493,38303,94192,132495,10274,0.027238763726933093,0.7261934412619344,0.0055624740556247405,0.289090154345447,0.710909845654553,0.03472583871089475
3277,45.0,68412,1188774,1257186,14445,63923,1620566,475283,1145283,1620566,96420,0.04221488048002982,0.7335548197358207,0.008913552425510594,0.29328210020449647,0.7067178997955036,0.03944486062277007
3278,,116,2977,3093,6,205,4341,1124,3217,4341,287,0.026721953466943102,0.6857866850956001,0.00138217000691085,0.2589265146279659,0.7410734853720341,0.04722414190278738
3279,24.0,190,4338,4528,18,1462,7278,1702,5576,7278,400,0.026106073097004672,0.596042868920033,0.00247320692497939,0.23385545479527342,0.7661445452047265,0.20087936246221488
3280,26.0,262,7717,7979,8,259,10438,3066,7372,10438,894,0.025100593983521748,0.7393178769879287,0.0007664303506418854,0.29373443188350257,0.7062655681164974,0.02481318260203104
3281,27.0,477,13725,14202,30,481,18383,5456,12927,18383,1370,0.02594788663439047,0.7466137191970843,0.001631942555622042,0.29679595278246207,0.7032040472175379,0.026165478975140075
3282,36.0,251,7116,7367,22,415,9603,2682,6921,9603,728,0.026137665312923046,0.7410184317400812,0.002290950744558992,0.27928772258669166,0.7207122774133083,0.0432156617723628
3283,17.0,559,26597,27156,42,1146,36808,10707,26101,36808,2820,0.015186915887850467,0.7225874809823951,0.0011410562921104108,0.2908878504672897,0.7091121495327103,0.031134535970441208
3284,,103,5495,6174,26,386,8248,2110,6138,8248,495,0.012487875848690592,0.6662221144519883,0.0031522793404461687,0.255819592628516,0.7441804073714839,0.0467992240543162
3285,15.0,60,3973,4033,10,425,5649,1540,4109,5649,535,0.010621348911311737,0.7033103204106922,0.0017702248185519562,0.27261462205700127,0.7273853779429987,0.07523455478845813
3286,,194,4413,4607,34,294,6244,1794,4450,6244,388,0.031069827033952595,0.7067584881486226,0.005445227418321589,0.28731582319026266,0.7126841768097374,0.04708520179372197
3287,,91,1952,2043,7,225,2890,767,2123,2890,191,0.0314878892733564,0.6754325259515571,0.002422145328719723,0.26539792387543254,0.7346020761245675,0.07785467128027682
3288,35.0,65,3865,3930,3,151,5040,1495,3545,5040,369,0.012896825396825396,0.7668650793650794,0.0005952380952380953,0.29662698412698413,0.7033730158730159,0.02996031746031746
3289,,98,2822,2920,2,151,3827,1100,2727,3827,281,0.025607525476874837,0.7373922132218448,0.0005226025607525476,0.28743140841390125,0.7125685915860988,0.03945649333681735
3290,16.0,405,9503,9908,29,670,13281,3780,9501,13281,976,0.030494691664784277,0.7155334688652963,0.0021835705142685038,0.28461712220465324,0.7153828777953467,0.05044800843309992
3291,,212,6436,6648,0,270,8687,2520,6167,8687,694,0.024404282260849546,0.740877172786923,0.0,0.290088638195004,0.7099113618049959,0.03108092552089329
3292,33.0,120,2583,2703,2,89,3760,1058,2702,3760,208,0.031914893617021274,0.686968085106383,0.0005319148936170213,0.28138297872340423,0.7186170212765958,0.023670212765957446
3293,33.0,320,10332,10652,54,636,14239,4022,10217,14239,1014,0.022473488306763115,0.7256127537046141,0.0037924011517662757,0.2824636561556289,0.717536343844371,0.04466605800969169
3294,27.0,61,1797,1858,1,78,2581,701,1880,2581,205,0.023634250290585045,0.696241766757071,0.0003874467260751647,0.27160015497869044,0.7283998450213096,0.030220844633862844
3295,16.0,129,6352,6481,4,249,8441,2480,5961,8441,676,0.01528254946096434,0.7525174742329108,0.00047387750266556097,0.2938040516526478,0.7061959483473522,0.02949887454093117
3296,17.0,326,3693,4019,8,251,5281,1525,3756,5281,351,0.06173073281575459,0.6992993751183488,0.0015148646089755728,0.2887710660859686,0.7112289339140314,0.047528877106608594
3297,,815,11018,11833,70,1824,17598,4211,13387,17598,816,0.04631208091828617,0.6260938743038982,0.003977724741447892,0.23928855551767247,0.7607114444823275,0.10364814183429935
3298,24.0,934,17300,18234,85,1136,24448,6872,17576,24448,1782,0.03820353403141361,0.7076243455497382,0.0034767670157068065,0.281086387434555,0.7189136125654451,0.046465968586387435
3299,,371,13458,13829,49,574,18051,5235,12816,18051,1367,0.020552877956899893,0.7455542629217218,0.002714531050911307,0.2900116337045039,0.7099883662954961,0.03179879231067531
3300,26.0,1000,22145,23145,57,1152,31304,8800,22504,31304,2391,0.03194479938665985,0.7074175824175825,0.0018208535650396116,0.2811142346026067,0.7188857653973934,0.03680040889343215
3301,33.0,12493,312400,324893,1213,15139,429452,123268,306184,429452,33203,0.02909056192543055,0.7274386893063718,0.002824529865968723,0.28703557091362947,0.7129644290863706,0.03525190242448516
3302,,841,13634,14475,89,784,19610,5429,14181,19610,1226,0.04288628250892402,0.695257521672616,0.004538500764915859,0.2768485466598674,0.7231514533401325,0.03997960224375319
3303,,157,5624,5781,10,227,7670,2202,5468,7670,588,0.02046936114732725,0.7332464146023469,0.001303780964797914,0.2870925684485007,0.7129074315514994,0.029595827900912648
3304,,190,2948,3138,11,198,4227,1197,3030,4227,317,0.044949136503430326,0.697421339011119,0.0026023184291459663,0.2831795599716111,0.716820440028389,0.0468417317246274
3305,25.0,56,1800,1856,2,91,2461,730,1731,2461,170,0.022754977651361235,0.7314099959366112,0.0008126777732629012,0.29662738724095894,0.7033726127590411,0.03697683868346201
3306,41.0,1392,37224,38616,229,2112,51368,14611,36757,51368,3707,0.02709858277526865,0.7246534807662358,0.004458028344494627,0.2844377822769039,0.7155622177230961,0.04111509110730416
3307,17.0,602,28169,28771,393,2652,39682,10581,29101,39682,1859,0.015170606320245956,0.7098684542109772,0.009903734690791794,0.26664482636963865,0.7333551736303614,0.06683130890580112
3308,16.0,324,19493,19817,70,2557,28427,6978,21449,28427,1416,0.011397614943539592,0.6857213212790657,0.002462447672986949,0.24547085517289902,0.754529144827101,0.08994969571182326
3309,,75,2462,2537,2,136,3402,970,2432,3402,282,0.02204585537918871,0.7236919459141682,0.0005878894767783657,0.28512639623750735,0.7148736037624926,0.03997648442092887
3310,25.0,3882,77104,80986,396,3285,105121,30769,74352,105121,7217,0.03692887244223324,0.7334785627990601,0.0037670874516033902,0.29270079242016345,0.7072992075798366,0.031249702723528124
3311,13.0,123,2153,2276,18,86,3145,874,2271,3145,246,0.03910969793322735,0.6845786963434022,0.005723370429252782,0.2779014308426073,0.7220985691573927,0.027344992050874404
3312,23.0,73,1898,1971,3,172,2715,703,2012,2715,214,0.026887661141804787,0.6990791896869245,0.0011049723756906078,0.25893186003683244,0.7410681399631676,0.06335174953959484
3313,14.0,382,19799,20181,21,1744,27000,7635,19365,27000,1985,0.014148148148148148,0.7332962962962963,0.0007777777777777777,0.2827777777777778,0.7172222222222222,0.06459259259259259
3314,13.0,314,6714,7028,250,950,10098,2359,7739,10098,600,0.031095266389384035,0.6648841354723708,0.02475737769855417,0.23361061596355714,0.7663893840364429,0.09407803525450584
3315,,125,1681,1806,5,86,2381,675,1706,2381,154,0.05249895002099958,0.7060058798824024,0.0020999580008399833,0.28349433011339775,0.7165056698866022,0.03611927761444771
3316,16.0,71,15155,15226,24,2228,21008,5495,15513,21008,983,0.00337966488956588,0.7213918507235338,0.0011424219345011425,0.2615670220868241,0.738432977913176,0.10605483625285606
3317,24.0,180,3540,3720,106,176,4974,1446,3528,4974,328,0.03618817852834741,0.7117008443908324,0.021310816244471252,0.29071170084439085,0.7092882991556092,0.03538399678327302
3318,26.0,81,2422,2503,4,139,3252,957,2295,3252,218,0.024907749077490774,0.7447724477244773,0.0012300123001230013,0.29428044280442806,0.705719557195572,0.04274292742927429
3319,,1127,17430,18946,170,1101,25595,6873,18722,25595,1515,0.04403203750732565,0.6809923813244775,0.006641922250439539,0.26852900957218206,0.7314709904278179,0.043016214104317246
3320,,1624,37037,38661,121,2392,52410,14807,37604,52411,3804,0.030985861746579916,0.7066646314704929,0.00230867565968976,0.28251702886798574,0.7174829711320143,0.045639274198164506
3321,,200,2108,2308,7,130,3195,878,2317,3195,262,0.06259780907668232,0.6597809076682316,0.002190923317683881,0.27480438184663536,0.7251956181533646,0.0406885758998435
3322,16.0,157,1972,2129,23,116,2806,808,1998,2806,167,0.05595153243050606,0.7027797576621525,0.00819672131147541,0.2879543834640057,0.7120456165359943,0.041339985744832504
3323,,212,11487,11699,91,681,15971,4372,11599,15971,1285,0.01327405923235865,0.7192411245382255,0.005697827312003006,0.2737461649239246,0.7262538350760754,0.04263978460960491
3324,16.0,171,5070,5241,2,370,7211,1977,5234,7211,513,0.023713770628206905,0.7030924975731522,0.0002773540424351685,0.27416447094716406,0.725835529052836,0.05131049785050617
3325,17.0,271,6949,7220,65,321,10013,2939,7074,10013,506,0.0270648157395386,0.6939978028562869,0.006491560970738041,0.29351842604614004,0.70648157395386,0.03205832417856786
3326,15.0,7389,50660,58049,531,4432,80508,21274,59235,80509,3984,0.09177855891887864,0.6292464196549454,0.006595535902818319,0.2642437491460582,0.7357562508539418,0.055049745991131424
3327,,550,13234,13784,65,729,18355,5128,13227,18355,1351,0.029964587305911197,0.7210024516480523,0.003541269408880414,0.27937891582675023,0.7206210841732498,0.03971669844728957
3328,16.0,308,13557,13865,7,639,18733,5226,13507,18733,1411,0.01644157369348209,0.7236961511770672,0.00037367212939732025,0.2789729354614851,0.721027064538515,0.03411092724069823
3329,23.0,6141,146804,152945,348,7379,206896,58206,148690,206896,15047,0.029681579150877737,0.7095545588121568,0.0016820044853452943,0.2813297502126672,0.7186702497873327,0.0356652617740314
3330,15.0,239,2795,3034,47,157,4113,1124,2989,4113,313,0.058108436664235354,0.6795526379771456,0.011427182105519086,0.27327984439581815,0.7267201556041819,0.03817165086311695
3331,23.0,259,8802,9061,115,329,12005,3389,8616,12005,964,0.021574344023323616,0.7331945022907123,0.009579341940857976,0.2822990420658059,0.7177009579341941,0.02740524781341108
3332,,292,10630,10922,11,447,14991,4312,10679,14991,883,0.019478353678873992,0.7090921219398305,0.0007337735974918284,0.28763925021679676,0.7123607497832033,0.029817890734440664
3333,17.0,13119,278832,291951,1667,23133,410235,112231,298004,410235,29272,0.03197923141613953,0.679688471242093,0.004063524565188246,0.2735773398174217,0.7264226601825783,0.05638963033383305
3334,27.0,80,2284,2364,6,182,3147,866,2281,3147,188,0.02542103590721322,0.7257705751509373,0.0019065776930409914,0.2751827136955831,0.7248172863044169,0.05783285668891007
3335,26.0,85,2175,2260,83,84,3136,874,2262,3136,240,0.027104591836734693,0.6935586734693877,0.02646683673469388,0.27869897959183676,0.7213010204081632,0.026785714285714284
3336,24.0,177,3054,3231,21,167,4297,1294,3003,4297,170,0.04119152897370258,0.7107284151733768,0.004887130556202001,0.3011403304631138,0.6988596695368862,0.03886432394693973
3337,25.0,890,14695,15585,152,679,19928,6115,13813,19928,1226,0.0446607788036933,0.7374046567643516,0.0076274588518667205,0.30685467683661183,0.6931453231633882,0.0340726615816941
3338,,347,7849,8196,24,612,11266,3096,8170,11266,821,0.03080063909107048,0.6966980294691993,0.002130303568258477,0.2748091603053435,0.7251908396946565,0.05432274099059116
3339,27.0,46,2848,2894,0,69,3631,1109,2522,3631,294,0.012668686312310658,0.7843569264665381,0.0,0.30542550261635915,0.6945744973836409,0.019003029468465986
3340,16.0,417,6806,7223,8,346,9940,2881,7059,9940,644,0.041951710261569415,0.684708249496982,0.0008048289738430583,0.2898390342052314,0.7101609657947686,0.03480885311871228
3341,15.0,288,6676,6964,39,469,9514,2643,6871,9514,694,0.030271179314694134,0.7017027538364515,0.0040992221988648304,0.2778011351692243,0.7221988648307757,0.04929577464788732
3342,23.0,957,28804,29761,130,1913,39327,10788,28539,39327,2966,0.024334426729727666,0.7324230172654919,0.0033056170061281052,0.27431535586238465,0.7256846441376154,0.048643425636331276
3343,17.0,536,5041,5577,10,274,7545,2245,5300,7545,251,0.07104042412193505,0.6681245858184228,0.0013253810470510272,0.2975480450629556,0.7024519549370444,0.03631544068919815
3344,26.0,607,18174,18781,141,910,25098,7316,17782,25098,1912,0.024185194039365688,0.7241214439397562,0.0056179775280898875,0.2914973304645789,0.7085026695354212,0.03625786915292055
3345,17.0,18,20523,20541,24,864,26821,7648,19173,26821,2480,0.0006711159166324894,0.7651839976138101,0.0008948212221766526,0.2851496961336266,0.7148503038663734,0.03221356399835949
3346,,102,1469,1571,15,76,2517,562,1955,2517,147,0.04052443384982122,0.5836313071116408,0.0059594755661501785,0.22328168454509337,0.7767183154549067,0.030194676201827572
3347,,5644,113741,119385,1807,6622,160994,43685,117309,160994,8718,0.035057207100885744,0.7064921674099656,0.011224020770960408,0.27134551598196205,0.7286544840180379,0.04113196765096836
3348,25.0,657,10124,10781,26,749,14484,4131,10353,14484,1043,0.04536039768019884,0.6989781828224247,0.0017950842308754487,0.2852112676056338,0.7147887323943662,0.05171223418945043
3349,15.0,2994,42060,45054,211,1998,58998,17028,41970,58998,4151,0.050747482965524254,0.7129055222210923,0.0035763924200820367,0.28861995321875317,0.7113800467812468,0.03386555476456829
3350,,486,14179,14665,49,344,19189,5654,13535,19189,1596,0.0253270102662984,0.7389129188597634,0.00255354630256918,0.29464797540257437,0.7053520245974256,0.017926937307832614
3351,23.0,82,2288,2370,7,90,3082,900,2182,3082,239,0.026606099935107073,0.7423750811161584,0.0022712524334847503,0.2920181700194679,0.7079818299805322,0.029201817001946788
3352,17.0,117,3836,3953,23,138,5397,1494,3903,5397,497,0.0216787103946637,0.7107652399481194,0.0042616268297202145,0.2768204558087827,0.7231795441912173,0.02556976097832129
3353,26.0,587,20303,20890,302,931,27105,8030,19075,27105,1797,0.021656520937096475,0.7490499907766095,0.011141855746172293,0.29625530344954804,0.7037446965504519,0.03434790629035234
3354,24.0,326,8635,8961,22,411,11758,3449,8309,11758,897,0.027725803708113624,0.7343936043544821,0.0018710665079095085,0.2933321993536316,0.7066678006463685,0.03495492430685491
3355,23.0,2434,66092,68526,210,2290,88657,25699,62958,88657,7156,0.027454120937996998,0.745479770350903,0.0023686792921032746,0.28986994822743833,0.7101300517725617,0.025829883709126183
3356,40.0,1003,23789,24792,116,1120,33149,9275,23874,33149,2217,0.030257322996168814,0.7176385411324625,0.0034993514133156356,0.2797972789526079,0.720202721047392,0.03378684123201303
3357,,219,6232,6451,11,272,8506,2429,6077,8506,668,0.025746531859863624,0.7326592993181283,0.0012932047966141547,0.28556313190688926,0.7144368680931108,0.03197742769809546
3358,27.0,339,3334,3673,8,194,4864,1403,3461,4864,345,0.06969572368421052,0.6854440789473685,0.001644736842105263,0.2884457236842105,0.7115542763157895,0.039884868421052634
3359,24.0,320,9224,9544,23,440,12471,3664,8807,12471,938,0.025659530109854865,0.7396359554165665,0.0018442787266458184,0.2938016197578382,0.7061983802421619,0.03528185390105044
3360,,497,13661,14158,21,756,19031,5357,13674,19031,1397,0.026115285586674374,0.7178288056329147,0.0011034627712679312,0.28148809836582417,0.7185119016341758,0.03972465976564553
3361,,68,2446,2514,9,111,3312,959,2353,3312,251,0.020531400966183576,0.7385265700483091,0.002717391304347826,0.28955314009661837,0.7104468599033816,0.03351449275362319
3362,16.0,8199,118832,127031,441,6812,173627,47934,125693,173627,10829,0.04722191825004175,0.6844096828258278,0.0025399275458310054,0.2760745736550191,0.7239254263449809,0.039233529347394124
3363,24.0,1844,50207,52051,157,3069,69782,19808,49974,69782,5187,0.026425152618153678,0.7194835344358144,0.00224986386174085,0.28385543549912584,0.7161445645008742,0.04397982287695967
3364,33.0,3308,111334,114642,477,4741,150558,43180,107378,150558,12130,0.02197159898510873,0.7394758166288075,0.0031682142430159805,0.28679977151662484,0.7132002284833752,0.03148952563131816
3365,24.0,11938,323982,335920,1328,15134,449154,128704,320450,449154,40077,0.026578857140312676,0.7213160742195327,0.0029566696500532112,0.2865475983738317,0.7134524016261683,0.03369445668968772
3366,39.0,153,4713,4866,37,364,6604,1875,4729,6604,485,0.02316777710478498,0.7136583888552392,0.005602665051483949,0.28391883706844334,0.7160811629315567,0.05511811023622047
3367,24.0,891,18061,18952,81,1372,25575,7151,18424,25575,1883,0.03483870967741935,0.706197458455523,0.0031671554252199413,0.27960899315738025,0.7203910068426197,0.05364613880742913
3368,,13067,248857,261924,934,18323,356456,99468,256988,356456,24597,0.036658100859573134,0.698142267208295,0.0026202392441142808,0.27904706331216195,0.720952936687838,0.05140325874722266
3369,,4389,88035,92424,1192,4933,124931,35524,89407,124931,9240,0.03513139252867583,0.7046689772754561,0.009541266779262153,0.2843489606262657,0.7156510393737343,0.03948579615948003
3370,,433,6614,7047,119,330,9607,2680,6927,9607,630,0.045071302175497034,0.6884563339231811,0.012386801290725512,0.2789632559591964,0.7210367440408035,0.03434995315915478
3371,,119,1785,1904,1,127,2571,735,1836,2571,184,0.046285492026448855,0.6942823803967327,0.00038895371450797355,0.28588098016336055,0.7141190198366394,0.049397121742512644
3372,24.0,2372,58607,60979,176,2307,79254,23206,56048,79254,5365,0.029929088752618165,0.7394831806596512,0.002220708103061044,0.2928054104524693,0.7071945895475307,0.029108940873646755
3373,,1859,85304,87163,392,4189,117963,33221,84742,117963,10309,0.01575917872553258,0.7231420021532176,0.0033230758797249986,0.28162220357230655,0.7183777964276934,0.0355111348473674
3374,,47,3438,3485,23,223,4652,1322,3330,4652,353,0.010103181427343079,0.7390369733447979,0.004944110060189166,0.28417884780739466,0.7158211521926053,0.047936371453138435
3375,,106,2821,2927,8,182,3834,1136,2698,3834,257,0.02764736567553469,0.7357850808555034,0.0020865936358894104,0.2962962962962963,0.7037037037037037,0.04747000521648409
3376,,266,5748,6014,3,509,8027,2266,5761,8027,529,0.0331381587143391,0.716083219135418,0.00037373863211660643,0.28229724679207674,0.7177027532079232,0.06341098791578423
3377,16.0,866,14862,15728,31,996,21740,5969,15771,21740,1688,0.03983440662373505,0.6836246550137994,0.0014259429622815087,0.27456301747930084,0.7254369825206992,0.04581416743330267
3378,14.0,47,1582,1629,1,51,2218,618,1600,2218,185,0.021190261496844005,0.7132551848512173,0.0004508566275924256,0.27862939585211904,0.721370604147881,0.022993688007213707
3379,,581,20832,21413,108,1448,28900,8097,20803,28900,2182,0.020103806228373704,0.7208304498269896,0.0037370242214532874,0.2801730103806228,0.7198269896193772,0.0501038062283737
3380,23.0,610,12270,12880,27,908,17612,4848,12764,17612,1260,0.0346354758119464,0.6966840790370202,0.0015330456506927096,0.2752668635021576,0.7247331364978424,0.05155575743811038
3381,,145,3921,4066,5,145,5431,1599,3832,5431,427,0.0266985822132204,0.7219664886761186,0.0009206407659731173,0.2944209169582029,0.7055790830417971,0.0266985822132204
3382,,259,3950,4209,11,260,5750,1603,4147,5750,331,0.04504347826086957,0.6869565217391305,0.0019130434782608696,0.2787826086956522,0.7212173913043478,0.04521739130434783
3383,,217,6388,6605,9,211,9449,2529,6920,9449,671,0.022965393163297702,0.6760503757011324,0.0009524817440999048,0.26764737009207323,0.7323526299079267,0.022330405333897768
3384,27.0,2535,53336,55871,593,3617,77050,21152,55898,77050,5387,0.03290071382219338,0.6922258273848151,0.007696301103179754,0.2745230369889682,0.7254769630110318,0.04694354315379624
3385,,9329,103874,113203,1121,6226,150706,43051,107655,150706,7420,0.0619019813411543,0.6892492667843351,0.007438323623478826,0.28566215014664315,0.7143378498533569,0.04131222379998142
3386,,50,2601,2651,3,546,4010,1109,2901,4010,319,0.012468827930174564,0.6486284289276808,0.0007481296758104738,0.2765586034912718,0.7234413965087282,0.13615960099750624
3387,,90,2508,2598,38,110,3504,983,2521,3504,290,0.025684931506849314,0.7157534246575342,0.010844748858447488,0.2805365296803653,0.7194634703196348,0.03139269406392694
3388,,130,2426,2556,37,131,3419,969,2450,3419,253,0.03802281368821293,0.7095642000584966,0.010821877742029834,0.28341620356829483,0.7165837964317052,0.03831529687042995
3389,27.0,540,17470,18010,10,949,23915,6469,17446,23915,1525,0.022579970729667574,0.7305038678653565,0.000418147606104955,0.27049968638929545,0.7295003136107046,0.039682207819360237
3390,,328,8438,8766,82,1267,12056,3271,8785,12056,483,0.027206370272063702,0.6999004644990047,0.0068015925680159255,0.2713171864631719,0.7286828135368282,0.105092899800929
3391,17.0,4449,60554,65003,275,4334,86561,25009,61552,86561,6447,0.051397280530492945,0.6995529164404293,0.003176950358706577,0.2889176418941556,0.7110823581058444,0.05006873765321565
3392,13.0,120,2413,2533,25,125,3531,936,2595,3531,328,0.033984706881903144,0.6833758142169357,0.007080147267063155,0.2650807136788445,0.7349192863211554,0.03540073633531578
3393,,1680,23613,25293,123,1796,34498,9697,24801,34498,2378,0.048698475273928926,0.6844744622876688,0.0035654240825555104,0.28108875876862427,0.7189112412313757,0.052060989042843064
3394,,208,5099,5307,36,262,7210,2033,5177,7210,557,0.02884882108183079,0.7072122052704577,0.0049930651872399446,0.28196948682385575,0.7180305131761442,0.03633841886269071
3395,14.0,1971,20544,22515,297,1704,31490,8574,22916,31490,2140,0.06259129882502382,0.652397586535408,0.009431565576373452,0.2722769133058114,0.7277230866941886,0.05411241664020324
3396,17.0,7901,205524,213425,798,9586,280574,80844,199733,280577,19910,0.02815982778346051,0.7325048026032069,0.002844139042045499,0.2881348079136921,0.7118651920863078,0.03416530934467187
3397,40.0,75,2218,2293,4,120,2994,862,2132,2994,215,0.025050100200400802,0.7408149632598531,0.0013360053440213762,0.2879091516366065,0.7120908483633934,0.04008016032064128
3398,16.0,174,6342,6516,46,577,8964,2448,6516,8964,652,0.019410977242302542,0.7074966532797858,0.005131637661758144,0.27309236947791166,0.7269076305220884,0.0643685854529228
3399,15.0,33,8987,9020,22,536,12287,3356,8931,12287,984,0.0026857654431512983,0.7314234556848702,0.0017905102954341987,0.27313420688532597,0.726865793114674,0.043623341743305934
3400,25.0,4642,68004,72646,330,4568,100200,27356,72844,100200,6377,0.046327345309381235,0.6786826347305389,0.0032934131736526945,0.27301397205588823,0.7269860279441118,0.045588822355289424
3401,34.0,310,8906,9216,62,365,12201,3479,8722,12201,1080,0.025407753462830914,0.7299401688386198,0.005081550692566183,0.285140562248996,0.714859437751004,0.029915580690107368
3402,36.0,15776,332760,348536,1294,15238,464625,133014,331611,464625,37701,0.03395426419155233,0.7161904761904762,0.0027850417002959374,0.2862824858757062,0.7137175141242937,0.03279634113532419
3403,24.0,8136,171267,179403,638,8776,235481,68485,166996,235481,16049,0.034550558219134456,0.7273070863466692,0.0027093481002713597,0.2908302580675299,0.7091697419324702,0.03726839957363864
3404,,2300,61127,63427,142,2460,82807,24347,58460,82807,5899,0.027775429613438478,0.73818638520898,0.0017148308717862017,0.2940210368688637,0.7059789631311363,0.0297076334126342
3405,,902,24537,25439,450,1478,34953,9739,25214,34953,2654,0.02580608245358052,0.7019998283409149,0.012874431379280748,0.2786313048951449,0.7213686951048551,0.04228535461905988
3406,15.0,147,5022,5169,13,276,6789,1936,4853,6789,529,0.021652673442333185,0.7397260273972602,0.001914862277213139,0.28516718220651055,0.7148328177934895,0.040653999116217414
3407,17.0,2981,44129,47110,595,3371,66112,18270,47842,66112,4596,0.04509015004840271,0.667488504356244,0.00899987899322362,0.27634922555663116,0.7236507744433688,0.05098923039690223
3408,37.0,2743,70659,73402,583,2279,94719,27875,66844,94719,6510,0.0289593428984681,0.745985493934691,0.006155048089612433,0.294291536017061,0.705708463982939,0.024060642532121326
3409,24.0,411,8059,8470,35,414,11241,3191,8050,11241,837,0.036562583400053375,0.7169290988346233,0.0031136019927052753,0.28387154167778667,0.7161284583222133,0.03682946357085669
3410,27.0,80,2505,2585,5,136,3387,956,2431,3387,246,0.023619722468261,0.7395925597874224,0.0014762326542663124,0.28225568349571895,0.717744316504281,0.040153528196043696
3411,,388,7716,8104,73,535,11218,3058,8160,11218,887,0.03458727045819219,0.6878231413799252,0.006507398823319665,0.2725976109823498,0.7274023890176502,0.04769121055446603
3412,16.0,2435,32814,35249,47,2934,48230,13376,34854,48230,3393,0.05048724860045615,0.6803649181007672,0.0009744972009122952,0.2773377565830396,0.7226622434169604,0.06083350611652499
3413,40.0,480,13874,14354,44,518,18941,5429,13512,18941,1490,0.025341851011034266,0.7324850852647695,0.0023230030093448076,0.28662689403938546,0.7133731059606145,0.027348080882741144
3414,17.0,5344,112148,117492,882,4713,156282,44642,111640,156282,12374,0.03419459694654535,0.7176002354717754,0.005643644181671593,0.2856502988188019,0.7143497011811981,0.030157023841517257
3415,,426,10214,10640,56,476,14162,4035,10127,14162,1035,0.03008049710492868,0.7212258155627737,0.003954243750882644,0.28491738455020477,0.7150826154497952,0.03361107188250247
3416,15.0,154,2887,3041,16,114,4102,1185,2917,4102,325,0.03754266211604096,0.7038030229156509,0.0039005363237445147,0.2888834714773281,0.7111165285226718,0.02779132130667967
3417,,1888,31274,33162,443,1089,43582,12863,30719,43582,2683,0.04332063696021293,0.7175898306640356,0.010164746913863522,0.29514478454407783,0.7048552154559222,0.024987380111055023
3418,,2963,54228,57191,238,2808,78988,22253,56735,78988,6204,0.03751202714336355,0.6865346634931888,0.003013115916341723,0.28172633817795106,0.7182736618220489,0.03554970375246873
3419,17.0,92,4271,4363,22,184,5820,1654,4166,5820,517,0.015807560137457044,0.733848797250859,0.003780068728522337,0.28419243986254294,0.715807560137457,0.03161512027491409
3420,,3654,62512,66166,233,4668,89612,24996,64616,89612,5953,0.04077578895683614,0.6975851448466723,0.0026000982011337766,0.2789358568048922,0.7210641431951078,0.05209123778065438
3421,33.0,65,1861,1926,9,68,2637,757,1880,2637,178,0.02464922260144103,0.7057262040197194,0.0034129692832764505,0.2870686386044748,0.7129313613955253,0.02578687902919985
3422,34.0,2337,69133,71470,266,2764,94453,27441,67012,94453,7624,0.0247424645061565,0.7319301663261093,0.0028162154722454554,0.2905254465183742,0.7094745534816258,0.029263231448445257
3423,,125,3090,3215,5,168,4307,1227,3080,4307,345,0.029022521476665893,0.7174367309031808,0.0011609008590666356,0.2848850708149524,0.7151149291850476,0.03900626886463896
3424,,4918,119031,123949,371,12219,170138,46573,123565,170138,12909,0.028905946937192162,0.699614430638658,0.002180582821004126,0.273736613807615,0.726263386192385,0.07181817113166959
3425,,3005,81085,84090,415,3716,108400,32188,76212,108400,7712,0.02772140221402214,0.7480166051660516,0.0038284132841328415,0.2969372693726937,0.7030627306273063,0.034280442804428046
3426,15.0,58,3104,3162,20,337,4353,1159,3194,4353,262,0.013324144268320699,0.7130714449804733,0.004594532506317482,0.2662531587410981,0.7337468412589019,0.07741787273144958
3427,,789,13275,14064,466,877,19276,5261,14015,19276,1128,0.04093172857439303,0.6886802241128865,0.024175140070554057,0.2729300684789375,0.7270699315210625,0.045496991076986924
3428,,832,15200,16219,375,1991,23515,5976,17562,23538,1347,0.03534709830911717,0.6457642960319483,0.015931684934998726,0.2538873311241397,0.7461126688758604,0.08458662588155323
3429,16.0,428,9970,10398,91,832,14311,3868,10443,14311,1144,0.029907064495842357,0.6966668995877298,0.006358745021312277,0.27028160156522957,0.7297183984347705,0.05813709733771225
3430,27.0,790,81929,82719,176,3195,107892,31486,76406,107892,8289,0.007322136951766581,0.7593612130649168,0.0016312608905201499,0.29182886590294,0.70817113409706,0.029612946279612945
3431,14.0,170,4322,4492,14,201,6032,1717,4315,6032,435,0.028183023872679045,0.7165119363395226,0.0023209549071618036,0.28464854111405835,0.7153514588859416,0.03332228116710875
3432,,234,5539,5773,21,167,7552,2200,5352,7552,521,0.030985169491525424,0.733448093220339,0.002780720338983051,0.2913135593220339,0.7086864406779662,0.02211334745762712
3433,44.0,81,1997,2078,6,93,2685,805,1880,2685,183,0.030167597765363128,0.7437616387337058,0.0022346368715083797,0.29981378026070765,0.7001862197392924,0.034636871508379886
3434,14.0,926,14524,15450,196,1303,21517,5754,15763,21517,1552,0.04303573918297161,0.6750011618720082,0.0091090765441279,0.2674164614026119,0.7325835385973881,0.060556769066319655
3435,,133,4898,5031,26,267,7057,1956,5101,7057,480,0.0188465353549667,0.6940626328468188,0.0036842851069859715,0.2771716026640215,0.7228283973359785,0.037834773983279016
3436,14.0,1034,48418,49452,1465,3241,67748,18945,48803,67748,5288,0.015262443171754148,0.7146779240715593,0.021624254590541417,0.2796392513432131,0.7203607486567869,0.04783905059927968
3437,,1008,20786,21794,93,1133,28824,8324,20500,28824,2301,0.034970857618651124,0.721135165140161,0.0032264779350541215,0.28878712184290867,0.7112128781570913,0.0393075215098529
3438,17.0,142,2691,2833,37,216,3949,1040,2909,3949,252,0.03595847049886047,0.6814383388199544,0.009369460622942517,0.26335781210433024,0.7366421878956698,0.054697391744745506
3439,15.0,877,13185,14062,34,686,18762,5449,13313,18762,1536,0.046743417546103824,0.7027502398464982,0.001812173542266283,0.2904274597590875,0.7095725402409124,0.03656326617631383
3440,14.0,113,10883,10996,142,1114,15813,4222,11591,15813,920,0.007146019098210333,0.6882312021754253,0.008979953203060774,0.2669955100233985,0.7330044899766015,0.0704483652690824
3441,,20033,347611,367644,2253,25301,508597,140386,368211,508597,33933,0.03938874983533131,0.68347040977434,0.004429833443767855,0.2760260088046135,0.7239739911953865,0.04974665599679117
3442,25.0,67,1992,2059,4,59,2605,761,1844,2605,187,0.025719769673704415,0.7646833013435701,0.0015355086372360845,0.2921305182341651,0.707869481765835,0.022648752399232246
3443,,3246,95950,99196,211,4387,132346,37626,94720,132346,10357,0.024526619618273314,0.7249935774409503,0.001594305834705998,0.2843002433016487,0.7156997566983513,0.033147960648602905
3444,15.0,7690,85956,93646,176,7490,128243,35812,92431,128243,8195,0.0599642865497532,0.6702588055488409,0.0013723945946367442,0.2792511092223357,0.7207488907776642,0.05840474723766599
3445,,305,3735,4040,60,242,5508,1562,3946,5508,324,0.055374001452432826,0.6781045751633987,0.010893246187363835,0.28358750907770514,0.7164124909222949,0.0439360929557008
3446,35.0,24421,569715,594136,1997,24474,769861,225458,544404,769862,50582,0.03172126952622678,0.740022237751701,0.0025939713870797624,0.2928550831187927,0.7071449168812073,0.03179011303324492
3447,15.0,1168,8504,9672,144,722,14340,3624,10716,14340,878,0.08145048814504881,0.59302649930265,0.0100418410041841,0.25271966527196654,0.7472803347280335,0.0503486750348675
3448,,197,4572,4769,18,271,6407,1791,4616,6407,478,0.030747619790853754,0.7135945060090526,0.002809427189012018,0.2795380053066958,0.7204619946933042,0.04229748712345872
3449,14.0,115,4306,4421,53,302,6872,1661,5215,6876,419,0.016724840023269343,0.6262361838278069,0.007707969749854567,0.24156486329261198,0.758435136707388,0.04392088423502036
3450,24.0,110,1971,2081,16,119,2859,783,2076,2859,162,0.03847499125568381,0.689401888772298,0.005596362364463099,0.2738719832109129,0.7261280167890871,0.0416229450856943
3451,15.0,275,7154,7429,36,380,9989,2796,7193,9989,768,0.027530283311642808,0.716187806587246,0.0036039643607968766,0.2799078986885574,0.7200921013114426,0.038041846030633694
3452,24.0,449,6980,8099,55,217,13044,2579,10465,13044,715,0.03442195645507513,0.5351119288561791,0.004216498006746397,0.19771542471634468,0.8022845752836553,0.0166360012266176
3453,,96,2903,2999,40,142,4071,1179,2892,4071,299,0.023581429624170966,0.7130926062392533,0.009825595676737903,0.2896094325718497,0.7103905674281503,0.03488086465241955
3454,26.0,765,20266,21031,151,1003,27406,7963,19443,27406,2181,0.027913595563015398,0.739473108078523,0.005509742392176896,0.29055681237685177,0.7094431876231482,0.0365978252937313
3455,16.0,94,1346,1440,1,64,1972,566,1406,1972,209,0.04766734279918864,0.6825557809330629,0.0005070993914807302,0.2870182555780933,0.7129817444219066,0.032454361054766734
3456,17.0,504,11625,12129,33,542,15937,4592,11345,15937,1210,0.03162452155361737,0.7294346489301625,0.002070653196963042,0.288134529710736,0.711865470289264,0.0340089100834536
3457,,53,2027,2080,1,64,2675,783,1892,2675,167,0.019813084112149534,0.7577570093457944,0.00037383177570093456,0.2927102803738318,0.7072897196261683,0.023925233644859812
3458,27.0,12,2494,2506,23,294,3647,941,2706,3647,208,0.003290375651220181,0.6838497395119276,0.006306553331505347,0.2580202906498492,0.7419797093501508,0.08061420345489444
3459,15.0,452,5167,5619,30,368,7592,2135,5457,7592,591,0.059536354056902004,0.6805848261327714,0.003951527924130664,0.2812170706006322,0.7187829293993677,0.04847207586933614
3460,,586,9453,10039,17,542,13548,3851,9697,13548,1012,0.04325361677000295,0.6977413640389726,0.0012547977561263655,0.28424859757897847,0.7157514024210215,0.040005904930617064
3461,43.0,97,3332,3429,14,180,4524,1288,3236,4524,340,0.021441202475685234,0.7365163572060124,0.003094606542882405,0.28470380194518125,0.7152961980548187,0.03978779840848806
3462,17.0,71,1612,1683,10,82,2214,644,1570,2214,171,0.032068654019873535,0.7280939476061428,0.004516711833785004,0.2908762420957543,0.7091237579042458,0.037037037037037035
3463,16.0,158,5604,5762,0,480,8117,2214,5903,8117,620,0.019465319699396327,0.690402858198842,0.0,0.2727608722434397,0.7272391277565603,0.059135148453862266
3464,,81,8288,8369,43,770,11518,3190,8328,11518,1039,0.007032470915089425,0.7195693696822365,0.00373328702899809,0.27695780517450946,0.7230421948254906,0.06685188400764022
3465,24.0,418,5974,6392,27,311,8560,2453,6107,8560,621,0.04883177570093458,0.6978971962616822,0.0031542056074766356,0.2865654205607477,0.7134345794392524,0.03633177570093458
3466,,204,5566,5770,12,285,7739,2215,5524,7739,653,0.02635999483137356,0.7192143687814964,0.0015505879312572683,0.28621268897790414,0.7137873110220959,0.036826463367360125
3467,25.0,166,3328,3494,15,203,4655,1329,3326,4655,309,0.03566058002148228,0.7149301825993555,0.00322234156820623,0.285499462943072,0.7145005370569281,0.04360902255639098
3468,27.0,184,8233,8417,9,429,10972,3172,7800,10972,848,0.016769959897921984,0.750364564345607,0.0008202697776157491,0.2890995260663507,0.7109004739336493,0.03909952606635071
3469,,32,2462,2494,14,131,3427,921,2506,3427,285,0.009337613072658301,0.7184126057776481,0.004085205719288007,0.26874817624744674,0.7312518237525533,0.038225853516194924
3470,,107,4472,4579,10,265,6101,1753,4348,6101,486,0.017538108506802163,0.7329945910506475,0.0016390755613833797,0.2873299459105065,0.7126700540894936,0.043435502376659565
3471,,58,1928,1986,5,85,2637,737,1900,2637,215,0.021994690936670457,0.7311338642396663,0.0018960940462646946,0.279484262419416,0.720515737580584,0.03223359878649981
3472,23.0,741,18922,19663,45,563,26492,7488,19009,26497,2428,0.027965430048684757,0.7141185794618259,0.0016983054685436086,0.28259802996565647,0.7174019700343435,0.021247688417556705
3473,,74,2190,2264,0,80,2937,881,2056,2937,229,0.02519577800476677,0.745658835546476,0.0,0.29996595165134493,0.7000340483486551,0.027238678924072182
3474,15.0,24,2748,2772,31,673,4234,1073,3161,4234,146,0.005668398677373642,0.649031648559282,0.007321681624940954,0.2534246575342466,0.7465753424657534,0.15895134624468588
3475,26.0,782,17941,18723,65,931,25338,7127,18211,25338,1769,0.030862735811824138,0.7080669350382824,0.0025653169153050754,0.2812771331596811,0.7187228668403189,0.036743231509985
3476,17.0,262,21653,21915,59,3188,31289,8155,23134,31289,1687,0.008373549809837323,0.6920323436351433,0.001885646712902298,0.26063472785963115,0.7393652721403688,0.1018888427242801
3477,37.0,513,11878,12391,24,489,16270,4828,11442,16270,1429,0.03153042409342348,0.7300553165334972,0.0014751075599262447,0.29674247080516286,0.7032575291948371,0.030055316533497235
3478,23.0,62,1620,1682,0,53,2246,628,1618,2246,185,0.027604630454140695,0.7212822796081924,0.0,0.27960819234194123,0.7203918076580588,0.023597506678539625
3479,,1384,19300,20684,226,1033,28479,7979,20500,28479,1975,0.048597211980757754,0.6776923347027635,0.007935671898591946,0.2801713543312616,0.7198286456687384,0.036272341023210086
3480,,611,10508,11119,58,726,15641,4101,11540,15641,917,0.03906399846557126,0.6718240521705773,0.0037082028003324594,0.262195511795921,0.7378044882040791,0.04641646953519596
3481,16.0,69,8630,8699,25,498,11766,3369,8397,11766,1155,0.005864354920958694,0.7334693183749788,0.002124766275709672,0.28633350331463536,0.7136664966853646,0.04232534421213666
3482,23.0,345,28501,28846,75,1447,38779,11075,27704,38779,3269,0.008896567729956936,0.7349596431058046,0.0019340364630341163,0.28559271770803785,0.7144072822919622,0.03731401016013822
3483,23.0,1166,20259,21425,92,867,28635,8000,20635,28635,2004,0.04071939933647634,0.7074908328968046,0.00321285140562249,0.2793783830976078,0.7206216169023921,0.030277632268203247
3484,26.0,853,26011,26864,134,1357,35103,9987,25116,35103,2518,0.024299917385978406,0.7409907985072501,0.003817337549497194,0.2845055978121528,0.7154944021878472,0.03865766458707233
3485,16.0,107,1954,2061,9,122,2763,757,2006,2763,196,0.03872602243937749,0.7072023163228375,0.003257328990228013,0.2739775606225118,0.7260224393774882,0.04415490408975751
3486,,31,18419,18450,54,1208,24746,7100,17646,24746,2094,0.0012527277135698698,0.7443223147175301,0.0021821708558959025,0.2869150569789057,0.7130849430210943,0.04881597025781945
3487,17.0,1539,23273,24812,87,2133,34309,9417,24892,34309,2520,0.044857034597335976,0.6783351307237168,0.00253577778425486,0.2744760849922761,0.725523915007724,0.06217027602086916
3488,16.0,233,4732,4965,17,386,6744,1883,4861,6744,411,0.03454922894424674,0.7016607354685647,0.0025207591933570582,0.2792111506524318,0.7207888493475683,0.057236061684460264
3489,17.0,2746,52808,55554,440,12469,83003,20800,62203,83003,3619,0.03308314157319615,0.6362179680252521,0.005301013216389769,0.25059335204751637,0.7494066479524837,0.15022348589810006
3490,,793,17059,17852,131,1102,23912,6796,17116,23912,1794,0.03316326530612245,0.7134074941451991,0.00547842087654734,0.28420876547340246,0.7157912345265975,0.04608564737370358
3491,,1676,32517,34193,224,1598,45833,13030,32803,45833,3396,0.03656753867300853,0.7094669779416578,0.004887308271332882,0.284292976676194,0.715707023323806,0.034865708114240834
3492,,411,11353,11764,35,566,15313,4435,10878,15313,1126,0.026839939920329133,0.7413961993077777,0.002285639652582773,0.2896231959772742,0.7103768040227257,0.036962058381767124
3493,,9946,189069,199015,1196,12421,269732,76228,193504,269732,17874,0.03687363753651773,0.7009513146382335,0.004434030815772693,0.28260643898388027,0.7173935610161197,0.04604941200895704
3494,,1393,30543,31936,85,1861,42619,12179,30440,42619,3521,0.03268495272061756,0.7166521973767569,0.001994415636218588,0.28576456510007275,0.7142354348999272,0.04366597057650344
3495,23.0,14216,346468,360684,1465,15831,473407,137660,335753,473413,33564,0.030028748682440067,0.7318514700694743,0.003094549579331366,0.29078204443055006,0.7092179555694499,0.03344014634156645
3496,35.0,224,7574,7798,7,279,10030,2977,7053,10030,729,0.022333000997008974,0.7551345962113659,0.0006979062811565304,0.29680957128614155,0.7031904287138584,0.02781655034895314
3497,34.0,524,6189,6713,35,277,8676,2518,6158,8676,678,0.060396496081143385,0.7133471645919779,0.004034117104656524,0.2902259105578608,0.7097740894421393,0.03192715537113877
3498,24.0,901,22189,23090,89,1241,30499,8787,21712,30499,2116,0.029541952195153938,0.7275320502311551,0.0029181284632283024,0.28810780681333814,0.7118921931866619,0.04068985868389127
3499,,1749,28488,30237,201,1588,39608,11514,28094,39608,2560,0.04415774590991719,0.7192486366390628,0.0050747323772975155,0.29069884871743085,0.7093011512825692,0.04009291052312664
3500,17.0,180,3616,3796,11,237,5211,1472,3739,5211,320,0.03454231433506045,0.6939167146421032,0.002110919209364805,0.2824793705622721,0.7175206294377279,0.04548071387449626
3501,,37,2244,2281,27,137,3447,832,2615,3447,220,0.010733971569480708,0.6510008703220191,0.007832898172323759,0.24136930664345807,0.7586306933565419,0.03974470554105019
3502,,5075,72826,77901,1032,4039,102495,29690,72805,102495,6550,0.04951461046880336,0.7105322210839553,0.010068783843114298,0.2896726669593639,0.7103273330406361,0.0394068003317235
3503,26.0,1628,23475,25103,455,1712,33889,9445,24444,33889,1663,0.04803918675676473,0.6927026468765676,0.013426185487916433,0.2787040042491664,0.7212959957508336,0.05051786715453392
3504,,503,13177,13680,35,549,17814,5343,12471,17814,1391,0.028236218704389807,0.7396991130571461,0.001964746828337263,0.29993263725159985,0.7000673627484001,0.030818457393061636
3505,36.0,502,9683,10185,311,560,14349,3882,10467,14349,893,0.03498501637744791,0.6748205449857133,0.021673984249773504,0.27054150114990594,0.7294584988500941,0.03902710990312914
3506,13.0,2860,48956,51816,106,3812,70751,20091,50660,70751,4308,0.04042345691226979,0.6919478169919859,0.0014982120394058036,0.28396771777077356,0.7160322822292264,0.05387909711523512
3507,,1514,42542,44056,65,1645,57735,16552,41183,57735,4449,0.026223261453191305,0.7368493981120637,0.0011258335498397852,0.28668918333766347,0.7133108166623365,0.028492249069022257
3508,15.0,218,3055,3278,8,269,4437,1153,3284,4437,305,0.049132296596799636,0.6885282848771692,0.001803020058598152,0.25986026594545863,0.7401397340545414,0.060626549470362855
3509,13.0,3760,39223,42983,916,2787,59116,16491,42625,59116,3549,0.06360376209486433,0.6634921171933148,0.015494959063536099,0.2789600108261723,0.7210399891738277,0.047144597063400774
3510,23.0,764,18875,19639,156,1343,26448,7612,18836,26448,1997,0.028886872353297035,0.7136645493042952,0.005898366606170599,0.28781004234724744,0.7121899576527526,0.050778886872353296
3511,,1287,35852,37139,126,1703,49035,14014,35021,49035,4041,0.026246558580605688,0.7311512185173855,0.002569593147751606,0.28579586009992863,0.7142041399000714,0.03473029468746813
3512,37.0,711,21140,21851,37,755,28616,8342,20274,28616,2344,0.024846239865809337,0.738747553816047,0.0012929829466032988,0.2915152362314789,0.7084847637685211,0.026383841207715964
3513,26.0,111,2739,2850,9,151,3835,1083,2752,3835,280,0.02894393741851369,0.7142112125162973,0.002346805736636245,0.28239895697522815,0.7176010430247718,0.039374185136897
3514,16.0,175,2872,3047,6,506,4534,1184,3350,4534,256,0.03859726510807234,0.6334362593736216,0.0013233348037053375,0.2611380679311866,0.7388619320688135,0.11160123511248346
3515,15.0,83,2584,2667,20,111,3537,1029,2508,3537,315,0.023466214305908964,0.7305626236923947,0.005654509471303365,0.2909245122985581,0.7090754877014419,0.031382527565733676
3516,15.0,754,11690,12444,31,906,16788,4797,11991,16788,1189,0.04491303311889445,0.6963307124136288,0.001846557064569931,0.2857398141529664,0.7142601858470335,0.05396711937097927
3517,,309,18221,18530,19,339,22843,7001,15842,22843,1680,0.013527119905441492,0.7976623035503217,0.0008317646543798975,0.30648338659545593,0.6935166134045441,0.014840432517620277
3518,17.0,83,5103,5186,5,265,6948,1970,4978,6948,583,0.011945883707541738,0.7344559585492227,0.0007196315486470927,0.2835348301669545,0.7164651698330455,0.03814047207829591
3519,23.0,16606,433679,450285,1196,24021,591833,170916,420917,591833,43234,0.028058590852487103,0.7327725895649617,0.0020208403384062734,0.28879092581860083,0.7112090741813991,0.04058746301743904
3520,,209,6325,6534,55,194,8511,2462,6049,8511,659,0.024556456350605098,0.7431559158735753,0.006462225355422395,0.2892727059099988,0.7107272940900011,0.02279403125367172
3521,16.0,503,14603,15106,46,731,19549,5672,13877,19549,1296,0.025730216379354444,0.7469947311882961,0.002353061537674561,0.2901427182976111,0.7098572817023888,0.03739321704435009
3522,24.0,1542,68019,69561,132,4870,93638,26189,67449,93638,6706,0.016467673380465196,0.726403810418847,0.0014096841026079157,0.2796834618424144,0.7203165381575856,0.05200879984621628
3523,,268,6836,7104,12,259,9126,2706,6420,9126,747,0.029366644751260135,0.7490685952224414,0.0013149243918474688,0.2965154503616042,0.7034845496383958,0.028380451457374535
3524,39.0,2010,41686,43696,225,2122,59053,16535,42522,59057,4479,0.03403491542069526,0.7058604399139814,0.0038098785918688725,0.279983744518008,0.720016255481992,0.035931388319758874
3525,,78,1931,2009,7,107,2731,780,1951,2731,225,0.02856096667887221,0.7070670084218235,0.002563163676309044,0.28560966678872207,0.7143903332112779,0.039179787623581104
3526,25.0,54,4343,4397,7,131,5692,1678,4014,5692,557,0.009486999297259312,0.7630007027406887,0.001229796205200281,0.29479971890372453,0.7052002810962755,0.023014757554462403
3527,,197,6661,6858,8,233,8770,2609,6161,8770,588,0.022462941847206385,0.759521094640821,0.0009122006841505131,0.2974914481185861,0.7025085518814139,0.026567844925883693
3528,13.0,392,6285,6677,32,318,8922,2500,6422,8922,754,0.04393633714413808,0.7044384667114997,0.003586639766868415,0.28020623178659493,0.719793768213405,0.03564223268325487
3529,27.0,510,13340,13850,9,491,18051,5254,12797,18051,1318,0.02825328236662789,0.7390172289623843,0.0004985873358816686,0.291064206969143,0.708935793030857,0.02720070910198881
3530,16.0,476,7407,7883,47,336,10640,2972,7668,10640,813,0.04473684210526316,0.6961466165413533,0.004417293233082707,0.2793233082706767,0.7206766917293234,0.031578947368421054
3531,27.0,4069,48626,52695,411,2801,68235,19904,48332,68236,3437,0.05963127967641714,0.7126150419133596,0.006023213552963245,0.2916935342048186,0.7083064657951814,0.041048713289172874
3532,,1321,32373,33694,23,1168,43762,12524,31238,43762,3236,0.03018600612403455,0.7397513824779489,0.0005255701293359536,0.286184360861021,0.713815639138979,0.026689822220191034
3533,33.0,7160,103892,111052,391,7291,151133,42223,108910,151133,9851,0.04737549046204337,0.6874210132796941,0.002587125247298737,0.2793764432652035,0.7206235567347965,0.048242276670217625
3534,,6,3543,3549,1,167,5019,1343,3676,5019,448,0.001195457262402869,0.7059175134488942,0.00019924287706714485,0.2675831839011755,0.7324168160988245,0.03327356047021319
3535,25.0,553,16859,17412,105,538,21874,6672,15202,21874,1378,0.025281155709975314,0.770732376337204,0.004800219438602907,0.3050196580415105,0.6949803419584896,0.024595410075889182
3536,25.0,192,4937,5129,24,357,6861,1838,5023,6861,409,0.027984258854394404,0.7195744060632561,0.0034980323567993005,0.26789097799154643,0.7321090220084536,0.05203323130738959
3537,26.0,58,1706,1764,9,84,2411,669,1742,2411,185,0.024056408129406886,0.7075902115304853,0.0037328909166321027,0.27747822480298634,0.7225217751970137,0.03484031522189963
3538,24.0,134,17683,17817,122,1582,24187,6660,17527,24187,1614,0.00554016620498615,0.7310952164385827,0.005044031917972465,0.2753545292925952,0.7246454707074048,0.0654070368379708
3539,23.0,95,2303,2398,8,102,3152,907,2245,3152,239,0.030139593908629442,0.7306472081218274,0.0025380710659898475,0.287753807106599,0.712246192893401,0.03236040609137056
3540,24.0,163,3584,3747,12,266,4973,1391,3582,4973,316,0.032776995777196866,0.7206917353710034,0.0024130303639654134,0.27971043635632414,0.7202895636436758,0.05348883973456666
3541,25.0,103,2681,2784,10,101,3711,1063,2648,3711,297,0.027755322015629212,0.7224467798437079,0.0026946914578280788,0.28644570196712477,0.7135542980328753,0.027216383724063594
3542,14.0,347,4864,5211,47,353,7187,1962,5225,7187,530,0.04828161959092806,0.6767775149575622,0.0065395853624599974,0.2729929038541812,0.7270070961458188,0.049116460275497424
3543,,984,19137,20121,205,1459,27257,7484,19773,27257,1624,0.03610081813845985,0.7020948747110833,0.007521003778845801,0.2745716696628389,0.7254283303371611,0.053527534211395236
3544,,222,4975,5197,25,337,7155,1941,5214,7155,503,0.0310272536687631,0.6953179594689028,0.0034940600978336828,0.2712788259958071,0.7287211740041929,0.047099930118798046
3545,24.0,4345,103383,107728,285,4053,144522,41246,103276,144522,10784,0.03006462683882039,0.7153443766346992,0.001972018101050359,0.28539599507341445,0.7146040049265856,0.028044173205463527
3546,26.0,839,17129,17968,98,1018,24989,6935,18054,24989,1901,0.03357477290007603,0.6854616031053664,0.003921725559246068,0.27752210972828045,0.7224778902717196,0.04073792468686222
3547,17.0,519,3306,3825,15,251,5251,1501,3750,5251,266,0.09883831651114074,0.6295943629784803,0.002856598743096553,0.28585031422586177,0.7141496857741383,0.04780041896781565
3548,,446,7002,7448,63,326,10010,2793,7217,10010,647,0.04455544455544456,0.6995004995004995,0.006293706293706294,0.279020979020979,0.720979020979021,0.03256743256743257
3549,26.0,63,1559,1622,0,86,2151,623,1528,2151,197,0.029288702928870293,0.7247791724779172,0.0,0.2896327289632729,0.7103672710367271,0.0399814039981404
3550,,106,1662,1768,6,148,2390,663,1727,2390,151,0.04435146443514645,0.695397489539749,0.002510460251046025,0.2774058577405858,0.7225941422594142,0.06192468619246862
3551,23.0,246,6704,6950,31,379,9274,2679,6595,9274,690,0.026525770972611603,0.7228811731723097,0.00334267845589821,0.28887211559197756,0.7111278844080224,0.040866939831787796
3552,,420,10646,11066,33,515,14490,4149,10341,14490,1178,0.028985507246376812,0.7347135955831609,0.002277432712215321,0.28633540372670807,0.7136645962732919,0.03554175293305728
3553,,1089,19291,20380,87,1261,26748,7706,19042,26748,1768,0.04071332436069987,0.721212800957081,0.0032525796321220277,0.28809630626588906,0.711903693734111,0.0471437116793779
3554,14.0,166,3553,3719,25,371,5038,1450,3588,5038,302,0.03294958316792378,0.7052401746724891,0.004962286621675268,0.28781262405716557,0.7121873759428344,0.07364033346566097
3555,23.0,429,23315,23744,111,1037,31396,9042,22354,31396,2496,0.013664161039622882,0.7426105236335839,0.003535482227035291,0.28799847114282073,0.7120015288571793,0.0330296853102306
3556,,16,2265,2281,11,96,3038,864,2174,3038,260,0.005266622778143515,0.7455562870309415,0.003620803159973667,0.2843976300197498,0.7156023699802502,0.031599736668861095
3557,,340,9011,9351,18,371,12003,3615,8388,12003,856,0.028326251770390734,0.7507289844205616,0.0014996250937265683,0.30117470632341914,0.6988252936765809,0.030908939431808714
3558,16.0,2041,59741,61782,255,3117,83497,23710,59787,83497,6261,0.024443991999712564,0.7154867839563098,0.0030540019401894677,0.2839622980466364,0.7160377019533636,0.037330682539492434
3559,,877,19997,20874,92,733,27538,7795,19743,27538,2029,0.031846902462052434,0.72616021497567,0.003340838114605273,0.283063403297262,0.716936596702738,0.026617764543539837
3560,14.0,74,1666,1740,20,116,2314,641,1673,2314,147,0.03197925669835782,0.7199654278305964,0.00864304235090752,0.277009507346586,0.722990492653414,0.05012964563526361
3561,16.0,1921,40908,42829,173,3123,58225,15961,42264,58225,3859,0.03299270072992701,0.702584800343495,0.002971232288535852,0.27412623443538,0.72587376556462,0.053636753971661656
3562,16.0,1141,23946,25087,66,1655,33973,9549,24424,33973,2180,0.03358549436317075,0.7048538545315397,0.0019427192182026904,0.28107614870632563,0.7189238512936744,0.04871515615341595
3563,,86,3099,3185,7,183,4186,1155,3031,4186,340,0.020544672718585764,0.7403248924988055,0.0016722408026755853,0.27591973244147155,0.7240802675585284,0.043717152412804584
3564,17.0,263,5185,5448,28,299,7386,2048,5338,7386,503,0.03560790685079881,0.7020037909558624,0.0037909558624424585,0.27728134308150554,0.7227186569184945,0.0404819929596534
3565,,823,20905,21728,38,1029,28547,8266,20281,28547,1956,0.028829649350194417,0.7323011174554244,0.0013311381230952464,0.28955757172382385,0.7104424282761761,0.03604581917539496
3566,,205,5863,6068,87,774,8487,2371,6116,8487,361,0.024154589371980676,0.6908212560386473,0.010250972074938141,0.2793684458583716,0.7206315541416284,0.0911983032873807
3567,17.0,627,19774,20401,66,1016,27647,7909,19738,27647,2237,0.022678771656960972,0.7152313090027851,0.0023872391217853654,0.28607082142727963,0.7139291785727203,0.03674901435960502
3568,,728,21307,22035,53,949,28793,8383,20410,28793,2143,0.02528392317577189,0.7400062515194665,0.0018407251762581182,0.29114715382210954,0.7088528461778905,0.03295939985413121
3569,15.0,610,36567,37177,179,5111,51380,13369,38011,51380,2164,0.011872323861424679,0.7116971584274037,0.0034838458544180616,0.2601985208252238,0.7398014791747761,0.09947450369793694
3570,27.0,59,1935,1994,0,72,2545,763,1782,2545,198,0.02318271119842829,0.7603143418467584,0.0,0.29980353634577606,0.7001964636542239,0.028290766208251474
3571,23.0,739,17657,18396,84,1042,24436,7045,17391,24436,1844,0.030242265509903422,0.7225814372237682,0.0034375511540350305,0.28830414143067606,0.7116958585693239,0.042642003601244066
3572,23.0,107,3296,3403,11,107,4344,1307,3037,4344,316,0.024631675874769797,0.7587476979742173,0.0025322283609576428,0.3008747697974217,0.6991252302025782,0.024631675874769797
3573,,351,7945,8296,36,327,10749,3145,7604,10749,790,0.03265420039073402,0.7391385245139083,0.0033491487580240022,0.29258535677737463,0.7074146432226254,0.030421434552051353
3574,,457,11104,11561,43,1114,15951,4337,11614,15951,1075,0.028650241364177795,0.6961319039558649,0.002695755751990471,0.2718951789856435,0.7281048210143565,0.06983888157482289
3575,25.0,722,16028,16750,78,773,22317,6402,15915,22317,1683,0.032352018640498276,0.7181968902630281,0.003495093426535825,0.2868665143164404,0.7131334856835596,0.034637272034771696
3576,13.0,377,7469,7846,183,550,10640,2910,7730,10640,749,0.03543233082706767,0.7019736842105263,0.017199248120300752,0.27349624060150374,0.7265037593984962,0.05169172932330827
3577,,93,2271,2364,19,136,3338,893,2445,3338,237,0.02786099460754943,0.6803475134811264,0.005692031156381066,0.26752546434991015,0.7324745356500899,0.04074295985620132
3578,23.0,263,5994,6257,15,344,8273,2363,5910,8273,599,0.03179016076393086,0.7245255650912608,0.0018131270397679197,0.2856279463314396,0.7143720536685604,0.041581046778677626
3579,,642,10846,11488,64,783,15597,4409,11188,15597,1171,0.04116176187728409,0.6953901391293198,0.004103353208950439,0.28268256716035134,0.7173174328396487,0.05020196191575303
3580,23.0,673,17726,18399,92,861,24138,7116,17022,24138,1588,0.027881348910431685,0.7343607589692601,0.0038114176816637668,0.29480487198608,0.7051951280139199,0.035669898086005465
3581,16.0,250,7507,7757,14,352,10252,2986,7266,10252,818,0.024385485758876318,0.7322473663675381,0.0013655872024970737,0.2912602419040187,0.7087397580959812,0.034334763948497854
3582,15.0,1382,15853,17404,182,1383,23835,6424,17411,23835,1404,0.05798195930354521,0.6651143276693937,0.0076358296622613805,0.26951961401300606,0.7304803859869939,0.05802391441157961
3583,23.0,291,3360,3651,232,371,5601,1391,4210,5601,270,0.05195500803427959,0.5998928762720943,0.04142117479021603,0.24834850919478665,0.7516514908052133,0.06623817175504375
3584,14.0,8294,130764,139058,777,9775,187316,52849,134467,187316,13358,0.04427811826005253,0.698093061991501,0.004148070639988042,0.2821382049584659,0.7178617950415341,0.05218454376561532
3585,26.0,61,1578,1639,11,76,2375,602,1773,2375,149,0.02568421052631579,0.6644210526315789,0.0046315789473684215,0.2534736842105263,0.7465263157894737,0.032
3586,23.0,1436,38979,40415,151,1986,53523,15179,38344,53523,4027,0.026829587280234664,0.7282663527829157,0.0028212170468770435,0.2835977056592493,0.7164022943407508,0.037105543411243766
3587,17.0,371,9382,9753,47,473,13060,3659,9401,13060,1021,0.028407350689127104,0.7183767228177642,0.0035987748851454824,0.2801684532924962,0.7198315467075038,0.03621745788667688
3588,,282,6774,7056,36,605,9767,2690,7077,9767,652,0.028872734718951572,0.6935599467594963,0.0036858810279512644,0.27541722125524726,0.7245827787447527,0.06194327838640319
3589,,181,4342,4523,31,206,5870,1690,4180,5870,356,0.030834752981260646,0.7396933560477001,0.005281090289608177,0.2879045996592845,0.7120954003407155,0.035093696763202724
3590,,235,5468,5703,27,365,8051,2179,5872,8051,600,0.029188920630977517,0.6791702894050429,0.00335362066823997,0.27064960874425537,0.7293503912557446,0.045335983107688486
3591,26.0,58,1928,1986,5,85,2637,737,1900,2637,215,0.021994690936670457,0.7311338642396663,0.0018960940462646946,0.279484262419416,0.720515737580584,0.03223359878649981
3592,,7602,180413,188015,390,8131,245031,72584,172489,245073,18046,0.03101932893464396,0.7361602461307447,0.001591362573600519,0.2961729770313335,0.7038270229686665,0.03317786945114313
3593,33.0,5444,141562,147006,392,7708,198983,54859,144124,198983,15287,0.027359121130950886,0.7114276093937673,0.001970017539186765,0.27569691883226205,0.7243030811677379,0.03873697753074383
3594,,2901,63938,66839,265,3391,90849,25328,65521,90849,6791,0.031932107122808175,0.7037832006956598,0.0029169280894671377,0.2787922816982025,0.7212077183017975,0.03732567226937005
3595,24.0,123,4151,4274,11,151,5480,1639,3841,5480,365,0.022445255474452554,0.7574817518248175,0.0020072992700729928,0.2990875912408759,0.7009124087591241,0.027554744525547445
3596,16.0,3142,20919,24061,155,4084,35440,9156,26284,35440,2088,0.0886568848758465,0.5902652370203161,0.004373589164785553,0.258352144469526,0.7416478555304741,0.11523702031602709
3597,17.0,351,8630,8981,8,433,11749,3434,8315,11749,953,0.0298748829687633,0.7345305983487956,0.0006809090135330666,0.29228019405906885,0.7077198059409311,0.03685420035747723
3598,35.0,283,7431,7714,17,215,9789,2990,6799,9789,768,0.028910001021554808,0.7591173766472571,0.001736643170906119,0.3054448871181939,0.6945551128818062,0.02196342833793033
3599,34.0,970,32222,33192,160,1035,42517,12697,29820,42517,3299,0.022814403650304585,0.7578615612578498,0.0037632006021120963,0.29863348778135806,0.701366512218642,0.024343203894912624
3600,,1052,20157,21209,81,871,29185,8017,21168,29185,2184,0.03604591399691622,0.690663011821141,0.0027753983210553365,0.274695905430872,0.7253040945691279,0.029844097995545656
3601,27.0,314,7726,8040,65,393,10778,3039,7741,10780,722,0.029128014842300556,0.7166975881261596,0.006029684601113173,0.28191094619666046,0.7180890538033395,0.03645640074211503
3602,24.0,3349,197295,200644,708,10332,264103,76494,187609,264103,22477,0.012680658682407999,0.7470380874128655,0.0026807722744535277,0.2896369976865087,0.7103630023134914,0.039121100479737075
3603,34.0,744,23378,24122,115,1351,32103,9169,22934,32103,2461,0.02317540416783478,0.7282185465532817,0.0035822197302432792,0.2856119365791359,0.7143880634208641,0.04208329439616235
3604,24.0,169,3999,4168,11,277,5659,1542,4117,5659,370,0.029863933557165576,0.7066619544089061,0.0019438063262060435,0.27248630500088356,0.7275136949991164,0.048948577487188547
3605,,133,1825,1958,11,409,2916,712,2204,2916,136,0.04561042524005487,0.6258573388203018,0.0037722908093278463,0.24417009602194786,0.7558299039780522,0.14026063100137173
3606,37.0,12786,337799,350585,834,22993,465893,133113,332781,465894,33290,0.027444010869425235,0.7250554847239931,0.0017901067624824531,0.28571520560470837,0.7142847943952916,0.04935242780546648
3607,24.0,1714,29099,30813,372,2542,43930,11674,32256,43930,2684,0.039016617345777375,0.662394718870931,0.008468017300250399,0.2657409515137719,0.7342590484862281,0.05786478488504439
3608,15.0,1912,30306,32218,344,2547,44256,12237,32019,44256,2896,0.043203181489515546,0.6847885032537961,0.00777295733911786,0.27650488069414314,0.7234951193058569,0.05755151843817787
3609,,10894,14358,25252,139,993,33274,9504,23770,33274,1568,0.32740277694295844,0.4315080843902146,0.004177435835787702,0.2856284185850814,0.7143715814149185,0.0298431207549438
3610,,961,16806,17767,211,1021,23615,6679,16936,23615,1439,0.04069447385136566,0.7116663137836121,0.008934998941350837,0.28282871056531866,0.7171712894346813,0.043235231844166847
3611,35.0,1606,32616,34222,98,1489,45717,12815,32902,45717,2812,0.03512916420587528,0.7134326399370038,0.0021436227224008574,0.2803114815057856,0.7196885184942144,0.03256994115974364
3612,,428,8274,8702,94,503,11549,3252,8297,11549,645,0.037059485669754956,0.7164256645597021,0.008139232834011603,0.2815828210234652,0.7184171789765348,0.04355355442029613
3613,37.0,123,4107,4230,17,223,5687,1669,4018,5687,469,0.021628275013187974,0.722173377879374,0.002989273782310533,0.2934763495691929,0.7065236504308071,0.039212238438544045
3614,,98,1796,1894,0,82,2723,738,1985,2723,220,0.03598971722365039,0.6595666544252663,0.0,0.27102460521483657,0.7289753947851634,0.030113845023870732
3615,,1862,38354,40216,990,3095,61933,14278,47655,61933,3549,0.03006474738830672,0.6192821274603201,0.01598501606574847,0.23053945392601682,0.7694605460739832,0.04997335830655709
3616,16.0,734,16789,17523,71,1111,23500,6834,16666,23500,1506,0.03123404255319149,0.7144255319148937,0.003021276595744681,0.2908085106382979,0.7091914893617022,0.04727659574468085
3617,,949,19863,20812,87,1388,28506,7687,20819,28506,1898,0.033291236932575595,0.6968006735424122,0.003051989054935803,0.2696625271872588,0.7303374728127412,0.04869150354311373
3618,35.0,120,21867,21987,30,782,28827,8384,20443,28827,2506,0.00416276407534603,0.7585596836299303,0.0010406910188365075,0.29083845006417597,0.709161549935824,0.02712734589100496
3619,16.0,889,3354,4243,9,759,6310,1632,4678,6310,254,0.14088748019017433,0.5315372424722662,0.0014263074484944533,0.25863708399366087,0.7413629160063392,0.1202852614896989
3620,25.0,271,5068,5339,16,201,6976,2111,4865,6976,454,0.03884747706422018,0.7264908256880734,0.0022935779816513763,0.30260894495412843,0.6973910550458715,0.028813073394495414
3621,,242,5475,5717,67,433,8003,2167,5836,8003,633,0.030238660502311634,0.6841184555791578,0.00837186055229289,0.2707734599525178,0.7292265400474822,0.05410471073347495
3622,,427,7386,7813,29,718,11138,2949,8189,11138,715,0.038337223918118155,0.6631352127850602,0.0026036990483031064,0.26476925839468485,0.7352307416053151,0.06446399712695278
3623,40.0,794,5671,6465,855,555,10667,2375,8292,10667,350,0.0744351739008156,0.5316396362613668,0.08015374519546264,0.22264929220961846,0.7773507077903815,0.05202962407424768
3624,37.0,201,3478,3679,121,171,4888,1445,3443,4888,286,0.04112111292962357,0.7115384615384616,0.024754500818330607,0.2956219312602291,0.7043780687397708,0.03498363338788871
3625,,956,17904,18860,14,1217,25597,7245,18352,25597,2019,0.03734812673360159,0.6994569676133922,0.000546939094425128,0.2830409813650037,0.7169590186349963,0.04754463413681291
3626,,188,3351,3539,23,145,4751,1388,3363,4751,376,0.0395706167122711,0.7053251946958535,0.00484108608713955,0.29214902125868236,0.7078509787413176,0.03051989054935803
3627,14.0,922,24294,25216,98,1396,33683,9105,24578,33683,2168,0.027372858712109968,0.7212540450672446,0.0029094795594216665,0.2703144019238191,0.7296855980761808,0.041445239438292314
3628,38.0,331,8910,9241,121,356,12522,3458,9064,12522,1011,0.026433477080338604,0.7115476760900814,0.009662993132087527,0.27615396901453443,0.7238460309854656,0.028429963264654207
3629,16.0,1137,15170,16307,105,1871,24595,6290,18305,24595,1203,0.04622890831469811,0.6167920309005895,0.0042691603984549705,0.2557430372026835,0.7442569627973166,0.07607237243342142
3630,27.0,2376,52506,54882,185,3964,73005,20825,52180,73005,4344,0.032545716046846106,0.7192110129443189,0.0025340730086980344,0.28525443462776523,0.7147455653722348,0.054297650845832476
3631,15.0,1835,30286,32121,226,2053,43877,12198,31679,43877,3251,0.04182145543223101,0.6902477379948493,0.005150762358411012,0.27800442145087406,0.721995578549126,0.04678988991954783
3632,44.0,93,2434,2527,9,89,3417,947,2470,3417,296,0.027216856892010536,0.7123207491952005,0.0026338893766461808,0.2771436932982148,0.7228563067017852,0.0260462393912789
3633,,221,5716,5937,23,255,7743,2265,5478,7743,546,0.028541908820870463,0.7382151620818804,0.0029704248999095958,0.2925222781867493,0.7074777218132506,0.032932971716388995
3634,43.0,124,1743,1867,0,110,2511,715,1796,2511,175,0.04938271604938271,0.6941457586618877,0.0,0.28474711270410197,0.7152528872958981,0.04380724810832338
3635,26.0,150,5133,5283,13,216,7085,2015,5070,7085,566,0.02117148906139732,0.7244883556810162,0.001834862385321101,0.28440366972477066,0.7155963302752294,0.03048694424841214
3636,17.0,1937,80554,82491,224,5868,110866,30920,79946,110866,8427,0.017471542222142044,0.7265888550141613,0.0020204571284253062,0.2788952429058503,0.7211047570941497,0.05292876084642722
3637,23.0,13,5473,5486,4,217,7149,2179,4970,7149,711,0.0018184361449153728,0.765561617009372,0.0005595188138201147,0.3047978738285075,0.6952021261714925,0.03035389564974122
3638,,1,1570,1571,4,57,2065,619,1446,2065,201,0.00048426150121065375,0.7602905569007264,0.001937046004842615,0.2997578692493947,0.7002421307506054,0.027602905569007265
3639,23.0,4045,105568,109613,450,5322,146334,41964,104370,146334,10199,0.02764224308773081,0.7214181256577419,0.003075156832998483,0.2867686251998852,0.7132313748001148,0.036368854811595394
3640,,115,3432,3547,11,180,4709,1278,3431,4709,289,0.024421320874920365,0.728817158632406,0.002335952431514122,0.2713952006795498,0.7286047993204502,0.03822467615204927
3641,35.0,5894,134119,140013,809,8800,191028,52872,138156,191028,12285,0.0308541156270285,0.7020907929727579,0.004234981259291832,0.2767761794082543,0.7232238205917457,0.046066545218502
3642,27.0,309,8350,8659,22,624,11910,3319,8591,11910,796,0.025944584382871536,0.7010915197313182,0.0018471872376154492,0.27867338371116707,0.7213266162888329,0.05239294710327456
3643,,203,3985,4188,14,179,5735,1520,4215,5735,300,0.035396687009590234,0.6948561464690497,0.0024411508282476025,0.26503923278116825,0.7349607672188317,0.03121185701830863
3644,,89,3818,3907,4,135,5053,1506,3547,5053,421,0.017613299030279042,0.7555907381753414,0.0007916089451810805,0.29804076786067685,0.7019592321393232,0.02671680189986147
3645,,6610,180879,187489,745,9021,252625,71145,181480,252625,18482,0.026165264720435427,0.7159980207817912,0.0029490351311232065,0.2816229589312222,0.7183770410687779,0.0357090549233053
3646,17.0,2123,40937,43060,241,3331,59671,16456,43215,59671,4274,0.035578421678872485,0.6860451475591158,0.004038812823649679,0.27577885404970587,0.7242211459502941,0.055822761475423574
3647,38.0,1614,40875,42489,439,2194,57211,16209,41002,57211,4164,0.0282113579556379,0.7144605058467777,0.007673349530684659,0.2833196413277167,0.7166803586722833,0.03834926849731695
3648,38.0,4284,83217,87501,1131,3734,113281,33206,80076,113282,6764,0.0378171289348705,0.7346003778181882,0.009983933899472114,0.29312688688405925,0.7068731131159407,0.032961988665454356
3649,23.0,12752,193986,206738,1467,12827,278873,78203,200670,278873,18588,0.045726907947345206,0.6956069608746633,0.005260459062010306,0.2804251397589584,0.7195748602410417,0.04599584757219236
3650,,3618,80758,84380,570,4124,111989,33007,78982,111989,6626,0.03230674441239765,0.7211243961460501,0.005089785603943245,0.29473430426202574,0.7052656957379743,0.03682504531695077
3651,26.0,58,11087,11145,14,435,14632,4211,10421,14632,1341,0.0039639147074904315,0.7577227993439037,0.0009568069983597594,0.2877938764352105,0.7122061235647895,0.02972936030617824
3652,25.0,398,10389,10787,127,674,14518,4115,10403,14518,982,0.027414244386279103,0.7155944344951095,0.008747761399641825,0.2834412453505993,0.7165587546494008,0.04642512742802039
3653,26.0,11,1551,1562,1,94,2100,600,1500,2100,215,0.005238095238095238,0.7385714285714285,0.0004761904761904762,0.2857142857142857,0.7142857142857143,0.04476190476190476
3654,,340,5406,5746,38,303,7884,2203,5681,7884,562,0.043125317097919835,0.6856925418569254,0.004819888381532217,0.27942668696093353,0.7205733130390665,0.03843226788432268
3655,17.0,100,1774,1874,18,106,2683,720,1963,2683,194,0.03727171077152441,0.6612001490868431,0.006708907938874394,0.2683563175549758,0.7316436824450242,0.03950801341781588
3656,26.0,109,2702,2811,1,94,3646,1088,2558,3646,247,0.029895776193088315,0.7410861217772902,0.00027427317608337906,0.2984092155787164,0.7015907844212836,0.02578167855183763
3657,24.0,314,4144,4458,34,95,6052,1757,4295,6052,395,0.0518836748182419,0.6847323198942499,0.0056179775280898875,0.2903172504957039,0.7096827495042961,0.01569729015201586
3658,14.0,281,5634,5915,32,370,7895,2234,5661,7895,571,0.03559214692843572,0.7136162127929069,0.004053198226725776,0.28296390120329323,0.7170360987967068,0.046865104496516784
3659,14.0,1905,2116,4021,0,141,6288,1514,4774,6288,58,0.3029580152671756,0.33651399491094147,0.0,0.2407760814249364,0.7592239185750637,0.022423664122137404
3660,,146,3316,3462,49,186,4750,1350,3400,4750,375,0.030736842105263156,0.6981052631578948,0.01031578947368421,0.28421052631578947,0.7157894736842105,0.03915789473684211
3661,15.0,3343,85812,89364,596,11517,127470,32751,94725,127476,7325,0.026224544227933102,0.6731620069660171,0.004675389877310239,0.2569189494493081,0.7430810505506918,0.0903464181492987
3662,,77,8678,8755,14,349,11485,3357,8128,11485,1144,0.006704397039616891,0.755594253373966,0.001218981279930344,0.29229429690901176,0.7077057030909882,0.030387461906835
3663,,21524,469683,491207,2664,28270,671930,187125,484805,671930,48123,0.03203309868587502,0.6990058488235381,0.00396469870373402,0.27848883068176744,0.7215111693182326,0.042072834967928206
3664,34.0,662,19409,20071,163,768,25688,7656,18034,25690,1835,0.025768781627092254,0.7555079797586609,0.006344881276761386,0.2980147917477618,0.7019852082522382,0.029894900739587386
3665,37.0,691,16163,16854,70,766,21950,6405,15545,21950,1687,0.031480637813211844,0.7363553530751709,0.0031890660592255125,0.2917995444191344,0.7082004555808656,0.03489749430523918
3666,17.0,182,21514,21696,41,904,29220,8570,20650,29220,2119,0.00622861054072553,0.7362765229295003,0.0014031485284052019,0.2932922655715264,0.7067077344284737,0.030937713894592746
3667,34.0,91,1573,1664,9,81,2203,639,1564,2203,184,0.041307308216069,0.7140263277349069,0.0040853381752156154,0.2900590104403087,0.7099409895596913,0.03676804357694054
3668,17.0,175,10964,11139,62,597,15055,4265,10790,15055,1194,0.011624045167718366,0.7282630355363666,0.004118233145134507,0.2832945865161076,0.7167054134838924,0.039654599800730654
3669,26.0,537,12624,13161,68,711,17910,5053,12857,17910,1347,0.029983249581239532,0.704857621440536,0.0037967615857063095,0.28213288665549974,0.7178671133445003,0.03969849246231156
3670,,255,4376,4631,52,252,6444,1748,4696,6444,494,0.03957169459962756,0.6790813159528243,0.008069522036002483,0.271260086902545,0.728739913097455,0.03910614525139665
3671,23.0,296,9620,9916,19,404,12881,3789,9092,12881,1036,0.022979582330564397,0.7468364257433429,0.001475040757705147,0.29415418057604226,0.7058458194239577,0.03136402453225681
3672,44.0,2469,49009,51478,118,2725,70722,19325,51397,70722,4353,0.034911343005005514,0.692980967732813,0.0016685048499759621,0.27325301886258874,0.7267469811374113,0.03853115013715675
3673,16.0,353,5750,6103,118,1077,9277,2404,6873,9277,514,0.038051094103697315,0.6198124393661744,0.012719629190471057,0.2591354963889188,0.7408645036110811,0.11609356472997737
3674,27.0,236,7878,8114,82,431,10958,3050,7908,10958,887,0.021536776784084687,0.7189268114619456,0.007483117357181967,0.2783354626756707,0.7216645373243292,0.03933199488957839
3675,17.0,212,4716,4928,25,269,6554,1885,4669,6554,447,0.03234665852914251,0.7195605736954531,0.0038144644491913335,0.28761061946902655,0.7123893805309734,0.04104363747329875
3676,,692,16424,17116,78,394,22046,6714,15337,22051,1663,0.03138179674391184,0.7448188290780463,0.0035372545462790802,0.30447598748356086,0.6955240125164391,0.017867670400435354
3677,,55,13574,13629,62,2350,19629,4966,14663,19629,956,0.002801976667176117,0.6915278414590657,0.0031585918793621682,0.2529930205308472,0.7470069794691527,0.11972082123388864
3678,27.0,398,10376,10774,44,468,14464,4104,10360,14464,1084,0.027516592920353983,0.7173672566371682,0.0030420353982300885,0.28373893805309736,0.7162610619469026,0.03235619469026549
3679,25.0,856,20107,20963,72,1482,28320,7663,20657,28320,2242,0.030225988700564973,0.7099929378531074,0.002542372881355932,0.2705861581920904,0.7294138418079096,0.05233050847457627
3680,16.0,281,8205,8486,89,759,11792,3223,8569,11792,772,0.023829715061058344,0.6958107191316146,0.007547489823609227,0.2733208955223881,0.726679104477612,0.06436567164179105
3681,,215,4792,5007,11,322,6839,1929,4910,6839,492,0.03143734464102939,0.7006872349758737,0.0016084222839596433,0.28205878052346833,0.7179412194765317,0.04708290685772774
3682,24.0,86,4416,4502,17,233,5964,1721,4243,5964,491,0.014419852448021462,0.7404426559356136,0.002850435949027498,0.2885647216633132,0.7114352783366867,0.03906773977196512
3683,36.0,242,6602,6844,21,426,9270,2534,6736,9270,698,0.02610571736785329,0.7121898597626753,0.0022653721682847896,0.2733549083063646,0.7266450916936353,0.045954692556634306
3684,,31539,410167,441706,3491,19693,579344,166930,412415,579345,35946,0.05443906480594465,0.7079840164323503,0.006025770482182465,0.28813573949891685,0.7118642605010831,0.033991835607453245
3685,24.0,359,7419,7778,65,402,11054,2953,8101,11054,696,0.03247693142753754,0.6711597611724263,0.005880224353175321,0.2671431156142573,0.7328568843857427,0.03636692599963814
3686,,1290,24389,25679,227,1562,36078,9573,26505,36078,2141,0.03575586229835357,0.6760075392205777,0.006291923055601752,0.2653417595210378,0.7346582404789622,0.04329508287599091
3687,,52,3024,3076,39,125,4272,1174,3098,4272,358,0.012172284644194757,0.7078651685393258,0.009129213483146067,0.274812734082397,0.725187265917603,0.029260299625468163
3688,17.0,1295,42291,43586,252,2849,59357,16297,43060,59357,4754,0.02181714035412841,0.7124854692791077,0.0042454975824249876,0.27455902420944456,0.7254409757905554,0.0479977087790825
3689,23.0,6456,113984,120440,849,7301,166149,46074,120075,166149,11460,0.03885668887564776,0.686034824163853,0.005109871260133976,0.2773053102937725,0.7226946897062275,0.04394248535952669
3690,17.0,466,9114,9580,16,588,12794,3704,9090,12794,1040,0.03642332343285915,0.7123651711739878,0.0012505862122870095,0.2895107081444427,0.7104892918555573,0.0459590433015476
3691,,1455,53703,55158,226,2396,71246,21258,49988,71246,4265,0.020422199141004408,0.7537686326249895,0.003172107907812368,0.2983746455941386,0.7016253544058614,0.03362995817309042
3692,24.0,259,4172,4431,22,261,6020,1743,4277,6020,261,0.04302325581395349,0.6930232558139535,0.003654485049833887,0.2895348837209302,0.7104651162790697,0.04335548172757475
3693,35.0,119,3476,3595,3,144,4660,1382,3278,4660,356,0.025536480686695277,0.7459227467811159,0.0006437768240343348,0.29656652360515023,0.7034334763948498,0.030901287553648068
3694,23.0,81,1639,1720,17,124,2388,643,1745,2388,164,0.03391959798994975,0.6863484087102177,0.00711892797319933,0.2692629815745394,0.7307370184254607,0.051926298157453935
3695,,2390,52594,54984,456,1919,69754,21210,48544,69754,4418,0.034263268056312184,0.7539926025747627,0.006537259511999312,0.3040685838804943,0.6959314161195057,0.027510967112997105
3696,17.0,238,5978,6216,0,180,8120,2458,5662,8120,663,0.029310344827586206,0.7362068965517241,0.0,0.30270935960591133,0.6972906403940887,0.022167487684729065
3697,,761,17285,18046,581,1007,24934,6907,18027,24934,1677,0.030520574316194753,0.6932301275366969,0.02330151600224593,0.2770113098580252,0.7229886901419749,0.04038662067859148
3698,,571,22439,23010,81,616,31057,8839,22218,31057,2687,0.018385549151560036,0.7225102231381009,0.002608107672988376,0.2846057249573365,0.7153942750426635,0.0198344978587758
3699,,89,1731,1820,14,61,2456,713,1743,2456,209,0.03623778501628665,0.7048045602605864,0.005700325732899023,0.2903094462540717,0.7096905537459284,0.0248371335504886
3700,,357,6344,6701,15,239,8876,2508,6368,8876,574,0.04022082018927445,0.7147363677332131,0.0016899504281207751,0.2825597115817936,0.7174402884182064,0.026926543488057685
3701,,101,2033,2134,5,101,2809,787,2022,2809,188,0.03595585617657529,0.7237451050195799,0.00177999288002848,0.2801708793164827,0.7198291206835172,0.03595585617657529
3702,26.0,185,3788,3973,25,367,5659,1478,4181,5659,382,0.03269128821346528,0.6693762148789538,0.004417741650468281,0.26117688637568476,0.7388231136243153,0.06485244742887436
3703,37.0,2253,32224,34477,423,2970,46347,13213,33134,46347,2942,0.04861156061881028,0.6952769327033034,0.00912680432390446,0.28508857099704404,0.714911429002956,0.06408181759337174
3704,37.0,181,3268,3449,17,224,4687,1276,3411,4687,377,0.03861745252826968,0.6972477064220184,0.0036270535523789203,0.27224237251973543,0.7277576274802645,0.04779176445487519
3705,,587,11598,12185,85,648,16005,4642,11363,16005,1157,0.036676038737894406,0.7246485473289597,0.005310840362386754,0.2900343642611684,0.7099656357388316,0.04048734770384255
3706,16.0,41,1855,1896,4,66,2552,743,1809,2552,232,0.016065830721003135,0.7268808777429467,0.001567398119122257,0.2911442006269592,0.7088557993730408,0.02586206896551724
3707,16.0,468,9404,9872,33,521,13281,3745,9536,13281,954,0.035238310368195164,0.7080792109027935,0.002484752654167608,0.2819817784805361,0.7180182215194639,0.039228973721858296
3708,,137,3243,3380,17,559,4885,1283,3602,4885,322,0.02804503582395087,0.6638689866939611,0.003480040941658137,0.26264073694984647,0.7373592630501535,0.11443193449334699
3709,15.0,127,3772,3899,50,267,5059,1408,3651,5059,291,0.025103775449693614,0.7456018976082229,0.0098833761612967,0.27831587270211505,0.721684127297885,0.05277722870132437
3710,35.0,126,4815,4941,2,186,6317,1925,4392,6317,427,0.019946176982744975,0.7622289061263258,0.00031660598385309483,0.30473325945860374,0.6952667405413963,0.02944435649833782
3711,16.0,180,2870,3050,1,213,4212,1168,3044,4212,262,0.042735042735042736,0.681386514719848,0.00023741690408357076,0.27730294396961064,0.7226970560303894,0.05056980056980057
3712,,741,10551,11292,31,621,15004,4343,10661,15004,949,0.049386830178619036,0.7032124766728872,0.002066115702479339,0.28945614502799255,0.7105438549720074,0.04138896294321514
3713,,6483,176730,183213,2229,8834,242274,70062,172212,242274,18955,0.026758958864756432,0.7294633349018054,0.009200326902597885,0.2891849723866366,0.7108150276133633,0.03646284784995501
3714,17.0,239,8958,9197,83,592,12125,3547,8578,12125,821,0.019711340206185566,0.7388041237113402,0.006845360824742268,0.2925360824742268,0.7074639175257732,0.04882474226804124
3715,16.0,324,9414,9738,18,444,13004,3610,9394,13004,999,0.024915410642879113,0.7239310981236543,0.0013841894801599507,0.27760689018763457,0.7223931098123654,0.034143340510612116
3716,,7670,202211,209881,728,7114,274226,80348,193878,274226,21670,0.027969630888391328,0.7373881397095826,0.00265474462669477,0.2929992050352629,0.7070007949647371,0.025942106146025542
3717,16.0,716,12809,13525,30,637,18095,5013,13082,18095,1395,0.03956894169660127,0.7078751036197845,0.0016579165515335729,0.27703785576126,0.72296214423874,0.035203094777562866
3718,,124,5028,5152,3,240,6675,1984,4691,6675,482,0.018576779026217228,0.7532584269662921,0.00044943820224719103,0.29722846441947565,0.7027715355805243,0.035955056179775284
3719,24.0,18,4633,4651,13,178,6160,1834,4326,6160,510,0.002922077922077922,0.7521103896103896,0.0021103896103896102,0.29772727272727273,0.7022727272727273,0.028896103896103895
3720,24.0,2637,57895,60532,1195,3611,80764,22315,58449,80764,4973,0.03265068594918528,0.7168416621266901,0.014796196325095339,0.2762988460205042,0.7237011539794959,0.044710514585706504
3721,27.0,252,5526,5778,31,435,8016,2146,5870,8016,543,0.03143712574850299,0.6893712574850299,0.003867265469061876,0.26771457085828343,0.7322854291417166,0.05426646706586826
3722,15.0,63,9747,9810,15,1475,14218,3712,10506,14218,976,0.004431002954001969,0.6855394570263047,0.0010550007033338022,0.2610775073850049,0.7389224926149951,0.10374173582782388
3723,,327,13470,13797,17,1692,19220,5827,13393,19220,1014,0.017013527575442246,0.7008324661810614,0.0008844953173777315,0.30317377731529654,0.6968262226847034,0.08803329864724245
3724,17.0,942,36915,37857,88,3446,51575,14382,37193,51575,4366,0.018264663111972855,0.7157537566650509,0.0017062530295685894,0.27885603490063016,0.7211439650993698,0.06681531749878818
3725,,751,25420,26171,701,918,35200,10175,25025,35200,2517,0.021335227272727273,0.7221590909090909,0.01991477272727273,0.2890625,0.7109375,0.026079545454545456
3726,27.0,160,5224,5384,97,268,7241,2083,5158,7241,562,0.022096395525479907,0.721447313906919,0.013395939787322193,0.2876674492473415,0.7123325507526584,0.037011462505178845
3727,25.0,125,6790,6915,115,306,9358,2617,6741,9358,742,0.013357555033126736,0.7255823893994443,0.012288950630476598,0.27965377217354137,0.7203462278264586,0.03269929472109425
3728,37.0,216,4659,4875,31,246,6601,1890,4711,6601,472,0.03272231480078776,0.7058021511892137,0.00469625814270565,0.2863202545068929,0.7136797454931071,0.037267080745341616
3729,27.0,914,37012,37926,100,2537,51654,14193,37463,51656,3807,0.017693975530432088,0.7165092148056373,0.0019358835372463993,0.27475995044138146,0.7252400495586185,0.04911336533994115
3730,23.0,818,27451,28269,101,2372,37538,10826,26712,37538,2858,0.021791251531781127,0.7312856305610315,0.002690606851723587,0.2884010868986094,0.7115989131013906,0.06318930150780543
3731,26.0,1210,26106,27316,216,1589,36479,10328,26151,36479,2419,0.03316976890813893,0.7156446174511363,0.005921214945585131,0.28312179610186683,0.7168782038981332,0.043559308095068396
3732,26.0,140,3147,3287,3,145,4385,1258,3127,4385,329,0.03192702394526796,0.7176738882554162,0.0006841505131128849,0.2868871151653364,0.7131128848346636,0.0330672748004561
3733,14.0,234,3576,3810,15,237,5420,1427,3993,5420,311,0.04317343173431734,0.6597785977859778,0.0027675276752767526,0.2632841328413284,0.7367158671586715,0.04372693726937269
3734,23.0,626,14931,15557,47,542,19684,6035,13649,19684,1387,0.031802479170900226,0.7585348506401138,0.0023877260719365983,0.30659418817313555,0.6934058118268644,0.027535053850843323
3735,,74,8339,8413,3,289,11223,3195,8028,11223,1100,0.006593602423594404,0.7430277109507262,0.0002673082063619353,0.2846832397754611,0.7153167602245389,0.02575069054619977
3736,,512,15105,15617,116,715,21237,5893,15344,21237,1643,0.024108866600743985,0.7112586523520271,0.005462165089231059,0.2774874040589537,0.7225125959410463,0.03366765550689834
3737,26.0,923,28585,29508,361,1407,37533,11151,26382,37533,1954,0.024591692643806784,0.7615964617803,0.00961820264833613,0.2970985532731197,0.7029014467268804,0.03748701142994165
3738,,128,2499,2627,47,159,3723,906,2817,3723,186,0.034380875637926404,0.6712328767123288,0.012624227773301102,0.24335213537469783,0.7566478646253022,0.0427074939564867
3739,,96,3174,3270,49,162,4405,1269,3136,4405,333,0.021793416572077184,0.7205448354143019,0.01112372304199773,0.28808172531214526,0.7119182746878547,0.03677639046538025
3740,13.0,304,7140,7444,106,388,10949,2872,8077,10949,638,0.02776509270252991,0.6521143483423144,0.009681249429171614,0.26230706000547993,0.73769293999452,0.03543702621243949
3741,17.0,78,4091,4169,22,331,5846,1549,4297,5846,394,0.013342456380431064,0.699794731440301,0.00376325692781389,0.26496749914471435,0.7350325008552857,0.056619911050290794
3742,,208,6433,6641,20,538,9223,2528,6695,9223,718,0.022552314865011386,0.6974953919548954,0.0021684918139434025,0.27409736528244605,0.7259026347175539,0.05833242979507752
3743,14.0,3417,36826,40243,224,5746,57236,15956,41280,57236,2312,0.059700188692431336,0.6434062478160598,0.0039136207980990986,0.27877559577888045,0.7212244042211196,0.1003913620798099
3744,25.0,588,15018,15606,72,829,21370,5938,15432,21370,1626,0.027515208235844642,0.7027608797379504,0.0033692091717360787,0.27786616752456716,0.7221338324754328,0.038792700046794575
3745,,401,13317,13718,65,671,18076,5166,12910,18076,1577,0.022184111529099357,0.7367227262668732,0.003595928302721841,0.28579331710555433,0.7142066828944457,0.03712104447886701
3746,14.0,113,2456,2569,6,125,3498,974,2524,3498,243,0.03230417381360778,0.7021154945683248,0.0017152658662092624,0.27844482561463696,0.7215551743853631,0.0357347055460263
3747,,843,16688,17531,118,985,23772,6796,16977,23773,1917,0.035460396247844195,0.7019728263155681,0.004963614184158499,0.28587052538594204,0.714129474614058,0.04143355907962815
3748,15.0,355,6902,7257,167,762,10037,2617,7420,10037,523,0.03536913420344725,0.6876556740061771,0.016638437780213212,0.2607352794659759,0.7392647205340241,0.07591909933246986
3749,,140,3988,4128,12,266,5685,1533,4152,5685,431,0.024626209322779244,0.701495162708883,0.0021108179419525065,0.2696569920844327,0.7303430079155673,0.04678979771328056
3750,,460,18615,19075,27,834,24790,7161,17629,24790,2152,0.01855586930213796,0.7509076240419524,0.0010891488503428802,0.2888664784187172,0.7111335215812827,0.0336425978217023
3751,,763,21904,22667,14,1085,31706,8725,22981,31706,2471,0.02406484577051662,0.6908471582665742,0.0004415568031287453,0.2751845076641645,0.7248154923358355,0.034220652242477764
3752,15.0,2804,55980,58784,343,4219,80551,22353,58198,80551,5644,0.03481024444140979,0.6949634393117404,0.004258171841442068,0.2775012104132785,0.7224987895867214,0.05237675509925389
3753,17.0,606,7128,7734,129,472,10674,2889,7785,10674,598,0.0567734682405846,0.6677908937605397,0.012085441259134345,0.2706576728499157,0.7293423271500843,0.04421959902566985
3754,25.0,357,9180,9537,55,433,12740,3657,9083,12740,1049,0.028021978021978023,0.7205651491365777,0.0043171114599686025,0.2870486656200942,0.7129513343799058,0.03398744113029827
3755,14.0,1169,20564,21733,105,1668,29764,8222,21542,29764,2026,0.03927563499529633,0.6909017605160597,0.0035277516462841017,0.27623975272140844,0.7237602472785916,0.056040854723827443
3756,,106,3371,3477,25,281,5151,1331,3820,5151,349,0.0205785284410794,0.654436031838478,0.0048534265191225,0.2583964278780819,0.7416035721219181,0.05455251407493691
3757,15.0,407,8972,9379,28,481,12374,3567,8807,12374,926,0.03289154679165993,0.7250686924195895,0.0022628091158881525,0.2882657184418943,0.7117342815581057,0.03887182802650719
3758,17.0,7602,180413,188015,390,8131,245031,72584,172489,245073,18046,0.03101932893464396,0.7361602461307447,0.001591362573600519,0.2961729770313335,0.7038270229686665,0.03317786945114313
3759,,213,7541,7754,17,548,10452,2930,7522,10452,718,0.020378874856486796,0.7214887102946804,0.0016264829697665518,0.2803291236127057,0.7196708763872943,0.052430156907768845
3760,,675,16367,17042,49,525,22401,6499,15902,22401,1846,0.030132583366813983,0.7306370251328066,0.0021874023481094594,0.29012097674210974,0.7098790232578903,0.02343645372974421
3761,26.0,66,1814,1880,0,92,2490,719,1771,2490,220,0.02650602409638554,0.7285140562248996,0.0,0.2887550200803213,0.7112449799196787,0.036947791164658635
3762,27.0,45,2770,2815,13,123,3746,1083,2663,3746,243,0.01201281366791244,0.7394554191137213,0.0034703683929524828,0.28910838227442603,0.710891617725574,0.03283502402562734
3763,34.0,3401,78498,81899,207,4588,107559,30985,76589,107574,7622,0.031615446111513935,0.7297116403591946,0.0019242567906743264,0.2880342833770242,0.7119657166229758,0.042649710896685074
3764,25.0,327,10728,11055,71,527,14502,4213,10289,14502,1098,0.02254861398427803,0.7397600330988829,0.004895876430837126,0.2905116535650255,0.7094883464349745,0.03633981519790374
3765,25.0,602,15776,16378,60,624,21395,6186,15209,21395,1714,0.028137415283944846,0.7373685440523486,0.002804393549894835,0.2891329749941575,0.7108670250058425,0.029165692918906288
3766,,5012,105372,110384,1352,5506,149747,42130,107617,149747,10266,0.03346978570522281,0.703666851422733,0.009028561507075266,0.2813411954830481,0.718658804516952,0.03676868317896185
3767,16.0,133,1653,1786,112,127,2770,668,2102,2770,120,0.048014440433213,0.5967509025270759,0.04043321299638989,0.24115523465703972,0.7588447653429603,0.04584837545126354
3768,,784,16479,17263,71,958,22934,6598,16336,22934,1505,0.03418505276009418,0.7185401587163164,0.003095840237202407,0.287695125141711,0.712304874858289,0.04177204151042121
3769,,2231,36706,38937,197,2018,52491,15217,37274,52491,2013,0.04250252424225105,0.6992817816387571,0.003753024327980035,0.2898973157303157,0.7101026842696844,0.03844468575565335
3770,17.0,1450,20415,21865,31,1196,28790,8071,20719,28790,1819,0.050364709968739145,0.7091003820771101,0.0010767627648489058,0.2803403959708232,0.7196596040291768,0.04154220215352553
3771,23.0,1143,35560,36703,26,1233,48232,14346,33886,48232,4025,0.023697959860673412,0.7372698623320617,0.0005390612041797976,0.2974373859678222,0.7025626140321778,0.025563940952065017
3772,,45550,760606,806156,5734,40146,1077375,307953,769422,1077375,79398,0.04227868662257803,0.7059807402250842,0.005322195150249449,0.28583640793595544,0.7141635920640446,0.0372627915071354
3773,16.0,76,3283,3359,7,189,4645,1272,3373,4645,283,0.01636167922497309,0.7067814854682454,0.0015069967707212056,0.2738428417653391,0.7261571582346609,0.04068891280947255
3774,,214,3240,3454,29,546,5183,1294,3889,5183,310,0.04128882886359252,0.625120586532896,0.0055952151263746865,0.2496623577078912,0.7503376422921089,0.10534439513795099
3775,,3488,92538,96026,573,6047,129535,36637,92898,129535,10114,0.026927085343729493,0.7143860732620527,0.0044235148801482225,0.2828347550854981,0.7171652449145018,0.04668236383988884
3776,16.0,4075,69688,73763,275,7592,104051,27857,76194,104051,7986,0.03916348713611594,0.6697484887218768,0.002642934714707211,0.26772448126399556,0.7322755187360045,0.07296421946929871
3777,16.0,184,7539,7723,21,401,10318,2929,7389,10318,955,0.017832913355301416,0.7306648575305291,0.0020352781546811396,0.2838728435743361,0.7161271564256639,0.03886412095367319
3778,17.0,28606,482941,511547,2867,26823,705956,197537,508419,705956,51040,0.04052093898203288,0.6840950427505397,0.004061159619013083,0.27981488931321497,0.720185110686785,0.03799528582517891
3779,15.0,143,3448,3591,8,219,5034,1374,3660,5034,355,0.02840683353198252,0.6849423917361939,0.0015891934843067143,0.2729439809296782,0.7270560190703218,0.043504171632896306
3780,27.0,33,9504,9537,60,550,12903,3614,9289,12903,1091,0.0025575447570332483,0.7365728900255755,0.0046500813764240876,0.2800899015732775,0.7199100984267225,0.042625745950554135
3781,17.0,75,1809,1884,18,106,2505,717,1788,2505,189,0.029940119760479042,0.7221556886227545,0.00718562874251497,0.28622754491017965,0.7137724550898203,0.04231536926147705
3782,,780,11584,12364,23,1627,17162,4016,13146,17162,970,0.04544924833935439,0.6749796061065144,0.001340170143339937,0.23400536068057337,0.7659946393194267,0.09480247057452511
3783,23.0,26259,520068,546327,5665,42637,775596,211432,564164,775596,48561,0.033856543870778084,0.6705398171212847,0.007304060361322131,0.2726058411853594,0.7273941588146406,0.05497320770091646
3784,16.0,739,32260,32999,118,2369,44781,11599,33182,44781,3301,0.016502534557066614,0.7203948102990108,0.002635046113306983,0.25901610057837027,0.7409838994216297,0.05290190035952748
3785,27.0,3576,87121,90697,667,3573,122760,34018,88742,122760,8861,0.029130009775171065,0.7096855653307266,0.005433365917236885,0.2771098077549691,0.7228901922450309,0.029105571847507332
3786,,1017,22175,23192,202,1958,31612,8711,22901,31612,2161,0.03217132734404656,0.7014741237504745,0.006389978489181323,0.2755599139567253,0.7244400860432747,0.06193850436543085
3787,14.0,104,3936,4040,3,220,5358,1520,3838,5358,408,0.01941022769690183,0.734602463605823,0.0005599104143337066,0.28368794326241137,0.7163120567375887,0.041060097051138486
3788,23.0,6599,202706,209305,393,7487,274600,79594,195006,274600,21224,0.024031318281136197,0.7381864530225783,0.001431172614712309,0.2898543335761107,0.7101456664238893,0.027265112891478514
3789,37.0,165,3882,4047,19,192,5308,1595,3713,5308,395,0.03108515448379804,0.7313489073097211,0.0035795026375282594,0.30048982667671437,0.6995101733232856,0.03617181612660136
3790,26.0,471,6297,6768,23,391,9058,2590,6468,9058,562,0.051998233605652464,0.6951865754029587,0.0025391918745860014,0.28593508500772796,0.714064914992272,0.04316626186796202
3791,25.0,15,19544,19559,41,1062,25946,7413,18533,25946,2255,0.0005781237955754259,0.7532567640484082,0.0015802050412394974,0.2857087797733755,0.7142912202266245,0.04093116472674015
3792,24.0,2278,87069,89347,477,2843,117987,34038,83949,117987,8753,0.019307211811470756,0.7379541813928653,0.004042818276589794,0.28848940985023774,0.7115105901497623,0.024095874969276277
3793,23.0,139,4688,4827,19,195,6318,1897,4421,6318,428,0.022000633111744224,0.7420069642291864,0.0030072807850585626,0.30025324469768916,0.6997467553023109,0.030864197530864196
3794,24.0,320,9963,10283,30,263,12913,3984,8929,12913,844,0.024781228219623634,0.7715480523503446,0.002323240145589716,0.30852629133431425,0.6914737086656857,0.020367071943003176
3795,,439,50077,50516,150,3688,68907,18975,49932,68907,5878,0.006370905713497903,0.7267331330634043,0.002176847054725935,0.2753711524228308,0.7246288475771693,0.05352141291886165
3796,15.0,847,13247,14094,69,877,18783,5374,13409,18783,1285,0.04509396794974179,0.705265399563435,0.0036735345791407124,0.28610978012032157,0.7138902198796784,0.046691156897194275
3797,24.0,535,12515,13050,46,491,17163,5063,12100,17163,1174,0.03117170657810406,0.7291848744392007,0.002680184116995863,0.29499504748587074,0.7050049525141292,0.028608052205325408
3798,17.0,409,7211,7620,20,509,10762,2878,7884,10762,672,0.03800408845939417,0.6700427429845753,0.001858390633711206,0.26742241219104257,0.7325775878089574,0.047296041627950196
3799,,458,7663,8121,6,371,10676,3033,7643,10676,849,0.04289996253278382,0.7177781940801798,0.0005620082427875609,0.284095166729112,0.7159048332708879,0.03475084301236418
3800,35.0,680,15998,16678,68,1017,22325,6208,16117,22325,1723,0.03045912653975364,0.7165957446808511,0.003045912653975364,0.2780739081746921,0.721926091825308,0.04555431131019037
3801,,256,4481,4737,29,180,6440,1777,4663,6440,445,0.03975155279503106,0.695807453416149,0.0045031055900621115,0.2759316770186335,0.7240683229813665,0.027950310559006212
3802,13.0,342,1121,1463,30,198,2202,539,1663,2202,10,0.1553133514986376,0.5090826521344233,0.013623978201634877,0.24477747502270664,0.7552225249772934,0.08991825613079019
3803,15.0,660,7266,7926,9,692,11399,3039,8360,11399,702,0.05789981577331345,0.6374243354680235,0.0007895429423633652,0.26660233353802965,0.7333976664619704,0.06070707956838319
3804,16.0,739,15400,17034,113,1059,23055,5934,17121,23055,1561,0.03205378442854045,0.6679679028410324,0.004901322923443938,0.25738451528952505,0.742615484710475,0.045933636955107354
3805,,206,3483,3689,21,231,5029,1403,3626,5029,330,0.040962417975740704,0.6925830184927421,0.0041757804732551205,0.27898190495128256,0.7210180950487174,0.04593358520580632
3806,,13,2290,2303,0,111,3000,898,2102,3000,263,0.004333333333333333,0.7633333333333333,0.0,0.29933333333333334,0.7006666666666667,0.037
3807,,768,13610,14378,83,639,19500,5512,13988,19500,1346,0.039384615384615386,0.6979487179487179,0.004256410256410256,0.2826666666666667,0.7173333333333334,0.032769230769230766
3808,27.0,2358,283315,285673,839,17245,386560,107665,278895,386560,34611,0.006099958609271523,0.7329133899006622,0.0021704263245033114,0.2785207988410596,0.7214792011589404,0.04461144453642384
3809,23.0,220,7709,7929,36,399,10391,3047,7344,10391,829,0.021172168222500242,0.7418920219420653,0.003464536618227312,0.29323452988162835,0.7067654701183717,0.03839861418535271
3810,26.0,292,3719,4011,3,203,5308,1538,3770,5308,434,0.055011303692539565,0.700640542577242,0.0005651846269781462,0.28975131876412963,0.7102486812358704,0.03824415975885456
3811,26.0,162,5776,5938,7,402,7901,2213,5688,7901,610,0.020503733704594355,0.7310467029489938,0.0008859638020503734,0.28009112770535377,0.7199088722946463,0.050879635489178586
3812,,77,1547,1624,6,89,2173,640,1533,2173,147,0.0354348826507133,0.7119190059825127,0.0027611596870685687,0.29452369995398064,0.7054763000460194,0.04095720202485044
3813,17.0,597,13885,14482,66,1569,20940,5422,15518,20940,1379,0.02851002865329513,0.6630850047755492,0.003151862464183381,0.2589302769818529,0.7410697230181471,0.07492836676217765
3814,26.0,138,4673,4811,50,227,6365,1801,4564,6365,525,0.021681068342498035,0.7341712490180675,0.007855459544383346,0.2829536527886881,0.7170463472113119,0.03566378633150039
3815,,105,3520,3625,9,165,4773,1384,3389,4773,367,0.02199874292897549,0.7374816677142259,0.0018856065367693275,0.2899643829876388,0.7100356170123612,0.034569453174104335
3816,16.0,456,9068,9524,36,551,13068,3627,9441,13068,1018,0.03489439853076217,0.6939087848178758,0.0027548209366391185,0.2775482093663912,0.7224517906336089,0.042164064891337616
3817,,340,9056,9396,19,457,12339,3599,8740,12339,907,0.027554907204797797,0.7339330577842613,0.0015398330496798767,0.29167679714725664,0.7083232028527433,0.037037037037037035
3818,15.0,345,8959,9304,31,460,12525,3395,9130,12525,874,0.027544910179640718,0.7152894211576847,0.0024750499001996006,0.2710578842315369,0.7289421157684631,0.036726546906187624
3819,17.0,1293,24367,25660,117,2442,35351,9599,25752,35351,2444,0.03657605159684309,0.6892874317558202,0.003309665921756103,0.2715340442986054,0.7284659557013946,0.06907866821306329
3820,26.0,257,5708,5965,18,362,8029,2236,5793,8029,504,0.032008967492838464,0.7109229044712916,0.0022418732096151452,0.2784904720388591,0.7215095279611409,0.04508656121559347
3821,42.0,368,8331,8699,39,422,11837,3165,8672,11837,924,0.031088958350933515,0.703810087015291,0.00329475373827828,0.26738193799104504,0.732618062008955,0.03565092506547267
3822,26.0,85,2327,2412,0,130,3179,897,2282,3179,250,0.026737967914438502,0.7319911921988047,0.0,0.2821642025794275,0.7178357974205725,0.04089336269267065
3823,,546,9699,10245,29,431,14029,3809,10221,14030,1029,0.03891660727013543,0.691304347826087,0.002066999287241625,0.2714896650035638,0.7285103349964362,0.030719885958660015
3824,17.0,2039,53319,55358,388,2244,70929,21269,49661,70930,4545,0.028746651628365996,0.7517129564359227,0.005470181869448752,0.2998590159311998,0.7001409840688002,0.03163682503877062
3825,15.0,406,4639,5052,79,389,7134,1902,5232,7134,414,0.056910569105691054,0.6502663302495094,0.011073731426969442,0.26661059714045415,0.7333894028595458,0.05452761424165966
3826,36.0,671,18281,18952,224,778,25547,7211,18336,25547,1778,0.026265314909774143,0.7155830430187498,0.008768152816377658,0.2822640623165147,0.7177359376834853,0.030453673621168825
3827,17.0,689,55740,56429,153,2431,73565,20619,52946,73565,5870,0.00936586692041052,0.7576972745191327,0.002079793380004078,0.2802827431523143,0.7197172568476857,0.03304560592673146
3828,14.0,22,2245,2267,25,336,3339,844,2495,3339,165,0.006588799041629231,0.67235699311171,0.007487271638215035,0.2527702905061396,0.7472297094938605,0.10062893081761007
3829,,529,7244,7773,89,596,10804,2903,7901,10804,649,0.04896334690855239,0.6704924102184376,0.00823768974453906,0.26869677897075156,0.7313032210292484,0.05516475379489078
3830,17.0,61,1629,1690,1,124,2290,639,1651,2290,159,0.026637554585152837,0.711353711790393,0.0004366812227074236,0.2790393013100437,0.7209606986899564,0.05414847161572053
3831,17.0,783,6518,7301,36,544,10086,2763,7323,10086,658,0.07763236168947055,0.6462423160816974,0.003569303985722784,0.2739440809042237,0.7260559190957763,0.05393614911758874
3832,,1976,39648,41624,152,1893,54532,15953,38579,54532,3651,0.03623560478251302,0.7270593413041884,0.002787354214039463,0.29254382747744445,0.7074561725225555,0.0347135626787941
3833,,181,4862,5043,18,262,6694,1913,4781,6694,501,0.027039139527935463,0.726322079474156,0.00268897520167314,0.2857783089333732,0.7142216910666268,0.039139527935464595
3834,,79,1430,1509,6,97,2078,579,1499,2078,160,0.03801732435033686,0.6881616939364774,0.0028873917228103944,0.27863330125120306,0.7213666987487969,0.04667949951876805
3835,25.0,1082,19934,21016,153,1364,28249,8010,20239,28249,1856,0.0383022407872845,0.705653297461857,0.0054161209246345,0.2835498601720415,0.7164501398279585,0.048284895040532405
3836,,642,18974,19616,129,809,25548,7354,18195,25549,1899,0.025128185056166583,0.742651375787702,0.005049121296332538,0.28783905436612,0.71216094563388,0.031664644408783124
3837,,404,3839,4243,11,218,5697,1623,4074,5697,469,0.07091451641214674,0.6738634368966122,0.0019308407934000352,0.28488678251711425,0.7151132174828857,0.03826575390556433
3838,17.0,167,2874,3041,0,274,4301,1162,3139,4301,247,0.03882817949314113,0.6682166937921413,0.0,0.27016972797023947,0.7298302720297605,0.06370611485701
3839,17.0,68,2114,2182,10,166,3058,828,2230,3058,198,0.02223675604970569,0.6913015042511446,0.0032701111837802484,0.2707652060170046,0.7292347939829954,0.05428384565075212
3840,35.0,2184,32568,34752,194,1408,46324,13301,33023,46324,3434,0.04714618772126759,0.703048096019342,0.004187893964251792,0.2871297815387272,0.7128702184612727,0.030394611864260426
3841,16.0,592,11620,12212,88,618,16628,4688,11940,16628,1216,0.035602598027423625,0.6988212653355785,0.005292278085157566,0.2819340870820303,0.7180659129179697,0.0371662256434929
3842,14.0,382,4874,5256,56,430,7490,1968,5522,7490,500,0.05100133511348465,0.6507343124165554,0.007476635514018692,0.26275033377837115,0.7372496662216288,0.05740987983978638
3843,34.0,172,4800,4972,14,176,6346,1820,4526,6346,399,0.027103687362117868,0.7563819728963126,0.002206114087614245,0.2867948313898519,0.7132051686101482,0.027734005672864798
3844,16.0,1822,34241,36063,138,2812,49233,13807,35426,49233,3277,0.03700769808868035,0.6954887981638332,0.0028029979891536164,0.2804419799727825,0.7195580200272175,0.05711616192391282
3845,,97,4531,4628,12,238,6076,1776,4300,6076,421,0.01596445029624753,0.7457208689927584,0.0019749835418038184,0.2922975641869651,0.7077024358130349,0.03917050691244239
3846,24.0,8097,176220,184317,1644,10023,247862,69740,178122,247862,17130,0.03266737135986961,0.7109601310406597,0.006632723047502239,0.2813662441197118,0.7186337558802882,0.04043782427318427
3847,24.0,262,5553,5815,12,235,7486,2216,5270,7486,502,0.03499866417312316,0.741784664707454,0.0016029922522041143,0.29601923590702645,0.7039807640929735,0.031391931605663906
3848,16.0,40,2945,2985,16,381,4328,1143,3185,4328,351,0.009242144177449169,0.680452865064695,0.0036968576709796672,0.26409426987060997,0.73590573012939,0.08803142329020333
3849,24.0,8040,110457,118497,624,7540,161323,45248,116075,161323,11702,0.049837902840884435,0.6846946808576583,0.0038680163398895386,0.28048077459506704,0.719519225404933,0.04673853077366526
3850,,259,6033,6292,42,501,8544,2467,6077,8544,605,0.03031367041198502,0.7061095505617978,0.0049157303370786515,0.28874063670411987,0.7112593632958801,0.0586376404494382
3851,24.0,762,17785,18547,24,1040,24330,7000,17330,24330,1757,0.031319358816276205,0.730990546650226,0.0009864364981504315,0.28771064529387586,0.7122893547061241,0.0427455815865187
3852,24.0,2173,56158,58331,175,2332,75946,22286,53660,75946,5108,0.028612435151291707,0.7394464487925632,0.002304268822584468,0.2934453427435283,0.7065546572564717,0.030706027967239882
3853,23.0,86,1508,1594,2,103,2127,600,1527,2127,158,0.040432534085566525,0.7089797837329572,0.0009402914903620122,0.2820874471086037,0.7179125528913963,0.04842501175364363
3854,,109,2367,2476,3,63,3298,951,2347,3298,221,0.03305033353547605,0.717707701637356,0.0009096422073984233,0.28835657974530016,0.7116434202546998,0.01910248635536689
3855,,152,4654,4806,26,212,6326,1865,4461,6326,497,0.02402782168827063,0.7356939614290231,0.004110022130888397,0.29481504900411004,0.70518495099589,0.03351248814416693
3856,14.0,172,4279,4451,16,485,6092,1720,4372,6092,399,0.028233749179251477,0.7023965856861457,0.0026263952724885093,0.28233749179251477,0.7176625082074852,0.07961260669730795
3857,,216,1498,1714,43,236,2677,584,2093,2677,72,0.08068733657078819,0.5595816212177811,0.016062756817332834,0.21815465072842735,0.7818453492715727,0.08815838625326858
3858,25.0,1391,32468,33859,169,1601,45132,12448,32684,45132,3834,0.030820703713551362,0.7194008685633253,0.0037445714792165206,0.27581317025613755,0.7241868297438624,0.035473721527962424
3859,,6382,123934,130316,1966,4805,169166,49833,119333,169166,8608,0.037726257049288864,0.7326176654883368,0.011621720676731732,0.29458047125308867,0.7054195287469113,0.02840405282385349
3860,16.0,195,5810,6005,38,282,7859,2362,5497,7859,673,0.024812317088688127,0.7392798065911693,0.004835220766000763,0.3005471434024685,0.6994528565975315,0.03588242778979514
3861,15.0,610,10227,10837,19,833,14478,4096,10382,14478,1036,0.042132891283326424,0.7063820969747203,0.0013123359580052493,0.2829120044205001,0.7170879955795,0.0575355712114933
3862,,998,16625,17623,180,878,24274,6678,17596,24274,1654,0.04111394908132158,0.6848891818406525,0.0074153415176732304,0.27510917030567683,0.7248908296943232,0.03617038806953943
3863,13.0,142,1761,1903,15,97,2626,736,1890,2626,149,0.05407463823305408,0.6706016755521707,0.0057121096725057125,0.2802741812642803,0.7197258187357197,0.03693830921553694
3864,37.0,200,6890,7090,125,212,9217,2760,6457,9217,600,0.021699034392969514,0.7475317348377997,0.013561896495605946,0.2994466746229793,0.7005533253770208,0.023000976456547684
3865,17.0,3169,69994,73163,157,2880,96261,27786,68476,96262,7831,0.03292057094180466,0.7271197357212608,0.001630965490016829,0.28864972678730966,0.7113502732126904,0.02991834784234693
3866,26.0,661,10028,10689,35,422,13954,4069,9885,13954,849,0.04736992976924179,0.7186469829439587,0.002508241364483302,0.2916009746309302,0.7083990253690698,0.030242224451770102
3867,16.0,848,32866,33714,182,1708,44196,12617,31579,44196,3262,0.019187256765318128,0.743641958548285,0.004118019730292334,0.2854783238302109,0.7145216761697891,0.038646031315051135
3868,17.0,218,7183,7401,49,363,9993,2792,7201,9993,780,0.02181527068948264,0.7188031622135495,0.0049034324026818775,0.2793955769038327,0.7206044230961673,0.036325427799459624
3869,,96,2793,2889,0,252,3806,1017,2789,3806,272,0.025223331581713086,0.733841303205465,0.0,0.267209668943773,0.732790331056227,0.06621124540199684
3870,,15,1775,1790,2,100,2358,693,1665,2358,201,0.006361323155216285,0.7527565733672604,0.0008481764206955047,0.29389312977099236,0.7061068702290076,0.04240882103477523
3871,23.0,54,1839,1893,3,98,2493,713,1780,2493,175,0.021660649819494584,0.7376654632972323,0.0012033694344163659,0.2860008022462896,0.7139991977537103,0.03931006819093462
3872,17.0,196,5242,5438,31,255,7203,2079,5124,7203,651,0.027210884353741496,0.7277523254199639,0.004303762321255033,0.2886297376093295,0.7113702623906706,0.03540191586838817
3873,16.0,558,29142,29700,1125,2628,44106,11113,32993,44106,3127,0.01265133995374779,0.6607264317779894,0.025506733777717318,0.2519611844193534,0.7480388155806467,0.059583730104747656
3874,33.0,1152,20443,21595,203,1221,29243,8301,20943,29244,2143,0.03939269593762823,0.6990493776501162,0.006941594857064697,0.28385309807139925,0.7161469019286008,0.04175215428805909
3875,17.0,118,3290,3408,18,192,4627,1301,3326,4627,352,0.025502485411713852,0.7110438729198184,0.0038902096390749947,0.28117570780203155,0.7188242921979684,0.04149556948346661
3876,,999,3266,4265,1,147,5498,1612,3886,5498,337,0.18170243724990906,0.5940341942524554,0.00018188432157148054,0.2931975263732266,0.7068024736267734,0.02673699527100764
3877,17.0,37,2167,2204,1,396,3264,888,2376,3264,198,0.01133578431372549,0.6639093137254902,0.00030637254901960784,0.27205882352941174,0.7279411764705882,0.1213235294117647
3878,35.0,344,10027,10371,28,398,13432,3974,9458,13432,1120,0.02561048243001787,0.746500893388922,0.002084574151280524,0.29586063132817153,0.7041393686718285,0.029630732578916023
3879,36.0,106,2355,2461,9,155,3284,949,2335,3284,241,0.03227771010962241,0.7171132764920828,0.0027405602923264312,0.2889768574908648,0.7110231425091352,0.047198538367844094
3880,,56,1719,1775,17,96,2370,684,1686,2370,155,0.02362869198312236,0.7253164556962025,0.007172995780590718,0.28860759493670884,0.7113924050632912,0.04050632911392405
3881,17.0,133,4521,4654,6,311,6384,1794,4590,6384,556,0.020833333333333332,0.7081766917293233,0.0009398496240601503,0.28101503759398494,0.7189849624060151,0.048715538847117795
3882,25.0,1495,120051,121546,509,9106,163453,45913,117540,163453,12395,0.009146360115751928,0.7344680122114614,0.0031140450159984827,0.2808942020030223,0.7191057979969777,0.05571020415654653
3883,,513,8057,8570,37,1012,12407,3302,9105,12407,653,0.04134762633996937,0.6493914725558153,0.0029821874748126058,0.2661400822116547,0.7338599177883453,0.08156685741919883
3884,33.0,6345,180739,187084,613,9257,246529,72083,174446,246529,18726,0.025737337189539567,0.7331348441765472,0.002486522883717534,0.2923915644812578,0.7076084355187422,0.037549334966677346
3885,16.0,3394,83266,86660,435,5637,116627,32824,83803,116627,9080,0.029101323021255798,0.7139513148756291,0.0037298395740265975,0.2814442624778139,0.7185557375221862,0.048333576273075704
3886,,88,17771,17859,285,883,24021,6810,17211,24021,1642,0.003663461138170767,0.7398109987094625,0.011864618458848508,0.2835019358061696,0.7164980641938304,0.03675950210232713
3887,34.0,477,8165,8642,118,427,11859,3251,8608,11859,722,0.0402226157348849,0.6885066194451471,0.009950248756218905,0.27413778564803104,0.725862214351969,0.03600640863479214
3888,25.0,79158,1729071,1808229,10456,98164,2395217,691759,1703458,2395217,159663,0.03304836263269675,0.7218849064615023,0.004365366478277333,0.2888084879157087,0.7111915120842913,0.04098334305409489
3889,15.0,1643,10859,12630,31,1224,17235,4735,12500,17235,709,0.09532927183057731,0.630055120394546,0.0017986655062373078,0.274731650710763,0.725268349289237,0.07101827676240209
3890,,2942,56906,59848,167,1869,77807,22649,55158,77807,5920,0.03781150796200856,0.7313737838497821,0.0021463364478774404,0.29109206112560565,0.7089079388743943,0.024020974976544526
3891,,159,4471,4630,12,189,6018,1775,4243,6018,430,0.02642073778664008,0.7429378531073446,0.0019940179461615153,0.29494848786972416,0.7050515121302758,0.03140578265204387
3892,33.0,185,3050,3235,2,146,4227,1246,2981,4227,325,0.043766264490182165,0.7215519280813816,0.0004731488052992666,0.2947717057014431,0.7052282942985569,0.03453986278684646
3893,17.0,63,2130,2193,4,171,3139,877,2262,3139,173,0.020070086014654348,0.6785600509716471,0.0012742911755336094,0.2793883402357439,0.7206116597642561,0.0544759477540618
3894,14.0,953,16637,17590,18,1445,23925,6769,17156,23925,1638,0.03983281086729363,0.6953814002089864,0.0007523510971786833,0.28292580982236154,0.7170741901776384,0.06039707419017764
3895,,2462,64803,67265,247,3153,86828,25885,60943,86828,6611,0.02835490855484406,0.7463375869535173,0.0028447044732114067,0.2981181185792601,0.7018818814207398,0.03631317086654075
3896,27.0,245,5811,6056,2,181,7704,2315,5389,7704,607,0.03180166147455867,0.7542834890965732,0.00025960539979231567,0.3004932502596054,0.6995067497403946,0.02349428868120457
3897,24.0,190,11627,11817,3,224,15344,4647,10697,15344,1596,0.012382690302398332,0.7577554744525548,0.00019551616266944735,0.3028545359749739,0.6971454640250261,0.014598540145985401
3898,,210,4691,4901,30,311,6655,1905,4750,6655,428,0.03155522163786627,0.7048835462058602,0.004507888805409466,0.28625093914350114,0.7137490608564989,0.046731780616078133
3899,16.0,2999,111810,114810,929,9698,157822,42816,115006,157822,10980,0.019002420448353208,0.7084563622308677,0.005886378324948359,0.2712929756307739,0.7287070243692261,0.06144897416076339
3900,,310,5954,6264,45,753,8741,2344,6397,8741,366,0.03546504976547306,0.6811577622697632,0.005148152385310605,0.2681615375815124,0.7318384624184876,0.08614574991419746
3901,,122,3990,4112,1,288,5661,1576,4085,5661,441,0.021550962727433315,0.7048224695283519,0.0001766472354707649,0.27839604310192545,0.7216039568980745,0.05087440381558029
3902,26.0,272,5546,5818,6,285,7857,2196,5661,7857,606,0.03461881125111366,0.7058673794068983,0.0007636502481863307,0.27949599083619703,0.720504009163803,0.036273386788850705
3903,17.0,152,2994,3146,10,178,4135,1216,2919,4135,340,0.03675937122128174,0.7240628778718259,0.0024183796856106408,0.29407496977025394,0.7059250302297461,0.043047158403869405
3904,34.0,222,7442,7664,26,235,10203,2925,7278,10203,872,0.02175830638047633,0.7293933156914633,0.002548270116632363,0.28668038812114083,0.7133196118788592,0.023032441438792513
3905,23.0,457,8610,9067,54,435,12322,3436,8886,12322,774,0.0370881350430125,0.6987502028891414,0.00438240545366012,0.2788508359032625,0.7211491640967376,0.03530271059892875
3906,,8175,126670,134845,324,8972,181639,51401,130238,181639,12535,0.045006854254868174,0.6973722603625874,0.0017837578934039495,0.2829843811075815,0.7170156188924185,0.04939467845561801
3907,26.0,421,10407,10828,53,467,14553,4194,10359,14553,1068,0.0289287432144575,0.715110286538858,0.0036418607847179276,0.2881880024737168,0.7118119975262832,0.03208960351817495
3908,16.0,430,10749,11179,0,336,14808,4225,10583,14808,1212,0.02903835764451648,0.7258914100486223,0.0,0.2853187466234468,0.7146812533765532,0.022690437601296597
3909,,511,11644,12155,31,767,16135,4770,11365,16135,842,0.0316702819956616,0.7216609854353889,0.0019212891230244809,0.29563061667183144,0.7043693833281686,0.04753641152773474
3910,24.0,2763,61428,64191,324,3824,87965,24162,63803,87965,5758,0.03141021997385324,0.6983231967259705,0.0036832831239697605,0.2746774285227079,0.7253225714772921,0.0434718353890752
3911,,135,2161,2296,15,124,3104,857,2247,3104,242,0.04349226804123711,0.6961984536082474,0.004832474226804124,0.2760953608247423,0.7239046391752577,0.03994845360824742
3912,27.0,870,19531,20401,113,1022,27304,7725,19579,27304,1857,0.03186346322883094,0.7153164371520656,0.004138587752710226,0.28292557866979196,0.717074421330208,0.03743041312628186
3913,,2994,67124,70118,336,4557,92934,26740,66194,92934,6523,0.03221641164697527,0.7222760238448792,0.0036154690425463233,0.2877310779693116,0.7122689220306885,0.049034798889534506
3914,16.0,1058,13965,15023,18,2090,21631,5852,15779,21631,1291,0.04891128473024826,0.6456012204706209,0.0008321390596828626,0.27053765429245064,0.7294623457075493,0.09662059081873238
3915,15.0,957,15863,16820,106,1052,22662,6399,16263,22662,1599,0.0422292824993381,0.6999823493072103,0.004677433589268379,0.2823669579030977,0.7176330420969023,0.04642132203688995
3916,16.0,117,5263,5380,73,635,7731,2023,5708,7731,340,0.015133876600698487,0.6807657482861208,0.009442504203854611,0.2616737808821627,0.7383262191178372,0.08213685163626956
3917,,209,5260,5469,22,271,7191,2055,5136,7191,555,0.029064107912668613,0.7314698929217077,0.003059379780280907,0.2857738840216938,0.7142261159783062,0.03768599638436935
3918,17.0,125,1724,1849,10,95,2494,686,1808,2494,171,0.05012028869286287,0.6912590216519647,0.00400962309542903,0.27506014434643145,0.7249398556535686,0.03809141940657578
3919,,39,2126,2165,7,69,3102,771,2331,3102,219,0.012572533849129593,0.685364281108962,0.002256608639587363,0.24854932301740812,0.7514506769825918,0.022243713733075435
3920,13.0,9,3181,3190,11,86,4247,1224,3023,4247,418,0.0021191429244172355,0.7489992936190252,0.0025900635742877325,0.2882034377207441,0.7117965622792559,0.020249587944431362
3921,16.0,2314,48214,50528,121,3102,67419,18998,48421,67419,4954,0.034322668683902165,0.7151396490603539,0.0017947462881383587,0.28178999985167386,0.7182100001483261,0.04601076847772883
3922,16.0,121,2103,2224,3,156,3121,831,2290,3121,196,0.0387696251201538,0.6738224927907722,0.0009612303748798462,0.2662608138417174,0.7337391861582826,0.049983979493752
3923,,108,4768,4876,3,214,6532,1871,4661,6532,593,0.01653398652786283,0.7299448867115738,0.00045927740355174526,0.28643600734843844,0.7135639926515616,0.0327617881200245
3924,,79,2006,2085,44,142,2817,775,2042,2817,165,0.028044018459353923,0.7121050763223287,0.01561945331913383,0.2751153709620163,0.7248846290379837,0.05040823571175009
3925,26.0,15744,256306,272050,2124,13608,363746,102504,261242,363746,21998,0.04328295019051756,0.7046290543401165,0.005839239469300006,0.2818010369873483,0.7181989630126517,0.03741072066771868
3926,25.0,307,6201,6508,81,451,8975,2571,6404,8975,595,0.03420612813370474,0.6909192200557103,0.009025069637883009,0.2864623955431755,0.7135376044568245,0.05025069637883008
3927,17.0,866,11717,12583,55,1107,17047,4739,12308,17047,1076,0.050800727400715666,0.6873350149586438,0.003226374142077785,0.2779961283510295,0.7220038716489705,0.06493811227782015
3928,23.0,117,2850,2967,26,97,4099,1118,2981,4099,331,0.028543547206635766,0.6952915345206148,0.006343010490363503,0.27274945108563065,0.7272505489143694,0.02366430836789461
3929,24.0,394,8973,9367,56,563,12766,3446,9320,12766,957,0.03086323045589848,0.7028826570578098,0.004386652044493185,0.2699357668807771,0.730064233119223,0.04410151966160113
3930,24.0,190,28762,28952,35,1629,39267,11023,28244,39267,3030,0.004838668602134107,0.7324725596556906,0.0008913336898668093,0.28071917895433823,0.7192808210456617,0.04148521659408664
3931,23.0,50,1423,1473,6,55,1973,585,1388,1973,164,0.025342118601115054,0.7212366953877344,0.0030410542321338066,0.2965027876330461,0.7034972123669538,0.027876330461226558
3932,26.0,1384,44687,46071,166,2485,61827,17149,44678,61827,4810,0.022385042133695635,0.7227748394714283,0.0026849111229721645,0.27737072799909424,0.7226292720009058,0.040192796027625474
3933,,1077,20116,21193,280,1193,28946,8036,20910,28946,2100,0.03720721343190769,0.6949492157811097,0.009673184550542389,0.2776203966005666,0.7223796033994334,0.04121467560284668
3934,15.0,317,4918,5235,19,343,7051,1980,5071,7051,465,0.04495816196284215,0.697489717770529,0.0026946532406750814,0.28081123244929795,0.719188767550702,0.04864558218692384
3935,,80,1934,2014,10,93,2653,771,1882,2653,211,0.03015454202789295,0.7289860535243121,0.003769317753486619,0.29061439879381834,0.7093856012061817,0.03505465510742556
3936,17.0,180,4760,4940,63,312,6645,1825,4820,6645,445,0.02708803611738149,0.7163280662151994,0.009480812641083521,0.2746425884123401,0.7253574115876599,0.04695259593679458
3937,17.0,9,1924,1933,8,57,2542,724,1818,2542,248,0.0035405192761605035,0.7568843430369787,0.003147128245476003,0.28481510621557826,0.7151848937844217,0.022423288749016522
3938,24.0,185,3675,3860,41,129,5089,1488,3601,5089,358,0.03635291805855767,0.7221458046767538,0.008056592650815484,0.2923953625466693,0.7076046374533307,0.025348791511102378
3939,,505,4238,4743,294,365,7077,1761,5316,7077,317,0.07135792002260845,0.5988413169422071,0.04154302670623145,0.24883425180161084,0.7511657481983891,0.051575526352974424
3940,25.0,128,1986,2114,20,149,3150,805,2345,3150,190,0.040634920634920635,0.6304761904761905,0.006349206349206349,0.25555555555555554,0.7444444444444445,0.0473015873015873
3941,36.0,1133,198499,199632,1384,10959,270200,76074,194126,270200,23075,0.00419319022945966,0.7346373056994818,0.005122131754256107,0.2815470022205773,0.7184529977794226,0.04055884529977794
3942,,28,4748,4776,10,181,6240,1856,4384,6240,649,0.004487179487179487,0.7608974358974359,0.0016025641025641025,0.29743589743589743,0.7025641025641025,0.029006410256410257
3943,15.0,3177,21271,24448,401,1781,33598,9097,24501,33598,1969,0.09455919995237812,0.6331031609024347,0.011935234240133341,0.27076016429549377,0.7292398357045062,0.05300910768498125
3944,,679,16433,17112,134,649,22865,6297,16568,22865,1854,0.02969604198556746,0.7186966980100591,0.00586048545812377,0.2753990815657118,0.7246009184342882,0.028383993002405423
3945,24.0,312,9871,10183,48,560,13420,3926,9494,13420,1072,0.02324888226527571,0.7355439642324888,0.0035767511177347243,0.292548435171386,0.707451564828614,0.041728763040238454
3946,23.0,702,17001,17703,53,851,23550,6793,16757,23550,1970,0.02980891719745223,0.7219108280254777,0.002250530785562633,0.28845010615711253,0.7115498938428875,0.03613588110403397
3947,15.0,224,2885,3109,1,119,4111,1194,2917,4111,319,0.05448795913403065,0.7017757236682073,0.00024324981756263683,0.2904402821697884,0.7095597178302117,0.02894672828995378
3948,,374,10888,11262,29,561,15144,4246,10898,15144,1080,0.024696249339672478,0.7189646064447967,0.0019149498151082938,0.28037506603275225,0.7196249339672478,0.03704437400950872
3949,,520,40911,41431,135,2050,55770,15722,40048,55770,4761,0.009324009324009324,0.7335664335664336,0.002420656266810113,0.2819078357539896,0.7180921642460104,0.036758113681190606
3950,,147,3856,4003,15,198,5444,1481,3963,5444,373,0.027002204261572373,0.7083027185892726,0.002755326965466569,0.27204261572373256,0.7279573842762674,0.03637031594415871
3951,23.0,3060,62653,65713,200,5798,87908,24897,63011,87908,6213,0.03480911862401602,0.7127110160622468,0.0022751057924193475,0.2832165445693225,0.7167834554306776,0.06595531692223688
3952,16.0,1333,19475,20808,152,1016,28101,8001,20100,28101,1949,0.04743603430482901,0.6930358350236646,0.005409060175794456,0.28472296359560156,0.7152770364043984,0.036155296964520835
3953,25.0,66,1510,1576,7,92,2151,611,1540,2151,155,0.030683403068340307,0.701999070199907,0.0032543003254300326,0.28405392840539284,0.7159460715946072,0.04277080427708043
3954,27.0,658,17150,17808,57,954,23625,6755,16870,23625,1687,0.027851851851851853,0.725925925925926,0.0024126984126984128,0.2859259259259259,0.7140740740740741,0.04038095238095238
3955,24.0,309,5377,5686,0,242,7606,2248,5358,7606,673,0.04062582171969498,0.7069418879831711,0.0,0.29555613988956086,0.7044438601104391,0.03181698658953458
3956,,322,13059,13381,0,501,17275,5097,12178,17275,1306,0.018639652677279305,0.7559479015918958,0.0,0.2950506512301013,0.7049493487698987,0.029001447178002893
3957,16.0,782,15772,16554,85,692,21502,6342,15160,21502,1601,0.03636870988745233,0.7335131615663659,0.0039531206399404705,0.2949493070412055,0.7050506929587945,0.032183052739280064
3958,17.0,49,4035,4084,11,467,5548,1557,3991,5548,356,0.008832011535688536,0.7272891131939437,0.0019826964671953856,0.2806416726748378,0.7193583273251623,0.08417447728911319
3959,26.0,517,20549,21066,105,918,27645,8019,19626,27645,2137,0.018701392656899983,0.7433170555254115,0.0037981551817688553,0.2900705371676614,0.7099294628323386,0.033206728160607706
3960,,367,12973,13340,21,597,17519,5094,12425,17519,1344,0.020948684285632742,0.740510303099492,0.0011986985558536446,0.29077002111992695,0.7092299788800731,0.03407728751641075
3961,24.0,307,12240,12547,11,391,16263,4824,11439,16263,1299,0.01887720592756564,0.7526286662977311,0.0006763819713460001,0.29662423907028224,0.7033757609297178,0.024042304617844186
3962,,242,7455,7697,23,509,10143,2802,7341,10143,660,0.02385881888987479,0.7349896480331263,0.0022675736961451248,0.27624963028689736,0.7237503697131026,0.05018239179729863
3963,14.0,69,4112,4181,7,247,5527,1573,3954,5527,504,0.01248416862674145,0.7439840781617514,0.0012665098606839153,0.28460285869368557,0.7153971413063145,0.04468970508413244
3964,,2955,57633,60588,424,3145,79865,22871,56994,79865,5077,0.03699993739435297,0.7216302510486445,0.005308958868089902,0.28637075064170786,0.7136292493582921,0.03937895198146873
3965,16.0,240,3817,4057,14,252,5534,1514,4020,5534,395,0.04336826888326708,0.6897361763642934,0.002529815684857246,0.2735814962052765,0.7264185037947235,0.04553668232743043
3966,,84,2209,2293,2,91,2979,864,2115,2979,252,0.028197381671701913,0.7415240013427324,0.000671366230278617,0.29003021148036257,0.7099697885196374,0.030547163477677074
3967,,61,2820,2881,25,220,3999,1053,2946,3999,276,0.015253813453363341,0.7051762940735183,0.006251562890722681,0.2633158289572393,0.7366841710427607,0.05501375343835959
3968,,8828,225557,234385,969,9077,307837,89340,218497,307837,24163,0.02867751439885394,0.7327156904465675,0.003147769761269763,0.2902185247387416,0.7097814752612583,0.029486384027910876
3969,24.0,5465,94258,99723,334,4877,135304,37544,97760,135304,8743,0.04039052799621593,0.6966386803050908,0.0024685153432271035,0.27747886241352804,0.722521137586472,0.03604475846981612
3970,35.0,121,2630,2751,21,154,3669,1039,2630,3669,227,0.03297901335513764,0.7168165712728264,0.005723630417007359,0.2831834287271736,0.7168165712728264,0.041973289724720635
3971,15.0,107,5316,5423,4,389,7347,2069,5278,7347,563,0.014563767524159521,0.7235606369946918,0.0005444399074452157,0.28161154212603784,0.7183884578739622,0.05294678099904723
3972,44.0,96,2667,2763,18,196,3672,1007,2665,3672,259,0.026143790849673203,0.7263071895424836,0.004901960784313725,0.27423747276688454,0.7257625272331155,0.05337690631808279
3973,,238,6526,6764,62,292,8922,2699,6223,8922,731,0.026675633266083836,0.7314503474557275,0.006949114548307554,0.30251064783680787,0.6974893521631921,0.03272808787267429
3974,17.0,129,7598,7727,9,281,9646,2948,6698,9646,647,0.013373419033796392,0.7876840140991085,0.0009330292349160273,0.3056189093924943,0.6943810906075057,0.029131246112378186
3975,39.0,73,1581,1654,12,111,2260,610,1650,2260,181,0.032300884955752215,0.6995575221238938,0.005309734513274336,0.26991150442477874,0.7300884955752213,0.04911504424778761
3976,24.0,172,3919,4091,31,130,5202,1627,3575,5202,178,0.0330642060745867,0.753364090734333,0.005959246443675509,0.31276432141484045,0.6872356785851595,0.024990388312187622
3977,,2703,56582,59285,360,2733,78073,22591,55482,78073,5822,0.034621444033148464,0.7247319816069576,0.004611069127611338,0.2893573962829659,0.710642603717034,0.03500569979378274
3978,14.0,339,6730,7069,49,590,9542,2712,6830,9542,593,0.03552714315657095,0.7053028715154056,0.005135191783693146,0.2842171452525676,0.7157828547474324,0.06183190106895829
3979,15.0,3144,42154,45298,87,3507,62763,17452,45311,62763,4592,0.0500932077816548,0.6716377483549225,0.0013861670092251805,0.2780619154597454,0.7219380845402547,0.05587687013049089
3980,45.0,8667,205274,213941,944,7730,278629,80798,197831,278629,21235,0.031105879143951274,0.7367287683622308,0.0033880177583812164,0.28998417250178554,0.7100158274982145,0.027742984398608905
3981,15.0,22,5364,5386,16,355,7123,2035,5088,7123,579,0.003088586269830128,0.753053488698582,0.0022462445598764565,0.28569422995928684,0.7143057700407132,0.04983855117225888
3982,,722,23189,23911,30,760,30634,8958,21676,30634,2401,0.023568583926356336,0.7569693804269766,0.0009793040412613436,0.2924201867206372,0.7075798132793628,0.024809035711954038
3983,15.0,135,5384,5519,43,596,7490,1953,5537,7490,534,0.018024032042723633,0.7188251001335113,0.0057409879839786385,0.2607476635514019,0.7392523364485981,0.07957276368491321
3984,,912,15739,16651,69,1165,22900,6218,16682,22900,1486,0.03982532751091703,0.6872925764192139,0.0030131004366812228,0.271528384279476,0.728471615720524,0.05087336244541485
3985,,1192,23589,24781,748,1953,34819,9273,25546,34819,1964,0.03423418248657342,0.6774749418420977,0.021482523909359834,0.2663201125822109,0.7336798874177891,0.05609006576868951
3986,16.0,243,8488,8731,12,1089,12108,3218,8890,12108,690,0.020069375619425175,0.7010241162867525,0.0009910802775024777,0.2657746944169144,0.7342253055830855,0.08994053518334985
3987,47.0,211,4860,5071,11,184,6747,1914,4833,6747,522,0.0312731584407885,0.7203201422854602,0.0016303542315103008,0.28368163628279236,0.7163183637172077,0.02727137987253594
3988,,1802,42185,43987,49,3041,59357,16831,42526,59357,4615,0.030358677156864397,0.7106996647404686,0.0008255134188048588,0.2835554357531546,0.7164445642468453,0.051232373603787254
3989,,6269,119957,126226,2009,6235,170933,47847,123086,170933,12459,0.03667518852415859,0.701777889582468,0.011753143044350711,0.2799166925052506,0.7200833074947494,0.03647628017995355
3990,,5332,80097,85429,201,4785,113323,32238,81085,113323,9355,0.04705134879944936,0.7068026790677974,0.0017736911306619133,0.2844788789566107,0.7155211210433893,0.042224438110533606
3991,,2017,49222,51239,129,2204,67962,19461,48509,67970,4651,0.02967485655436222,0.7241724290127998,0.001897896130645873,0.2863174930116228,0.7136825069883772,0.03242607032514345
3992,24.0,7086,128360,135446,424,7661,179805,51266,128539,179805,13037,0.03940936014015183,0.7138844859709129,0.0023581101749117097,0.285119991101471,0.714880008898529,0.04260726898584578
3993,15.0,2980,19311,22291,196,1668,30751,8399,22352,30751,1881,0.09690741764495464,0.6279795778999057,0.006373776462554063,0.27312932912750804,0.7268706708724919,0.05424213846704172
3994,33.0,163,4591,4754,4,238,6234,1854,4380,6234,526,0.026146936156560795,0.7364452999679179,0.0006416426050689766,0.29740134744947067,0.7025986525505293,0.0381777350016041
3995,26.0,2723,55195,57918,460,2834,78930,21622,57308,78930,5971,0.034498923096414544,0.699290510578994,0.005827948815406056,0.2739389332319777,0.7260610667680223,0.03590523248447992
3996,15.0,45,4234,4279,2,265,5778,1641,4137,5778,488,0.00778816199376947,0.732779508480443,0.00034614053305642093,0.28400830737279337,0.7159916926272066,0.04586362062997577
3997,25.0,3159,51468,54627,503,3992,74388,20910,53478,74388,5127,0.042466526859170836,0.6918857880303275,0.00676184330806044,0.28109372479432165,0.7189062752056783,0.05366456955422918
3998,,642,12031,12673,51,701,16945,4715,12230,16945,1061,0.03788728238418412,0.7100029507229271,0.0030097373856594867,0.27825317202714667,0.7217468279728534,0.04136913543818235
3999,23.0,87,2359,2446,15,124,3365,917,2448,3365,275,0.025854383358098067,0.701040118870728,0.004457652303120356,0.2725111441307578,0.7274888558692422,0.03684992570579495
4000,23.0,87,1919,2006,3,82,2630,793,1837,2630,216,0.03307984790874525,0.7296577946768061,0.0011406844106463879,0.3015209125475285,0.6984790874524714,0.0311787072243346
4001,34.0,747,15869,16616,276,805,24326,6282,18044,24326,1513,0.030707884567951985,0.6523472827427443,0.011345885061251336,0.2582422099810902,0.7417577900189098,0.03309216476198306
4002,26.0,252,14369,14621,5,588,18795,5719,13076,18795,1414,0.013407821229050279,0.764511838254855,0.00026602819898909286,0.3042830540037244,0.6957169459962756,0.03128491620111732
4003,,1036,608,1644,9,61,2296,636,1660,2296,81,0.45121951219512196,0.26480836236933797,0.0039198606271777,0.2770034843205575,0.7229965156794426,0.02656794425087108
4004,,14593,409360,423953,1093,19123,549101,162240,386861,549101,37545,0.02657616722606588,0.7455094782198539,0.001990526333042555,0.2954647687766003,0.7045352312233997,0.0348260156146137
4005,25.0,142,2947,3089,0,136,4189,1169,3020,4189,332,0.03389830508474576,0.7035091907376462,0.0,0.2790642158032943,0.7209357841967057,0.03246598233468608
4006,23.0,77,2054,2131,8,68,2715,828,1887,2715,237,0.028360957642725598,0.7565377532228361,0.0029465930018416206,0.30497237569060776,0.6950276243093922,0.025046040515653775
4007,16.0,206,7736,7942,30,271,10442,2967,7475,10442,993,0.019728021451829152,0.740854242482283,0.002873012832790653,0.2841409691629956,0.7158590308370044,0.025952882589542235
4008,,1716,42852,44568,155,2188,58688,17016,41682,58698,4059,0.029234386180108353,0.7300419094347337,0.0026406351153361275,0.28989062659715836,0.7101093734028416,0.03727554601519643
4009,,179,5028,5207,8,402,7095,1991,5104,7095,531,0.025229034531360113,0.7086680761099365,0.001127554615926709,0.2806201550387597,0.7193798449612403,0.056659619450317125
4010,17.0,833,14447,15280,144,1076,20662,5718,14944,20662,1398,0.040315555125350885,0.6992062723840867,0.006969315651921402,0.2767399090117123,0.7232600909882877,0.05207627528796825
4011,14.0,219,8860,9079,90,499,11893,3373,8520,11893,879,0.01841419322290423,0.744976036323888,0.007567476666946944,0.283612208862356,0.716387791137644,0.041957453964516944
4012,23.0,153,3404,3557,21,337,4766,1324,3442,4766,282,0.03210239194292908,0.7142257658413764,0.0044062106588334034,0.27780109106168693,0.7221989089383131,0.070709190096517
4013,,623,8822,9445,133,512,13248,3583,9665,13248,714,0.04702596618357488,0.6659118357487923,0.010039251207729468,0.27045591787439616,0.7295440821256038,0.03864734299516908
4014,17.0,1073,24373,25446,86,1356,34077,9619,24458,34077,2752,0.031487513572204126,0.7152331484579042,0.0025236963347712534,0.28227250051354286,0.7177274994864571,0.03979223523197464
4015,23.0,334,6546,6880,13,329,9512,2581,6931,9512,644,0.03511354079058032,0.6881833473507148,0.0013666947014297729,0.27134146341463417,0.7286585365853658,0.0345878889823381
4016,,94,2752,2846,11,122,3742,1041,2701,3742,300,0.02512025654730091,0.7354355959380011,0.002939604489577766,0.27819347942276856,0.7218065205772314,0.03260288615713522
4017,14.0,17,1902,1919,16,308,2794,715,2079,2794,134,0.006084466714387974,0.6807444523979957,0.00572655690765927,0.2559055118110236,0.7440944881889764,0.11023622047244094
4018,44.0,97,3499,3596,4,164,4783,1401,3382,4783,373,0.02028015889609032,0.7315492368806189,0.00083629521220991,0.29291239807652103,0.707087601923479,0.034288103700606316
4019,17.0,71,1783,1854,10,88,2553,699,1854,2553,179,0.027810419114766942,0.6983940462201331,0.0039169604386995694,0.27379553466509987,0.7262044653349001,0.03446925186055621
4020,33.0,93,3003,3096,4,145,4178,1153,3025,4178,310,0.02225945428434658,0.718764959310675,0.0009573958831977022,0.27596936333173766,0.7240306366682623,0.03470560076591671
4021,16.0,17647,166245,183892,4432,20593,269322,69334,199988,269322,16031,0.06552379679342943,0.6172722614565465,0.016456138005807176,0.25743905065312156,0.7425609493468784,0.07646237589205486
4022,25.0,5556,150091,155647,270,6600,206569,58950,147619,206569,16244,0.02689658177170824,0.7265901466338124,0.0013070693085603358,0.2853767990356733,0.7146232009643267,0.03195058309814154
4023,35.0,297,6604,6901,80,259,9263,2593,6670,9263,650,0.0320630465292022,0.7129439706358631,0.008636510849616755,0.2799309079132031,0.7200690920867969,0.027960703875634242
4024,40.0,589,16061,16650,46,677,22091,6486,15605,22091,1929,0.02666244171834684,0.7270381603367887,0.002082295957629804,0.29360373002580237,0.7063962699741977,0.030645964419899505
4025,,157,4726,4883,29,190,6405,1828,4577,6405,467,0.02451209992193599,0.7378610460577674,0.004527712724434036,0.28540202966432476,0.7145979703356753,0.02966432474629196
4026,23.0,349,8189,8538,21,449,11377,3174,8203,11377,959,0.03067592511206821,0.7197855322141162,0.0018458293047376286,0.27898391491605873,0.7210160850839413,0.03946558846796168
4027,,637,9215,9852,50,558,13722,3716,10006,13722,872,0.04642180440169071,0.6715493368313656,0.003643783704999271,0.27080600495554585,0.7291939950444541,0.040664626147791864
4028,,330,6255,6585,59,299,8954,2447,6507,8954,654,0.036855036855036855,0.6985704712977441,0.006589233861961134,0.27328568237659145,0.7267143176234085,0.03339289702926067
4029,27.0,5074,116718,121792,468,6502,164626,46223,118403,164626,11799,0.030821376939244104,0.7089888595969045,0.0028428073329850694,0.2807758191294206,0.7192241808705794,0.03949558392963445
4030,46.0,181,4904,5085,39,217,6622,1918,4704,6622,516,0.027333131984294774,0.7405617638175778,0.005889459377831471,0.28964059196617337,0.7103594080338267,0.03276955602536998
4031,,13067,248857,261924,934,18323,356456,99468,256988,356456,24597,0.036658100859573134,0.698142267208295,0.0026202392441142808,0.27904706331216195,0.720952936687838,0.05140325874722266
4032,,1184,22786,23970,159,1481,32185,9237,22948,32185,2275,0.03678732328724561,0.7079695510330899,0.004940189529283828,0.2869970483144322,0.7130029516855678,0.046015224483455026
4033,15.0,621,16659,17280,29,738,22976,6549,16427,22976,2027,0.027028203342618386,0.7250609331476323,0.0012621866295264624,0.2850365598885794,0.7149634401114207,0.03212047353760446
4034,,568,9144,9712,81,776,13483,3668,9815,13483,1060,0.042127123043832974,0.6781873470295928,0.006007565081955054,0.2720462805013721,0.7279537194986279,0.05755395683453238
4035,16.0,182,8301,8483,9,865,11522,3326,8196,11522,853,0.015795868772782502,0.7204478389168547,0.000781114389862871,0.2886651622982121,0.7113348377017878,0.07507377191459816
4036,17.0,1560,39677,41237,233,2127,53911,15819,38092,53911,3826,0.02893658066071859,0.7359722505611099,0.004321938008940662,0.2934280573537868,0.7065719426462133,0.03945391478547977
4037,27.0,131,3006,3137,18,149,4102,1184,2918,4102,289,0.031935641150658216,0.7328132618235007,0.004388103364212579,0.2886396879570941,0.711360312042906,0.0363237445148708
4038,,101,3351,3452,0,196,4671,1371,3300,4671,363,0.021622778848212374,0.7174052665382146,0.0,0.2935131663455363,0.7064868336544637,0.04196103618068936
4039,,216,5900,6116,23,301,8175,2283,5892,8175,681,0.026422018348623854,0.7217125382262997,0.0028134556574923547,0.27926605504587154,0.7207339449541285,0.03681957186544343
4040,25.0,582,12704,13286,67,650,17733,5067,12666,17733,1265,0.03282016579259009,0.7164044436925506,0.003778266508768962,0.2857384537303333,0.7142615462696668,0.03665482433880336
4041,23.0,1032,24682,25714,247,1190,33855,9881,23974,33855,2387,0.030482941958351793,0.729050361837247,0.007295820410574509,0.2918623541574361,0.7081376458425639,0.03514990400236302
4042,,10564,209643,220207,2526,13745,304189,83445,220744,304189,22492,0.03472840898257334,0.6891866569797067,0.008304047812379802,0.274319584205872,0.725680415794128,0.045185723349628025
4043,17.0,908,18451,19359,60,986,25970,7344,18626,25970,1902,0.03496341932999615,0.7104736234116288,0.0023103581055063534,0.2827878321139777,0.7172121678860224,0.03796688486715441
4044,42.0,128,4299,4427,20,152,5745,1683,4062,5745,477,0.02228024369016536,0.7483028720626632,0.0034812880765883376,0.2929503916449086,0.7070496083550913,0.026457789382071367
4045,17.0,257,4643,4900,13,340,6566,1859,4707,6566,427,0.039141029546146816,0.7071276271702711,0.0019798964361864148,0.28312519037465733,0.7168748096253427,0.05178190679256777
4046,24.0,558,13956,14514,63,709,19294,5593,13701,19294,1506,0.028920908054317403,0.7233336788638955,0.003265263812584223,0.2898828651394216,0.7101171348605784,0.03674717528765419
4047,,705,14310,15015,42,755,19964,5610,14354,19964,1437,0.035313564415948705,0.7167902224003205,0.0021037868162692847,0.2810058104588259,0.7189941895411741,0.037818072530555
4048,,550,6998,7548,43,515,10704,2853,7851,10704,683,0.05138266068759342,0.6537742899850523,0.0040171898355754855,0.26653587443946186,0.7334641255605381,0.048112855007473844
4049,27.0,308,8177,8485,31,467,11208,3254,7954,11208,920,0.027480371163454677,0.7295681655960029,0.0027658815132048536,0.2903283369022127,0.7096716630977873,0.041666666666666664
4050,17.0,18,2508,2526,9,122,3328,943,2385,3328,303,0.005408653846153846,0.7536057692307693,0.002704326923076923,0.28335336538461536,0.7166466346153846,0.03665865384615385
4051,,483,6417,6900,44,552,9417,2578,6839,9417,618,0.05129021981522778,0.6814272061165977,0.004672400976956568,0.2737602208771371,0.7262397791228629,0.05861739407454603
4052,,132,2637,2769,2,209,3803,1034,2769,3803,253,0.03470943991585591,0.6933999474099395,0.0005259006047856955,0.27189061267420456,0.7281093873257954,0.05495661320010518
4053,23.0,42,1629,1671,1,156,2320,631,1689,2320,179,0.01810344827586207,0.7021551724137931,0.0004310344827586207,0.27198275862068966,0.7280172413793103,0.06724137931034482
4054,,4,14158,14162,16,519,18833,5407,13426,18833,1527,0.00021239313970158763,0.7517655179737694,0.0008495725588063505,0.2871024265916211,0.7128975734083789,0.027558009876280997
4055,40.0,647,14604,15251,58,725,20095,5816,14279,20095,1209,0.03219706394625529,0.7267479472505598,0.002886290121920876,0.2894252301567554,0.7105747698432446,0.03607862652401095
4056,,296,8872,9168,75,274,12433,3496,8937,12433,985,0.023807608783077295,0.7135848146062898,0.006032333306522963,0.2811871631947237,0.7188128368052763,0.022038124346497226
4057,,397,15752,16149,34,318,19840,6150,13690,19840,1365,0.020010080645161292,0.7939516129032258,0.0017137096774193549,0.30997983870967744,0.6900201612903226,0.016028225806451614
4058,15.0,887,36203,37090,395,2162,49920,14038,35882,49920,3647,0.017768429487179487,0.7252203525641026,0.007912660256410256,0.28120993589743587,0.7187900641025641,0.04330929487179487
4059,27.0,124,2681,2805,7,124,3797,1057,2740,3797,285,0.03265736107453253,0.7060837503292072,0.0018435607058203845,0.2783776665788781,0.7216223334211219,0.03265736107453253
4060,26.0,1911,39757,41668,76,1987,55765,15844,39921,55765,4057,0.034268806599121314,0.7129382228996682,0.001362862010221465,0.2841208643414328,0.7158791356585672,0.035631668609342776
4061,,1179,31591,32770,30,1344,43004,12600,30404,43004,3901,0.02741605432052832,0.7346060831550554,0.0006976095246953772,0.2929960003720584,0.7070039996279416,0.0312529067063529
4062,15.0,3597,32877,36474,265,2054,48865,13529,35336,48865,3481,0.07361096899621405,0.6728128517343702,0.005423104471503121,0.2768648316791159,0.7231351683208841,0.04203417579044306
4063,24.0,18377,366090,384467,2473,19439,515555,147027,368528,515555,36707,0.03564508151409646,0.7100891272512148,0.004796772410315097,0.28518198834265984,0.7148180116573402,0.03770499752693699
4064,,25,1463,1488,0,242,2010,398,1612,2010,124,0.012437810945273632,0.7278606965174129,0.0,0.19800995024875623,0.8019900497512438,0.12039800995024875
4065,,312,4459,4771,5,336,6496,1793,4703,6496,398,0.0480295566502463,0.6864224137931034,0.000769704433497537,0.27601600985221675,0.7239839901477833,0.05172413793103448
4066,15.0,300,5939,6239,80,766,8875,2393,6482,8875,531,0.03380281690140845,0.6691830985915493,0.009014084507042254,0.2696338028169014,0.7303661971830986,0.08630985915492957
4067,16.0,312,139469,139781,780,5994,184191,52913,131278,184191,15836,0.0016938938384611626,0.7571976915267304,0.004234734596152906,0.28727245087979325,0.7127275491202067,0.03254230662735964
4068,17.0,1138,21630,22768,125,1521,30928,8399,22529,30928,2167,0.036795137092602175,0.6993662700465597,0.0040416451112260735,0.2715662183135023,0.7284337816864976,0.04917873771339886
4069,17.0,922,21218,22140,37,1650,30546,8537,22009,30546,2183,0.030183984809795065,0.6946245007529628,0.0012112878936685655,0.2794801283310417,0.7205198716689583,0.05401689255549008
4070,23.0,1960,35835,37795,251,2549,51533,14517,37016,51533,4093,0.03803388120233637,0.6953796596355734,0.004870665398870626,0.28170298643587605,0.718297013564124,0.04946345060446704
4071,17.0,50,1686,1736,3,57,2289,642,1647,2289,204,0.021843599825251202,0.7365661861074705,0.001310615989515072,0.2804718217562254,0.7195281782437746,0.02490170380078637
4072,,591,10445,11036,76,689,14884,4251,10633,14884,1057,0.03970706799247514,0.7017602794947595,0.005106154259607632,0.28560870733673743,0.7143912926632625,0.04629131953775867
4073,,454,8857,9311,68,780,12770,3539,9231,12770,887,0.03555207517619421,0.6935787000783086,0.005324980422866093,0.27713390759592793,0.7228660924040721,0.06108065779169929
4074,,471,11697,12168,121,433,15754,4709,11045,15754,1080,0.02989716897295925,0.7424781007997969,0.007680589056747493,0.29890821378697474,0.7010917862130253,0.02748508315348483
4075,24.0,2567,64088,66655,813,2860,87092,25434,61658,87092,6277,0.029474578606531025,0.7358655215174758,0.009334956138336473,0.2920360078996923,0.7079639921003077,0.03283883709181096
4076,,545,11320,11865,44,492,15780,4544,11236,15780,1071,0.03453738910012674,0.7173637515842839,0.002788339670468948,0.2879594423320659,0.7120405576679341,0.0311787072243346
4077,48.0,311,11108,11419,64,2001,16621,3087,13534,16621,802,0.01871126887672222,0.6683111726129595,0.003850550508392997,0.18572889717826846,0.8142711028217315,0.1203898682389748
4078,26.0,971,17588,18559,528,1037,25611,7069,18542,25611,1946,0.03791339658740385,0.6867361680527898,0.02061614150169849,0.27601421264300496,0.723985787356995,0.04049041427511616
4079,17.0,147,11144,11291,52,825,15272,4235,11037,15272,1186,0.00962545835515977,0.7297014143530645,0.0034049240440020955,0.2773048716605553,0.7226951283394447,0.05402042954426401
4080,13.0,62,5833,5895,17,1034,8904,2227,6677,8904,506,0.006963162623539982,0.6550988319856245,0.0019092542677448339,0.2501123090745732,0.7498876909254267,0.11612758310871518
4081,23.0,449,13676,14125,20,534,18966,5428,13538,18966,1677,0.023673942845091216,0.7210798270589476,0.0010545186122535063,0.2861963513656016,0.7138036486343984,0.028155646947168617
4082,,282,3289,3571,30,185,4815,1380,3435,4815,308,0.058566978193146414,0.683073727933541,0.006230529595015576,0.2866043613707165,0.7133956386292835,0.03842159916926272
4083,13.0,81,1757,1838,7,157,2574,682,1892,2574,176,0.03146853146853147,0.6825951825951826,0.0027195027195027195,0.26495726495726496,0.7350427350427351,0.06099456099456099
4084,,519,12618,13137,21,669,17257,5017,12240,17257,1230,0.030074752274439356,0.7311815495161383,0.0012168974908732689,0.29072260531958044,0.7092773946804195,0.03876687720924842
4085,,17031,261820,278851,1755,14999,375271,105622,269649,375271,25240,0.04538320307191336,0.6976824747982124,0.004676620362351474,0.2814552683260897,0.7185447316739103,0.03996844946718505
4086,,473,16842,17315,40,945,22573,6313,16260,22573,1589,0.020954237363221547,0.7461126124130598,0.0017720285296593276,0.27967040269348337,0.7203295973065167,0.04186417401320161
4087,,95,1578,1673,0,95,2317,659,1658,2317,204,0.041001294777729826,0.6810530858869227,0.0,0.2844195079844627,0.7155804920155373,0.041001294777729826
4088,40.0,493,19039,19532,70,830,24859,7451,17408,24859,1457,0.01983185164326803,0.7658795607224748,0.0028158815720664547,0.2997304799066736,0.7002695200933263,0.033388310068787966
4089,27.0,2987,99905,102892,662,4332,134211,38942,95269,134211,10089,0.022255999880784735,0.7443875688281885,0.004932531610672746,0.2901550543547101,0.7098449456452899,0.03227753313811833
4090,34.0,243,6453,6696,13,211,8641,2545,6096,8641,706,0.02812174516838329,0.7467885661381785,0.00150445550283532,0.2945260965166069,0.7054739034833931,0.02441847008448096
4091,38.0,184,5065,5249,79,229,6965,2015,4950,6965,509,0.02641780330222541,0.7272074659009332,0.011342426417803302,0.28930366116295764,0.7106963388370423,0.03287867910983489
4092,,1409,24805,26214,69,1621,35561,10148,25413,35561,2579,0.03962205787238829,0.6975338151345575,0.0019403278872922583,0.28536880290205563,0.7146311970979444,0.04558364500435871
4093,,461,10049,10510,254,847,15083,3721,11362,15083,892,0.030564211363787046,0.6662467678843731,0.016840151163561627,0.24670158456540475,0.7532984154345952,0.05615593714778227
4094,,46,5731,5777,0,354,7776,2233,5543,7776,732,0.0059156378600823045,0.7370113168724279,0.0,0.2871656378600823,0.7128343621399177,0.04552469135802469
4095,23.0,169,15133,15302,28,700,19874,5839,14035,19874,1710,0.008503572506792794,0.7614471168360673,0.0014088759182851968,0.29380094595954515,0.7061990540404549,0.03522189795712992
4096,,152,2713,2865,10,146,3861,1094,2767,3861,262,0.03936803936803937,0.7026677026677026,0.00259000259000259,0.28334628334628337,0.7166537166537167,0.03781403781403781
4097,25.0,1099,25224,26323,200,2008,35871,9768,26103,35871,2465,0.030637562376292827,0.7031864179978256,0.005575534554375401,0.27230910763569455,0.7276908923643054,0.05597836692592902
4098,15.0,90,2090,2180,24,122,2937,810,2127,2937,218,0.030643513789581207,0.7116104868913857,0.008171603677221655,0.27579162410623087,0.7242083758937692,0.04153898535921008
4099,15.0,376,28068,28444,108,1878,37616,10890,26726,37616,3376,0.009995746490854955,0.7461718417694598,0.0028711186729051467,0.2895044661846023,0.7104955338153977,0.04992556358996172
4100,40.0,61,1790,1851,15,93,2470,675,1795,2470,190,0.024696356275303644,0.7246963562753036,0.006072874493927126,0.2732793522267207,0.7267206477732794,0.03765182186234818
4101,,409,10434,10843,51,515,14265,4132,10133,14265,1030,0.028671573781983876,0.7314405888538381,0.0035751840168243955,0.28966000701016476,0.7103399929898353,0.03610234840518752
4102,27.0,355,8259,8614,65,253,11949,3335,8614,11949,724,0.02970959912963428,0.691187547075069,0.00543978575613022,0.2791028537952967,0.7208971462047034,0.021173319943091472
4103,16.0,3462,55883,59345,436,4008,79123,22555,56568,79123,5356,0.04375466046535142,0.7062800955474388,0.005510407846011906,0.28506249763027186,0.7149375023697282,0.050655308822971826
4104,16.0,312,5115,5427,13,370,7624,2136,5488,7624,553,0.040923399790136414,0.6709076600209863,0.0017051416579223506,0.2801678908709339,0.7198321091290661,0.04853095487932844
4105,27.0,117,1967,2084,4,106,2746,803,1943,2746,205,0.04260742898761835,0.7163146394756009,0.0014566642388929353,0.2924253459577567,0.7075746540422433,0.03860160233066278
4106,24.0,107,2546,2653,13,244,3698,1025,2673,3698,251,0.02893455922120065,0.6884802595997837,0.003515413737155219,0.277176852352623,0.722823147647377,0.06598161168199027
4107,17.0,155,7312,7467,23,354,9910,2890,7020,9910,798,0.01564076690211907,0.7378405650857719,0.002320887991927346,0.29162462159434915,0.7083753784056509,0.03572149344096872
4108,14.0,926,20321,21247,97,1091,28638,8016,20622,28638,1958,0.03233466024163698,0.7095816746979537,0.003387108038270829,0.2799078147915357,0.7200921852084643,0.03809623577065437
4109,13.0,235,5012,5247,5,227,7146,1949,5197,7146,697,0.03288553036663868,0.7013713965855024,0.0006996921354603975,0.27273999440246294,0.7272600055975371,0.031766022949902044
4110,23.0,93,2638,5278,106,611,7351,1068,6291,7359,234,0.012637586628618018,0.35847261856230467,0.014404130996059247,0.14512841418671016,0.8548715858132898,0.08302758526973773
4111,,1807,29344,31151,325,1915,42285,11822,30463,42285,2986,0.042733829963343975,0.6939576682038548,0.007685940640889204,0.27957904694336055,0.7204209530566394,0.045287927160931774
4112,24.0,37,3897,3934,5,336,5532,1469,4063,5532,472,0.006688358640636298,0.7044468546637744,0.0009038322487346348,0.26554591467823574,0.7344540853217643,0.06073752711496746
4113,27.0,188,4794,4982,10,274,6631,1885,4746,6631,516,0.02835168149600362,0.7229678781480923,0.0015080681646810435,0.2842708490423767,0.7157291509576232,0.041321067712260594
4114,14.0,468,8827,9295,249,329,12517,3559,8958,12517,819,0.03738915075497324,0.7052009267396341,0.01989294559399217,0.2843333067028841,0.715666693297116,0.026284253415355115
4115,,191,7447,7638,10,374,10046,3055,6991,10046,512,0.01901254230539518,0.7412900656977902,0.0009954210631096954,0.30410113478001194,0.695898865219988,0.037228747760302605
4116,16.0,12,2053,2065,31,145,2849,785,2064,2849,203,0.004212004212004212,0.7206037206037206,0.01088101088101088,0.2755352755352755,0.7244647244647244,0.05089505089505089
4117,25.0,252,11318,11570,10,196,14374,4473,9901,14374,959,0.01753165437595659,0.7873939056630026,0.0006957005704744677,0.31118686517322947,0.6888131348267705,0.013635731181299569
4118,,658,12419,13077,65,821,17625,5169,12456,17625,685,0.037333333333333336,0.7046241134751773,0.0036879432624113474,0.29327659574468085,0.7067234042553191,0.04658156028368794
4119,14.0,357,8489,8846,48,732,12154,3378,8776,12154,856,0.029373045910811257,0.6984531841369097,0.003949317097251934,0.27793319071910483,0.7220668092808952,0.06022708573309199
4120,26.0,2394,48940,51334,182,2552,68043,19805,48238,68043,4475,0.03518363387857678,0.7192510618285496,0.002674779183751451,0.2910659435944917,0.7089340564055083,0.03750569492820716
4121,46.0,199,5077,5276,34,255,6741,2006,4735,6741,475,0.029520842604954755,0.7531523512831924,0.005043762053107847,0.297581961133363,0.702418038866637,0.037828215398308856
4122,,3353,81028,84381,439,4514,112083,32009,80074,112083,7564,0.02991533060321369,0.7229285440254097,0.003916740272833525,0.2855830054513173,0.7144169945486827,0.040273725721117384
4123,,420,10625,11045,27,777,14708,4170,10538,14708,991,0.028555887952134894,0.722395974979603,0.0018357356540658145,0.28351917323905357,0.7164808267609464,0.052828392711449554
4124,17.0,412,61341,61753,210,2653,82448,23612,58836,82448,7668,0.004997089074325636,0.7439962157966233,0.002547059965068892,0.2863865709295556,0.7136134290704444,0.03217785755870367
4125,17.0,2248,34541,36789,730,1724,49815,13881,35934,49815,3085,0.0451269697882164,0.6933855264478571,0.014654220616280238,0.2786510087323095,0.7213489912676905,0.034608049784201546
4126,,326,11446,11772,21,830,16010,4729,11281,16010,906,0.020362273579013115,0.7149281698938164,0.001311680199875078,0.29537788881948784,0.7046221111805122,0.051842598376014994
4127,23.0,205,3940,4145,12,341,5603,1559,4044,5603,401,0.036587542388006426,0.7031947171158308,0.0021417097983223274,0.2782437979653757,0.7217562020346243,0.06086025343565947
4128,16.0,248,3532,3780,11,395,5362,1426,3936,5362,299,0.04625139873181649,0.6587094367773219,0.002051473330846699,0.2659455427079448,0.7340544572920552,0.07366654233494964
4129,24.0,308,10931,11239,25,716,15423,4336,11087,15423,1090,0.019970174414834986,0.7087466770407832,0.0016209557154898528,0.28113855929456005,0.7188614407054399,0.046424171691629386
4130,,68,3369,3437,7,152,4552,1294,3258,4552,408,0.014938488576449912,0.7401142355008787,0.0015377855887521968,0.28427065026362036,0.7157293497363796,0.033391915641476276
4131,16.0,2216,97859,100075,2414,11060,145002,36408,108594,145002,4966,0.015282547826926526,0.6748803464779796,0.01664804623384505,0.2510861919145943,0.7489138080854058,0.07627481000262065
4132,15.0,920,13279,14199,32,922,18925,5435,13490,18925,1306,0.04861294583883752,0.701664464993395,0.001690885072655218,0.2871862615587847,0.7128137384412153,0.04871862615587847
4133,27.0,140,11551,11691,21,777,15731,4346,11385,15731,1423,0.008899624944377344,0.7342826266607336,0.0013349437416566017,0.27626978577331385,0.7237302142266862,0.04939291844129426
4134,,152,3193,3345,54,177,4535,1262,3273,4535,398,0.033517089305402425,0.7040793825799339,0.011907386990077177,0.2782800441014333,0.7217199558985667,0.03902976846747519
4135,26.0,863,18916,19779,91,1049,26468,7527,18941,26468,1978,0.03260541030678555,0.7146743237116518,0.00343811394891945,0.2843811394891945,0.7156188605108055,0.039632764092489045
4136,16.0,125,9586,9711,2,863,13362,3627,9735,13362,1291,0.009354886992965125,0.7174075737165095,0.000149678191887442,0.27144140098787606,0.7285585990121239,0.06458613979943122
4137,36.0,870,16495,17365,33,981,23666,6581,17085,23666,1578,0.03676159891827939,0.6969914645482972,0.0013944054762105975,0.27807825572551337,0.7219217442744866,0.04145187188371503
4138,15.0,773,8878,9651,46,879,13787,3622,10165,13787,929,0.056067309784579675,0.6439399434249655,0.0033364763908029305,0.26271124972800464,0.7372887502719954,0.06375571190251686
4139,26.0,606,14504,15110,234,799,21054,5663,15391,21054,1617,0.028783129096608722,0.6888952218105823,0.011114277571957822,0.2689750166239194,0.7310249833760806,0.03795003324783889
4140,,179,2775,2954,24,169,3900,1122,2778,3900,265,0.0458974358974359,0.7115384615384616,0.006153846153846154,0.2876923076923077,0.7123076923076923,0.043333333333333335
4141,36.0,89,2863,2952,0,157,4037,1128,2909,4037,296,0.022046073817190984,0.7091899925687392,0.0,0.27941540748080257,0.7205845925191974,0.038890265048303195
4142,17.0,158,2771,2929,11,145,4108,1117,2991,4108,321,0.038461538461538464,0.6745374878286271,0.002677702044790652,0.2719084712755599,0.7280915287244402,0.035296981499513144
4143,34.0,2771,58091,60862,314,3281,80288,23428,56860,80288,5566,0.0345132522917497,0.7235327819848545,0.003910920685532084,0.2917995217218015,0.7082004782781984,0.040865384615384616
4144,24.0,65,2163,2228,48,118,3072,838,2238,3076,155,0.021131339401820545,0.703185955786736,0.015604681404421327,0.27243172951885564,0.7275682704811444,0.03836150845253576
4145,16.0,2028,9344,11372,23,700,15218,4344,10874,15218,549,0.13326324089893546,0.6140097253252726,0.0015113681167039032,0.28545143908529375,0.7145485609147063,0.045998160073597055
4146,15.0,61,2689,2750,2,249,3849,942,2907,3849,273,0.0158482722785139,0.6986230189659652,0.0005196154845414394,0.24473889321901793,0.7552611067809821,0.0646921278254092
4147,,165,5479,5644,47,248,7589,2144,5445,7589,589,0.02174199499275267,0.7219660034260114,0.006193174331268942,0.28251416523916195,0.717485834760838,0.032678877322440375
4148,15.0,263,4318,4581,62,210,6355,1766,4589,6355,506,0.04138473642800944,0.6794649881982691,0.00975609756097561,0.2778914240755311,0.722108575924469,0.03304484657749803
4149,,4199,102021,106220,149,3891,138109,40454,97655,138109,10633,0.030403521855925392,0.7386991434301892,0.0010788580034610344,0.29291356826854154,0.7070864317314585,0.028173399271589832
4150,,3932,69122,73054,347,4193,96062,27917,68145,96062,6342,0.04093189814911203,0.7195561200058296,0.003612250421602715,0.2906143948699798,0.7093856051300202,0.043648893422997645
4151,33.0,194,7250,7444,52,339,9701,2787,6914,9701,769,0.019997938356870425,0.7473456344706731,0.005360272136893104,0.28728997010617463,0.7127100298938254,0.034944851046283885
4152,37.0,57,1838,1895,13,59,2538,717,1821,2538,226,0.022458628841607566,0.7241922773837668,0.00512214342001576,0.28250591016548465,0.7174940898345153,0.023246650906225373
4153,25.0,169,3613,3782,16,155,5093,1469,3624,5093,321,0.03318279992146083,0.709405065776556,0.0031415668564696644,0.28843510700962105,0.711564892990379,0.030433928922049873
4154,17.0,1734,77861,79595,1113,8401,112974,28474,84500,112974,6454,0.01534866429443943,0.6891939738346876,0.009851824313558872,0.2520402924566714,0.7479597075433285,0.07436224263989945
4155,,5,2915,2920,13,322,4096,1083,3013,4096,236,0.001220703125,0.711669921875,0.003173828125,0.264404296875,0.735595703125,0.07861328125
4156,,87,2118,2205,0,154,3122,858,2264,3122,226,0.02786675208199872,0.6784112748238309,0.0,0.27482383087764256,0.7251761691223575,0.04932735426008968
4157,23.0,3490,79632,83122,765,5764,115146,31765,83383,115148,8358,0.03030881995345121,0.6915621634765693,0.006643623857991454,0.2758623684301942,0.7241376315698058,0.050057317539166986
4158,15.0,200,4161,4361,12,195,5659,1667,3992,5659,426,0.03534193320374625,0.7352889203039407,0.002120515992224775,0.29457501325322494,0.705424986746775,0.03445838487365259
4159,,77,3044,3121,8,138,4102,1222,2880,4102,347,0.01877133105802048,0.7420770355923939,0.0019502681618722574,0.2979034617259873,0.7020965382740126,0.03364212579229644
4160,,327,12816,13143,109,1151,18196,5013,13183,18196,1242,0.017970982633545834,0.7043306221147505,0.0059903275445152785,0.2755001099142669,0.7244998900857331,0.0632556605847439
4161,16.0,425,3267,3692,6,281,5326,1381,3945,5326,271,0.07979722117912129,0.6134059331580923,0.0011265490048817123,0.2592940292902741,0.7407059707097259,0.05276004506196019
4162,,2059,29472,31531,250,1288,41175,11406,29769,41175,3291,0.05000607164541591,0.7157741347905282,0.006071645415907711,0.2770127504553734,0.7229872495446266,0.03128111718275653
4163,42.0,565,7750,8315,62,586,11159,3015,8144,11159,564,0.05063177704095349,0.6945066762254682,0.005556053409803746,0.2701855004928757,0.7298144995071243,0.05251366609911282
4164,34.0,132,2871,3003,5,133,4009,1137,2872,4009,322,0.03292591668745323,0.7161386879521078,0.001247193813918683,0.2836118732851085,0.7163881267148915,0.03317535545023697
4165,23.0,326,6634,6960,10,410,9301,2650,6651,9301,714,0.03504999462423395,0.7132566390710676,0.0010751532093323298,0.2849156004730674,0.7150843995269326,0.044081281582625524
4166,42.0,89,2887,2976,12,115,3897,1142,2755,3897,319,0.02283808057480113,0.7408262766230433,0.003079291762894534,0.29304593276879654,0.7069540672312035,0.02950987939440595
4167,24.0,194,5878,6072,9,309,7869,2257,5612,7869,500,0.024653704409708984,0.7469818274240692,0.001143728555089592,0.2868217054263566,0.7131782945736435,0.03926801372474266
4168,24.0,276,4737,5013,35,335,6825,1879,4946,6825,420,0.04043956043956044,0.6940659340659341,0.005128205128205128,0.2753113553113553,0.7246886446886447,0.04908424908424908
4169,33.0,1113,36699,37812,154,2439,50626,14168,36458,50626,3882,0.021984750918500374,0.7249041994232213,0.0030419152214277248,0.27985620037135067,0.7201437996286493,0.048176826136767666
4170,15.0,789,13923,14712,10,506,19810,5828,13982,19810,1444,0.03982836951034831,0.7028268551236749,0.0005047955577990914,0.29419485108531046,0.7058051489146896,0.025542655224634024
4171,,2393,61776,64169,480,6917,88832,22945,65887,88832,5715,0.026938490634005764,0.6954250720461095,0.005403458213256484,0.2582965597982709,0.7417034402017291,0.07786608429394813
4172,14.0,75,3592,3667,7,293,4979,1405,3574,4979,433,0.01506326571600723,0.7214300060253063,0.0014059048001606748,0.28218517774653545,0.7178148222534646,0.05884715806386825
4173,16.0,143,2818,2961,12,150,3980,1145,2835,3980,281,0.03592964824120603,0.7080402010050251,0.003015075376884422,0.2876884422110553,0.7123115577889447,0.03768844221105527
4174,34.0,50,3304,3354,21,99,4267,1339,2928,4267,291,0.011717834544176237,0.7743145066791657,0.004921490508554019,0.3138036090930396,0.6861963909069604,0.02320131239746895
4175,,5573,101265,106838,392,7385,144800,40584,104216,144800,10312,0.03848756906077348,0.6993439226519337,0.0027071823204419887,0.28027624309392263,0.7197237569060774,0.05100138121546961
4176,,193,1860,2053,4,213,2882,796,2086,2882,188,0.0669673837612769,0.6453851492019431,0.0013879250520471894,0.2761970853573907,0.7238029146426093,0.07390700902151284
4177,17.0,223,4985,5208,10,278,7045,1966,5079,7045,482,0.031653655074520934,0.7075940383250532,0.0014194464158978,0.27906316536550746,0.7209368346344925,0.03946061036195884
4178,45.0,244,8368,8612,6,325,11135,3346,7789,11135,809,0.02191288729232151,0.7515042658284687,0.0005388414907947912,0.30049393803322855,0.6995060619667715,0.02918724741805119
4179,13.0,3111,57060,60171,1053,3718,83242,22910,60332,83242,5907,0.037372960764998436,0.6854712765190649,0.012649864251219337,0.275221642920641,0.724778357079359,0.04466495278825593
4180,,1656,24554,26210,139,1456,35250,9995,25255,35250,2371,0.04697872340425532,0.6965673758865248,0.003943262411347518,0.2835460992907801,0.7164539007092199,0.041304964539007095
4181,33.0,49,6218,6267,50,319,8287,2354,5933,8287,688,0.005912875588270786,0.7503318450585253,0.006033546518643659,0.28405937009774346,0.7159406299022566,0.03849402678894654
4182,25.0,193,6112,6305,18,410,8328,2420,5908,8328,575,0.02317483189241114,0.733909702209414,0.002161383285302594,0.2905859750240154,0.7094140249759846,0.04923150816522574
4183,,241,7192,7433,18,492,10016,2746,7270,10016,777,0.02406150159744409,0.7180511182108626,0.0017971246006389776,0.27416134185303515,0.7258386581469649,0.04912140575079872
4184,26.0,78,2560,2638,8,236,3556,977,2579,3556,251,0.021934758155230598,0.7199100112485939,0.0022497187851518562,0.2747469066366704,0.7252530933633295,0.06636670416197975
4185,26.0,51,2538,2589,9,80,3366,1010,2356,3366,290,0.015151515151515152,0.7540106951871658,0.00267379679144385,0.30005941770647654,0.6999405822935235,0.023767082590612002
4186,27.0,1433,35368,36801,276,1430,46968,15497,31471,46968,1926,0.03051013455970022,0.7530233350366207,0.005876341338783853,0.32994804973599046,0.6700519502640095,0.03044626128427866
4187,14.0,935,11574,12509,213,1226,17588,4757,12831,17588,969,0.05316124630429839,0.6580623152149193,0.012110529906754606,0.27046850125085287,0.7295314987491471,0.06970661814873777
4188,,2328,67157,69485,200,3699,92372,26423,65949,92372,7232,0.025202442298532024,0.7270276707227298,0.0021651582730697616,0.2860498852466115,0.7139501147533884,0.040044602260425236
4189,24.0,43931,900454,944385,6971,49385,1269078,359582,909496,1269078,88728,0.03461646959446149,0.7095340081539512,0.005492964183446565,0.2833411342722827,0.7166588657277173,0.03891407777930119
4190,23.0,5391,120844,126235,524,5855,164245,48246,115999,164245,12114,0.032822916983774236,0.7357545130749794,0.0031903558708027643,0.2937441017991415,0.7062558982008584,0.035647964930439285
4191,25.0,277,8317,8594,50,296,11101,3321,7780,11101,874,0.024952706963336638,0.7492117827222773,0.004504098729844158,0.299162237636249,0.7008377623637511,0.026664264480677418
4192,15.0,5185,105954,111139,361,7514,151728,42107,109621,151728,10617,0.03417299377834019,0.698315406516925,0.0023792576188969737,0.27751634503848993,0.7224836549615101,0.04952283032795529
4193,14.0,1401,18097,19498,57,1849,26689,7299,19390,26689,1318,0.0524935366630447,0.6780696166960171,0.0021357113417512833,0.2734834576042564,0.7265165423957436,0.06927947843680918
4194,25.0,1327,38552,39879,239,1639,51636,15230,36406,51636,3674,0.025699124641722828,0.7466108916259974,0.004628553722209311,0.2949492602060578,0.7050507397939422,0.03174142071423038
4195,,1088,24392,25480,103,1315,34027,9604,24423,34027,2355,0.03197460839921239,0.7168425074205778,0.0030270079642636728,0.28224645134745935,0.7177535486525406,0.03864578129132747
4196,34.0,4279,79860,84139,993,2584,107379,31992,75387,107379,6665,0.039849505024259865,0.7437208392702483,0.00924761824937837,0.2979353504875255,0.7020646495124745,0.024064295625774126
4197,33.0,1056,23809,25302,610,1713,34967,9652,25315,34967,2456,0.03019990276546458,0.680899133468699,0.01744501958989905,0.2760316870191895,0.7239683129808104,0.04898904681556897
4198,24.0,18708,466695,485403,1155,26001,639806,182934,456872,639806,45841,0.029240113409377218,0.7294320465891223,0.0018052347117720059,0.28592104481671005,0.7140789551832899,0.04063888116085188
4199,,109,4108,4217,1,152,5464,1584,3880,5464,447,0.019948755490483163,0.7518301610541728,0.00018301610541727673,0.28989751098096633,0.7101024890190337,0.027818448023426062
4200,25.0,89,1752,1841,14,94,2475,712,1763,2475,128,0.03595959595959596,0.7078787878787879,0.0056565656565656566,0.2876767676767677,0.7123232323232324,0.03797979797979798
4201,15.0,2175,71072,73247,330,4421,102465,27992,74473,102465,6759,0.02122676035719514,0.6936222124627922,0.00322061191626409,0.2731859659395891,0.7268140340604109,0.04314644024788952
4202,,155,3546,3701,10,135,4988,1410,3578,4988,395,0.03107457898957498,0.710906174819567,0.002004811547714515,0.2826784282277466,0.7173215717722534,0.02706495589414595
4203,13.0,847,13984,14831,201,995,20718,5674,15044,20718,1375,0.04088232454870161,0.6749686263152814,0.009701708659136983,0.27386813398976734,0.7261318660102326,0.04802587122309103
4204,17.0,244,22268,22512,162,991,30036,8368,21668,30036,2593,0.008123585031295778,0.7413770142495671,0.005393527766679984,0.27859901451591423,0.7214009854840857,0.03299374084432015
4205,,3848,75662,79510,599,4223,104456,30154,74302,104456,6560,0.03683847744504863,0.7243432641494983,0.005734471930765107,0.2886765719537413,0.7113234280462587,0.040428505782338975
4206,,261,6577,6838,21,244,9255,2592,6663,9255,743,0.02820097244732577,0.7106428957320368,0.00226904376012966,0.280064829821718,0.719935170178282,0.02636412749864938
4207,42.0,191,6149,6340,0,210,8232,2377,5855,8232,666,0.023202137998056364,0.7469630709426628,0.0,0.2887512147716229,0.7112487852283771,0.025510204081632654
4208,,622,5359,5981,35,695,8718,2172,6546,8718,336,0.07134663913741685,0.6147052076164258,0.004014682266574902,0.24913971094287682,0.7508602890571232,0.07972011929341592
4209,,158,4866,5024,11,160,6524,1916,4608,6524,479,0.02421827099938688,0.7458614347026364,0.0016860821581851624,0.2936848559166156,0.7063151440833845,0.024524831391784182
4210,24.0,547,10816,11363,45,717,15087,4174,10913,15087,1126,0.03625637966461192,0.7169085968051965,0.0029827003380393717,0.2766620269105853,0.7233379730894147,0.04752435871942732
4211,23.0,3396,110980,114376,222,5599,150767,43598,107169,150767,10625,0.02252482307136177,0.7361027280505681,0.001472470766149091,0.28917468676832464,0.7108253132316754,0.03713677396247189
4212,17.0,1492,16062,17554,139,2496,25312,6555,18757,25312,1720,0.058944374209860935,0.6345606826801518,0.005491466498103666,0.2589680783817952,0.7410319216182049,0.0986093552465234
4213,,312,9473,9785,13,935,13562,3670,9892,13562,922,0.023005456422356584,0.6984957970800767,0.0009585606842648577,0.27060905471169444,0.7293909452883056,0.0689426338298186
4214,,29142,469778,498920,1067,39500,678807,188905,489902,678807,46050,0.042931201357676044,0.6920641655139089,0.0015718753636895318,0.2782897053212474,0.7217102946787526,0.0581903250850389
4215,,239,5709,5948,14,310,7904,2288,5616,7904,632,0.030237854251012147,0.7222925101214575,0.001771255060728745,0.2894736842105263,0.7105263157894737,0.039220647773279355
4216,23.0,289,7183,7472,2,420,9767,2848,6919,9767,712,0.029589433807719872,0.735435650660387,0.0002047711682195147,0.2915941435445889,0.7084058564554111,0.043001945326098086
4217,34.0,206,4434,4640,70,213,6396,1762,4634,6396,400,0.032207629768605375,0.6932457786116323,0.010944340212632896,0.2754846779237023,0.7245153220762977,0.03330206378986867
4218,36.0,718,16303,17021,24,826,23297,6400,16897,23297,1772,0.03081941880928875,0.6997896724900202,0.0010301755590848608,0.2747134824226295,0.7252865175773705,0.03545520882517062
4219,,64,3853,3917,28,214,5180,1485,3695,5180,409,0.012355212355212355,0.7438223938223938,0.005405405405405406,0.28667953667953666,0.7133204633204633,0.04131274131274131
4220,26.0,1012,21584,22596,123,2048,31485,8493,22992,31485,2024,0.03214228997935525,0.6855327933936796,0.0039066222010481185,0.26974749880895665,0.7302525011910433,0.06504684770525647
4221,15.0,465,5223,5688,67,392,8255,2228,6027,8255,482,0.056329497274379164,0.6327074500302847,0.008116293155663234,0.26989703210175653,0.7301029678982435,0.047486371895820716
4222,15.0,39,2848,2887,12,129,3898,1087,2811,3898,325,0.010005130836326322,0.7306310928681375,0.0030785017957927143,0.2788609543355567,0.7211390456644433,0.03309389430477168
4223,25.0,81,2064,2145,7,114,2900,838,2062,2900,241,0.02793103448275862,0.7117241379310345,0.002413793103448276,0.2889655172413793,0.7110344827586207,0.039310344827586205
4224,26.0,1598,19895,21493,155,1354,29959,8186,21773,29959,2111,0.05333956407089689,0.664074234787543,0.0051737374411695985,0.2732400947962215,0.7267599052037785,0.04519509996995894
4225,14.0,98,1869,1967,9,118,2793,685,2108,2793,191,0.03508771929824561,0.6691729323308271,0.00322234156820623,0.24525599713569637,0.7547440028643037,0.042248478338703904
4226,14.0,64,3271,3335,45,445,4947,1181,3766,4947,390,0.01293713361633313,0.6612088134222761,0.009096422073984234,0.23873054376389732,0.7612694562361026,0.0899535071760663
4227,17.0,4378,53285,57663,573,4753,79013,22137,56876,79013,5341,0.05540860364750105,0.6743826965182944,0.007251971194613544,0.2801690860997557,0.7198309139002442,0.06015465809423766
4228,,101,1821,1922,3,151,2648,713,1935,2648,178,0.03814199395770393,0.6876888217522659,0.0011329305135951663,0.2692598187311178,0.7307401812688822,0.05702416918429003
4229,16.0,518,6486,7004,9,694,9397,2673,6724,9397,666,0.05512397573693732,0.6902202830690646,0.0009577524741938917,0.28445248483558583,0.7155475151644142,0.07385335745450676
4230,23.0,1108,11114,12223,270,947,16621,4534,12087,16621,640,0.06666265567655376,0.6686721617231214,0.016244509957282955,0.27278743757896634,0.7272125624210336,0.056976114553877626
4231,23.0,2069,58877,60946,278,5225,83020,22854,60166,83020,5795,0.024921705613105277,0.7091905564924115,0.003348590701035895,0.2752830643218502,0.7247169356781499,0.06293664177306674
4232,26.0,541,19259,19800,127,478,25735,7528,18207,25735,2034,0.021021954536623276,0.7483582669516223,0.00493491354186905,0.2925199145133087,0.7074800854866913,0.018573926559160677
4233,16.0,1722,4838,6560,83,1163,9759,2280,7479,9759,220,0.17645250537964954,0.4957475151142535,0.00850496977149298,0.233630494927759,0.766369505072241,0.11917204631622093
4234,,948,11660,12608,62,1205,17231,4824,12407,17231,937,0.055017120306424465,0.6766873657942081,0.003598166095989786,0.2799605362428182,0.7200394637571819,0.06993209912367244
4235,17.0,1172,23445,24617,96,1230,33462,9472,23990,33462,2613,0.035024804255573486,0.700645508337816,0.002868925945849023,0.2830673599904369,0.7169326400095631,0.036758113681190606
4236,,585,15773,16358,277,975,22553,6331,16222,22553,1777,0.02593889948122201,0.6993748060125039,0.012282179754356404,0.2807165343856693,0.7192834656143307,0.04323149913537002
4237,17.0,266,24100,24393,151,2813,34304,9066,25238,34304,2671,0.00775419776119403,0.7025419776119403,0.004401819029850746,0.2642840485074627,0.7357159514925373,0.08200209888059702
4238,23.0,326,1284,1610,5,167,2359,607,1752,2359,164,0.13819415006358626,0.5442984315387877,0.00211954217888936,0.2573124205171683,0.7426875794828317,0.07079270877490462
4239,16.0,264,1286,1550,1,127,2191,556,1635,2191,103,0.1204929256047467,0.5869465997261525,0.00045641259698767686,0.25376540392514835,0.7462345960748517,0.05796439981743496
4240,17.0,99,1967,2066,33,80,2825,805,2020,2825,220,0.035044247787610616,0.6962831858407079,0.01168141592920354,0.2849557522123894,0.7150442477876107,0.02831858407079646
4241,25.0,877,20609,21486,19,1066,28002,8359,19643,28002,1862,0.0313191914863224,0.7359831440611385,0.0006785229626455253,0.29851439182915507,0.7014856081708449,0.03806870937790158
4242,15.0,108,1522,1630,4,116,2217,607,1610,2217,174,0.04871447902571042,0.6865133062697338,0.0018042399639152007,0.2737934145241317,0.7262065854758682,0.05232295895354082
4243,26.0,1202,28176,29378,99,1894,40166,11081,29085,40166,2754,0.02992580789722651,0.7014888213912264,0.0024647711995219837,0.27588009759498083,0.7241199024050192,0.047154309615097346
4244,,1128,9760,10888,82,1672,15951,3940,12011,15951,798,0.0707165694940756,0.6118738637076045,0.005140743527051596,0.24700645727540593,0.7529935427245941,0.10482101435646668
4245,23.0,937,15739,16676,249,1246,22729,6413,16316,22729,1349,0.04122486691011483,0.6924633727836684,0.010955167407277047,0.2821505565577016,0.7178494434422984,0.05481983369263936
4246,16.0,9,3158,3167,11,308,4272,1152,3120,4272,303,0.002106741573033708,0.7392322097378277,0.0025749063670411983,0.2696629213483146,0.7303370786516854,0.07209737827715355
4247,16.0,473,3636,4109,1037,891,7316,1365,5951,7316,330,0.06465281574630946,0.49699289229086935,0.14174412247129578,0.1865773646801531,0.8134226353198469,0.12178786221979224
4248,,336,7749,8085,36,246,11174,3075,8099,11174,852,0.03006980490424199,0.6934848756040809,0.0032217648111687847,0.2751924109540004,0.7248075890459996,0.02201539287632003
4249,,136,3447,3583,10,114,4721,1314,3407,4721,372,0.028807456047447576,0.7301419190849396,0.0021181952976064393,0.27833086210548613,0.7216691378945139,0.024147426392713407
4250,,235,9948,10183,99,484,13601,3833,9768,13601,1192,0.01727814131313874,0.7314168075876774,0.007278876553194618,0.281817513418131,0.718182486581869,0.03558561870450702
4251,17.0,234,5133,5367,23,662,7505,1961,5544,7505,408,0.031179213857428383,0.683944037308461,0.0030646235842771486,0.261292471685543,0.7387075283144571,0.08820786142571618
4252,27.0,57,1707,1764,13,71,2361,686,1675,2361,200,0.0241423125794155,0.7229987293519695,0.005506141465480729,0.29055484963998307,0.709445150360017,0.030072003388394747
4253,14.0,268,5427,5695,22,421,7541,2149,5392,7541,479,0.03553905317597136,0.71966582681342,0.0029173849622066038,0.284975467444636,0.715024532555364,0.055828139504044555
4254,,52,4203,4255,18,863,6853,1667,5186,6853,212,0.007587917700277251,0.6133080402743324,0.0026265868962498176,0.24325113089158032,0.7567488691084197,0.12593024952575516
4255,15.0,1350,21551,22901,76,1702,31175,8913,22262,31175,2116,0.04330392943063352,0.6912910986367281,0.00243785084202085,0.28590216519647155,0.7140978348035285,0.05459502806736167
4256,,383,4225,4608,18,744,6701,1774,4927,6701,362,0.057155648410684975,0.6305029100134308,0.0026861662438442025,0.26473660647664526,0.7352633935233547,0.11102820474556037
4257,17.0,116,2329,2445,4,77,3197,991,2206,3197,266,0.03628401626524867,0.7284954644979669,0.0012511729746637473,0.3099781044729434,0.6900218955270566,0.024085079762277136
4258,,148,2066,2214,19,251,3165,812,2353,3165,199,0.04676145339652449,0.6527646129541864,0.006003159557661927,0.25655608214849923,0.7434439178515008,0.07930489731437598
4259,,2407,46297,48704,489,2142,64762,18609,46153,64762,4679,0.037166857107563074,0.7148790957660356,0.0075507241901114856,0.2873444303758377,0.7126555696241623,0.033074951360365645
4260,24.0,29,2043,2072,11,114,2732,810,1922,2732,230,0.01061493411420205,0.7478038067349927,0.004026354319180088,0.2964860907759883,0.7035139092240117,0.04172767203513909
4261,17.0,90,2981,3071,6,101,4142,1189,2953,4142,309,0.021728633510381457,0.7197006277160792,0.0014485755673587638,0.2870593915982617,0.7129406084017383,0.024384355383872524
4262,,186,6717,6903,38,261,9023,2632,6391,9023,680,0.020613986478998116,0.7444308988141416,0.004211459603236174,0.2916989914662529,0.7083010085337471,0.028926077801174777
4263,33.0,161,1882,2043,0,87,2762,766,1996,2762,195,0.05829109341057205,0.6813902968863143,0.0,0.277335264301231,0.722664735698769,0.031498913830557564
4264,,2022,48663,50685,207,2719,66906,19219,47687,66906,4444,0.030221504797775984,0.727333871401668,0.003093892924401399,0.2872537590051714,0.7127462409948285,0.040639105610857026
4265,,373,9615,9988,29,493,13308,3795,9513,13308,1041,0.028028253681995793,0.722497745716862,0.0021791403666967238,0.2851668169522092,0.7148331830477908,0.037045386233844305
4266,35.0,693,19630,20323,39,815,26228,7711,18517,26228,2136,0.026422144273295714,0.7484367851151441,0.0014869605002287632,0.29399877992984597,0.706001220070154,0.031073661735549794
4267,15.0,968,17239,18207,58,1615,25274,6907,18367,25274,1809,0.038300229484846085,0.6820843554641133,0.0022948484608688773,0.2732847986072644,0.7267152013927356,0.06389965972936615
4268,23.0,118,4990,5108,3,214,6595,1986,4609,6595,495,0.0178923426838514,0.756633813495072,0.0004548900682335102,0.3011372251705838,0.6988627748294163,0.03244882486732373
4269,25.0,315,7481,7796,10,479,10569,2941,7628,10569,860,0.029804144195288106,0.7078247705553978,0.0009461633077869241,0.27826662882013437,0.7217333711798657,0.045321222442993664
4270,,909,36532,37441,114,1359,48149,14488,33661,48149,3202,0.018878896757980435,0.7587281148102765,0.002367650418492596,0.3008992917817608,0.6991007082182392,0.028224885252030155
4271,,10,1528,1538,0,191,2210,572,1638,2210,170,0.004524886877828055,0.6914027149321267,0.0,0.25882352941176473,0.7411764705882353,0.08642533936651584
4272,,197,8900,9097,44,212,12602,3495,9107,12602,1269,0.015632439295349944,0.7062371052213934,0.0034915092842405966,0.27733693064592924,0.7226630693540708,0.016822726551341056
4273,24.0,593,8672,9265,19,686,12602,3394,9208,12602,895,0.04705602285351532,0.6881447389303286,0.0015076971909220758,0.2693223297889224,0.7306776702110777,0.05443580384066021
4274,25.0,133,5076,5209,64,373,7622,1943,5679,7622,429,0.017449488323274732,0.665966937811598,0.00839674626082393,0.2549199685122015,0.7450800314877984,0.04893728680136447
4275,17.0,1390,22134,23524,0,1631,30917,8952,21965,30917,2077,0.04495908399909435,0.7159168095222693,0.0,0.2895494388200666,0.7104505611799333,0.05275414820325387
4276,14.0,231,7097,7328,42,278,9726,2795,6931,9726,713,0.023750771128932757,0.7296936047707177,0.00431832202344232,0.28737404894098295,0.712625951059017,0.02858317910754678
4277,46.0,1054,21530,22584,390,1160,30083,8544,21539,30083,1778,0.03503639929528305,0.7156866004055447,0.012964132566565834,0.2840142273044577,0.7159857726955423,0.038559984044144534
4278,,172,2803,2975,28,192,3991,1146,2845,3991,313,0.043096968178401404,0.7023302430468554,0.007015785517414182,0.2871460786770233,0.7128539213229766,0.04810824354798296
4279,26.0,80,1975,2055,8,68,2844,760,2084,2844,212,0.02812939521800281,0.6944444444444444,0.0028129395218002813,0.2672292545710267,0.7327707454289732,0.02390998593530239
4280,17.0,654,9713,10367,58,489,13836,4002,9834,13836,1012,0.047267996530789246,0.7020092512286789,0.004191962995085285,0.28924544666088464,0.7107545533391153,0.03534258456201214
4281,,911,14667,15578,27,1430,21409,5912,15497,21409,1394,0.042552197673875476,0.6850857116166098,0.0012611518520248494,0.27614554626558924,0.7238544537344107,0.06679433882946424
4282,,49,2086,2135,1,103,2783,816,1967,2783,204,0.01760689902982393,0.7495508444125045,0.00035932446999640676,0.2932087675170679,0.7067912324829321,0.037010420409629895
4283,33.0,371,9571,9942,26,664,13116,3738,9378,13116,944,0.02828606282403172,0.7297194266544679,0.001982311680390363,0.2849954254345837,0.7150045745654163,0.05062519060689234
4284,,522,9446,9968,48,535,13091,3770,9321,13091,918,0.03987472309220075,0.7215644335803224,0.0036666412038805288,0.28798411122144985,0.7120158887785502,0.040867771751585055
4285,,1109,24489,25598,139,1257,34068,9751,24317,34068,2236,0.03255254197487378,0.7188270517787954,0.004080075143829987,0.2862216742984619,0.7137783257015381,0.036896794646002117
4286,,272,3633,3905,27,143,5754,1480,4274,5754,325,0.04727146332985749,0.6313868613138686,0.0046923879040667365,0.2572123740006952,0.7427876259993048,0.024852276677094196
4287,,174,4397,4571,1,186,6052,1760,4292,6052,408,0.028750826173165895,0.7265366820885658,0.00016523463317911433,0.29081295439524124,0.7091870456047588,0.030733641771315268
4288,,1067,29990,31057,112,1555,40637,11836,28801,40637,2946,0.026256859512267146,0.7379973915397298,0.0027561089647365703,0.29126165809483967,0.7087383419051603,0.038265620001476486
4289,24.0,1864,35348,37212,99,2148,50262,14110,36152,50262,3491,0.03708567108352234,0.7032748398392423,0.0019696788826548883,0.2807289801440452,0.7192710198559548,0.04273606302972424
4290,14.0,1032,12660,13692,187,982,18921,5080,13841,18921,1278,0.054542571745679405,0.6690978278103694,0.009883198562443846,0.26848475239152264,0.7315152476084773,0.05190000528513292
4291,27.0,2006,38055,40061,450,2452,54543,15489,39054,54543,3888,0.03677832169114277,0.6977063967878554,0.008250371266707001,0.283977779000055,0.716022220999945,0.04495535632436793
4292,24.0,2438,83671,86109,177,3504,111083,32973,78110,111083,8240,0.021947552730840904,0.7532295670804714,0.001593403130992141,0.2968320985209258,0.7031679014790742,0.03154398062709866
4293,43.0,1262,49001,50263,75,1657,63700,19277,44423,63700,4772,0.019811616954474098,0.7692464678178964,0.0011773940345368916,0.3026216640502355,0.6973783359497645,0.026012558869701725
4294,26.0,772,32130,32902,96,1208,42783,12618,30165,42783,3269,0.018044550405534907,0.7509992286655914,0.0022438819157141856,0.2949302292966833,0.7050697707033168,0.02823551410607017
4295,48.0,576,22694,23270,156,2107,31061,7768,23293,31061,2362,0.018544155049740833,0.7306268310743376,0.0050223753259714754,0.25008853546247706,0.7499114645375229,0.06783426161424294
4296,15.0,13,1831,1844,20,347,2643,702,1941,2643,95,0.004918653045781309,0.6927733636019675,0.007567158531971245,0.2656072644721907,0.7343927355278093,0.13129020052970108
4297,,17,297,518,15,23,693,98,595,693,19,0.024531024531024532,0.42857142857142855,0.021645021645021644,0.1414141414141414,0.8585858585858586,0.03318903318903319
4298,,650,25176,25826,23,823,32575,9572,23003,32575,2293,0.019953952417498082,0.7728626247122026,0.000706062931696086,0.2938449731389102,0.7061550268610898,0.02526477359938603
4299,38.0,1462,45184,46646,276,2248,64690,17611,47079,64690,4227,0.022600092750038644,0.6984696243623435,0.004266501777709074,0.2722368217653424,0.7277631782346576,0.034750347812644924
4300,,179,3181,3360,8,193,4482,1266,3216,4482,314,0.03993752788933512,0.7097278000892459,0.00178491744756805,0.2824631860776439,0.7175368139223561,0.04306113342257921
4301,,109,4262,4371,16,217,5851,1637,4214,5851,418,0.01862929413775423,0.7284224918817296,0.00273457528627585,0.2797812339770979,0.720218766022902,0.03708767732011622
4302,26.0,376,11219,11595,37,506,15351,4400,10951,15351,1179,0.024493518337567584,0.7308318676307732,0.002410266432154257,0.2866262784183441,0.7133737215816559,0.03296202201810957
4303,17.0,590,5428,6018,354,279,8745,2157,6588,8745,259,0.06746712407089765,0.6206975414522584,0.04048027444253859,0.24665523156089195,0.753344768439108,0.031903945111492284
4304,16.0,111,2703,2814,28,78,3687,1039,2648,3687,350,0.030105777054515868,0.7331163547599675,0.007594250067805804,0.2818009221589368,0.7181990778410632,0.02115541090317331
4305,17.0,139,3602,3741,2,188,5067,1402,3665,5067,370,0.027432405762778764,0.7108742845865403,0.00039471087428458656,0.27669232287349516,0.7233076771265048,0.037102822182751134
4306,33.0,341,6753,7094,20,290,9941,2752,7189,9941,747,0.03430238406598934,0.6793079167085806,0.0020118700331958556,0.27683331656774973,0.7231666834322503,0.029172115481339904
4307,46.0,86,3185,3271,9,115,4337,1253,3084,4337,271,0.019829375144108832,0.7343786027207747,0.0020751671662439476,0.28890938436707403,0.711090615632926,0.026516024902005993
4308,,6,2856,2862,31,113,3818,1085,2733,3818,330,0.001571503404924044,0.748035620743845,0.008119434258774228,0.28418019905709796,0.7158198009429021,0.02959664745940283
4309,13.0,85,2911,2996,12,162,4005,1140,2865,4005,342,0.02122347066167291,0.7268414481897628,0.00299625468164794,0.2846441947565543,0.7153558052434457,0.04044943820224719
4310,14.0,1460,46478,47938,146,4155,65255,17628,47627,65255,3871,0.022373764462493295,0.7122519347176461,0.0022373764462493297,0.2701402191402958,0.7298597808597043,0.06367328174086277
4311,26.0,16788,227334,244122,1673,11867,323275,93133,230142,323275,24154,0.05193101848271595,0.7032217152579073,0.005175160467094579,0.2880921815791509,0.7119078184208492,0.03670868455649215
4312,15.0,582,3863,4445,277,430,6517,1618,4899,6517,427,0.08930489489028694,0.592757403713365,0.042504219733005985,0.24827374558846094,0.7517262544115391,0.06598127972993709
4313,26.0,11442,198782,210224,1907,11855,284478,79935,204692,284627,19063,0.0401999810278013,0.6983947411875894,0.006699996837966883,0.28084124134393434,0.7191587586560657,0.04165100289150362
4314,15.0,132,2571,2703,4,149,3654,1046,2608,3654,308,0.0361247947454844,0.7036124794745484,0.0010946907498631637,0.2862616310892173,0.7137383689107827,0.04077723043240285
4315,25.0,518,18676,19194,172,955,25036,7282,17756,25038,1652,0.020688553398833773,0.7459062225417366,0.0068695582714274304,0.29083792635194505,0.709162073648055,0.038142024123332535
4316,,5194,146250,151444,223,9453,202426,57455,144971,202426,14485,0.025658759250293935,0.7224862418859237,0.0011016371414739213,0.2838321164277316,0.7161678835722683,0.04669854662938555
4317,16.0,31458,400115,431573,7249,30353,585447,163958,421489,585447,36657,0.053733301221118225,0.6834350504827935,0.012381991879709009,0.28005609389065106,0.7199439061093489,0.05184585453508174
4318,24.0,1892,30909,32801,243,2089,46994,12301,34693,46994,2543,0.04026045878197217,0.6577222624164787,0.005170872877388603,0.26175682001957695,0.738243179980423,0.044452483295739885
4319,15.0,6,2359,2365,11,122,3258,891,2367,3258,276,0.001841620626151013,0.7240638428483732,0.003376304481276857,0.27348066298342544,0.7265193370165746,0.0374462860650706
4320,,1494,9097,11842,177,3075,18580,2682,15926,18608,49,0.08028804815133277,0.48887575236457437,0.009512037833190027,0.14413155631986244,0.8558684436801376,0.16525150472914876
4321,25.0,3642,70074,73716,320,5224,100248,28314,71934,100248,6638,0.0363299018434283,0.699006463969356,0.003192083632591174,0.2824395499162078,0.7175604500837922,0.052110765302050915
4322,25.0,9069,341739,350808,1872,26248,491687,132798,358889,491687,34935,0.018444660932666515,0.695033629117711,0.003807300172670825,0.27008645744142107,0.729913542558579,0.053383554985183664
4323,,1648,75618,77266,267,5066,105392,29468,75924,105392,8788,0.01563686048276909,0.7174927888264764,0.0025333991194777593,0.27960376499165024,0.7203962350083498,0.048068164566570516
4324,26.0,168,5104,5272,8,312,7095,1993,5102,7095,485,0.023678646934460888,0.7193798449612403,0.001127554615926709,0.28090204369274135,0.7190979563072586,0.04397463002114165
4325,,133,2849,2982,30,193,4145,1098,3047,4145,254,0.032086851628468034,0.6873341375150784,0.007237635705669481,0.26489746682750304,0.735102533172497,0.046562123039806995
4326,24.0,709,23146,23855,101,724,31715,9076,22639,31715,2886,0.022355352356928898,0.7298123916128015,0.0031846129591675864,0.2861737348257922,0.7138262651742078,0.022828314677597352
4327,27.0,3013,64212,67225,223,2851,88826,25613,63213,88826,6992,0.03392024857586742,0.7228964492378358,0.0025105261972845788,0.28835025780739876,0.7116497421926012,0.03209645824420778
4328,33.0,862,16984,17846,140,1023,23989,6608,17381,23989,1794,0.035933136020676146,0.7079911626161991,0.005836008170411439,0.2754595856434199,0.7245404143565801,0.0426445454166493
4329,15.0,268,15763,16031,102,799,21086,6092,14994,21086,1614,0.012709854880015177,0.7475576211704449,0.004837332827468462,0.288912074362136,0.7110879256378639,0.03789244048183629
4330,16.0,645,7064,7709,51,939,11336,2745,8591,11336,624,0.056898376852505296,0.6231474947071277,0.00449894142554693,0.24214890613973183,0.7578510938602682,0.082833450952717
4331,15.0,64,6356,6420,12,286,8419,2500,5919,8419,717,0.007601852951656966,0.7549590212614324,0.0014253474284356812,0.2969473809241002,0.7030526190758998,0.03397078037771707
4332,25.0,21,2163,2184,6,94,2944,836,2108,2944,254,0.007133152173913043,0.7347146739130435,0.0020380434782608695,0.28396739130434784,0.7160326086956522,0.03192934782608696
4333,34.0,3269,61832,65101,275,3422,88654,24674,63980,88654,6265,0.036873688722449074,0.6974530196043044,0.0031019468946691634,0.278317955196607,0.7216820448033929,0.0385994991765741
4334,15.0,608,12104,12712,143,940,17349,4891,12458,17349,1155,0.035045247564701135,0.6976770995446423,0.00824255000288201,0.2819182661824889,0.7180817338175111,0.054181797221741886
4335,,150,3184,3334,20,182,4540,1253,3287,4540,323,0.03303964757709251,0.7013215859030837,0.004405286343612335,0.27599118942731277,0.7240088105726872,0.04008810572687225
4336,36.0,88,2066,2154,20,116,2879,820,2059,2879,226,0.0305661688086141,0.7176102813476901,0.0069468565474122956,0.2848211184439041,0.7151788815560959,0.040291767974991316
4337,24.0,7881,189287,197168,1023,8435,259110,75817,183293,259110,18690,0.03041565358342017,0.7305275751611284,0.003948130137779321,0.29260545714175445,0.7073945428582455,0.03255374165412373
4338,,335,6847,7182,13,292,9791,2771,7020,9791,824,0.034215095495863546,0.6993156980900828,0.0013277499744663466,0.2830150137881728,0.7169849862118272,0.029823307118782557
4339,16.0,60603,1028452,1089055,3658,75118,1491490,413936,1077555,1491491,104510,0.040632494597687814,0.6895462325954363,0.0024525793316888937,0.27753167803225093,0.722468321967749,0.05036436693215045
4340,,762,18827,19589,22,1348,26587,7403,19184,26587,1844,0.02866062361304397,0.708128032497085,0.0008274720728175424,0.278444352503103,0.7215556474968969,0.050701470643547596
4341,,1868,39583,41451,120,2454,55266,15780,39486,55266,4192,0.03380016646762928,0.7162269749936669,0.0021713169037020953,0.2855281728368255,0.7144718271631745,0.04440343068070785
4342,,129,1572,1701,5,109,2293,631,1662,2293,136,0.05625817706061927,0.6855647623201047,0.002180549498473615,0.27518534670737027,0.7248146532926297,0.04753597906672481
4343,16.0,479,12089,12568,73,949,17327,4739,12588,17327,1365,0.027644716338662202,0.6976972355283662,0.004213077855370231,0.2735037802273908,0.7264962197726093,0.05477001211981301
4344,27.0,44,12195,12239,72,165,16140,4566,11574,16140,1609,0.0027261462205700124,0.7555762081784386,0.0044609665427509295,0.2828996282527881,0.7171003717472119,0.010223048327137546
4345,23.0,149,3998,4147,0,191,5516,1571,3945,5516,418,0.027012327773749095,0.7248005801305294,0.0,0.28480783176214647,0.7151921682378535,0.03462654097171863
4346,,91,2519,2610,30,94,3573,1016,2557,3573,364,0.025468793730758468,0.7050097956898964,0.008396305625524769,0.2843548838511055,0.7156451161488945,0.026308424293310942
4347,42.0,161,8777,8938,8,448,11619,3408,8211,11619,990,0.013856614166451502,0.7554006368878561,0.0006885274119975902,0.2933126775109734,0.7066873224890265,0.038557535071865046
4348,17.0,2408,44328,46736,146,3016,64911,17943,46968,64911,4722,0.0370969481289766,0.6829042843277718,0.0022492335659595446,0.27642464297268565,0.7235753570273143,0.04646361941735607
4349,,473,6662,7135,88,502,9725,2753,6972,9725,646,0.048637532133676095,0.6850385604113111,0.009048843187660669,0.28308483290488434,0.7169151670951157,0.05161953727506427
4350,41.0,84,4169,4253,6,108,5432,1607,3825,5432,452,0.015463917525773196,0.7674889543446245,0.0011045655375552283,0.295839469808542,0.7041605301914581,0.019882179675994108
4351,17.0,608,17822,18430,98,1111,25413,7089,18324,25413,1672,0.02392476291661748,0.7012946129933498,0.003856294022744265,0.27895171762483767,0.7210482823751623,0.04371778223743753
4352,23.0,3598,89828,93426,139,4670,124117,35742,88375,124117,9843,0.02898877671874119,0.723736474455554,0.0011199110516689897,0.28797022164570524,0.7120297783542947,0.03762578857046174
4353,26.0,82,4858,4940,13,112,6243,1864,4379,6243,452,0.013134710876181323,0.7781515297132788,0.0020823322120775267,0.2985744033317315,0.7014255966682684,0.01794009290405254
4354,26.0,478,7190,7668,13,385,10343,2947,7396,10343,777,0.04621483128686068,0.6951561442521512,0.0012568887170066711,0.28492700377066615,0.7150729962293338,0.037223242772889874
4355,23.0,69,1694,1763,6,74,2290,680,1610,2290,157,0.030131004366812226,0.7397379912663755,0.0026200873362445414,0.29694323144104806,0.7030567685589519,0.032314410480349345
4356,23.0,357,15908,16265,11,993,21487,5902,15585,21487,1688,0.01661469725880765,0.7403546330339275,0.0005119374505514962,0.2746777121049937,0.7253222878950063,0.04621398985433053
4357,,217,6663,6880,20,191,8747,2657,6090,8747,683,0.024808505773408027,0.7617468846461644,0.002286498227963873,0.3037612895850006,0.6962387104149994,0.02183605807705499
4358,,854,23120,23974,128,1345,32239,9480,22759,32239,2497,0.026489655386333324,0.7171438320047148,0.003970346474766587,0.2940537857874004,0.7059462142125996,0.04171965631688328
4359,,1098,31986,33084,53,1445,43030,12510,30520,43030,3296,0.025517081106204972,0.7433418545201023,0.0012316988147803858,0.2907273994887288,0.7092726005112712,0.03358122240297467
4360,,444,20102,20546,68,750,26423,7969,18454,26423,2168,0.016803542368391173,0.7607765961472959,0.0025735154978617112,0.30159330885970553,0.6984066911402944,0.028384362108768876
4361,17.0,12,1886,1898,0,48,2477,721,1756,2477,264,0.004844570044408559,0.7614049253128785,0.0,0.2910779168348809,0.7089220831651191,0.019378280177634235
4362,24.0,2919,82772,85691,467,5305,114812,32651,82161,114812,8416,0.02542417168937045,0.7209350938926244,0.0040675190746611856,0.28438664947914855,0.7156133505208515,0.04620597150123681
4363,24.0,677,22715,23392,101,648,30104,9020,21084,30104,2454,0.02248870581982461,0.7545508902471433,0.0033550358756311454,0.2996279564177518,0.7003720435822482,0.021525378687217645
4364,23.0,142,3599,3741,11,256,4870,1329,3541,4870,263,0.02915811088295688,0.7390143737166325,0.0022587268993839835,0.2728952772073922,0.7271047227926078,0.052566735112936344
4365,23.0,193,6594,6787,3,355,8870,2483,6387,8870,730,0.021758737316798196,0.7434047350620068,0.0003382187147688839,0.2799323562570462,0.7200676437429537,0.040022547914317926
4366,,157,3303,3460,18,255,4749,1315,3434,4749,375,0.033059591492945885,0.6955148452305748,0.003790271636133923,0.2769004000842283,0.7230995999157718,0.05369551484523057
4367,,353,11545,11898,41,579,15943,4450,11493,15943,1147,0.02214137866148153,0.7241422567898137,0.0025716615442513955,0.27911936272972465,0.7208806372702754,0.03631687888101361
4368,26.0,564,21079,21643,30,1036,28560,8369,20191,28560,2149,0.019747899159663865,0.7380602240896359,0.0010504201680672268,0.2930322128851541,0.706967787114846,0.03627450980392157
4369,41.0,211,4656,4867,7,274,6451,1914,4537,6451,493,0.03270810727019067,0.7217485661137808,0.0010851030847930554,0.2966981863277011,0.7033018136722988,0.04247403503332817
4370,,540,10180,10720,198,594,14289,4031,10258,14289,881,0.037791307999160195,0.7124361396878718,0.013856812933025405,0.2821051158233606,0.7178948841766394,0.04157043879907621
4371,,385,5197,5582,29,455,7712,2128,5584,7712,511,0.049922199170124484,0.6738848547717843,0.0037603734439834026,0.27593360995850624,0.7240663900414938,0.05899896265560166
4372,,59,1653,1712,2,96,2285,644,1641,2285,188,0.025820568927789934,0.7234135667396061,0.00087527352297593,0.2818380743982494,0.7181619256017505,0.04201312910284464
4373,13.0,769,9836,10605,57,629,13839,3857,9982,13839,677,0.055567598814943275,0.7107449960257244,0.004118794710600477,0.27870510875063226,0.7212948912493677,0.04545126092925789
4374,14.0,305,4822,5127,34,309,7019,1909,5110,7019,548,0.04345348340219404,0.6869924490668187,0.0048439948710642545,0.27197606496651944,0.7280239350334805,0.04402336515173102
4375,33.0,310,4382,4692,3,214,6106,1820,4286,6106,475,0.050769734687192924,0.7176547658041271,0.000491320013101867,0.29806747461513267,0.7019325253848674,0.03504749426793318
4376,23.0,219,7276,7495,22,331,10030,2907,7123,10030,693,0.021834496510468593,0.7254237288135593,0.002193419740777667,0.28983050847457625,0.7101694915254237,0.03300099700897308
4377,,120,2140,2260,6,76,2943,858,2086,2944,196,0.04076086956521739,0.7269021739130435,0.0020380434782608695,0.2914402173913043,0.7085597826086957,0.025815217391304348
4378,23.0,1176,32530,33706,284,2082,44816,12365,32463,44828,2484,0.02623360399750156,0.7256625323458553,0.006335326135451057,0.27583206924243775,0.7241679307575623,0.04644418666904613
4379,24.0,16539,417691,434230,871,18331,563585,165560,398032,563592,38731,0.029345696887109824,0.7411230109724766,0.0015454442220613493,0.29375860551604704,0.706241394483953,0.03252530199151159
4380,,0,1425,1425,21,349,2151,546,1605,2151,105,0.0,0.6624825662482566,0.009762900976290097,0.25383542538354253,0.7461645746164575,0.16225011622501162
4381,13.0,3017,87970,90987,472,3267,122015,34617,87406,122023,9656,0.024724846955082237,0.7209296608016521,0.0038681232226711357,0.2836924186423871,0.7163075813576129,0.026773641034886865
4382,,353,8012,8365,8,561,11288,3261,8027,11288,756,0.03127214741318214,0.7097802976612332,0.0007087172218284905,0.2888908575478384,0.7111091424521616,0.04969879518072289
4383,27.0,106,1711,1817,11,125,2506,698,1808,2506,172,0.04229848363926576,0.6827613727055067,0.004389465283320032,0.2785315243415802,0.7214684756584198,0.04988028731045491
4384,15.0,149,3260,3409,0,125,4864,1397,3467,4864,308,0.030633223684210526,0.6702302631578947,0.0,0.2872121710526316,0.7127878289473685,0.025699013157894735
4385,17.0,433,7258,7691,33,565,10240,2910,7330,10240,682,0.04228515625,0.7087890625,0.00322265625,0.2841796875,0.7158203125,0.05517578125
4386,,387,7865,8252,41,324,10920,3135,7785,10920,691,0.03543956043956044,0.7202380952380952,0.0037545787545787547,0.28708791208791207,0.7129120879120879,0.02967032967032967
4387,26.0,6603,138135,144738,746,10293,197912,54270,143642,197912,13181,0.033363312987590446,0.6979617203605643,0.003769352035247989,0.274212781438215,0.7257872185617851,0.052007963135130765
4388,23.0,275,8862,9137,156,449,12221,3565,8656,12221,1096,0.022502250225022502,0.725145241796907,0.012764912854921855,0.29171098928074624,0.7082890107192538,0.03674003764012765
4389,16.0,2024,40311,42335,212,1787,56756,16248,40508,56756,4590,0.03566142786665727,0.7102508985834097,0.0037352878990767496,0.2862781027556558,0.7137218972443442,0.03148565790401015
4390,,1920,31318,33238,119,2187,44567,12738,31829,44567,3453,0.04308120358112505,0.702717257163372,0.002670137096955146,0.28581686000852646,0.7141831399914735,0.04907218345412525
4391,23.0,1148,21529,22932,162,923,30367,8771,21596,30367,2308,0.037804195343629596,0.7089603846280502,0.005334738367306616,0.2888332729607798,0.7111667270392202,0.030394836500148188
4392,25.0,271,22762,23033,157,1996,32019,8605,23414,32019,2510,0.008463724663481059,0.7108904088197633,0.004903338642680909,0.2687466816577657,0.7312533183422343,0.06233798682032543
4393,13.0,2906,17842,20748,90,1915,28349,7748,20601,28349,1809,0.1025080249744259,0.6293696426681717,0.0031747151575011465,0.2733077004479876,0.7266922995520124,0.06755088362905218
4394,17.0,731,8100,8831,21,334,11775,3342,8433,11775,894,0.06208067940552017,0.6878980891719745,0.0017834394904458599,0.28382165605095544,0.7161783439490446,0.028365180467091296
4395,,93,2173,2266,4,134,3505,845,2660,3505,208,0.02653352353780314,0.6199714693295293,0.0011412268188302425,0.24108416547788872,0.7589158345221113,0.038231098430813126
4396,,954,21742,22696,105,1120,30501,8701,21800,30501,2630,0.03127766302744173,0.7128290875708994,0.0034425100816366677,0.2852693354316252,0.7147306645683749,0.03672010753745779
4397,17.0,1474,7874,9348,151,913,14043,3666,10377,14043,417,0.10496332692444635,0.5607064017660044,0.010752688172043012,0.26105533005768,0.73894466994232,0.06501459802036602
4398,24.0,64,1758,1822,2,48,2393,658,1735,2393,180,0.026744671959882994,0.734642707898036,0.0008357709987463436,0.274968658587547,0.725031341412453,0.020058503969912243
4399,,436,9244,9680,92,1289,13980,3477,10503,13980,856,0.03118741058655222,0.6612303290414878,0.006580829756795422,0.24871244635193132,0.7512875536480687,0.09220314735336195
4400,14.0,692,7357,8049,25,604,10767,3039,7728,10767,685,0.06427045602303334,0.6832915389616421,0.0023219095384043836,0.2822513234884369,0.7177486765115632,0.05609733444784991
4401,14.0,101,2681,2782,5,128,3691,1088,2603,3691,283,0.027363858033053374,0.7263614196694663,0.00135464643727987,0.2947710647520997,0.7052289352479003,0.03467894879436467
4402,24.0,262,4181,4443,10,299,5943,1674,4269,5943,365,0.04408547871445398,0.7035167423860004,0.0016826518593303045,0.281675921251893,0.718324078748107,0.050311290593976106
4403,17.0,111,12408,12519,100,870,17465,4674,12791,17465,1340,0.0063555682794159745,0.71044947036931,0.005725737188663041,0.2676209561981105,0.7323790438018895,0.04981391354136845
4404,14.0,147,2266,2413,19,205,3620,888,2732,3620,218,0.04060773480662983,0.6259668508287293,0.005248618784530387,0.24530386740331492,0.7546961325966851,0.05662983425414365
4405,23.0,508,14231,14739,11,642,19197,5519,13678,19197,1529,0.026462468093973016,0.7413137469396259,0.0005730061988852425,0.2874928374225139,0.712507162577486,0.03344272542584779
4406,27.0,2245,74388,76633,216,2673,97886,29467,68419,97886,6747,0.022934842571971478,0.7599452424248616,0.002206648550354494,0.30103385570970315,0.6989661442902969,0.027307275810636862
4407,17.0,71,2743,2814,11,295,4051,1073,2978,4051,313,0.017526536657615402,0.6771167612935077,0.0027153789187854853,0.26487287089607503,0.735127129103925,0.0728215255492471
4408,,3227,61955,65182,215,6587,89396,24622,64774,89396,6041,0.03609781198263905,0.6930399570450579,0.0024050293077990067,0.27542619356570763,0.7245738064342924,0.07368338628126538
4409,16.0,176,4662,4838,19,333,6456,1821,4635,6456,500,0.027261462205700124,0.7221189591078067,0.002942998760842627,0.2820631970260223,0.7179368029739777,0.05157992565055762
4410,,1683,43061,44744,164,2612,59846,17103,42743,59846,4182,0.0281221802626742,0.7195301273268054,0.0027403669418173313,0.28578351101159644,0.7142164889884036,0.043645356414797984
4411,23.0,245,7901,8146,25,533,11190,3105,8085,11190,829,0.021894548704200177,0.706076854334227,0.002234137622877569,0.2774798927613941,0.7225201072386059,0.047631814119749774
4412,,59,1686,1745,4,104,2451,645,1806,2451,189,0.024071807425540596,0.6878824969400245,0.0016319869441044472,0.2631578947368421,0.7368421052631579,0.04243166054671563
4413,,77,1707,1784,10,93,2399,672,1727,2399,191,0.032096706961233845,0.7115464776990412,0.004168403501458941,0.28011671529804083,0.7198832847019592,0.038766152563568156
4414,,447,9445,9892,24,669,13315,3692,9623,13315,906,0.033571160345475026,0.7093503567405182,0.0018024784078107398,0.2772812617348855,0.7227187382651146,0.05024408561772437
4415,17.0,373,13610,17369,203,1132,23634,5299,18335,23634,1353,0.01578234746551578,0.5758652788355758,0.00858932047050859,0.2242108826267242,0.7757891173732758,0.047897097402047895
4416,24.0,10066,19325,29391,107,1247,39646,11277,28369,39646,2230,0.2538969883468698,0.48743883367805074,0.002698885133430863,0.2844423144831761,0.7155576855168239,0.031453362255965296
4417,26.0,207,5117,5324,38,360,7198,2006,5192,7198,568,0.028757988330091692,0.7108919144206725,0.005279244234509586,0.2786885245901639,0.7213114754098361,0.05001389274798555
4418,14.0,104,20350,20454,60,1398,27257,7637,19620,27257,2249,0.003815533624390065,0.7465972043878637,0.002201269398686576,0.2801849066294897,0.7198150933705103,0.05128957698939722
4419,,868,14537,15405,210,653,20123,5931,14192,20123,1508,0.04313472146300253,0.7224071957461611,0.010435819708790936,0.2947373652039954,0.7052626347960046,0.032450429856383245
4420,,1653,35707,37360,146,1807,49584,14136,35448,49584,3406,0.03333736689254598,0.7201314940303324,0.0029444982252339463,0.2850919651500484,0.7149080348499516,0.0364432074862859
4421,,544,3145,3689,14,489,5186,1488,3698,5186,256,0.10489780177400694,0.6064404165059777,0.002699575780948708,0.2869263401465484,0.7130736598534516,0.09429232549170845
4422,17.0,72,2542,2614,20,145,3522,1006,2516,3522,293,0.020442930153321975,0.7217490062464509,0.0056785917092561046,0.28563316297558206,0.7143668370244179,0.041169789892106755
4423,,458,15519,15977,29,578,20895,6094,14801,20895,1634,0.02191911940655659,0.742713567839196,0.0013878918401531467,0.2916487197894233,0.7083512802105767,0.027662120124431682
4424,24.0,99,3514,3613,11,107,4576,1393,3183,4576,300,0.021634615384615384,0.7679195804195804,0.002403846153846154,0.3044143356643357,0.6955856643356644,0.023382867132867132
4425,,710,16866,17576,223,976,23181,6688,16493,23181,1693,0.030628531987403475,0.7275786204218972,0.009619947370691514,0.28851214356585136,0.7114878564341487,0.04210344678831802
4426,,442,13721,14163,76,612,18936,5260,13676,18936,1504,0.02334178284748627,0.7245986480777356,0.004013519222644698,0.2777777777777778,0.7222222222222222,0.03231939163498099
4427,36.0,319,7273,7592,25,424,10089,2950,7139,10089,784,0.03161859450887105,0.7208841312320349,0.0024779462781246903,0.29239766081871343,0.7076023391812866,0.042025968876994745
4428,,205,5088,5293,46,210,7085,1973,5112,7085,465,0.02893436838390967,0.7181369089625971,0.006492589978828511,0.2784756527875794,0.7215243472124206,0.029640084685956247
4429,24.0,159,5073,5232,24,318,7213,2013,5200,7213,542,0.02204353251074449,0.7033134618050741,0.003327325661999168,0.27907943990018025,0.7209205600998198,0.04408706502148898
4430,,487,14968,15455,27,611,20448,5894,14554,20448,1738,0.023816510172143975,0.7320031298904538,0.0013204225352112676,0.2882433489827856,0.7117566510172144,0.029880672926447575
4431,,1479,41336,42815,139,1780,55907,16277,39630,55907,4258,0.02645464789740104,0.7393707406943675,0.0024862718443128765,0.2911442216538179,0.7088557783461821,0.03183858908544547
4432,26.0,1594,24378,25972,195,1265,34045,9851,24194,34045,2366,0.04682038478484359,0.716052283742106,0.005727713320605081,0.28935232780143927,0.7106476721985607,0.03715670436187399
4433,,63,2080,2143,9,254,3029,800,2229,3029,231,0.02079894354572466,0.6866952789699571,0.0029712776493892373,0.26411356883459886,0.7358864311654011,0.08385605810498514
4434,,1553,23915,25468,77,1671,34698,9872,24826,34698,2194,0.044757622917747424,0.6892328088074241,0.002219148077699003,0.28451207562395525,0.7154879243760447,0.04815839529655888
4435,15.0,4997,70373,75370,517,4465,102564,28624,73940,102564,7678,0.04872079872079872,0.6861374361374362,0.005040755040755041,0.2790842790842791,0.7209157209157209,0.04353379353379353
4436,24.0,279,1730,2072,5,276,2990,718,2275,2993,146,0.09321750751754093,0.5780153691947878,0.001670564650851988,0.23989308386234548,0.7601069161376546,0.09221516872702974
4437,,182,4852,5034,33,260,6781,1898,4883,6781,468,0.026839699159416017,0.7155286830850907,0.004866538858575431,0.27989971980533845,0.7201002801946615,0.03834242737059431
4438,,219,26078,26297,79,1272,35194,10143,25051,35194,2907,0.006222651588338921,0.7409785758936183,0.0022447008012729443,0.28820253452293004,0.7117974654770699,0.036142524293913736
4439,17.0,1511,23006,24517,36,2151,33570,9563,24007,33570,1645,0.04501042597557343,0.6853142686922847,0.0010723860589812334,0.2848674411677093,0.7151325588322908,0.06407506702412868
4440,37.0,449,15946,16395,12,253,21442,6168,15274,21442,1573,0.020940210801231228,0.7436806268072008,0.0005596492864471598,0.28765973323384014,0.7123402667661599,0.011799272455927618
4441,,315,3136,3451,79,275,4957,1306,3651,4957,272,0.06354649989913254,0.6326407101069195,0.015937058704861812,0.26346580593100666,0.7365341940689933,0.05547710308654428
4442,27.0,1351,31148,32499,61,1470,43352,12335,31017,43352,2878,0.0311634988005167,0.71849049640155,0.0014070861782616718,0.28453127883373314,0.7154687211662668,0.033908470197453404
4443,,2307,41247,43554,114,2383,57077,16751,40326,57077,3793,0.040419082993149606,0.7226553603027489,0.001997301890428719,0.2934807365488726,0.7065192634511275,0.04175061758676875
4444,23.0,506,13753,14259,183,866,19829,5448,14381,19829,1410,0.02551818044278582,0.6935801099399869,0.009228907156185386,0.27474910484643705,0.725250895153563,0.04367340763528166
4445,17.0,77,2006,2083,9,225,2939,769,2170,2939,192,0.026199387546784622,0.6825450833616876,0.003062266076896904,0.26165362368152434,0.7383463763184757,0.07655665192242259
4446,36.0,163,2978,3141,9,147,4436,1170,3266,4436,282,0.03674481514878269,0.6713255184851218,0.0020288548241659153,0.263751127141569,0.736248872858431,0.033137962128043284
4447,26.0,446,10052,10498,56,568,14029,4007,10022,14029,1087,0.0317912894718084,0.7165157887233587,0.003991731413500606,0.285622638819588,0.714377361180412,0.04048756147979186
4448,14.0,214,3191,3405,10,206,4578,1308,3270,4578,334,0.04674530362603757,0.6970292704237658,0.00218435998252512,0.2857142857142857,0.7142857142857143,0.04499781564001747
4449,13.0,27,1620,1647,1,119,2363,612,1751,2363,184,0.011426153195090986,0.6855691917054592,0.00042319085907744394,0.2589928057553957,0.7410071942446043,0.050359712230215826
4450,37.0,133,4118,4251,11,161,5513,1664,3849,5513,442,0.024124795936876473,0.7469617268274986,0.0019952838744785053,0.30183203337565756,0.6981679666243424,0.02920370034463994
4451,,877,18638,19515,63,1128,26653,7446,19207,26653,1917,0.032904363486286725,0.699283382733651,0.002363711402093573,0.2793681761902975,0.7206318238097025,0.042321689866056354
4452,26.0,1125,34760,35885,75,1581,46669,13656,33013,46669,3798,0.024105937560264842,0.7448199018620497,0.0016070625040176562,0.29261394073153485,0.7073860592684651,0.0338768775846922
4453,,7893,55645,63538,758,7387,90353,23542,66811,90353,6012,0.0873573650017155,0.6158622292563611,0.008389317454871448,0.26055581995063803,0.739444180049362,0.08175710823104933
4454,17.0,714,11642,12356,94,705,16343,4628,11715,16343,1175,0.043688429296946704,0.7123539129902711,0.005751697974668054,0.28317934283791224,0.7168206571620878,0.0431377348100104
4455,,421,13143,13564,227,1466,19196,4653,14543,19196,1143,0.02193165242758908,0.6846738903938321,0.011825380287559908,0.24239424880183372,0.7576057511981663,0.07637007709939571
4456,35.0,307,4198,4505,13,463,6590,1654,4936,6590,382,0.04658573596358118,0.6370257966616085,0.0019726858877086493,0.2509863429438543,0.7490136570561456,0.07025796661608498
4457,,114,12298,12412,43,366,17253,4790,12463,17253,1714,0.0066075465136498,0.7128035703935548,0.0024923201762012404,0.27763287544195214,0.7223671245580479,0.021213701964875674
4458,,51,1729,1780,9,63,2379,664,1715,2379,159,0.021437578814627996,0.726775956284153,0.0037831021437578815,0.2791088692728037,0.7208911307271963,0.02648171500630517
4459,,114,21898,22012,205,2178,31101,8363,22738,31101,2306,0.003665476994308865,0.7040931159769782,0.0065914279283624325,0.2688981061702196,0.7311018938297804,0.07002990257547989
4460,17.0,107,2356,2463,35,126,3542,908,2634,3542,181,0.03020892151326934,0.6651609260304913,0.009881422924901186,0.256352343308865,0.743647656691135,0.03557312252964427
4461,16.0,916,15744,16660,8,996,22250,6295,15955,22250,1717,0.0411685393258427,0.7075955056179776,0.00035955056179775283,0.28292134831460675,0.7170786516853933,0.044764044943820226
4462,16.0,710,15891,16601,22,485,22118,6252,15866,22118,1716,0.03210055158694276,0.7184645989691654,0.0009946649787503392,0.2826657021430509,0.7173342978569491,0.02192784157699611
4463,33.0,229,4786,5015,76,149,6508,1872,4636,6508,455,0.035187461585740626,0.7354025814382299,0.011677934849416103,0.2876459741856177,0.7123540258143823,0.022894898586355256
4464,26.0,559,7083,7642,158,459,10169,2751,7418,10169,512,0.05497099026452945,0.6965286655521683,0.01553741764185269,0.2705280755236503,0.7294719244763497,0.04513718163044547
4465,,234,2469,2707,42,821,4448,1016,3432,4448,165,0.05260791366906475,0.5550809352517986,0.009442446043165468,0.22841726618705036,0.7715827338129496,0.1845773381294964
4466,24.0,155,3917,4072,38,171,5372,1584,3788,5372,365,0.02885331347728965,0.7291511541325391,0.007073715562174236,0.29486224869694716,0.7051377513030529,0.031831720029784065
4467,,624,8147,8771,19,540,11947,3206,8741,11947,788,0.05223068552774755,0.681928517619486,0.0015903574119025697,0.2683518875031389,0.7316481124968611,0.045199631706704615
4468,14.0,26,1487,1513,3,42,2071,573,1498,2071,185,0.012554321583775953,0.718010622887494,0.0014485755673587638,0.2766779333655239,0.7233220666344761,0.020280057943022695
4469,17.0,759,15307,16066,141,1769,24857,5955,18902,24857,1341,0.030534658245162327,0.6158023896689061,0.005672446393370077,0.23957034235828942,0.7604296576417106,0.07116707567284869
4470,,729,7974,8703,28,578,11830,3317,8513,11830,805,0.06162299239222316,0.6740490278951817,0.002366863905325444,0.28038884192730346,0.7196111580726965,0.04885883347421809
4471,,17,2544,2567,19,211,3572,947,2625,3572,214,0.004759238521836506,0.7122060470324748,0.005319148936170213,0.26511758118701007,0.7348824188129899,0.059070548712206045
4472,16.0,742,12698,13440,35,721,18307,5111,13196,18307,1292,0.04053094444747911,0.6936144644125198,0.0019118370022395805,0.27918282624132845,0.7208171737586715,0.03938384224613536
4473,14.0,418,10355,10773,25,309,14753,4217,10536,14753,1270,0.02833322036196028,0.7018911407849251,0.0016945705958110215,0.2858401681014031,0.7141598318985969,0.020944892564224226
4474,16.0,55,1450,1505,6,78,2121,571,1550,2121,156,0.02593116454502593,0.6836397925506836,0.002828854314002829,0.2692126355492692,0.7307873644507308,0.036775106082036775
4475,,340,12278,12618,5,462,16500,4876,11624,16500,1462,0.020606060606060607,0.7441212121212121,0.00030303030303030303,0.2955151515151515,0.7044848484848485,0.028
4476,15.0,190,2648,2838,10,832,4650,1065,3585,4650,361,0.04086021505376344,0.5694623655913978,0.002150537634408602,0.22903225806451613,0.7709677419354839,0.1789247311827957
4477,24.0,748,37597,38345,140,2796,51834,14474,37360,51834,3875,0.014430682563568314,0.7253347223829919,0.002700929891576957,0.27923756607632055,0.7207624339236794,0.053941428406065514
4478,26.0,681,23418,24099,38,790,30709,9179,21530,30709,2331,0.02217590934253802,0.762577745937673,0.001237422254062327,0.2989026018431079,0.7010973981568921,0.02572535738708522
4479,42.0,309,8600,8909,23,415,11735,3472,8263,11735,1069,0.026331487004686835,0.7328504473796336,0.00195994887089902,0.2958670643374521,0.704132935662548,0.035364294844482315
4480,,205,3536,3741,23,227,5025,1425,3600,5025,349,0.04079601990049751,0.703681592039801,0.004577114427860697,0.2835820895522388,0.7164179104477612,0.04517412935323383
4481,,467,12247,12714,103,532,16420,4931,11489,16420,1172,0.028440925700365407,0.7458587088915957,0.006272838002436053,0.3003045066991474,0.6996954933008526,0.03239951278928136
4482,14.0,142,7969,8111,7,1346,11650,3069,8581,11650,598,0.012188841201716738,0.6840343347639485,0.0006008583690987124,0.26343347639484976,0.7365665236051502,0.11553648068669528
4483,27.0,51,3073,3124,0,113,3976,1255,2721,3976,318,0.012826961770623743,0.772887323943662,0.0,0.31564386317907445,0.6843561368209256,0.028420523138832997
4484,15.0,184,4143,4327,17,203,5874,1625,4249,5874,457,0.03132448076268301,0.7053115423901941,0.0028941096356826694,0.2766428328226081,0.7233571671773918,0.03455907388491658
4485,14.0,279,3242,3521,4,359,4922,1308,3614,4922,341,0.05668427468508736,0.6586753352295814,0.0008126777732629012,0.2657456318569687,0.7342543681430312,0.07293783015034538
4486,,923,15250,16173,123,1294,22732,6310,16422,22732,1442,0.04060355446067218,0.670860461024107,0.005410874538096076,0.27758226288931903,0.722417737110681,0.05692415977476685
4487,15.0,4622,73939,78561,642,4308,107622,29981,77641,107622,7733,0.04294660942929884,0.6870249577223988,0.0059653230752076715,0.2785768709000019,0.7214231290999982,0.04002899035513185
4488,27.0,329,8708,9037,38,297,12019,3464,8555,12019,1145,0.027373325567850902,0.7245195107746069,0.0031616607038855147,0.28821033363840587,0.7117896663615941,0.024710874448789416
4489,36.0,799,13412,14211,74,847,19011,5372,13639,19011,1343,0.04202829940560728,0.7054862974067645,0.0038924832991426017,0.28257324706748727,0.7174267529325128,0.04455315343748356
4490,23.0,4041,91553,95594,260,6553,129715,36609,93106,129715,10759,0.031152912153567438,0.7058011795089234,0.0020043942489303473,0.2822264194580426,0.7177735805419574,0.05051844428169448
4491,16.0,153,1959,2112,16,162,2918,806,2112,2918,180,0.05243317340644277,0.6713502398903358,0.0054832076764907475,0.2762165867032214,0.7237834132967786,0.055517477724468814
4492,17.0,339,16285,16624,16,782,21839,6216,15623,21839,1694,0.015522688767800724,0.7456843262054124,0.0007326342781262879,0.2846284170520628,0.7153715829479371,0.03580750034342232
4493,16.0,145,5599,5744,16,602,7938,2161,5777,7938,513,0.018266565885613505,0.7053413958175863,0.002015621063240111,0.2722348198538675,0.7277651801461326,0.07583774250440917
4494,15.0,122,2429,2551,25,173,3571,949,2622,3571,232,0.03416409969196304,0.6802016241949034,0.007000840100812098,0.2657518902268272,0.7342481097731728,0.048445813497619714
4495,,83,1580,1663,8,149,2430,627,1803,2430,163,0.034156378600823045,0.6502057613168725,0.0032921810699588477,0.2580246913580247,0.7419753086419754,0.06131687242798354
4496,,505,10793,11298,68,603,16340,4225,12115,16340,1164,0.03090575275397797,0.6605263157894737,0.00416156670746634,0.25856793145654833,0.7414320685434517,0.03690330477356181
4497,,176,3813,3989,1,267,5305,1541,3764,5305,381,0.033176248821866164,0.71875589066918,0.00018850141376060322,0.2904806786050895,0.7095193213949105,0.050329877474081054
4498,26.0,155,3542,3697,19,150,5034,1423,3611,5034,433,0.03079062375844259,0.7036154151767978,0.0037743345252284465,0.28267779102105683,0.7173222089789432,0.029797377830750895
4499,39.0,163,3559,3722,11,161,5071,1424,3647,5071,351,0.032143561427726286,0.7018339577992506,0.0021691973969631237,0.28081246302504437,0.7191875369749556,0.03174916190100572
4500,24.0,142,4253,4395,23,129,5710,1709,4001,5710,477,0.024868651488616462,0.7448336252189142,0.004028021015761821,0.29929947460595446,0.7007005253940455,0.022591943957968475
4501,17.0,241,14671,14912,103,586,20251,5608,14643,20251,2023,0.011900646881635476,0.7244580514542491,0.005086168584267444,0.2769245963162313,0.7230754036837687,0.028936842625055553
4502,24.0,239,5610,5849,2,262,7775,2256,5519,7775,573,0.030739549839228296,0.7215434083601286,0.0002572347266881029,0.2901607717041801,0.7098392282958199,0.03369774919614148
4503,,986,25997,26983,0,1165,36009,10053,25956,36009,2465,0.02738204337804438,0.7219583992890666,0.0,0.27918020494876283,0.7208197950512372,0.03235302285539726
4504,25.0,274,6972,7246,38,481,9826,2662,7164,9826,655,0.02788520252391614,0.7095461021778954,0.0038672908609810705,0.2709139018929371,0.7290860981070629,0.04895176063504987
4505,36.0,1137,23426,24563,1034,1988,34741,9143,25598,34741,2416,0.032727900751273714,0.6743041363230765,0.02976310411329553,0.26317607437897583,0.7368239256210242,0.05722345355631674
4506,33.0,1352,33801,35153,85,1613,45714,13355,32360,45715,3166,0.029574537897845345,0.7393853221043422,0.001859345947719567,0.29213606037405665,0.7078639396259433,0.03528382369025484
4507,23.0,273,5895,6168,118,1153,9269,1762,7507,9269,413,0.029453015427769985,0.6359909375337145,0.012730607401014133,0.19009601898802458,0.8099039810119754,0.12439313841838386
4508,26.0,74,1476,1550,7,76,2159,587,1572,2159,190,0.03427512737378416,0.6836498378879111,0.003242241778601204,0.27188513200555814,0.7281148679944419,0.03520148216767022
4509,33.0,2160,45503,47663,391,2876,63908,17875,46033,63908,2061,0.03379858546660825,0.7120078863366088,0.0061181698691869565,0.27969894222945485,0.7203010577705452,0.04500219064905802
4510,27.0,928,4696,5624,80,203,7601,2209,5392,7601,632,0.12208919878963294,0.6178134455992632,0.010524930930140772,0.290619655308512,0.7093803446914879,0.026707012235232207
4511,17.0,45,1342,1387,1,101,1868,516,1352,1868,141,0.024089935760171308,0.7184154175588865,0.0005353319057815846,0.2762312633832976,0.7237687366167024,0.05406852248394004
4512,17.0,646,14187,14833,19,999,20010,5471,14539,20010,1542,0.03228385807096452,0.7089955022488755,0.0009495252373813094,0.2734132933533233,0.7265867066466767,0.04992503748125937
4513,,2909,49062,51971,356,5582,71226,20037,51189,71226,3929,0.040841827422570406,0.6888214977676691,0.004998174823800297,0.2813158116418162,0.7186841883581838,0.078370258051835
4514,35.0,2059,61097,63156,288,2542,83211,23796,59415,83211,6045,0.024744324668613524,0.7342418670608453,0.003461080866712334,0.2859718066121066,0.7140281933878935,0.030548845705495667
4515,,779,10133,10912,170,380,14843,4202,10641,14843,718,0.052482651755036046,0.682678703766085,0.011453210267466145,0.283096409081722,0.7169035909182779,0.02560129353904197
4516,16.0,122,3168,3290,4,166,4471,1216,3255,4471,341,0.027286960411541043,0.7085663162603444,0.0008946544397226571,0.27197494967568775,0.7280250503243122,0.03712815924849027
4517,,143,3971,4114,22,234,5507,1547,3960,5507,391,0.0259669511530779,0.7210822589431632,0.003994915562011985,0.28091519883784277,0.7190848011621572,0.042491374614127476
4518,,201,13089,13290,32,977,18477,4991,13486,18477,1416,0.010878389348920279,0.7083942198408832,0.001731882881420144,0.2701196081614981,0.729880391838502,0.05287654922335877
4519,35.0,82,3833,3915,18,125,4996,1512,3484,4996,388,0.016413130504403524,0.7672137710168134,0.003602882305844676,0.3026421136909528,0.6973578863090473,0.02502001601281025
4520,,180,3446,3626,29,227,5227,1376,3851,5227,366,0.034436579299789556,0.6592691792615267,0.005548115553854984,0.26324851731394683,0.7367514826860532,0.043428352783623496
4521,,7,3497,3504,4,150,4640,1357,3283,4640,462,0.0015086206896551724,0.7536637931034482,0.0008620689655172414,0.29245689655172413,0.7075431034482759,0.032327586206896554
4522,,150,3250,3400,23,277,4753,1289,3464,4753,369,0.031559015358720806,0.6837786661056175,0.004839049021670524,0.27119713864927414,0.7288028613507258,0.058278981695771094
4523,17.0,115,1626,1741,0,60,2341,739,1602,2341,169,0.049124305852199915,0.6945749679624093,0.0,0.3156770610850064,0.6843229389149936,0.025630072618539085
4524,25.0,2054,50382,52436,332,1627,66279,19950,46329,66279,3494,0.030990208059868133,0.7601502738423935,0.005009128079783944,0.3010003168424388,0.6989996831575612,0.024547745137977337
4525,14.0,136,2903,3039,17,190,4171,1161,3010,4171,297,0.032606089666746586,0.695996163989451,0.004075761208343323,0.27835051546391754,0.7216494845360825,0.04555262526971949
4526,,852,17749,18601,166,1061,25686,6979,18707,25686,1839,0.033169820135482364,0.6909989877754419,0.006462664486490696,0.2717044304290275,0.7282955695709725,0.04130654831425679
4527,16.0,2108,47572,49680,124,2172,65311,19062,46249,65311,4182,0.03227633936090398,0.7283918482338351,0.0018986081977002342,0.29186507632711184,0.7081349236728882,0.03325626617262023
4528,24.0,491,14917,15795,37,1105,20922,5583,15348,20931,1514,0.023458028761167645,0.712674979695189,0.001767712961635851,0.2667335531030529,0.7332664468969471,0.05279250871912474
4529,43.0,2532,39740,42272,519,3418,58114,16093,42021,58114,3100,0.04356953574009705,0.6838283374057886,0.008930722373266338,0.27692122380149364,0.7230787761985064,0.05881543173761916
4530,15.0,73,6105,6178,32,282,8307,2310,5997,8307,765,0.008787769351149633,0.7349223546406645,0.003852172866257373,0.27807872878295414,0.7219212712170459,0.033947273383893105
4531,,3474,95515,98989,284,2975,125334,37899,87435,125334,8229,0.027717937670544306,0.7620837123206792,0.0022659453939074792,0.30238402987218155,0.6976159701278185,0.023736575869277292
4532,17.0,1671,31597,33268,16,1183,43471,12914,30557,43471,3301,0.038439419383036966,0.7268523843481861,0.0003680614662648662,0.2970716109590302,0.7029283890409699,0.027213544661958546
4533,,2869,51349,54218,403,2732,72129,20764,51365,72129,5151,0.03977595696599149,0.7119050589915291,0.005587211801078623,0.28787311622232387,0.7121268837776761,0.03787658223460744
4534,24.0,90,1671,1761,17,194,2580,691,1889,2580,146,0.03488372093023256,0.6476744186046511,0.006589147286821705,0.2678294573643411,0.732170542635659,0.07519379844961241
4535,24.0,1847,16632,18479,173,1203,26072,7022,19050,26072,1476,0.07084228290886775,0.6379257440932802,0.006635471003375268,0.26933108315434184,0.7306689168456582,0.04614145443387542
4536,25.0,8754,168861,177615,498,10540,240086,67429,172657,240086,17791,0.03646193447348034,0.7033354714560616,0.0020742567246736588,0.2808535274859842,0.7191464725140159,0.04390093549811318
4537,13.0,23,5199,5222,83,968,7644,1942,5702,7644,319,0.003008895866038723,0.6801412872841445,0.010858189429618002,0.25405546834118264,0.7459445316588174,0.12663526949241236
4538,33.0,3103,43669,46772,429,3024,66141,17984,48157,66141,4533,0.046914924177136726,0.6602410002872651,0.006486143239443008,0.2719039627462542,0.7280960372537458,0.045720506191318545
4539,,678,13618,14296,70,868,19488,5428,14066,19494,1474,0.034779932286857496,0.6985739201805684,0.0035908484661947267,0.27844464963578536,0.7215553503642146,0.04452652098081461
4540,17.0,1901,40215,42116,48,3672,57597,15151,42446,57597,3988,0.033005191242599444,0.6982134486171154,0.0008333767383717902,0.263051895063979,0.7369481049360209,0.06375332048544195
4541,,167,4233,4400,10,173,5634,1659,3975,5634,424,0.029641462548810792,0.7513312034078807,0.001774937877174299,0.2944621938232162,0.7055378061767839,0.03070642527511537
4542,14.0,44,2297,2341,1,300,3378,903,2475,3378,294,0.013025458851391355,0.6799881586737715,0.0002960331557134399,0.2673179396092362,0.7326820603907638,0.08880994671403197
4543,23.0,93,2872,2965,10,101,3960,1120,2840,3960,360,0.023484848484848483,0.7252525252525253,0.0025252525252525255,0.2828282828282828,0.7171717171717171,0.025505050505050506
4544,38.0,223,4171,4394,36,236,5764,1637,4127,5764,357,0.03868841082581541,0.7236294240111034,0.006245662734212352,0.28400416377515614,0.7159958362248439,0.040943789035392086
4545,23.0,196,5750,5946,24,266,8003,2233,5770,8003,719,0.024490815944020992,0.7184805697863301,0.002998875421716856,0.2790203673622392,0.7209796326377609,0.03323753592402849
4546,24.0,220,3909,4129,66,192,5607,1597,4010,5607,391,0.0392366684501516,0.6971642589620117,0.011771000535045479,0.28482254324950956,0.7151774567504905,0.03424291064740503
4547,,323,8782,9105,35,374,11869,3583,8286,11869,883,0.027213750105316372,0.7399106917179207,0.0029488583705451175,0.30187884404751875,0.6981211559524813,0.03151065801668211
4548,34.0,315,6161,6476,8,330,8872,2487,6385,8872,665,0.03550495942290351,0.6944319206492335,0.0009017132551848512,0.2803201082055906,0.7196798917944094,0.03719567177637511
4549,,10,166,387,7,10,594,73,521,594,11,0.016835016835016835,0.27946127946127947,0.011784511784511785,0.12289562289562289,0.877104377104377,0.016835016835016835
4550,43.0,108,2240,2348,15,106,3146,904,2242,3146,237,0.034329307056579786,0.7120152574698029,0.004767959313413859,0.2873490146217419,0.7126509853782581,0.033693579148124604
4551,17.0,1043,13267,14310,109,1225,20499,5430,15069,20499,1163,0.05088053075759793,0.6472023025513439,0.005317332552807454,0.2648909702912337,0.7351090297087662,0.05975901263476267
4552,16.0,355,5064,5419,98,522,7621,2045,5576,7621,483,0.04658181341031361,0.6644797270699383,0.012859204828762629,0.2683374885185671,0.7316625114814329,0.06849494816953156
4553,27.0,1507,30839,32346,156,1221,42391,12349,30042,42391,3414,0.03554999882050435,0.7274893255643887,0.0036800264207025074,0.2913118350593286,0.7086881649406713,0.028803283715883088
4554,24.0,154,2120,2274,18,114,3102,887,2215,3102,215,0.04964539007092199,0.6834300451321728,0.005802707930367505,0.2859445519019987,0.7140554480980013,0.0367504835589942
4555,14.0,0,1713,1713,38,3,2285,627,1658,2285,207,0.0,0.749671772428884,0.01663019693654267,0.27439824945295405,0.7256017505470459,0.001312910284463895
4556,35.0,351,8038,8389,22,525,11221,3185,8036,11221,818,0.03128063452455218,0.7163354424739328,0.0019606095713394526,0.2838427947598253,0.7161572052401747,0.046787273861509666
4557,33.0,60,1689,1749,8,88,2353,666,1687,2353,167,0.025499362515937103,0.7178070548236294,0.003399915002124947,0.28304292392690183,0.7169570760730982,0.037399065023374416
4558,27.0,572,7756,8328,281,757,11763,3160,8603,11763,657,0.048627050922383744,0.6593556065629517,0.02388846382725495,0.268638952648134,0.731361047351866,0.06435433137804981
4559,,1101,15005,16106,171,915,21812,5990,15822,21812,1482,0.05047680176049881,0.6879240784889052,0.0078397212543554,0.2746194755180634,0.7253805244819366,0.04194938565927012
4560,,171,5310,5481,1,768,7482,1721,5761,7482,430,0.02285485164394547,0.7097032878909383,0.00013365410318096765,0.23001871157444534,0.7699812884255547,0.10264635124298316
4561,23.0,4213,131810,136023,708,5594,176091,51055,125036,176091,11562,0.02392512962048032,0.74853342873855,0.004020648414740106,0.28993531753468377,0.7100646824653162,0.03176766558200021
4562,39.0,38,2400,2438,1,209,3728,927,2801,3728,261,0.0101931330472103,0.6437768240343348,0.0002682403433476395,0.2486587982832618,0.7513412017167382,0.056062231759656654
4563,16.0,380,11135,11515,30,1338,15770,4397,11373,15770,839,0.024096385542168676,0.7060875079264426,0.0019023462270133164,0.27882054533925177,0.7211794546607483,0.08484464172479392
4564,,177,4307,4484,90,233,6264,1681,4583,6264,453,0.02825670498084291,0.6875798212005109,0.014367816091954023,0.2683588761174968,0.7316411238825032,0.037196679438058745
4565,33.0,288,7851,8139,63,425,11415,3045,8370,11415,870,0.025229960578186595,0.6877792378449409,0.005519053876478318,0.266754270696452,0.7332457293035479,0.03723171265878231
4566,,345,10142,10487,63,1063,14212,3940,10272,14212,776,0.0242752603433718,0.7136222910216719,0.004432873627920068,0.27723050942865185,0.7227694905713482,0.07479594708696875
4567,15.0,2603,31238,33841,446,1745,44938,12822,32117,44939,2701,0.05792296223769999,0.6951200516255368,0.009924564409532922,0.2853201005807873,0.7146798994192127,0.03883041456196177
4568,16.0,213,6583,6796,55,408,9273,2626,6647,9273,733,0.02296991264962795,0.7099104928286423,0.005931198102016607,0.2831877493799202,0.7168122506200798,0.043998705920414105
4569,17.0,661,16508,17169,30,799,22779,6519,16260,22779,1838,0.029017955134114756,0.7247025769348961,0.0013170025023047543,0.28618464375082314,0.7138153562491769,0.035076166644716626
4570,24.0,535,19214,19749,223,1375,26846,7291,19555,26846,1724,0.019928480965506964,0.7157118378901884,0.008306637860388886,0.27158608358787156,0.7284139164121284,0.05121805855620949
4571,,52,1557,1609,7,65,2134,615,1519,2134,169,0.02436738519212746,0.7296157450796626,0.0032802249297094657,0.2881911902530459,0.711808809746954,0.030459231490159326
4572,,5984,114452,120436,385,5633,160537,46715,113822,160537,10764,0.03727489612986414,0.7129322212324885,0.0023982010377669944,0.290992107738403,0.709007892261597,0.03508848427465319
4573,16.0,181,4042,4223,3,182,5780,1591,4189,5780,536,0.031314878892733565,0.6993079584775086,0.0005190311418685121,0.27525951557093425,0.7247404844290657,0.0314878892733564
4574,25.0,4573,69058,73631,775,4437,100205,28015,72190,100205,5987,0.04563644528716132,0.6891672072251883,0.007734145002744374,0.27957686742178534,0.7204231325782147,0.04427922758345392
4575,,218,4732,4950,24,226,6589,1880,4709,6589,499,0.033085445439368644,0.7181666413719836,0.0036424343602974654,0.2853240248899681,0.7146759751100319,0.03429959022613446
4576,,292,6615,6907,21,449,9694,2640,7054,9694,699,0.030121724778213326,0.6823808541365793,0.0021662884258304106,0.2723334021043945,0.7276665978956055,0.046317309676088304
4577,23.0,517,15590,16107,23,591,21603,6187,15416,21603,1926,0.023931861315558023,0.7216590288385872,0.0010646669444058696,0.28639540804517893,0.7136045919548211,0.02735731148451604
4578,25.0,254,6684,6938,31,507,9056,2585,6471,9056,509,0.028047703180212016,0.7380742049469965,0.0034231448763250884,0.2854461130742049,0.714553886925795,0.05598498233215548
4579,,302,8682,8984,46,468,12081,3366,8715,12081,859,0.02499793063488122,0.7186491184504594,0.0038076318185580665,0.27861931959274894,0.721380680407251,0.03873851502359076
4580,36.0,2876,96710,99586,348,4289,129864,37693,92171,129864,10009,0.02214624530277829,0.7447021499414772,0.002679726483090002,0.2902497997905501,0.7097502002094499,0.033026858867738554
4581,15.0,275,6354,6629,24,248,9252,2510,6742,9252,635,0.02972330306960657,0.6867704280155642,0.0025940337224383916,0.2712926934716818,0.7287073065283182,0.02680501513186338
4582,,1568,32121,33689,92,1520,45827,13200,32627,45827,3030,0.034215637069849654,0.7009186723983678,0.002007550134200362,0.28803980186353023,0.7119601981364697,0.03316821960852773
4583,25.0,28909,470596,499505,2146,30793,669826,189718,480108,669826,44762,0.04315896964286248,0.7025645466135981,0.003203817110712334,0.2832347505172985,0.7167652494827015,0.04597164039616258
4584,17.0,2749,59085,61834,270,2370,80081,23694,56387,80081,5620,0.034327743160050446,0.737815461844882,0.0033715862689027358,0.29587542613104234,0.7041245738689577,0.029595035027035126
4585,,2313,63823,66136,100,3219,88319,25785,62534,88319,6967,0.026189155221413286,0.7226417871579162,0.001132259196775326,0.29195303388851773,0.7080469661114822,0.036447423544197735
4586,25.0,788,17406,18194,47,879,24286,6956,17330,24286,1795,0.032446677097916495,0.7167092151857037,0.0019352713497488264,0.2864201597628263,0.7135798402371737,0.036193691838919545
4587,17.0,379,12598,12977,15,661,17499,4992,12507,17499,1579,0.021658380478884506,0.7199268529630265,0.0008571918395336877,0.2852734441968112,0.7147265558031888,0.037773587062117836
4588,,150,3629,3779,9,198,5011,1405,3606,5011,359,0.029934144881261227,0.7242067451606465,0.0017960486928756735,0.28038315705448014,0.7196168429455199,0.039513071243264815
4589,23.0,70,2369,2439,2,126,3202,965,2237,3202,281,0.021861336664584636,0.7398500936914428,0.0006246096189881324,0.3013741411617739,0.6986258588382261,0.03935040599625234
4590,,201,9018,9219,21,619,12493,3479,9014,12493,864,0.016089009845513487,0.7218442327703514,0.0016809413271432001,0.2784759465300568,0.7215240534699432,0.04954774673817338
4591,24.0,1356,31428,32784,114,1446,43311,12441,30870,43311,3204,0.03130844358246173,0.7256355198448431,0.0026321257879060745,0.2872480432222761,0.7127519567777238,0.033386437625545475
4592,24.0,114,7916,8030,21,388,10597,3023,7574,10597,745,0.010757761630650184,0.7470038690195339,0.001981692931961876,0.2852694158724167,0.7147305841275833,0.03661413607624799
4593,34.0,281,6735,7016,54,330,9491,2730,6761,9491,656,0.02960699610156991,0.709619639658624,0.005689600674323043,0.2876409229796649,0.7123590770203351,0.03476978189864082
4594,13.0,151,3319,3470,10,346,5073,1316,3757,5073,361,0.02976542479794993,0.6542479794993101,0.001971220185294697,0.25941257638478216,0.7405874236152178,0.06820421841119653
4595,15.0,306,8508,8814,105,642,12377,3310,9067,12377,680,0.02472327704613396,0.687404055910156,0.008483477417791064,0.267431526217985,0.7325684737820151,0.051870404783065364
4596,40.0,150,5177,5327,13,239,7092,1976,5116,7092,548,0.021150592216582064,0.7299774393683023,0.0018330513254371122,0.27862380146644106,0.7213761985335589,0.033699943598420753
4597,,2028,11231,13259,1027,960,18546,4902,13644,18546,414,0.109349725008088,0.6055753262158956,0.05537582227973687,0.26431575541895824,0.7356842445810418,0.0517631834357813
4598,33.0,481,14648,15129,78,614,19537,5722,13815,19537,1322,0.024619951886164712,0.7497568715770078,0.003992424630188872,0.2928801760761632,0.7071198239238369,0.0314275477299483
4599,23.0,92,2333,2425,5,124,3196,924,2272,3196,241,0.028785982478097622,0.7299749687108886,0.0015644555694618273,0.28911138923654567,0.7108886107634543,0.03879849812265332
4600,14.0,201,3465,3666,37,211,5104,1440,3664,5104,318,0.039380877742946706,0.6788793103448276,0.0072492163009404385,0.28213166144200624,0.7178683385579937,0.04134012539184953
4601,,742,15499,16241,275,886,22143,5939,16204,22143,1397,0.03350946122928239,0.6999503229011426,0.012419274714356682,0.26821117283114304,0.731788827168857,0.04001264507970916
4602,27.0,136,2398,2534,7,95,3379,969,2410,3379,274,0.04024859425865641,0.7096774193548387,0.0020716188221367266,0.2867712340929269,0.7132287659070731,0.02811482687185558
4603,,2235,36456,38691,79,2077,52172,14704,37469,52173,4340,0.042838249669369215,0.6987522281639929,0.001514193165047055,0.28183159871964425,0.7181684012803558,0.0398098633392751
4604,15.0,2604,29279,31883,378,2155,45358,11993,33365,45358,2684,0.057409938709819655,0.6455090612460866,0.008333700780457693,0.2644076017461087,0.7355923982538912,0.04751091317959345
4605,23.0,29,5504,5533,2,286,7295,2180,5115,7295,632,0.003975325565455792,0.7544893762851268,0.00027416038382453733,0.2988348183687457,0.7011651816312543,0.03920493488690884
4606,,1368,32031,33399,138,2012,44717,12631,32086,44717,3355,0.030592392155108797,0.7163047610528435,0.0030860746472258873,0.2824652816602187,0.7175347183397813,0.04499407384216294
4607,15.0,444,8961,9405,24,414,12340,3605,8735,12340,849,0.035980551053484605,0.7261750405186386,0.0019448946515397082,0.29213938411669366,0.7078606158833063,0.03354943273905997
4608,23.0,71,2334,2405,0,76,3190,925,2265,3190,262,0.02225705329153605,0.7316614420062696,0.0,0.28996865203761757,0.7100313479623824,0.023824451410658306
4609,,1671,26623,28294,147,1567,38571,10723,27848,38571,2530,0.043322703585595396,0.6902335951880947,0.0038111534572606363,0.27800679266806666,0.7219932073319333,0.04062637733011848
4610,16.0,92,2001,2093,10,150,2890,787,2103,2890,207,0.03183391003460208,0.6923875432525951,0.0034602076124567475,0.27231833910034603,0.727681660899654,0.05190311418685121
4611,,6735,110552,117287,454,6762,160194,44773,115422,160195,10714,0.042042510690096443,0.6901089297418771,0.002834046006429664,0.2794906208058928,0.7205093791941072,0.04221105527638191
4612,24.0,101,2778,2879,15,137,3761,1074,2687,3761,292,0.026854559957458123,0.7386333421962245,0.003988300983780909,0.2855623504387131,0.7144376495612869,0.03642648231853231
4613,17.0,458,9961,10419,44,412,14001,4021,9980,14001,994,0.03271194914648954,0.7114491822012713,0.0031426326690950647,0.2871937718734376,0.7128062281265624,0.02942646953789015
4614,15.0,202,11936,12138,60,1515,17593,4500,13093,17593,946,0.011481839367930426,0.6784516569089979,0.0034104473370090375,0.25578355027567784,0.7442164497243222,0.0861137952594782
4615,,458,8596,9054,16,406,12170,3564,8606,12170,775,0.037633525061626955,0.7063270336894002,0.001314708299096138,0.29285127362366475,0.7071487263763353,0.033360723089564503
4616,23.0,92,2053,2145,19,82,2899,821,2078,2899,213,0.03173508106243532,0.7081752328389099,0.006553984132459468,0.2832011038289065,0.7167988961710935,0.028285615729561918
4617,23.0,502,15442,15944,21,914,21560,6124,15436,21560,1577,0.023283858998144714,0.7162337662337662,0.000974025974025974,0.28404452690166976,0.7159554730983302,0.042393320964749535
4618,,513,1580,2093,8,288,2876,769,2107,2876,89,0.17837273991655075,0.5493741307371349,0.0027816411682892906,0.26738525730180807,0.7326147426981919,0.10013908205841446
4619,15.0,1181,10664,11845,26,945,16492,4613,11879,16492,950,0.07161047780742177,0.6466165413533834,0.0015765219500363814,0.2797113752122241,0.7202886247877759,0.05730050933786078
4620,25.0,240,4998,5238,23,263,6838,2104,4734,6838,302,0.0350979818660427,0.7309154723603393,0.003363556595495759,0.3076923076923077,0.6923076923076923,0.038461538461538464
4621,,683,3215,3898,42,182,5276,1412,3864,5276,366,0.12945413191811977,0.609363153904473,0.00796057619408643,0.2676269901440485,0.7323730098559514,0.03449583017437453
4622,,630,11379,12009,93,667,16019,4473,11546,16019,1095,0.039328297646544726,0.7103439665397341,0.005805605843061365,0.27923091329046756,0.7207690867095324,0.04163805480991323
4623,16.0,56,1841,1897,2,85,2500,719,1781,2500,221,0.0224,0.7364,0.0008,0.2876,0.7124,0.034
4624,14.0,60,1750,1810,10,56,2421,700,1721,2421,209,0.024783147459727387,0.7228418009087154,0.004130524576621231,0.28913672036348614,0.7108632796365139,0.023130937629078894
4625,,3241,147906,151147,813,14056,204637,56920,147717,204637,13433,0.0158378005932456,0.7227725191436544,0.00397288857831184,0.27815106750001223,0.7218489324999878,0.06868748075861159
4626,,485,45409,45894,840,2144,61393,17319,44074,61393,4895,0.007899923444040852,0.7396445848875279,0.013682341635039825,0.28210056521101756,0.7178994347889824,0.03492254817324451
4627,15.0,18,4185,4203,18,137,5675,1570,4105,5675,596,0.003171806167400881,0.7374449339207049,0.003171806167400881,0.27665198237885463,0.7233480176211454,0.024140969162995594
4628,27.0,107,2283,2390,4,77,3241,878,2363,3241,253,0.0330145016970071,0.7044122184510954,0.001234186979327368,0.2709040419623573,0.7290959580376427,0.023758099352051837
4629,,328,7663,7991,90,355,10729,3029,7700,10729,929,0.030571348681144563,0.7142324540963743,0.008388479821045763,0.2823189486438624,0.7176810513561376,0.03308789262745829
4630,45.0,28620,347793,376413,2419,14782,496123,141798,354325,496123,31576,0.057687307381435654,0.701021722435767,0.004875807007536438,0.28581218770345257,0.7141878122965474,0.029795030667798105
4631,,273,2157,2430,24,104,4135,810,3325,4135,98,0.0660217654171705,0.5216444981862153,0.005804111245465538,0.19588875453446192,0.8041112454655381,0.025151148730350664
4632,17.0,211,7096,7307,32,211,9548,2762,6786,9548,832,0.02209886887306242,0.7431922915793884,0.0033514872224549644,0.2892752408881441,0.7107247591118558,0.02209886887306242
4633,35.0,954,19522,20476,95,931,27222,7872,19350,27222,1748,0.03504518404231871,0.7171405480861068,0.003489824406729851,0.28917787083976193,0.710822129160238,0.03420027918595254
4634,24.0,117,2998,3115,0,209,4168,1220,2948,4168,317,0.028071017274472167,0.7192898272552783,0.0,0.2927063339731286,0.7072936660268714,0.05014395393474088
4635,,436,16121,16557,86,680,21422,6272,15150,21422,1505,0.020352908225189058,0.7525441135281487,0.004014564466436374,0.2927831201568481,0.7072168798431518,0.03174306787414807
4636,23.0,249,4491,4740,22,160,6459,1812,4647,6459,441,0.03855085926614027,0.695308871342313,0.0034061000154822726,0.2805387830933581,0.7194612169066419,0.02477163647623471
4637,17.0,2128,46946,49074,100,3403,66122,18204,47918,66122,4838,0.032182934575481686,0.7099906233931218,0.001512355948095944,0.2753092767913856,0.7246907232086144,0.05146547291370497
4638,,55,1546,1601,27,96,2193,612,1581,2193,164,0.025079799361605107,0.7049703602371181,0.012311901504787962,0.27906976744186046,0.7209302325581395,0.04377564979480164
4639,25.0,103,2584,2687,16,123,3590,1018,2572,3590,258,0.028690807799442896,0.7197771587743732,0.004456824512534819,0.2835654596100279,0.7164345403899721,0.03426183844011142
4640,13.0,60,1713,1773,4,208,2459,645,1814,2459,131,0.024400162667751118,0.6966246441642945,0.0016266775111834079,0.2623017486783245,0.7376982513216754,0.0845872305815372
4641,,500,10546,11046,527,689,15510,4511,10999,15510,1077,0.032237266279819474,0.6799484203739523,0.033978078658929725,0.29084461637653125,0.7091553836234687,0.044422952933591234
4642,,1938,30499,32437,163,1946,43380,12506,30874,43380,3013,0.04467496542185339,0.7030659289995389,0.0037574919317657908,0.2882895343476256,0.7117104656523744,0.044859382203780544
4643,17.0,658,14064,14722,106,806,20008,5505,14503,20008,1437,0.03288684526189524,0.7029188324670131,0.005297880847660936,0.27513994402239106,0.7248600559776089,0.04028388644542183
4644,16.0,734,13187,13921,51,779,18823,5296,13527,18823,1317,0.038994846730064286,0.7005790787865909,0.0027094512033150934,0.2813579131913085,0.7186420868086915,0.04138553896828348
4645,14.0,157,3879,4036,5,220,5359,1550,3809,5359,380,0.029296510543011755,0.7238290725881694,0.000933009889904833,0.28923306587049824,0.7107669341295018,0.04105243515581265
4646,26.0,12571,207938,220509,843,10934,289749,83820,205929,289749,19114,0.04338582704340654,0.7176487235503832,0.0029094147003095785,0.2892848637959061,0.7107151362040939,0.03773610952928224
4647,17.0,350,8072,8422,76,388,11383,3200,8183,11383,695,0.03074760607924097,0.7091276464903804,0.006676623034349468,0.281120969867346,0.718879030132654,0.03408591759641571
4648,23.0,4232,110314,114546,220,5039,148605,43091,105514,148605,9615,0.028478180411157093,0.742330338817671,0.0014804347094646883,0.28997005484337673,0.7100299451566232,0.03390868409542075
4649,,482,4114,4596,16,392,6348,1740,4608,6348,357,0.0759294265910523,0.6480781348456207,0.002520478890989288,0.2741020793950851,0.725897920604915,0.06175173282923756
4650,,2089,47746,49835,175,2163,64403,19080,45323,64403,4447,0.0324363771873981,0.7413629799854045,0.0027172647236929958,0.2962594910174992,0.7037405089825008,0.03358539198484543
4651,24.0,3513,64069,67582,332,3059,90807,25998,64809,90807,7459,0.038686444877597544,0.7055513341482484,0.0036561058068210603,0.28629951435462025,0.7137004856453798,0.03368683031043862
4652,26.0,1528,30091,31619,131,1716,42038,11920,30118,42038,3181,0.0363480660354917,0.7158047480850659,0.0031162281745087776,0.28355297587896666,0.7164470241210333,0.040820210285931774
4653,,362,5098,5460,30,527,7647,2156,5491,7647,482,0.04733882568327449,0.6666666666666666,0.003923107100823852,0.28194063031254085,0.7180593696874591,0.06891591473780567
4654,24.0,2580,79549,82749,664,6555,113373,31205,82168,113373,7540,0.022756741022994895,0.7016573611000856,0.005856773658631244,0.27524190062889753,0.7247580993711025,0.057817998994469585
4655,27.0,679,7870,8549,132,1453,12689,3320,9369,12689,336,0.05351091496571834,0.6202222397352037,0.010402711009535819,0.2616439435731736,0.7383560564268263,0.1145086295216329
4656,17.0,1257,20657,21914,47,1304,29282,8386,20896,29282,2104,0.042927395669694696,0.7054504473738132,0.0016050816201079161,0.28638754183457416,0.7136124581654258,0.044532477289802606
4657,16.0,3814,58302,62116,235,4954,85048,23642,61406,85048,5525,0.044845263851001786,0.6855187658733891,0.0027631455178252283,0.27798419715925127,0.7220158028407487,0.05824945912896247
4658,17.0,69,2409,2478,39,84,3149,958,2191,3149,169,0.0219117180057161,0.7650047634169578,0.012384884090187362,0.3042235630358844,0.6957764369641156,0.02667513496348047
4659,15.0,152,2370,2522,7,98,3370,946,2424,3370,215,0.045103857566765576,0.7032640949554896,0.0020771513353115725,0.2807121661721068,0.7192878338278932,0.029080118694362018
4660,,215,4741,4956,1,339,6656,1829,4827,6656,501,0.032301682692307696,0.7122896634615384,0.00015024038461538462,0.27478966346153844,0.7252103365384616,0.050931490384615384
4661,14.0,270,3821,4091,2,600,5763,1285,4478,5763,322,0.04685059864653826,0.6630227312163803,0.00034704147145583897,0.22297414541037655,0.7770258545896235,0.10411244143675169
4662,24.0,4338,111714,116052,605,4172,147308,44769,102539,147308,10033,0.02944850245743612,0.7583702175034621,0.004107041029679312,0.30391424769869935,0.6960857523013007,0.028321611860862954
4663,15.0,169,9406,9575,86,585,12820,3713,9107,12820,963,0.013182527301092043,0.7336973478939157,0.00670826833073323,0.2896255850234009,0.710374414976599,0.04563182527301092
4664,,76,1690,1766,8,106,2622,651,1971,2622,165,0.028985507246376812,0.6445461479786423,0.0030511060259344014,0.2482837528604119,0.7517162471395881,0.04042715484363082
4665,26.0,275,5994,6269,13,267,8301,2429,5872,8301,586,0.03312853873027346,0.7220816769063968,0.0015660763763402,0.2926153475484881,0.7073846524515118,0.032164799421756415
4666,23.0,1261,31154,32415,175,1742,43249,12397,30852,43249,3367,0.02915674350852043,0.7203403546902819,0.004046336331475872,0.2866424657217508,0.7133575342782492,0.04027838793960554
4667,47.0,99,2503,2602,3,171,3492,1034,2458,3492,263,0.028350515463917526,0.7167812142038946,0.000859106529209622,0.2961053837342497,0.7038946162657503,0.04896907216494845
4668,,202,7641,7843,38,422,10535,2988,7547,10535,780,0.019174181300427147,0.725296630280019,0.0036070242050308494,0.28362600854295206,0.7163739914570479,0.04005695301376364
4669,,1338,28327,29665,124,1334,39667,11163,28504,39667,3512,0.033730808984798445,0.7141200494113494,0.0031260241510575543,0.2814178032117377,0.7185821967882623,0.03362996949605466
4670,38.0,826,20162,20988,223,1259,28243,7996,20247,28243,2239,0.029246184895372306,0.7138760046737245,0.007895761781680416,0.2831144000283256,0.7168855999716744,0.04457741741316432
4671,44.0,75,2241,2316,23,65,3027,897,2130,3027,242,0.024777006937561942,0.7403369672943508,0.007598282127518996,0.29633300297324083,0.7036669970267592,0.021473406012553684
4672,15.0,139,4453,4592,29,781,7130,1665,5465,7130,353,0.019495091164095372,0.6245441795231417,0.004067321178120617,0.2335203366058906,0.7664796633941094,0.10953716690042076
4673,15.0,51,1807,1858,2,226,2625,712,1913,2625,197,0.019428571428571427,0.6883809523809524,0.0007619047619047619,0.2712380952380952,0.7287619047619047,0.0860952380952381
4674,,455,3966,4421,8,427,6316,1701,4615,6316,302,0.0720392653578214,0.6279290690310323,0.001266624445851805,0.26931602279924005,0.73068397720076,0.06760607979734008
4675,,2158,56378,58536,281,2633,82771,22006,60765,82771,5581,0.026071933406627924,0.6811322806296891,0.0033949088448852857,0.2658660642012299,0.7341339357987701,0.031810658322359284
4676,,241,8588,8829,40,340,11840,3353,8487,11840,959,0.02035472972972973,0.7253378378378378,0.0033783783783783786,0.28319256756756755,0.7168074324324324,0.028716216216216218
4677,33.0,437,13213,13650,52,656,17988,5167,12821,17988,1363,0.024293973760284634,0.7345452523904825,0.00289081609962197,0.28724705359128305,0.7127529464087169,0.03646875694907716
4678,15.0,113,4672,4785,49,558,6633,1741,4892,6633,470,0.017036031961405095,0.7043570028644656,0.0073873058947685815,0.26247550128147146,0.7375244987185285,0.08412483039348712
4679,26.0,254,22480,22734,14,1029,29881,8685,21196,29881,2713,0.008500384859944447,0.7523175261872093,0.0004685251497607175,0.2906529232622737,0.7093470767377263,0.034436598507412736
4680,17.0,825,21261,22086,92,945,29017,8497,20520,29017,2374,0.02843160905675983,0.7327084123100251,0.0031705551917841266,0.29282834200641006,0.7071716579935899,0.03256711582865217
4681,,79,1583,1662,2,122,2363,631,1732,2363,169,0.03343207786711807,0.6699111299195938,0.0008463817181548879,0.2670334320778671,0.7329665679221329,0.05162928480744816
4682,27.0,19,2479,2498,13,215,3560,936,2624,3560,272,0.0053370786516853935,0.6963483146067416,0.003651685393258427,0.26292134831460673,0.7370786516853932,0.060393258426966294
4683,15.0,91,1584,1675,12,208,2372,570,1802,2372,140,0.03836424957841484,0.6677908937605397,0.00505902192242833,0.2403035413153457,0.7596964586846543,0.08768971332209106
4684,25.0,16531,438661,455192,1887,22069,598630,173465,425165,598630,43968,0.027614720277968026,0.7327748358752485,0.0031521975176653358,0.28976997477573796,0.710230025224262,0.036865843676394436
4685,24.0,18701,321685,340386,5070,17512,472221,128499,343722,472221,30040,0.03960222014692273,0.6812170572676777,0.010736498376819328,0.2721162337126049,0.7278837662873952,0.037084331277092715
4686,,43,7689,7732,22,612,10730,2905,7825,10730,767,0.004007455731593662,0.7165890027958993,0.0020503261882572226,0.2707362534948742,0.7292637465051258,0.05703634669151911
4687,,433,23472,23905,157,2710,33411,9023,24388,33411,2192,0.012959803657478076,0.7025231211277723,0.0046990512106791175,0.27006075843285143,0.7299392415671485,0.08111101134356949
4688,17.0,152,3775,3927,8,291,5345,1494,3851,5345,363,0.0284377923292797,0.706267539756782,0.0014967259120673526,0.27951356407857814,0.7204864359214219,0.054443405051449956
4689,24.0,76,1941,2017,6,208,2726,726,2000,2726,153,0.027879677182685254,0.7120322817314747,0.0022010271460014674,0.2663242846661775,0.7336757153338225,0.07630227439471754
4690,25.0,627,107502,108129,286,6997,145335,41262,104073,145335,12702,0.0043141707090515015,0.7396841779337393,0.0019678673409708604,0.28390958819279594,0.716090411807204,0.048143943303402485
4691,,842,7755,8597,257,364,12595,3087,9508,12595,531,0.06685192536720921,0.6157205240174672,0.0204049225883287,0.24509726081778482,0.7549027391822152,0.02890035728463676
4692,,4261,85677,89938,370,4263,119410,35053,84357,119410,9821,0.03568377857800854,0.7175027217150992,0.003098567959132401,0.2935516288418055,0.7064483711581945,0.03570052759400385
4693,17.0,284,33036,33320,142,3191,45618,12989,32629,45618,2619,0.006225612696742514,0.7241878205971327,0.003112806348371257,0.28473409619010037,0.7152659038098996,0.06995045815248367
4694,26.0,8168,157261,165433,995,9143,231489,63368,168121,231489,15450,0.03528461395573872,0.6793454548596262,0.0042982603925024515,0.2737408688965782,0.7262591311034218,0.039496477154422026
4695,,6300,174327,180627,1155,10746,243340,69376,173964,243340,19461,0.025889701652009534,0.71639270156982,0.0047464453028684146,0.28509903838251005,0.71490096161749,0.044160433960713404
4696,,2,1881,1883,8,66,2515,706,1809,2515,283,0.0007952286282306163,0.7479125248508947,0.0031809145129224653,0.28071570576540755,0.7192842942345924,0.026242544731610338
4697,33.0,156,4838,4994,26,251,6739,1876,4863,6739,555,0.02314883513874462,0.7179106692387595,0.0038581391897907704,0.27837958154028786,0.7216204184597121,0.03724588217836474
4698,17.0,143,3787,3930,23,240,5381,1498,3883,5381,398,0.026574986062070247,0.7037725329864337,0.004274298457535774,0.27838691692993867,0.7216130830700613,0.04460137520906895
4699,17.0,201,22921,23122,139,2184,32634,9147,23487,32634,2029,0.0061592204449347305,0.7023656309370595,0.0042593614022185455,0.28029049457620886,0.7197095054237911,0.06692406692406692
4700,25.0,2,2675,2677,6,171,3595,1111,2484,3595,182,0.0005563282336578582,0.7440890125173852,0.0016689847009735744,0.3090403337969402,0.6909596662030598,0.04756606397774687
4701,17.0,298,6323,6621,21,480,9052,2422,6630,9052,677,0.032920901458241274,0.698519664162616,0.0023199292973928413,0.26756517896597437,0.7324348210340257,0.05302695536897923
4702,17.0,539,11414,11953,27,548,15829,4566,11263,15829,1243,0.034051424600416956,0.7210815591635605,0.0017057299892602187,0.28845789373933917,0.7115421062606608,0.034620001263503695
4703,15.0,3492,51241,54733,409,3788,76025,20536,55489,76025,5030,0.045932259125287735,0.6740019730351858,0.005379809273265373,0.27012167050312397,0.729878329496876,0.04982571522525485
4704,,476,6896,7372,19,685,10315,2851,7464,10315,549,0.046146388754241395,0.6685409597673291,0.0018419777023751817,0.2763936015511391,0.7236063984488609,0.0664081434803684
4705,,1688,32715,34403,36,2689,47078,12989,34089,47078,3210,0.035855388929011425,0.694910573941119,0.0007646883894812863,0.27590381919367857,0.7240961808063214,0.05711797442542164
4706,17.0,323,17074,17397,132,1062,23488,6606,16882,23488,1555,0.013751702997275204,0.7269243869209809,0.005619891008174387,0.28125,0.71875,0.04521457765667575
4707,,88,2128,2216,4,119,3024,822,2202,3024,229,0.0291005291005291,0.7037037037037037,0.0013227513227513227,0.2718253968253968,0.7281746031746031,0.03935185185185185
4708,16.0,71,2049,2120,11,105,2838,808,2030,2838,243,0.025017618040873855,0.7219873150105708,0.003875968992248062,0.284707540521494,0.715292459478506,0.03699788583509514
4709,25.0,199,6130,6329,21,252,8418,2389,6029,8418,683,0.02363981943454502,0.7282014730339749,0.0024946543121881683,0.2837966262770254,0.7162033737229746,0.02993585174625802
4710,17.0,188,2829,3017,18,128,4003,1156,2847,4003,262,0.04696477641768673,0.7067199600299775,0.0044966275293529855,0.2887834124406695,0.7112165875593305,0.03197601798651012
4711,,94,8166,8260,8,315,10656,3162,7494,10656,946,0.008821321321321322,0.7663288288288288,0.0007507507507507507,0.29673423423423423,0.7032657657657657,0.02956081081081081
4712,15.0,130,2164,2294,5,130,3066,860,2206,3066,226,0.042400521852576645,0.7058056099151989,0.0016307893020221786,0.2804957599478147,0.7195042400521853,0.042400521852576645
4713,26.0,9651,179225,188876,1012,10401,250195,71814,178381,250195,16946,0.038573912348368274,0.7163412538220189,0.004044845020883711,0.28703211495033876,0.7129678850496612,0.04157157417214573
4714,16.0,6147,164884,171031,268,6070,225448,64766,160682,225448,17958,0.027265710939995032,0.7313615556580675,0.0011887441893474327,0.28727688868386503,0.712723111316135,0.026924168766189985
4715,,719,22977,23696,393,2789,33877,9052,24825,33877,1733,0.02122383918292647,0.6782477787289312,0.011600791097204593,0.2672019364170381,0.7327980635829618,0.08232724267201937
4716,,78,2267,2345,15,88,3126,883,2243,3126,271,0.02495201535508637,0.7252079334612924,0.0047984644913627635,0.28246960972488805,0.717530390275112,0.02815099168266155
4717,26.0,251,5320,5571,16,290,7481,2129,5352,7481,507,0.0335516642160139,0.711134875016709,0.002138751503809651,0.2845876219756717,0.7154123780243283,0.03876487100654993
4718,38.0,1024,69055,70079,154,3086,94266,27210,67056,94266,9388,0.010862877389514778,0.7325546856767021,0.0016336749199074958,0.28865126344599323,0.7113487365540068,0.032737148070354105
4719,15.0,278,3610,3888,8,234,5896,1509,4387,5896,265,0.047150610583446405,0.6122795115332429,0.0013568521031207597,0.25593622795115334,0.7440637720488467,0.039687924016282225
4720,,166,4063,4229,12,237,5772,1569,4203,5772,455,0.02875952875952876,0.703915453915454,0.002079002079002079,0.2718295218295218,0.7281704781704782,0.04106029106029106
4721,15.0,38,2681,2719,6,204,3748,1028,2720,3748,322,0.010138740661686232,0.7153148345784418,0.0016008537886872999,0.2742796157950907,0.7257203842049093,0.054429028815368194
4722,45.0,464,5249,5713,51,201,7358,2114,5244,7358,408,0.06306061429736341,0.7133731992389236,0.006931231312856755,0.28730633324272903,0.712693666757271,0.027317205762435445
4723,15.0,118,2046,2164,13,101,2890,830,2060,2890,193,0.04083044982698962,0.7079584775086505,0.004498269896193772,0.28719723183391005,0.71280276816609,0.03494809688581315
4724,,3054,63307,66361,196,4226,87801,25122,62679,87801,5540,0.03478320292479584,0.7210282343025706,0.002232320816391613,0.28612430382341886,0.7138756961765811,0.04813157025546406
4725,35.0,1344,43666,45010,45,2037,58452,17061,41391,58452,4194,0.02299322521042907,0.7470403065763361,0.0007698624512420448,0.29188051734756726,0.7081194826524327,0.03484910695955656
4726,,226,3244,3470,10,306,4789,1298,3491,4789,294,0.04719148047609104,0.6773856755063687,0.0020881186051367718,0.27103779494675295,0.728962205053247,0.06389642931718521
4727,,57,4242,4299,11,233,5754,1687,4067,5754,227,0.009906152241918665,0.7372262773722628,0.0019117135905457074,0.29318734793187345,0.7068126520681265,0.04049356969064998
4728,35.0,556,14668,15224,175,593,19996,5882,14114,19996,1533,0.027805561112222446,0.7335467093418684,0.008751750350070014,0.29415883176635327,0.7058411682336467,0.029655931186237248
4729,,219,5018,5237,19,350,7158,1929,5229,7158,512,0.030595138306789605,0.7010338083263481,0.002654372729812797,0.2694886839899413,0.7305113160100587,0.04889633975970942
4730,13.0,135,6711,6846,10,171,8950,2561,6389,8950,902,0.015083798882681564,0.7498324022346369,0.0011173184357541898,0.28614525139664804,0.713854748603352,0.019106145251396648
4731,,528,17224,17752,20,1057,23467,6639,16828,23467,1728,0.022499680402267012,0.7339668470618315,0.000852260621297993,0.28290791323986875,0.7170920867601313,0.04504197383559893
4732,24.0,1076,23225,24301,46,1614,32456,9395,23061,32456,2312,0.033152575794922354,0.7155841754991373,0.001417303426176978,0.2894688193246241,0.7105311806753759,0.04972886369238354
4733,,837,53754,54591,165,3269,73875,20634,53241,73875,5921,0.01132994923857868,0.7276345177664975,0.002233502538071066,0.27930964467005076,0.7206903553299492,0.044250423011844335
4734,23.0,170,25074,25244,46,1621,33744,9486,24258,33744,2771,0.0050379326695116165,0.7430654338549075,0.0013632053105737316,0.2811166429587482,0.7188833570412517,0.04803816974869606
4735,25.0,3917,99526,103443,306,4897,136950,39526,97424,136950,10307,0.02860167944505294,0.7267323840817816,0.0022343921139101864,0.2886162833150785,0.7113837166849215,0.03575757575757576
4736,37.0,167,3727,3894,17,294,5300,1463,3837,5300,380,0.031509433962264154,0.7032075471698114,0.0032075471698113206,0.2760377358490566,0.7239622641509434,0.05547169811320755
4737,35.0,298,6477,6775,25,672,9248,2308,6940,9248,644,0.03222318339100346,0.7003676470588235,0.0027032871972318337,0.2495674740484429,0.7504325259515571,0.0726643598615917
4738,26.0,113,2448,2561,10,84,3329,962,2367,3329,279,0.03394412736557525,0.735355962751577,0.0030039050765995794,0.28897566836887956,0.7110243316311204,0.025232802643436466
4739,25.0,780,18578,19358,71,1134,25743,7287,18456,25743,2013,0.030299498892902926,0.7216719108107058,0.002758031309482189,0.2830672415802354,0.7169327584197646,0.044050809928912714
4740,23.0,1859,85304,87163,392,4189,117963,33221,84742,117963,10309,0.01575917872553258,0.7231420021532176,0.0033230758797249986,0.28162220357230655,0.7183777964276934,0.0355111348473674
4741,16.0,916,15511,16427,96,1057,22080,6224,15856,22080,1347,0.04148550724637681,0.7024909420289855,0.004347826086956522,0.2818840579710145,0.7181159420289855,0.0478713768115942
4742,,211,7733,7944,56,520,10570,3007,7563,10570,805,0.019962157048249763,0.7315988647114475,0.005298013245033113,0.28448438978240304,0.715515610217597,0.04919583727530748
4743,,517,9538,10055,206,694,13828,3772,10056,13828,849,0.037387908591264105,0.6897599074341915,0.014897309806190338,0.2727798669366503,0.7272201330633498,0.05018802429852473
4744,25.0,140,2254,2394,43,189,3382,863,2519,3382,206,0.04139562389118864,0.6664695446481372,0.0127143701951508,0.25517445298639857,0.7448255470136014,0.05588409225310467
4745,25.0,176,4944,5120,40,332,7180,1994,5186,7180,494,0.024512534818941504,0.6885793871866295,0.005571030640668524,0.2777158774373259,0.722284122562674,0.046239554317548746
4746,,156,2687,2843,14,153,3832,1075,2757,3832,246,0.0407098121085595,0.7012004175365344,0.0036534446764091857,0.2805323590814196,0.7194676409185804,0.039926931106471816
4747,,84,3548,3632,14,235,4922,1393,3529,4922,394,0.017066233238520925,0.7208451848841935,0.0028443722064201544,0.2830150345388054,0.7169849654611946,0.04774481917919545
4748,14.0,216,5129,5345,42,436,7248,2016,5232,7248,472,0.029801324503311258,0.7076434878587197,0.005794701986754967,0.2781456953642384,0.7218543046357616,0.06015452538631347
4749,24.0,386,7630,8016,25,447,10814,3058,7756,10814,731,0.035694470131311266,0.7055668577769558,0.0023118180136859627,0.28278157943406695,0.7172184205659331,0.04133530608470501
4750,14.0,77,3188,3265,279,294,4868,1055,3813,4868,103,0.015817584223500412,0.6548890714872637,0.05731306491372227,0.216721446179129,0.783278553820871,0.06039441248972884
4751,14.0,1043,17887,18930,465,2297,26586,7087,19499,26586,1451,0.03923117430226435,0.6727977130820733,0.01749040848566915,0.26656887083427366,0.7334311291657263,0.08639885654103664
4752,48.0,782,21596,22378,207,1117,30927,8508,22419,30927,2162,0.025285349371099688,0.6982895204837197,0.006693180715879329,0.2750994276845475,0.7249005723154525,0.03611730850066285
4753,23.0,644,70669,71313,262,3482,93955,27454,66501,93955,7908,0.006854345165238678,0.7521579479538076,0.0027885689957958598,0.2922037145441967,0.7077962854558033,0.03706029482198925
4754,14.0,256,10198,10454,29,1265,15246,4099,11147,15246,810,0.016791289518562246,0.6688967598058507,0.0019021382657746294,0.26885740522104157,0.7311425947789584,0.08297258297258298
4755,,510,12687,13197,30,2004,18625,4764,13861,18625,1199,0.02738255033557047,0.6811812080536913,0.001610738255033557,0.25578523489932886,0.7442147651006712,0.10759731543624161
4756,33.0,94,1714,1808,4,128,2635,674,1961,2635,150,0.03567362428842505,0.6504743833017078,0.0015180265654648956,0.2557874762808349,0.7442125237191651,0.04857685009487666
4757,14.0,81,1977,2058,1,108,2727,801,1926,2727,191,0.0297029702970297,0.724972497249725,0.0003667033370003667,0.29372937293729373,0.7062706270627063,0.039603960396039604
4758,,152,4472,4624,8,166,6381,1703,4678,6381,420,0.023820717755837644,0.7008305908164865,0.0012537219871493496,0.2668860680144178,0.7331139319855822,0.026014731233349006
4759,15.0,438,5410,5848,146,373,8265,2200,6065,8265,545,0.052994555353902,0.6545674531155475,0.017664851784634,0.2661826981246219,0.7338173018753781,0.04513006654567453
4760,15.0,549,13047,13596,91,893,18453,5114,13339,18453,1201,0.02975125995773045,0.7070395057714193,0.0049314474611174336,0.2771365089687314,0.7228634910312687,0.04839321519536119
4761,,285,7400,7685,17,391,10084,2963,7121,10084,776,0.028262594208647362,0.7338357794525981,0.0016858389527965093,0.29383181277270926,0.7061681872272908,0.03877429591431972
4762,23.0,2633,59030,61663,212,2815,82911,23557,59354,82911,5776,0.03175694419317099,0.7119682551169326,0.0025569586665219334,0.2841239401285716,0.7158760598714284,0.0339520690861285
4763,25.0,689,8920,9609,27,877,13074,3615,9459,13074,705,0.052700015297537095,0.6822701545051246,0.002065167508031207,0.2765029830197338,0.7234970169802661,0.0670797001682729
4764,35.0,839,24441,25280,113,906,32914,9792,23122,32914,2789,0.02549067266208908,0.7425715501002613,0.0034331895242146197,0.29750258248769523,0.7024974175123048,0.02752628061007474
4765,26.0,1083,27260,28343,98,1191,36990,10696,26294,36990,2520,0.029278183292781833,0.7369559340362261,0.0026493646931603134,0.2891592322249257,0.7108407677750743,0.032197891321978915
4766,13.0,291,2979,3270,51,249,4616,1199,3417,4616,279,0.06304159445407279,0.645363951473137,0.011048526863084922,0.2597487001733102,0.7402512998266898,0.053942807625649916
4767,16.0,9554,206539,216093,2741,7302,293989,84428,209561,293989,23729,0.03249781454408158,0.7025398909483008,0.009323478089316268,0.28718081288755704,0.712819187112443,0.024837663994231075
4768,23.0,608,13215,13823,101,1443,19456,5202,14254,19456,1149,0.03125,0.6792249177631579,0.005191200657894737,0.26737253289473684,0.7326274671052632,0.07416735197368421
4769,17.0,3229,64765,67994,316,4022,95172,26233,68939,95172,6729,0.033928046063968396,0.6805047703105955,0.003320304291178078,0.2756377926280839,0.7243622073719161,0.042260328668095655
4770,,3415,51429,54844,253,3381,74697,20868,53829,74697,5254,0.04571803419146686,0.6885015462468372,0.0033870168815347337,0.2793686493433471,0.7206313506566528,0.0452628619623278
4771,13.0,43,2014,2057,0,72,2737,800,1937,2737,248,0.015710632078918523,0.7358421629521373,0.0,0.2922908293752284,0.7077091706247717,0.026306174643770552
4772,,103,1925,2028,0,107,2735,827,1908,2735,197,0.0376599634369287,0.7038391224862889,0.0,0.3023765996343693,0.6976234003656308,0.03912248628884826
4773,23.0,100,1551,1651,6,94,2386,607,1779,2386,155,0.041911148365465216,0.6500419111483655,0.002514668901927913,0.25440067057837384,0.7455993294216261,0.039396479463537304
4774,15.0,261,4658,4919,27,312,6601,1852,4749,6601,469,0.039539463717618545,0.7056506589910619,0.00409028935009847,0.28056355097712465,0.7194364490228753,0.0472655658233601
4775,24.0,12,6961,6973,0,339,9270,2679,6591,9270,846,0.0012944983818770227,0.7509169363538296,0.0,0.2889967637540453,0.7110032362459547,0.03656957928802589
4776,24.0,198,6693,6891,38,383,9231,2673,6558,9231,753,0.021449463763405913,0.7250568735781605,0.004116563752572852,0.28956776080597985,0.7104322391940201,0.04149062940093164
4777,,122,3946,4068,8,222,5563,1556,4007,5563,518,0.021930612978608665,0.7093294984720474,0.0014380729822038468,0.2797051950386482,0.7202948049613518,0.03990652525615675
4778,,98,2308,2406,4,176,3265,904,2361,3265,244,0.03001531393568147,0.7068912710566616,0.001225114854517611,0.27687595712098007,0.7231240428790199,0.053905053598774885
4779,17.0,858,23349,24207,53,1667,32694,9271,23423,32694,2434,0.026243347403193246,0.7141677371994861,0.0016210925552089068,0.2835688505536184,0.7164311494463816,0.05098794885911788
4780,47.0,92,2775,2867,9,73,3679,1117,2562,3679,270,0.025006795324816526,0.7542810546344115,0.002446316933949443,0.30361511280239195,0.696384887197608,0.01984234846425659
4781,24.0,114,2097,2211,29,85,2943,868,2075,2943,226,0.03873598369011213,0.7125382262996942,0.009853890587835541,0.2949371389738362,0.7050628610261638,0.028882093102276588
4782,15.0,153,3833,3986,6,176,5311,1527,3784,5311,450,0.028808134061382037,0.7217096591978912,0.001129730747505178,0.2875164752400678,0.7124835247599323,0.03313876859348522
4783,,1468,36841,38309,128,1400,49228,14382,34846,49228,3595,0.029820427399041196,0.7483749085886081,0.002600146258227025,0.29215080848297714,0.7078491915170229,0.028439099699358088
4784,25.0,92,1428,1520,0,114,2156,575,1581,2156,149,0.04267161410018553,0.6623376623376623,0.0,0.26669758812615957,0.7333024118738405,0.05287569573283859
4785,17.0,151,3786,3937,22,243,5233,1485,3748,5233,385,0.02885534110452895,0.7234855723294478,0.004204089432447927,0.28377603669023505,0.7162239633097649,0.04643607873112937
4786,16.0,155,2518,2673,40,116,3670,1018,2652,3670,225,0.04223433242506812,0.6861035422343325,0.010899182561307902,0.2773841961852861,0.7226158038147139,0.03160762942779292
4787,24.0,1481,36657,38138,327,1620,49124,14513,34621,49134,3133,0.03014206048764603,0.7460617902063744,0.006655269263646355,0.29537591077461633,0.7046240892253837,0.03297105873733056
4788,23.0,128,2190,2318,18,198,3165,867,2298,3165,219,0.04044233807266982,0.6919431279620853,0.005687203791469194,0.2739336492890995,0.7260663507109004,0.06255924170616113
4789,,238,7797,8035,39,420,10540,3096,7444,10540,814,0.02258064516129032,0.739753320683112,0.003700189753320683,0.2937381404174573,0.7062618595825427,0.03984819734345351
4790,38.0,351,9041,9392,16,545,12743,3582,9161,12743,1044,0.027544534254100292,0.7094875617986346,0.0012555913050302126,0.28109550341363887,0.7189044965863611,0.04276857882759162
4791,39.0,742,13812,14554,130,282,18842,5504,13338,18842,1671,0.03938010826876128,0.7330432013586669,0.006899479885362488,0.29211336376180874,0.7078866362381913,0.01496656405901709
4792,25.0,882,16417,17299,213,910,23184,6533,16651,23184,1822,0.03804347826086957,0.7081176673567978,0.009187370600414078,0.2817891649413389,0.7182108350586611,0.0392512077294686
4793,17.0,117,4486,4603,35,542,6866,1738,5128,6866,516,0.017040489367899796,0.6533644043110982,0.005097582289542674,0.25313137197786195,0.746868628022138,0.07893970288377512
4794,,239,6196,6435,16,341,8639,2431,6208,8639,664,0.027665239032295404,0.7172126403518926,0.0018520662113670563,0.28139830998958215,0.7186016900104178,0.03947216112976039
4795,24.0,163,3718,3881,8,319,5365,1441,3924,5365,383,0.03038210624417521,0.6930102516309413,0.0014911463187325257,0.2685927306616962,0.7314072693383038,0.05945945945945946
4796,16.0,112,1817,1929,16,138,2695,713,1982,2695,196,0.04155844155844156,0.6742115027829314,0.005936920222634508,0.26456400742115027,0.7354359925788497,0.051205936920222635
4797,,4763,94777,99540,374,5742,133704,38010,95694,133704,8728,0.035623466762400524,0.708856877879495,0.0027972237180637826,0.2842846885657871,0.7157153114342129,0.04294561120086161
4798,17.0,104,1965,2069,73,322,3134,803,2331,3134,174,0.03318442884492661,0.6269942565411615,0.023292916400765796,0.25622208040842376,0.7437779195915762,0.10274409700063816
4799,13.0,1786,26603,28389,613,1670,37069,10461,26608,37069,1634,0.04818042029728344,0.7176616579891554,0.016536728803042973,0.2822034584153875,0.7177965415846125,0.04505112088267825
4800,,354,6751,7105,25,391,9510,2768,6742,9510,719,0.03722397476340694,0.7098843322818086,0.0026288117770767614,0.291062039957939,0.708937960042061,0.041114616193480544
4801,16.0,841,23395,24236,79,1062,32218,9070,23148,32218,2639,0.02610342044819666,0.7261468744180272,0.0024520454404370227,0.28151964740207336,0.7184803525979266,0.03296293997144453
4802,26.0,3819,59266,63085,41,2419,86946,25835,61111,86946,3407,0.04392381478158857,0.6816414786189129,0.0004715570584040669,0.2971384537529041,0.7028615462470958,0.027821866445839945
4803,16.0,86,1415,1501,20,153,2095,556,1539,2095,163,0.04105011933174224,0.6754176610978521,0.00954653937947494,0.26539379474940333,0.7346062052505966,0.0730310262529833
4804,23.0,903,23968,24871,110,1552,33014,9244,23770,33014,2452,0.027352032471072877,0.7259950324104926,0.0033319197916035622,0.2800024232143939,0.719997576785606,0.04701035924153389
4805,23.0,382,22920,23302,13,793,30320,8698,21622,30320,2366,0.012598944591029023,0.7559366754617414,0.0004287598944591029,0.2868733509234829,0.7131266490765171,0.026154353562005277
4806,25.0,9386,182558,191944,920,9349,250150,73545,176605,250150,16194,0.03752148710773536,0.7297941235258845,0.0036777933240055966,0.2940035978412952,0.7059964021587047,0.037373575854487306
4807,39.0,315,14516,14831,17,670,19007,5583,13424,19007,1478,0.016572841584679327,0.763718629978429,0.0008944073236176145,0.293733887515126,0.706266112484874,0.0352501709896354
4808,26.0,184,3411,3595,3,210,4745,1368,3377,4745,350,0.03877766069546892,0.7188619599578504,0.0006322444678609062,0.28830347734457323,0.7116965226554267,0.044257112750263436
4809,,245,5395,5640,33,245,7336,2141,5195,7336,529,0.033396946564885496,0.7354143947655398,0.004498364231188659,0.2918484187568157,0.7081515812431843,0.033396946564885496
4810,16.0,230,1913,2143,10,99,3382,817,2565,3382,156,0.06800709639266705,0.5656416321703134,0.0029568302779420462,0.24157303370786518,0.7584269662921348,0.029272619751626257
4811,14.0,226,4562,4788,26,484,6761,1787,4974,6761,396,0.03342700783907706,0.6747522555834936,0.003845584972637184,0.2643100133116403,0.7356899866883597,0.0715870433367845
4812,,106,2232,2338,2,333,3250,736,2514,3250,175,0.032615384615384616,0.6867692307692308,0.0006153846153846154,0.22646153846153846,0.7735384615384615,0.10246153846153847
4813,24.0,92,33294,33386,231,1836,45422,12468,32954,45422,3960,0.002025450222359209,0.7329928228611686,0.0050856413191845366,0.27449253665624584,0.7255074633437542,0.04042094139403813
4814,14.0,533,8179,8712,11,576,11807,3274,8533,11807,706,0.04514271195053782,0.6927246548657576,0.0009316507156771407,0.27729313119335985,0.7227068688066401,0.048784619293639364
4815,17.0,197,5950,6147,13,313,8147,2294,5853,8147,603,0.024180680004909784,0.7303301828894071,0.00159567939118694,0.2815760402602185,0.7184239597397815,0.0384190499570394
4816,33.0,270,6254,6524,10,266,8715,2483,6232,8715,655,0.03098106712564544,0.7176133103843947,0.0011474469305794606,0.2849110728628801,0.7150889271371199,0.030522088353413655
4817,23.0,126,2832,2958,22,331,4121,1090,3031,4121,238,0.030575103130308177,0.6872118417859743,0.005338510070371269,0.2644989080320311,0.735501091967969,0.08032031060422228
4818,23.0,1774,37866,39640,140,2469,53310,15105,38205,53310,3638,0.03327705871318702,0.7102982554867755,0.0026261489401613208,0.28334271243669107,0.7166572875633089,0.04631401238041643
4819,34.0,597,20679,21276,82,1016,28935,7863,21072,28935,2305,0.020632452047693105,0.714670813893209,0.002833938137204078,0.27174701918092276,0.7282529808190772,0.03511318472438223
4820,,164,8105,8269,2,240,10849,3082,7767,10849,884,0.015116600608351,0.7470734629919809,0.0001843487879067195,0.2840814821642548,0.7159185178357452,0.02212185454880634
4821,25.0,609,14526,15135,46,762,20306,5743,14563,20306,1627,0.029991135624938443,0.7153550674677436,0.002265340293509308,0.2828228109918251,0.717177189008175,0.037525854427262875
4822,15.0,1152,12492,13644,9,813,18460,5202,13258,18460,1369,0.062405200433369445,0.6767063921993499,0.0004875406283856988,0.2817984832069339,0.7182015167930661,0.044041170097508124
4823,44.0,436,4110,4546,27,214,5894,1726,4168,5894,389,0.07397353240583644,0.6973193077706142,0.004580929759077028,0.29284017645062776,0.7071598235493722,0.03630810994231422
4824,34.0,13879,321389,335268,1661,17263,453513,128146,325367,453513,32024,0.030603312363702916,0.7086654627320496,0.0036625190457605407,0.28256301362915726,0.7174369863708427,0.038065060979508854
4825,,2473,47808,50281,295,3337,67416,19811,47605,67416,4069,0.036682686602586924,0.7091491634033464,0.004375815830070013,0.29386199121870177,0.7061380087812982,0.04949863533879198
4826,,184,4050,4234,10,242,5672,1619,4053,5672,422,0.03244005641748942,0.714033850493653,0.001763046544428773,0.2854372355430183,0.7145627644569816,0.04266572637517631
4827,23.0,376,16509,16885,55,489,21808,6307,15501,21808,1845,0.017241379310344827,0.7570157740278797,0.0025220102714600145,0.28920579603815116,0.7107942039618489,0.02242296404988995
4828,,202,5285,5487,49,357,7465,2054,5411,7465,584,0.027059611520428666,0.7079705291359678,0.006563965170797053,0.2751507032819826,0.7248492967180175,0.0478231748158071
4829,25.0,928,20411,21339,5,1133,28304,7997,20307,28304,2110,0.03278688524590164,0.7211348219332957,0.00017665347654041832,0.28253957037874505,0.7174604296212549,0.04002967778405879
4830,16.0,1462,70116,71578,173,1906,93051,27262,65789,93051,8079,0.01571181395148897,0.7535222619853629,0.001859195494943633,0.2929791189777649,0.7070208810222351,0.020483390828685343
4831,,265,8723,8988,20,342,11813,3389,8424,11813,977,0.022432912892575974,0.738423770422416,0.0016930500296283755,0.28688732752052826,0.7131126724794717,0.02895115550664522
4832,,3093,64211,74504,912,3749,102067,25411,76656,102067,6712,0.03030362409005849,0.6291063713051231,0.008935307200172436,0.24896391585919053,0.7510360841408095,0.03673077488316498
4833,,1081,24401,25482,101,1106,34288,9644,24644,34288,2596,0.03152706486234251,0.7116483901073262,0.0029456369575361642,0.2812645823611759,0.7187354176388241,0.03225618292113859
4834,16.0,64,3085,3149,21,526,4678,1151,3527,4678,235,0.013681060282171868,0.6594698589140658,0.004489097905087645,0.2460453185121847,0.7539546814878153,0.11244121419410004
4835,24.0,3340,75688,79028,304,2729,105466,30301,75165,105466,8786,0.03166897388731914,0.7176530825100033,0.002882445527468568,0.28730586160468774,0.7126941383953123,0.025875637646255667
4836,,2412,65841,68253,279,2705,88759,25877,62882,88759,6783,0.027174709043589946,0.7417951982334186,0.003143343210266001,0.2915422661363918,0.7084577338636082,0.030475782737525207
4837,13.0,233,3226,3459,29,278,5347,1311,4036,5347,354,0.04357583691789789,0.6033289695156162,0.005423602019824201,0.24518421544791472,0.7548157845520853,0.05199177108659061
4838,15.0,22,1432,1454,2,95,2765,538,2258,2796,212,0.007868383404864092,0.5121602288984263,0.000715307582260372,0.19241773962804007,0.8075822603719599,0.033977110157367665
4839,15.0,28,2971,2999,13,145,3977,1120,2857,3977,382,0.00704048277596178,0.7470455116922303,0.003268795574553684,0.2816193110384712,0.7183806889615288,0.03645964294694493
4840,,675,24807,25482,214,2824,35016,9777,25239,35016,2590,0.019276901987662784,0.7084475668265936,0.006111491889421979,0.27921521590130227,0.7207847840986977,0.08064884624171807
4841,25.0,412,8183,8595,22,529,11346,3181,8165,11346,847,0.03631235677771902,0.7212233386215406,0.0019390093424995593,0.2803631235677772,0.7196368764322228,0.046624361008284855
4842,,62,2302,2364,6,132,3280,860,2420,3280,255,0.018902439024390243,0.7018292682926829,0.001829268292682927,0.2621951219512195,0.7378048780487805,0.04024390243902439
4843,,898,41166,42064,125,2767,56714,16164,40550,56714,4513,0.01583383291603484,0.7258525231865148,0.0022040413301830236,0.28500899248862716,0.7149910075113729,0.04878865888493141
4844,13.0,20,3453,3473,8,116,4596,1315,3281,4596,455,0.004351610095735422,0.7513054830287206,0.0017406440382941688,0.286118363794604,0.713881636205396,0.025239338555265448
4845,24.0,130,2868,2998,9,279,4084,1056,3028,4084,273,0.031831537708129284,0.702252693437806,0.0022037218413320275,0.25857002938295787,0.7414299706170421,0.06831537708129284
4846,,44,1742,1786,0,104,2402,654,1748,2402,154,0.018318068276436304,0.7252289758534555,0.0,0.2722731057452123,0.7277268942547876,0.04329725228975854
4847,15.0,55,6204,6259,22,843,8864,2288,6576,8864,529,0.006204873646209386,0.6999097472924187,0.0024819494584837547,0.2581227436823105,0.7418772563176895,0.09510379061371842
4848,,7190,157474,164664,315,7655,215658,61407,154251,215658,16374,0.03333982509343498,0.7302024501757413,0.0014606460228695434,0.28474250897253983,0.7152574910274602,0.035496016841480495
4849,23.0,174,5232,5406,5,279,7369,2048,5321,7369,549,0.023612430451893065,0.7100013570362329,0.0006785181164337087,0.2779210204912471,0.7220789795087529,0.03786131089700095
4850,,336,8367,8703,160,1635,13081,3194,9887,13081,615,0.025686109624646434,0.6396299977065973,0.01223148077364116,0.24417093494381165,0.7558290650561884,0.1249904441556456
4851,,156,3951,4107,2,151,5378,1552,3826,5378,453,0.02900706582372629,0.7346597248047602,0.0003718854592785422,0.2885831164001488,0.7114168835998512,0.028077352175529938
4852,27.0,325,4344,4669,100,241,6353,1741,4612,6353,353,0.051156933732095074,0.68377144656068,0.015740594994490792,0.27404375885408466,0.7259562411459153,0.03793483393672281
4853,27.0,11,4034,4045,29,220,5381,1593,3788,5381,484,0.0020442296970823266,0.7496747816391005,0.0053893328377624975,0.2960416279501951,0.7039583720498048,0.040884593941646535
4854,25.0,85,6902,6987,24,453,9045,2683,6362,9045,666,0.009397457158651189,0.7630735212824765,0.0026533996683250414,0.2966279712548369,0.703372028745163,0.050082918739635156
4855,46.0,411,9319,9730,4,285,13017,3906,9111,13017,1157,0.03157409541368979,0.7159099638933702,0.00030729046631328263,0.3000691403549205,0.6999308596450795,0.02189444572482139
4856,,7,2382,2389,18,95,3298,868,2430,3298,289,0.002122498483929654,0.7222559126743481,0.005457853244390539,0.26318981200727715,0.7368101879927229,0.028805336567616736
4857,14.0,135,2096,2231,5,233,3152,837,2315,3152,226,0.04282994923857868,0.6649746192893401,0.0015862944162436548,0.2655456852791878,0.7344543147208121,0.07392131979695432
4858,17.0,2763,57284,60047,73,3306,80099,22964,57135,80099,6037,0.034494812669321716,0.7151649833331253,0.0009113721769310479,0.2866952146718436,0.7133047853281564,0.04127392351964444
4859,,2825,80103,82928,103,3356,108994,31512,77482,108994,8317,0.02591885791878452,0.7349303631392554,0.0009450061471273648,0.2891168321191992,0.7108831678808007,0.03079068572581977
4860,,91,2045,2136,7,89,2919,813,2106,2919,213,0.03117505995203837,0.7005823912298732,0.002398081534772182,0.27852004110996914,0.7214799588900308,0.030489893799246316
4861,,347,2814,3161,16,608,4587,1207,3380,4587,274,0.07564857205144974,0.6134728580771747,0.003488118596032265,0.263134946588184,0.736865053411816,0.13254850664922607
4862,25.0,307,6201,6508,81,451,8975,2571,6404,8975,595,0.03420612813370474,0.6909192200557103,0.009025069637883009,0.2864623955431755,0.7135376044568245,0.05025069637883008
4863,16.0,1011,11273,12284,194,849,16417,4707,11710,16417,1111,0.061582505938965706,0.6866662605835414,0.01181701894377779,0.28671499055856736,0.7132850094414327,0.051714685996223426
4864,,1568,32121,33689,92,1520,45827,13200,32627,45827,3030,0.034215637069849654,0.7009186723983678,0.002007550134200362,0.28803980186353023,0.7119601981364697,0.03316821960852773
4865,14.0,221,1737,1958,10,66,2617,746,1871,2617,225,0.08444784103935804,0.6637371035536874,0.0038211692777990066,0.2850592281238059,0.7149407718761941,0.025219717233473445
4866,23.0,7603,112256,119859,1045,6627,162789,45313,117476,162789,11352,0.04670462991971202,0.689579762760383,0.006419352658963443,0.27835418855082344,0.7216458114491765,0.040709138823876306
4867,27.0,197,6370,6567,52,211,8614,2542,6072,8614,644,0.022869746923612724,0.739493847225447,0.006036684467146506,0.2951009983747388,0.7048990016252612,0.024495008126306013
4868,33.0,218,6229,6447,31,158,8334,2489,5845,8334,655,0.026157907367410606,0.7474202063834893,0.0037197024238060953,0.2986561075113991,0.701343892488601,0.018958483321334294
4869,23.0,992,25007,25999,94,1722,34698,9844,24854,34698,2393,0.0285895440659404,0.7207043633638827,0.0027090898610870945,0.2837051126866102,0.7162948873133899,0.049628220646723155
4870,,141,5876,6017,60,431,8193,2259,5934,8193,550,0.01720981325521787,0.7171976077139021,0.007323324789454412,0.2757231783229586,0.7242768216770413,0.0526058830709142
4871,,625,9743,10368,71,560,15740,3915,11825,15740,723,0.03970775095298602,0.6189961880559085,0.004510800508259212,0.24872935196950444,0.7512706480304956,0.035578144853875476
4872,24.0,454,11373,11827,65,495,15853,4446,11407,15853,1316,0.02863811266006434,0.717403645997603,0.004100170314766921,0.2804516495300574,0.7195483504699426,0.031224373935532707
4873,33.0,336,7267,7603,33,362,10053,2885,7168,10053,751,0.033422858848105044,0.7228687953844624,0.003282602208296031,0.28697901124042574,0.7130209887595742,0.03600915149706555
4874,,161,2032,2193,9,126,2918,842,2076,2918,228,0.055174777244688146,0.6963673749143249,0.003084304318026045,0.28855380397532554,0.7114461960246744,0.04318026045236463
4875,27.0,180,9317,9497,11,419,12232,3508,8724,12232,835,0.014715500327011119,0.7616906474820144,0.0008992805755395684,0.2867887508175278,0.7132112491824723,0.034254414650098104
4876,,114,3579,3693,9,172,4750,1428,3322,4750,322,0.024,0.7534736842105263,0.001894736842105263,0.3006315789473684,0.6993684210526315,0.03621052631578947
4877,27.0,616,16885,17501,61,718,22856,6585,16271,22856,1921,0.02695134756737837,0.7387556877843893,0.0026688834441722085,0.2881081554077704,0.7118918445922297,0.03141407070353518
4878,,364,8701,9065,13,418,12054,3377,8677,12054,896,0.030197444831591175,0.721835075493612,0.0010784801725568277,0.28015596482495436,0.7198440351750456,0.03467728554836569
4879,17.0,255,4864,5119,13,273,6719,1949,4770,6719,466,0.037952076201815746,0.7239172495907129,0.0019348117279357048,0.29007292751897606,0.7099270724810239,0.0406310462866498
4880,45.0,177,6576,6753,9,371,8901,2517,6384,8901,710,0.01988540613414223,0.7387933940006741,0.0010111223458038423,0.2827772160431412,0.7172227839568588,0.04168071003258061
4881,,305,4630,4935,18,290,6662,1823,4839,6662,412,0.04578204743320324,0.6949864905433804,0.002701891323926749,0.27364154908435906,0.726358450915641,0.04353047132993095
4882,26.0,601,14683,15284,43,1200,21245,5873,15372,21245,1628,0.028289009178630267,0.6911273240762532,0.002024005648387856,0.2764415156507414,0.7235584843492586,0.056483878559661096
4883,,374,24173,24547,66,1398,34002,9480,24522,34002,3034,0.010999352979236515,0.7109287688959472,0.0019410622904535027,0.2788071289924122,0.7211928710075878,0.041115228515969646
4884,,514,17113,17627,21,811,23982,6633,17349,23982,1974,0.021432741222583606,0.7135768493036444,0.0008756567425569177,0.27658243682762074,0.7234175631723793,0.033817029438745726
4885,15.0,96,4706,4802,33,498,6810,1830,4980,6810,426,0.014096916299559472,0.6910425844346549,0.004845814977973568,0.2687224669603524,0.7312775330396476,0.07312775330396476
4886,15.0,230,6044,6274,35,343,8320,2364,5956,8320,615,0.027644230769230768,0.7264423076923077,0.004206730769230769,0.2841346153846154,0.7158653846153846,0.04122596153846154
4887,25.0,1103,12178,13387,61,1192,19516,4693,14841,19534,865,0.056465649636531175,0.6234258216443125,0.003122760315347599,0.24024777311354562,0.7597522268864544,0.06102180812941538
4888,,320,3771,4091,4,424,5925,1571,4354,5925,316,0.0540084388185654,0.6364556962025316,0.0006751054852320675,0.2651476793248945,0.7348523206751055,0.07156118143459915
4889,37.0,15874,403514,419392,3615,18612,546662,158650,388422,547072,36326,0.029016290360318202,0.7375884709873655,0.006607905357978475,0.28999839143659334,0.7100016085634067,0.03402111605053814
4890,,5487,81016,86503,341,5320,116231,32961,83270,116231,8533,0.04720771566965783,0.6970257504452341,0.002933812838227323,0.28358183272965043,0.7164181672703496,0.04577092169903038
4891,25.0,108,2626,2734,1,119,3653,1096,2557,3653,287,0.02956474130851355,0.7188612099644128,0.0002737476047084588,0.30002737476047087,0.6999726252395292,0.0325759649603066
4892,17.0,642,9158,9800,41,598,13446,3788,9658,13446,974,0.047746541722445336,0.6810947493678418,0.003049233972928752,0.28171947047449053,0.7182805295255095,0.04447419306857058
4893,24.0,80,1759,1839,16,169,2665,698,1967,2665,170,0.0300187617260788,0.6600375234521576,0.00600375234521576,0.2619136960600375,0.7380863039399624,0.06341463414634146
4894,,2360,33239,35599,259,2414,48411,13175,35236,48411,3228,0.04874925120323893,0.6866001528578216,0.005350023754931731,0.2721488917807936,0.7278511082192064,0.04986470017144864
4895,25.0,373,8962,9335,11,523,12444,3505,8939,12444,900,0.029974284795885566,0.7201864352298296,0.0008839601414336227,0.2816618450658952,0.7183381549341048,0.042028286724525875
4896,14.0,527,11422,11949,55,637,15858,4639,11219,15858,1000,0.03323243788624038,0.7202673729347964,0.003468280993820154,0.2925337369151217,0.7074662630848783,0.040168999873880694
4897,,38,1991,2029,4,42,2615,789,1826,2615,216,0.014531548757170172,0.761376673040153,0.0015296367112810707,0.3017208413001912,0.6982791586998088,0.01606118546845124
4898,23.0,2235,51012,53247,259,2447,68727,20112,48615,68727,4496,0.03251997031734253,0.7422410406390502,0.0037685334730164274,0.29263608188921386,0.7073639181107861,0.035604638642745934
4899,17.0,750,20744,21494,97,794,28160,8189,19971,28160,2072,0.026633522727272728,0.7366477272727273,0.003444602272727273,0.29080255681818185,0.7091974431818182,0.028196022727272726
4900,17.0,314,7402,7716,29,243,10034,2938,7096,10034,750,0.031293601754036275,0.7376918477177596,0.002890173410404624,0.2928044648196133,0.7071955351803867,0.024217659956149093
4901,34.0,5594,58313,63907,995,4019,85017,23449,61568,85017,3838,0.06579860498488538,0.6858981144947481,0.011703541644612254,0.2758154251502641,0.724184574849736,0.04727289836150417
4902,36.0,116,2022,2138,5,113,2913,796,2117,2913,210,0.03982148987298318,0.694129763130793,0.0017164435290078957,0.273257809818057,0.726742190181943,0.038791623755578444
4903,,137,37365,37502,123,5140,53005,13636,39369,53005,3387,0.002584661824356193,0.7049334968399208,0.0023205357985095747,0.25725874917460617,0.7427412508253939,0.09697198377511555
4904,15.0,140,2102,2242,22,177,3097,812,2285,3097,202,0.045205037132709076,0.6787213432353891,0.007103648692282854,0.2621892153697126,0.7378107846302874,0.05715208266063933
4905,,324,8948,9272,23,348,12129,3564,8565,12129,907,0.02671283700222607,0.7377360046170336,0.0018962816390469123,0.2938412070244868,0.7061587929755132,0.02869156566905763
4906,,193,6206,6399,40,374,8719,2360,6359,8719,664,0.022135566005275834,0.7117788737240509,0.004587682073632297,0.27067324234430556,0.7293267576556944,0.04289482738846198
4907,16.0,205,3375,3580,12,224,5031,1368,3663,5031,346,0.04074736632876168,0.6708407871198568,0.002385211687537269,0.27191413237924866,0.7280858676207513,0.044523951500695685
4908,25.0,52,1763,1815,9,59,2374,681,1693,2374,194,0.02190395956192081,0.7426284751474305,0.0037910699241786015,0.2868576242628475,0.7131423757371524,0.02485256950294861
4909,,677,13195,13872,90,683,18739,5270,13469,18739,1434,0.03612786167885159,0.7041464325737766,0.004802817653023107,0.2812316559047975,0.7187683440952025,0.036448049522386464
4910,17.0,126,4570,4696,4,231,6216,1800,4416,6216,535,0.02027027027027027,0.7351994851994852,0.0006435006435006435,0.28957528957528955,0.7104247104247104,0.037162162162162164
4911,16.0,135,3326,3461,4,211,4645,1331,3314,4645,361,0.02906350914962325,0.7160387513455329,0.000861141011840689,0.28654467168998926,0.7134553283100108,0.04542518837459634
4912,,1236,21995,23231,59,1301,32203,9036,23167,32203,2148,0.03838151724994566,0.6830108996056268,0.0018321274415427134,0.28059497562338914,0.7194050243766109,0.04039996273639102
4913,16.0,171,4284,4455,13,237,6086,1671,4415,6086,474,0.028097272428524483,0.7039106145251397,0.0021360499507065396,0.2745645744331252,0.7254354255668748,0.038941833716726916
4914,,230,4038,4268,29,279,5743,1625,4118,5743,402,0.04004875500609437,0.7031168378896048,0.005049625631203204,0.28295316036914503,0.7170468396308549,0.04858088107261013
4915,,7881,189287,197168,1023,8435,259110,75817,183293,259110,18690,0.03041565358342017,0.7305275751611284,0.003948130137779321,0.29260545714175445,0.7073945428582455,0.03255374165412373
4916,23.0,102,4482,4584,22,134,5995,1737,4258,5995,529,0.01701417848206839,0.7476230191826522,0.003669724770642202,0.28974145120934114,0.7102585487906589,0.022351959966638867
4917,,34,3810,3844,0,244,5074,1493,3581,5074,384,0.006700827749310209,0.7508868742609381,0.0,0.2942451714623571,0.7057548285376429,0.04808829325975562
4918,16.0,2761,45092,47853,381,2706,66499,18385,48114,66499,4459,0.041519421344681874,0.6780853847426277,0.005729409464803982,0.2764703228619979,0.7235296771380021,0.04069234123821411
4919,15.0,392,4111,4503,96,256,6486,1633,4853,6486,392,0.06043786617329633,0.6338267036694418,0.014801110083256245,0.25177304964539005,0.74822695035461,0.039469626888683315
4920,23.0,153,2028,4976,85,209,7382,841,6568,7409,214,0.020650560129572143,0.27372114995276015,0.011472533405317857,0.11351059522202726,0.8864894047779728,0.028208935078958025
4921,,1554,42151,43705,255,2701,59214,16400,42814,59214,4148,0.026243793697436416,0.7118417941702976,0.004306414023710609,0.27696152936805485,0.7230384706319452,0.04561421285506806
4922,,2361,12964,15325,1214,1121,21448,5638,15810,21448,447,0.11008019395747855,0.6044386422976501,0.05660201417381574,0.26286833271167476,0.7371316672883252,0.05226594554270794
4923,,135,3937,4072,24,142,5430,1569,3861,5430,475,0.024861878453038673,0.7250460405156538,0.004419889502762431,0.28895027624309394,0.7110497237569061,0.02615101289134438
4924,23.0,1738,82387,84125,203,4178,111722,31524,80198,111722,9112,0.015556470525053257,0.7374286174611984,0.0018170100785879237,0.28216465870643204,0.717835341293568,0.03739639462236623
4925,26.0,878,19341,20219,74,750,27270,7792,19478,27270,1938,0.03219655298863219,0.7092409240924092,0.0027136046938027137,0.28573524019068575,0.7142647598093143,0.027502750275027504
4926,35.0,1672,49929,51601,109,2365,66836,19745,47092,66837,4725,0.02501608390562114,0.7470263476816733,0.0016308332211200382,0.29542020138546016,0.7045797986145399,0.035384592366503584
4927,,12312,380856,393168,654,25409,522144,150018,372184,522202,36371,0.023577083197689783,0.7293269654271719,0.0012523889222944378,0.28727963508374155,0.7127203649162585,0.04865741609568711
4928,26.0,443,36549,36992,90,2177,49977,13939,36038,49977,4045,0.008864077475638794,0.7313164055465514,0.0018008283810552854,0.27890829781699583,0.7210917021830042,0.04356003761730396
4929,,132,3370,3502,0,123,4649,1343,3306,4649,343,0.028393202839320283,0.7248870724887072,0.0,0.2888793288879329,0.7111206711120671,0.026457302645730263
4930,15.0,378,8778,9156,48,866,12777,3444,9333,12777,928,0.02958440948579479,0.6870157313923456,0.0037567504108945763,0.2695468419816858,0.7304531580183141,0.06777803866322298
4931,,2381,106785,109166,188,3339,145273,41838,103435,145273,12130,0.01638983155851397,0.7350643271633407,0.001294115217555912,0.2879957046388524,0.7120042953611476,0.022984312294782927
4932,,700,18091,18791,104,1144,25181,6908,18273,25181,1823,0.027798737143084073,0.7184385052221913,0.004130098089829634,0.2743338231206068,0.7256661768793932,0.04543107898812597
4933,37.0,102,3030,3132,11,110,4023,1219,2804,4023,332,0.02535421327367636,0.7531692766592095,0.002734277902063137,0.3030077056922694,0.6969922943077306,0.02734277902063137
4934,23.0,268,11642,11910,59,524,15590,4511,11079,15590,1187,0.017190506735086594,0.7467607440667094,0.003784477228992944,0.28935214881334187,0.7106478511866581,0.03361128928800513
4935,17.0,280,3994,4274,103,255,5974,1619,4355,5974,404,0.04686976899899565,0.668563776364245,0.017241379310344827,0.2710077000334784,0.7289922999665216,0.042684968195513893
4936,,663,13616,14279,41,839,19649,5412,14237,19649,1342,0.03374217517430912,0.6929614738663545,0.0020866201842332944,0.27543386431879485,0.7245661356812052,0.04269937401394473
4937,,114,3840,3954,19,129,5108,1495,3613,5108,416,0.022317932654659357,0.7517619420516837,0.0037196554424432263,0.2926781519185591,0.7073218480814408,0.025254502740798747
4938,26.0,880,17741,18621,353,764,24387,7230,17157,24387,956,0.03608479927830401,0.727477754541354,0.014474925165046951,0.2964694304342478,0.7035305695657522,0.03132816664616394
4939,17.0,151,2483,2634,3,137,3665,990,2675,3665,256,0.04120054570259209,0.6774897680763984,0.0008185538881309686,0.27012278308321963,0.7298772169167803,0.0373806275579809
4940,24.0,51,4156,4207,59,229,5623,1584,4039,5623,468,0.009069891516983817,0.7391072381291126,0.010492619598079317,0.2817001600569091,0.7182998399430909,0.0407255913213587
4941,16.0,40,1866,1906,11,67,2554,728,1826,2554,169,0.015661707126076743,0.73061863743148,0.004306969459671104,0.2850430696945967,0.7149569303054033,0.026233359436178542
4942,16.0,651,14524,15175,95,1076,21415,5850,15568,21418,1114,0.03039499486413297,0.6781212064618545,0.004435521523951816,0.27313474647492764,0.7268652535250724,0.050238117471285836
4943,35.0,2607,63756,66363,155,3679,88099,25188,62911,88099,6139,0.029591709327007117,0.7236858534149082,0.0017593843289935187,0.2859056288947661,0.7140943711052339,0.04175983836365907
4944,17.0,258,2284,2542,12,247,3611,978,2633,3611,213,0.07144835225699252,0.6325117695929106,0.003323179174743838,0.2708391027416228,0.7291608972583772,0.068402104680144
4945,17.0,1156,8782,9938,45,1813,15294,3797,11497,15294,588,0.07558519680920622,0.5742121093239179,0.0029423303256178894,0.2482672943638028,0.7517327056361972,0.11854321956322741
4946,24.0,1602,30350,31952,108,1541,42510,12162,30348,42510,2810,0.03768525052928723,0.7139496589037874,0.0025405786873676783,0.28609738884968244,0.7139026111503176,0.03625029404845918
4947,,446,11418,11864,24,593,15358,4569,10789,15358,1132,0.029040239614533142,0.7434561791899987,0.0015627034770152363,0.2974996744367756,0.7025003255632244,0.038611798411251466
4948,,58,2308,2366,5,60,3053,887,2166,3053,266,0.01899770717327219,0.7559777268260727,0.0016377333770062235,0.29053390108090404,0.709466098919096,0.01965280052407468
4949,17.0,458,6562,7020,1,472,9407,2579,6828,9407,572,0.048687147868608484,0.6975656426065696,0.00010630381630700542,0.274157542255767,0.7258424577442331,0.050175401296906556
4950,24.0,1076,26668,27744,74,1804,37331,10522,26810,37332,3099,0.028822457944926605,0.7143469409621772,0.0019822136504875176,0.2818493517625629,0.718150648237437,0.04832315439837137
4951,,674,19232,19906,76,831,26008,7570,18438,26008,1846,0.025915103045216856,0.7394647800676715,0.002922177791448785,0.29106428791141187,0.7089357120885881,0.03195170716702553
4952,36.0,205,6428,6633,6,243,8526,2546,5980,8526,716,0.024044100398780202,0.7539291578700446,0.0007037297677691766,0.2986159981233873,0.7013840018766128,0.028501055594651655
4953,17.0,198,1821,2019,0,143,3261,841,2420,3261,201,0.06071757129714812,0.5584176632934683,0.0,0.2578963508126342,0.7421036491873658,0.043851579270162526
4954,17.0,890,23464,24354,93,1077,32691,9407,23284,32691,2827,0.027224618396500568,0.7177510629836958,0.0028448196751399467,0.28775503961334925,0.7122449603866507,0.03294484720565293
4955,,948,14519,15467,15,794,20503,6093,14410,20503,1382,0.046237136028873825,0.7081402721552943,0.0007316002536214213,0.2971760230210213,0.7028239769789787,0.0387260400916939
4956,,178,3872,4050,17,221,5539,1560,3979,5539,335,0.03213576457844376,0.6990431485827767,0.003069146055244629,0.28163928506950714,0.7183607149304929,0.03989889871818018
4957,23.0,1016,30935,31951,136,909,41585,12125,29460,41585,3241,0.02443188649753517,0.7438980401587111,0.00327041000360707,0.291571480100998,0.708428519899002,0.02185884333293255
4958,36.0,2850,71170,74020,236,3036,95826,28465,67361,95826,6713,0.029741406298916785,0.7427003109803185,0.00246279715317346,0.2970488176486549,0.7029511823513451,0.031682424394214516
4959,,93,3944,4037,31,237,5351,1602,3749,5351,449,0.017379928985236406,0.737058493739488,0.005793309661745468,0.29938329284245935,0.7006167071575407,0.04429078676882826
4960,,244,3847,4091,61,262,5593,1569,4024,5593,349,0.04362596102270695,0.6878240657965313,0.010906490255676738,0.28052923296978366,0.7194707670302164,0.04684426962274271
4961,43.0,224,6062,6286,64,173,8297,2413,5884,8297,688,0.026997710015668315,0.7306255272990237,0.00771363143304809,0.2908280101241413,0.7091719898758587,0.020850909967458118
4962,,122,2897,3019,1,157,4002,1154,2848,4002,341,0.030484757621189407,0.723888055972014,0.0002498750624687656,0.28835582208895555,0.7116441779110445,0.039230384807596205
4963,26.0,116,2849,2965,7,145,3907,1188,2719,3907,218,0.0296902994625032,0.729203992833376,0.0017916560020476069,0.3040696186332224,0.6959303813667775,0.037112874328129
4964,23.0,179,4068,4247,12,218,5582,1659,3923,5582,449,0.032067359369401645,0.728771049802938,0.002149767108563239,0.2972053027588678,0.7027946972411322,0.03905410247223218
4965,,314,14829,15143,57,566,20290,5696,14594,20290,1888,0.01547560374568753,0.7308526367668803,0.0028092656481025135,0.2807294233612617,0.7192705766387383,0.027895515032035485
4966,16.0,583,9979,10562,77,721,14099,3918,10181,14099,798,0.04135045038655224,0.7077806936662174,0.005461380239733315,0.2778920490814951,0.7221079509185049,0.051138378608411944
4967,25.0,134,3636,3770,13,240,5076,1453,3623,5076,359,0.02639873916469661,0.7163120567375887,0.00256107171000788,0.2862490149724192,0.7137509850275807,0.04728132387706856
4968,,33,1393,1426,4,229,1955,403,1552,1955,106,0.01687979539641944,0.7125319693094629,0.0020460358056265983,0.2061381074168798,0.7938618925831202,0.11713554987212277
4969,17.0,3032,38527,41559,1312,3936,58190,16144,42046,58190,3323,0.05210517271008765,0.6620897061350748,0.022546829352122356,0.27743598556453,0.72256401443547,0.06764048805636708
4970,16.0,60,1542,1602,6,40,2118,603,1515,2118,179,0.028328611898016998,0.7280453257790368,0.0028328611898017,0.2847025495750708,0.7152974504249292,0.018885741265344664
4971,15.0,175,10546,10721,41,487,14184,4080,10104,14184,1237,0.012337845459672871,0.7435138183869149,0.0028905809362662154,0.2876480541455161,0.7123519458544839,0.03433446136491822
4972,,97,2470,2567,18,64,3258,949,2309,3258,199,0.029772866789441375,0.7581338244321669,0.0055248618784530384,0.2912829957028852,0.7087170042971148,0.019643953345610803
4973,24.0,3418,50399,53817,1417,3507,74165,20464,53774,74238,5445,0.04604111102130984,0.67888412942159,0.0190872598938549,0.27565397774724537,0.7243460222527547,0.04723995797300574
4974,,1078,28910,29988,58,1313,38982,11528,27454,38982,2769,0.02765378892822328,0.7416243394387153,0.001487866194653943,0.29572623262018366,0.7042737673798163,0.03368221230311426
4975,27.0,28717,586482,615199,3569,29061,815608,233953,581655,815608,51670,0.03520931624015458,0.7190733783876568,0.004375876646624359,0.286844905886161,0.713155094113839,0.03563108748320271
4976,,101,2417,2518,22,160,3405,972,2433,3405,238,0.029662261380323053,0.7098384728340675,0.0064610866372980915,0.2854625550660793,0.7145374449339207,0.04698972099853157
4977,14.0,494,7091,7585,7,874,10317,2658,7659,10317,634,0.04788213627992634,0.6873122031598333,0.0006784918096345837,0.25763303285838907,0.7423669671416109,0.0847145488029466
4978,24.0,2038,45843,47881,279,2898,64317,18090,46227,64317,4842,0.03168680131225026,0.7127664536592192,0.004337888894071552,0.28126311861560704,0.718736881384393,0.045058071738420635
4979,,352,7512,7864,99,393,10970,2946,8024,10970,637,0.03208751139471285,0.6847766636280765,0.00902461257976299,0.26855059252506835,0.7314494074749316,0.035824977210574295
4980,15.0,986,22052,23038,844,1524,31354,8592,22762,31354,1896,0.03144734324169165,0.7033233399247305,0.026918415513172162,0.2740320214326721,0.725967978567328,0.04860623843847675
4981,,1374,30990,32364,209,2038,43452,11975,31477,43452,3001,0.031621099143882905,0.7132007732670533,0.004809905182730369,0.2755914572401731,0.7244085427598269,0.04690232900672006
4982,27.0,2817,49585,52402,254,3464,71185,20105,51080,71185,4621,0.039572943738147084,0.6965652876308212,0.003568167451007937,0.2824330968602936,0.7175669031397064,0.04866193720587202
4983,25.0,4,3601,3605,8,181,4761,1366,3395,4761,427,0.0008401596303297626,0.7563537072043688,0.0016803192606595252,0.28691451375761395,0.7130854862423861,0.03801722327242176
4984,23.0,1788,21778,23566,129,1041,31584,9177,22407,31584,2646,0.05661094224924012,0.6895263424518744,0.00408434650455927,0.29055851063829785,0.7094414893617021,0.032959726443768995
4985,35.0,9,4310,4319,3,150,5873,1715,4158,5873,653,0.001532436574152903,0.7338668482887791,0.000510812191384301,0.29201430274135876,0.7079856972586412,0.025540609569215052
4986,13.0,437,42260,42697,122,6606,61751,16242,45509,61751,5034,0.007076808472737284,0.6843613868601318,0.00197567650726304,0.26302408058169097,0.736975919418309,0.10697802464737413
4987,23.0,141,2259,2400,2,243,3473,937,2536,3473,199,0.040598905845090696,0.6504463000287936,0.0005758710048949035,0.2697955657932623,0.7302044342067376,0.06996832709473078
4988,,96,2095,2191,6,80,2884,866,2018,2884,187,0.033287101248266296,0.7264216366158114,0.0020804438280166435,0.3002773925104022,0.6997226074895978,0.027739251040221916
4989,23.0,110,5666,5776,3,249,7470,2235,5235,7470,656,0.014725568942436412,0.7585006693440428,0.00040160642570281126,0.2991967871485944,0.7008032128514057,0.03333333333333333
4990,37.0,299,5410,5709,10,139,7931,2257,5674,7931,475,0.03770016391375615,0.6821334005800025,0.0012608750472828142,0.28457949817173117,0.7154205018282688,0.017526163157231118
4991,26.0,46,1582,1628,1,94,2142,642,1500,2142,173,0.021475256769374416,0.738562091503268,0.00046685340802987864,0.29971988795518206,0.7002801120448179,0.04388422035480859
4992,15.0,1305,32101,33406,37,2194,45327,12852,32475,45327,3635,0.028790786948176585,0.7082092351137291,0.0008162905111743552,0.28353961215169765,0.7164603878483023,0.04840382112206852
4993,,4229,115045,119274,177,4220,158301,45286,113015,158301,12360,0.026714929153953543,0.7267484096752389,0.0011181230693425815,0.2860752616850178,0.7139247383149823,0.026658075438563245
4994,17.0,161,22729,22890,154,2754,32519,8552,23967,32519,1969,0.004950951751283864,0.6989452320182047,0.004735692979488914,0.2629847166272026,0.7370152833727974,0.0846889510747563
4995,24.0,213,4957,5170,30,970,8141,1986,6155,8141,484,0.02616386193342341,0.608893256356713,0.003685050976538509,0.2439503746468493,0.7560496253531507,0.11914998157474511
4996,27.0,646,11361,12007,20,604,16245,4621,11624,16245,1153,0.03976608187134503,0.699353647276085,0.0012311480455524776,0.2844567559249,0.7155432440751001,0.037180670975684824
4997,17.0,1192,26458,27650,133,1675,37856,10368,27488,37856,2682,0.031487743026204565,0.6989116652578191,0.0035133136094674558,0.2738799661876585,0.7261200338123415,0.04424661876584954
4998,23.0,745,25801,26546,27,1170,33776,10448,23330,33778,1785,0.022055775948842442,0.7638403694712534,0.0007993368464681153,0.30931375451477294,0.6906862454852271,0.03463793001361833
4999,27.0,25734,592014,617748,2795,34810,846038,236434,609604,846038,66150,0.03041707346478527,0.6997487110508038,0.0033036341157252984,0.27946026065023083,0.7205397393497691,0.041144723995848884
5000,24.0,66,3080,3146,8,94,4039,1181,2858,4039,329,0.016340678385739046,0.7625649913344887,0.0019806882891804903,0.29239910869026986,0.7076008913097301,0.02327308739787076
5001,17.0,1316,25224,26540,197,1971,35762,10253,25509,35762,2517,0.03679883675409653,0.7053296795481238,0.005508640456350316,0.2867009675074101,0.7132990324925899,0.055114367205413566
5002,25.0,301,4702,5003,27,383,6800,1878,4922,6800,394,0.04426470588235294,0.6914705882352942,0.003970588235294117,0.2761764705882353,0.7238235294117648,0.0563235294117647
5003,14.0,2634,58686,61320,50,2906,89320,22724,66596,89320,5880,0.02948947604120018,0.6570309001343484,0.0005597850425436632,0.2544111061352441,0.7455888938647559,0.032534706672637706
5004,26.0,661,12504,13165,201,398,17918,4981,12937,17918,1197,0.036890277932805,0.6978457417122447,0.011217769840383971,0.27798861480075904,0.722011385199241,0.02221230047996428
5005,,301,9650,9951,38,320,12835,3832,9003,12835,1100,0.0234514998052201,0.7518504090377873,0.0029606544604596804,0.29855862874951306,0.701441371250487,0.024931827035449942
5006,23.0,4163,61091,65254,461,4217,89868,24717,65151,89868,5155,0.04632349668402546,0.6797859082209463,0.0051297458494681085,0.27503672052343436,0.7249632794765656,0.04692437797658788
5007,17.0,95,2028,2123,2,90,2875,796,2079,2875,238,0.03304347826086956,0.705391304347826,0.0006956521739130435,0.2768695652173913,0.7231304347826087,0.03130434782608696
5008,16.0,199,4452,4651,19,240,6290,1776,4514,6290,482,0.03163751987281399,0.7077901430842607,0.0030206677265500795,0.2823529411764706,0.7176470588235294,0.03815580286168521
5009,13.0,353,5518,5871,71,553,7987,2202,5785,7987,469,0.04419681983222737,0.6908726680856392,0.008889445348691623,0.2756980092650557,0.7243019907349443,0.06923751095530237
5010,35.0,9601,136155,145756,1824,9985,200879,55058,145821,200879,14069,0.047794941233279736,0.677796086201146,0.009080092991303221,0.274085394690336,0.725914605309664,0.04970653975776462
5011,37.0,325,9909,10234,37,234,13211,3872,9339,13211,1147,0.024600711528271896,0.7500567708727576,0.0028006963893724927,0.29308909242298087,0.7069109075770191,0.017712512300355764
5012,24.0,156,2953,3109,14,174,4205,1172,3033,4205,261,0.0370986920332937,0.7022592152199763,0.0033293697978596906,0.2787158145065398,0.7212841854934602,0.041379310344827586
5013,14.0,75,1490,1565,6,112,2099,583,1516,2099,155,0.03573130061934254,0.7098618389709386,0.0028585040495474035,0.2777513101476894,0.7222486898523106,0.0533587422582182
5014,14.0,7517,68048,75565,527,6387,108848,29077,79771,108848,5903,0.0690596060561517,0.625165368219903,0.004841613993826253,0.2671339850066147,0.7328660149933852,0.05867815669557548
5015,14.0,403,4991,5394,6,301,7294,2042,5252,7294,541,0.05525089114340554,0.6842610364683301,0.0008225939128050452,0.2799561283246504,0.7200438716753496,0.04126679462571977
5016,,5192,124685,129877,442,7940,173573,51157,122418,173575,9700,0.0299121417254789,0.718335013682846,0.002546449661529598,0.29472562292956933,0.7052743770704306,0.04574391473426473
5017,,244,7467,7711,14,372,10237,2904,7333,10237,711,0.02383510794177982,0.7294129139396307,0.001367588160593924,0.28367685845462537,0.7163231415453746,0.03633877112435284
5018,24.0,827,33241,34068,195,1044,43696,13111,30585,43696,3486,0.018926217502746246,0.7607332478945441,0.004462651043573782,0.3000503478579275,0.6999496521420725,0.023892347125595022
5019,,642,5399,6041,30,468,8301,2347,5954,8301,546,0.07734007950849295,0.6504035658354416,0.003614022406938923,0.2827370196361884,0.7172629803638116,0.056378749548247196
5020,,304,4564,4868,352,191,6835,1664,5171,6835,403,0.04447695683979517,0.6677395757132407,0.0514996342355523,0.24345281638624724,0.7565471836137527,0.027944403803950257
5021,,88,2201,2289,9,207,3226,858,2368,3226,200,0.02727836329820211,0.6822690638561686,0.002789832610043397,0.26596404215747055,0.7340359578425294,0.06416615003099814
5022,17.0,150,3110,3260,11,154,4866,1227,3639,4866,273,0.030826140567200986,0.6391286477599671,0.002260583641594739,0.2521578298397041,0.747842170160296,0.03164817098232635
5023,,267,8956,9223,83,351,12054,3445,8609,12054,740,0.02215032354405177,0.7429898788783806,0.006885681101708977,0.2857972457275593,0.7142027542724407,0.029118964659034345
5024,25.0,15013,326466,341479,4251,29956,481257,129062,352195,481257,28545,0.031195390404710997,0.678361042021207,0.00883311827152644,0.2681768784661833,0.7318231215338167,0.062245328379639156
5025,24.0,1066,23045,24111,157,1068,31826,9180,22646,31826,2380,0.033494627034500096,0.7240935084522089,0.004933073587632753,0.28844341104757115,0.7115565889524288,0.03355746873625338
5026,17.0,1513,41235,42748,108,1541,54870,16313,38557,54870,3677,0.027574266447967923,0.7515035538545654,0.0019682886823400767,0.2973027155093858,0.7026972844906142,0.028084563513759795
5027,25.0,67,2729,2796,0,125,3714,1081,2633,3714,285,0.018039849219170706,0.7347872913301023,0.0,0.2910608508346796,0.7089391491653204,0.03365643511039311
5028,27.0,118,1963,2081,14,252,3107,790,2319,3109,221,0.037954326149887425,0.6313927307816019,0.004503055644901898,0.2541009971051785,0.7458990028948215,0.08105500160823416
5029,23.0,487,9302,9789,42,684,13228,3683,9545,13228,872,0.03681584517689749,0.7032053220441488,0.0031750831569398244,0.2784245539764137,0.7215754460235864,0.051708497127305714
5030,23.0,246,6338,6584,34,443,8855,2418,6437,8855,601,0.027780914737436477,0.7157538114059854,0.0038396386222473177,0.2730660643704122,0.7269339356295879,0.05002823263692829
5031,17.0,1059,29700,30759,64,1918,40834,11930,28904,40834,3461,0.025934270460890436,0.7273350639173238,0.0015673213498555126,0.2921584953715041,0.7078415046284958,0.046970661703482394
5032,23.0,147,4179,4326,9,201,5687,1663,4024,5687,430,0.02584842623527343,0.7348338315456304,0.0015825567082820467,0.29242131176367153,0.7075786882363285,0.03534376648496571
5033,16.0,3505,68475,71980,638,3901,98623,27623,71000,98623,6520,0.035539377224379706,0.6943106577573183,0.006469079220871399,0.2800867951694838,0.7199132048305162,0.0395546677752654
5034,34.0,1316,39772,41088,245,1257,52435,15832,36603,52435,3533,0.025097740059120816,0.75850100123963,0.0046724516067512155,0.30193572995136836,0.6980642700486316,0.02397253742729093
5035,15.0,253,4929,5182,5,357,6986,2012,4974,6986,511,0.03621528771829373,0.7055539650730032,0.0007157171485828801,0.2880045805897509,0.711995419410249,0.05110220440881764
5036,,596,22084,22680,24,612,28978,8711,20267,28978,2180,0.020567326937676857,0.7620953827041204,0.0008282145075574574,0.3006073573055421,0.6993926426944579,0.021119469942715165
5037,37.0,1137,30602,31739,132,2085,42799,12230,30569,42799,3100,0.026566041262646323,0.7150167059978036,0.0030841842099114465,0.28575434005467415,0.7142456599453259,0.04871609149746489
5038,,2837,6547,9384,41,401,12755,3529,9226,12755,746,0.22242257938063503,0.5132889063112505,0.0032144257154057233,0.27667581340650726,0.7233241865934927,0.03143865150921207
5039,,61,2222,2283,7,134,3044,881,2163,3044,240,0.020039421813403416,0.7299605781865965,0.0022996057818659658,0.28942181340341655,0.7105781865965834,0.04402102496714849
5040,36.0,122,3218,3340,25,216,4444,1295,3149,4444,314,0.027452745274527453,0.7241224122412241,0.0056255625562556255,0.2914041404140414,0.7085958595859586,0.048604860486048604
5041,24.0,1128,20973,22101,164,1035,30594,8364,22230,30594,2136,0.036869974504804864,0.6855265738380074,0.005360528208145388,0.2733869386154148,0.7266130613845853,0.0338301627770151
5042,,97,3015,3112,7,233,4304,1163,3141,4304,320,0.02253717472118959,0.7005111524163569,0.0016263940520446097,0.27021375464684017,0.7297862453531598,0.05413568773234201
5043,16.0,159,4095,4254,8,196,5726,1602,4124,5726,397,0.02776807544533706,0.715158924205379,0.0013971358714634998,0.27977645826056585,0.7202235417394341,0.034229828850855744
5044,15.0,216,6081,6297,35,223,8377,2392,5985,8377,772,0.02578488719111854,0.7259161991166289,0.004178106720783096,0.2855437507460905,0.7144562492539095,0.02662050853527516
5045,23.0,1496,39342,40838,76,1601,53297,15748,37549,53297,4153,0.02806912208942342,0.738165375161829,0.0014259714430455749,0.2954762932247594,0.7045237067752407,0.030039214214683755
5046,15.0,2344,50811,53155,172,1906,71285,19997,51288,71285,5637,0.03288209300694396,0.7127867012695518,0.002412849828154591,0.2805218489163218,0.7194781510836782,0.02673774286315494
5047,,5142,66996,72138,235,6455,100681,28473,72208,100681,7510,0.05107219832937694,0.6654284323755227,0.0023341047466751423,0.2828041040514099,0.7171958959485901,0.06411338782888529
5048,17.0,656,14185,14841,99,1288,20691,5595,15096,20691,1384,0.031704605867285296,0.6855637716881736,0.004784688995215311,0.2704074235174714,0.7295925764825286,0.06224928712966991
5049,34.0,131,2580,2711,8,144,3591,1022,2569,3591,284,0.03648008911166806,0.7184628237259816,0.002227791701475912,0.28460038986354774,0.7153996101364523,0.040100250626566414
5050,15.0,1077,40340,41417,26,1562,53636,15126,38513,53639,4484,0.020078674099069705,0.7520647290217939,0.0004847219373962975,0.2819963086560152,0.7180036913439848,0.029120602546654488
5051,24.0,393,8913,9306,19,509,12422,3481,8941,12422,1031,0.03163741748510707,0.717517308001932,0.0015295443567863469,0.2802286266301723,0.7197713733698278,0.04097568829496055
5052,,1852,50626,52478,224,2520,68367,20150,48217,68367,5362,0.027089092690918134,0.7405034592712858,0.0032764345371304867,0.2947328389427648,0.7052671610572352,0.036859888542717975
5053,16.0,792,16373,17165,192,809,22944,6506,16438,22944,1579,0.034518828451882845,0.7136070432357043,0.008368200836820083,0.2835599721059972,0.7164400278940027,0.03525976290097629
5054,,513,19015,19528,29,1647,26691,7728,18963,26691,2005,0.019219961784871304,0.7124124236634072,0.001086508560938144,0.2895357985837923,0.7104642014162077,0.061706193098797345
5055,26.0,95,3484,3583,5,293,5233,1351,3882,5233,393,0.018154022549206957,0.6657748901203898,0.0009554748710108924,0.2581693101471431,0.7418306898528568,0.055990827441238296
5056,14.0,269,7977,8246,12,378,12765,3259,9506,12765,635,0.021073247160203683,0.6249118683901292,0.0009400705052878966,0.25530748139443793,0.7446925186055621,0.029612220916568743
5057,14.0,271,4608,4879,0,366,6572,1856,4716,6572,389,0.041235544735240416,0.7011564211807669,0.0,0.2824102251978089,0.7175897748021911,0.055690809494826535
5058,,782,18349,19131,487,1021,25574,7200,18374,25574,1669,0.030577930710878234,0.7174865097364511,0.019042777821224682,0.28153593493391726,0.7184640650660827,0.039923359662156876
5059,,174,3828,4002,15,157,5411,1530,3881,5411,469,0.03215671779708002,0.7074477915357605,0.002772130844575864,0.28275734614673814,0.7172426538532619,0.029014969506560708
5060,36.0,97,3392,3489,0,240,4539,1256,3283,4539,281,0.021370345891165456,0.7473011676580744,0.0,0.27671293236395683,0.7232870676360432,0.05287508261731659
5061,23.0,387,10165,10552,195,390,13349,3928,9421,13349,776,0.028990935650610533,0.7614802606936849,0.014607835792943292,0.2942542512547756,0.7057457487452243,0.029215671585886584
5062,,2785,422625,425410,5540,30943,576702,160880,415822,576702,46712,0.004829183876594844,0.7328308207705193,0.009606347819150965,0.27896556627166197,0.7210344337283381,0.05365509396534085
5063,,262,3790,4052,15,249,5606,1509,4097,5606,405,0.04673564038530146,0.6760613628255441,0.002675704602211916,0.2691758829825187,0.7308241170174813,0.0444166963967178
5064,23.0,562,13921,14483,73,716,19113,5577,13536,19113,1239,0.02940407052791294,0.7283524302830534,0.003819389944017161,0.2917909276408727,0.7082090723591273,0.03746141369748339
5065,26.0,819,18206,19025,174,1188,25429,7255,18193,25448,1810,0.03218327569946558,0.7154196793461176,0.006837472492926752,0.28509116629990566,0.7149088337000943,0.04668343288274128
5066,27.0,457,8819,9276,75,612,12575,3395,9180,12575,923,0.03634194831013916,0.7013121272365805,0.005964214711729622,0.2699801192842942,0.7300198807157058,0.048667992047713715
5067,,1720,42639,44359,236,2332,60478,16564,43914,60478,4515,0.028440093918449684,0.7050332352260326,0.0039022454446244917,0.27388471841000034,0.7261152815899997,0.038559476173153875
5068,23.0,456,4464,4920,11,164,8015,1706,6309,8015,325,0.056893325015595755,0.5569557080474111,0.001372426699937617,0.21285090455396133,0.7871490954460387,0.020461634435433564
5069,25.0,639,18584,19223,27,617,24879,7391,17488,24879,1848,0.025684312070420837,0.7469753607460107,0.0010852526226938382,0.2970778568270429,0.7029221431729571,0.024800032155633266
5070,15.0,144,3007,3151,8,232,4284,1191,3093,4284,261,0.03361344537815126,0.7019140989729225,0.0018674136321195146,0.27801120448179273,0.7219887955182073,0.05415499533146592
5071,39.0,451,8355,8806,45,576,12085,3238,8847,12085,732,0.03731899048407116,0.6913529168390566,0.003723624327678941,0.26793545717832024,0.7320645428216798,0.047662391394290446
5072,25.0,334,8053,8387,41,280,11143,3213,7930,11143,869,0.029973974692632147,0.7226958628735529,0.003679440007179395,0.2883424571479853,0.7116575428520148,0.025127882975859283
5073,,1918,48156,50074,316,2675,66643,18787,47856,66643,4727,0.028780216977026846,0.7225965217652267,0.004741683297570637,0.2819050763020872,0.7180949236979127,0.04013924943354891
5074,26.0,3278,74385,77663,652,3836,103551,29434,74117,103551,6979,0.03165589902560091,0.7183416867051018,0.006296414327239717,0.284246409981555,0.715753590018445,0.03704454809707294
5075,16.0,528,8843,9371,42,648,12903,3527,9376,12903,778,0.04092071611253197,0.6853444935286368,0.0032550569634968614,0.27334728357746263,0.7266527164225374,0.050220878865380146
5076,16.0,535,33036,33571,202,2792,45997,12587,33410,45997,3821,0.011631193338696002,0.718220753527404,0.004391590755918864,0.27364828140965713,0.7263517185903429,0.06069961084418549
5077,,87,2999,3086,6,111,4009,1228,2781,4009,347,0.021701172362185085,0.7480668495884261,0.0014966325767024195,0.30631080069842853,0.6936891993015715,0.02768770266899476
5078,,194,5866,6060,37,504,8233,2335,5898,8233,682,0.023563707032673388,0.7124984817199077,0.0044941090732418315,0.28361472124377507,0.7163852787562249,0.06121705332199684
5079,,3808,71186,74994,673,3984,100365,28804,71561,100365,7482,0.03794151347581328,0.7092711602650327,0.006705524834354605,0.2869924774572809,0.713007522542719,0.039695112838140784
5080,,256,9247,9503,22,1418,13574,3538,10036,13574,829,0.018859584499778988,0.6812288198025638,0.0016207455429497568,0.2606453514071018,0.7393546485928982,0.10446441726830706
5081,17.0,2169,37399,39568,172,4172,54571,15167,39404,54571,3840,0.03974638544281761,0.6853273716809294,0.003151857213538326,0.2779315020798593,0.7220684979201407,0.07645086217954591
5082,16.0,374,23108,23482,91,870,31875,8847,23028,31875,2862,0.011733333333333333,0.7249568627450981,0.0028549019607843136,0.2775529411764706,0.7224470588235294,0.027294117647058823
5083,,121,3665,3786,23,175,5408,1439,3969,5408,394,0.022374260355029586,0.6776997041420119,0.004252958579881657,0.2660872781065089,0.7339127218934911,0.0323594674556213
5084,17.0,168,2620,2788,9,186,3842,1072,2770,3842,248,0.04372722540343571,0.6819364914107235,0.002342529932326913,0.27902134305049453,0.7209786569495055,0.048412285268089536
5085,14.0,253,6162,6415,23,443,8583,2431,6152,8583,655,0.029476872888267506,0.717930793428871,0.002679715717115228,0.2832343003611791,0.716765699638821,0.05161365489921939
5086,16.0,192,2133,2325,5,157,3128,901,2227,3128,222,0.061381074168797956,0.6819053708439897,0.00159846547314578,0.28804347826086957,0.7119565217391305,0.0501918158567775
5087,25.0,276,5570,5846,20,301,7957,2214,5743,7957,576,0.034686439612919444,0.7000125675505844,0.0025135101168782203,0.278245569938419,0.721754430061581,0.03782832725901722
5088,15.0,340,6217,6557,6,236,8690,2524,6166,8690,683,0.039125431530494824,0.7154200230149598,0.0006904487917146145,0.2904487917146145,0.7095512082853855,0.02715765247410817
5089,26.0,117,2570,2687,48,171,3785,976,2809,3785,216,0.030911492734478203,0.678996036988111,0.012681638044914135,0.25785997357992074,0.7421400264200793,0.04517833553500661
5090,26.0,3667,106982,110649,272,4259,142360,42656,99704,142360,10849,0.025758640067434672,0.7514891823545939,0.0019106490587243608,0.29963472885642034,0.7003652711435796,0.029917111548187693
5091,24.0,3757,74488,78245,459,3387,104161,29827,74334,104161,7589,0.036069162162421634,0.7151237027294285,0.004406639721200833,0.28635477769990686,0.7136452223000931,0.032516968923109416
5092,,275,6336,6611,43,316,8792,2482,6310,8792,672,0.031278434940855325,0.7206551410373067,0.0048908098271155595,0.282302092811647,0.717697907188353,0.0359417652411283
5093,35.0,44,1899,1943,12,23,2513,751,1762,2513,230,0.017508953442101075,0.7556705133306805,0.00477516912057302,0.29884600079586154,0.7011539992041385,0.00915240748109829
5094,14.0,5195,89042,94237,536,6644,126560,35459,91101,126560,9398,0.04104772439949431,0.7035556257901391,0.004235145385587864,0.2801754108723135,0.7198245891276864,0.052496839443742095
5095,,90,3617,3707,8,137,4809,1404,3405,4809,365,0.018714909544603867,0.752131420253691,0.0016635475150758993,0.2919525888958203,0.7080474111041797,0.028488251195674778
5096,34.0,521,12583,13104,21,824,17497,4827,12670,17497,1147,0.029776533119963422,0.7191518546036464,0.001200205749557067,0.27587586443390294,0.724124135566097,0.047093787506429674
5097,23.0,2523,4744,7267,9,245,9553,2816,6737,9553,546,0.2641055165916466,0.49659792735266406,0.0009421124254160996,0.2947765099968596,0.7052234900031403,0.025646393802993824
5098,45.0,102,3269,3371,6,179,4408,1280,3128,4408,336,0.023139745916515426,0.7416061705989111,0.0013611615245009074,0.29038112522686027,0.7096188747731398,0.040607985480943735
5099,15.0,288,3987,4275,29,222,6070,1598,4472,6070,367,0.04744645799011532,0.656836902800659,0.0047775947281713345,0.2632619439868204,0.7367380560131795,0.03657331136738056
5100,,6,2335,2341,14,239,3248,890,2358,3248,263,0.0018472906403940886,0.7189039408866995,0.004310344827586207,0.27401477832512317,0.7259852216748769,0.07358374384236453
5101,23.0,69,2887,2956,0,79,3779,1124,2655,3779,302,0.018258798623974597,0.7639587192378936,0.0,0.29743318338184704,0.7025668166181529,0.02090500132310135
5102,,1190,31371,32561,102,1828,43111,12426,30685,43111,3024,0.02760316392568022,0.7276797105147178,0.002365985479344019,0.2882327016306743,0.7117672983693257,0.04240217113961634
5103,27.0,4023,90514,94537,888,3107,123937,35880,88057,123937,9872,0.03246004018170522,0.7303226639340955,0.007164930569563569,0.28950192436479827,0.7104980756352017,0.025069188377966223
5104,36.0,87,2130,2217,39,98,3047,842,2205,3047,224,0.028552674762061043,0.699048244174598,0.01279947489333771,0.2763373810305218,0.7236626189694781,0.03216278306531014
5105,,222,7857,8079,38,454,10788,3036,7752,10788,771,0.020578420467185762,0.7283092324805339,0.0035224323322209862,0.2814238042269188,0.7185761957730812,0.042083796811271786
5106,24.0,827,6650,7477,396,810,11254,2628,8626,11254,433,0.07348498311711392,0.5909010129731651,0.035187488892838105,0.23351697174338013,0.7664830282566198,0.07197440909898703
5107,14.0,2,2267,2269,189,452,3603,838,2765,3603,138,0.0005550929780738274,0.6291978906466833,0.05245628642797669,0.23258395781293367,0.7674160421870664,0.12545101304468498
5108,25.0,357,13276,13633,30,677,17857,5086,12771,17857,1394,0.0199921599372795,0.7434619476955816,0.001680013440107521,0.2848182785462284,0.7151817214537717,0.03791230329842639
5109,33.0,577,11572,12149,113,575,16690,4590,12162,16752,1085,0.034443648519579755,0.6907831900668577,0.006745463228271251,0.2739971346704871,0.7260028653295129,0.034324259789875834
5110,,970,21086,22056,33,1005,29810,8511,21299,29810,2272,0.032539416303253944,0.7073465280107346,0.001107011070110701,0.2855082187185508,0.7144917812814492,0.03371351895337135
5111,,22,1831,1853,0,42,2370,740,1630,2370,219,0.009282700421940928,0.7725738396624473,0.0,0.31223628691983124,0.6877637130801688,0.017721518987341773
5112,,488,7597,8085,140,629,12232,2905,9327,12232,673,0.03989535644211903,0.6210758665794637,0.01144538914323087,0.23749182472204056,0.7625081752779594,0.051422498364944405
5113,,90,4466,4556,0,185,5834,1766,4068,5834,489,0.015426808364758314,0.7655125128556737,0.0,0.3027082619129242,0.6972917380870758,0.03171066163866987
5114,42.0,79,1744,1823,2,93,2388,701,1687,2388,174,0.0330820770519263,0.7303182579564489,0.0008375209380234506,0.2935510887772194,0.7064489112227805,0.038944723618090454
5115,27.0,220,3787,4007,25,175,5640,1552,4088,5640,372,0.03900709219858156,0.6714539007092198,0.004432624113475178,0.275177304964539,0.724822695035461,0.03102836879432624
5116,16.0,967,6774,7741,18,393,10201,2964,7237,10201,710,0.09479462797764925,0.6640525438682482,0.0017645328889324577,0.29055974904421134,0.7094402509557887,0.03852563474169199
5117,14.0,0,2044,2044,10,116,2735,758,1977,2735,233,0.0,0.7473491773308958,0.003656307129798903,0.2771480804387569,0.7228519195612432,0.04241316270566728
5118,16.0,129,4834,4963,26,396,6680,1844,4836,6680,516,0.019311377245508982,0.7236526946107784,0.0038922155688622755,0.2760479041916168,0.7239520958083833,0.0592814371257485
5119,26.0,95,2357,2452,8,80,3244,968,2276,3244,238,0.029284833538840937,0.7265721331689272,0.002466091245376079,0.29839704069050554,0.7016029593094945,0.02466091245376079
5120,17.0,52,1661,1713,0,95,2340,655,1685,2340,176,0.022222222222222223,0.7098290598290599,0.0,0.2799145299145299,0.7200854700854701,0.0405982905982906
5121,23.0,1558,46464,48022,225,1966,63427,18326,45101,63427,4231,0.02456367162249515,0.7325586895170826,0.0035473851829662447,0.28893058161350843,0.7110694183864915,0.03099626342094061
5122,,41,1797,1838,42,211,2781,700,2081,2781,137,0.014742898238043868,0.6461704422869471,0.015102481121898598,0.25170801869830994,0.7482919813016901,0.07587198849334771
5123,17.0,131,3281,3412,6,301,4785,1457,3328,4785,250,0.027377220480668756,0.6856844305120168,0.0012539184952978057,0.3044932079414838,0.6955067920585162,0.06290491118077325
5124,,401,4164,4565,27,413,7071,1600,5471,7071,229,0.05671050770753783,0.5888841747984727,0.003818413237165889,0.22627633998020083,0.7737236600197992,0.05840758025738934
5125,17.0,267,6795,7062,11,907,9951,2706,7245,9951,589,0.02683147422369611,0.6828459451311426,0.0011054165410511506,0.27193246909858304,0.728067530901417,0.09114661843030851
5126,24.0,2018,40559,42577,174,2594,56498,15711,40787,56498,3780,0.035718078516053665,0.7178838188962441,0.0030797550355764806,0.27808064002265565,0.7219193599773444,0.045913129668306844
5127,,72,1572,1644,2,68,2484,637,1847,2484,183,0.028985507246376812,0.6328502415458938,0.0008051529790660225,0.25644122383252815,0.7435587761674718,0.027375201288244767
5128,,888,22198,23086,20,1251,30716,8926,21790,30716,1990,0.028910014324781873,0.7226852454746712,0.0006511264487563485,0.2905977340799583,0.7094022659200416,0.0407279593697096
5129,,254,10700,10954,7,335,14010,4344,9666,14010,790,0.01812990720913633,0.7637401855817273,0.0004996431120628123,0.3100642398286938,0.6899357601713062,0.023911491791577446
5130,25.0,193,6367,6560,4,224,8598,2534,6064,8598,755,0.022447080716445685,0.7405210514073041,0.00046522447080716444,0.2947197022563387,0.7052802977436613,0.02605257036520121
5131,25.0,2025,42511,44536,215,2213,59289,16730,42559,59289,3772,0.034154733593077975,0.7170132739631297,0.0036263050481539576,0.282177132351701,0.7178228676482991,0.037325642193324224
5132,14.0,145,3723,3868,8,171,5143,1447,3696,5143,360,0.028193661287186467,0.7238965584289325,0.0015555123468792534,0.28135329574178497,0.7186467042582151,0.03324907641454404
5133,24.0,1841,35562,37403,279,2119,52323,14181,38142,52323,3483,0.03518529136326281,0.6796628633679261,0.005332263058310876,0.27102803738317754,0.7289719626168224,0.040498442367601244
5134,24.0,369,8104,8473,38,302,11041,3167,7874,11041,834,0.033420885789330675,0.7339914862784168,0.003441717235757631,0.28683996014853724,0.7131600398514627,0.02735259487365275
5135,14.0,121,12428,12549,242,970,17293,4762,12531,17293,1519,0.006997050829815533,0.7186722951483259,0.013994101659631065,0.27537153761637656,0.7246284623836234,0.05609206037124848
5136,,85,1721,1806,16,135,2647,696,1951,2647,170,0.032111824707215714,0.6501700037778617,0.006044578768417076,0.2629391764261428,0.7370608235738572,0.05100113335851908
5137,15.0,115,2051,2166,9,109,2957,841,2116,2957,232,0.038890767669935745,0.6936083868785932,0.003043625295908015,0.28440987487318226,0.7155901251268177,0.0368616841393304
5138,14.0,27,3068,3095,20,400,4481,1152,3329,4481,317,0.0060254407498326265,0.6846686007587592,0.004463289444320465,0.25708547199285875,0.7429145280071413,0.08926578888640928
5139,16.0,1345,6279,7624,22,579,10626,2932,7694,10626,718,0.12657632222849613,0.5909090909090909,0.002070393374741201,0.2759269715791455,0.7240730284208545,0.05448898927159797
5140,24.0,108,1859,1967,8,119,2709,757,1952,2709,182,0.03986710963455149,0.6862310815799187,0.0029531192321889995,0.2794389073458841,0.7205610926541159,0.04392764857881137
5141,,366,17613,17979,68,1001,24689,6811,17878,24689,1865,0.014824415731702378,0.7133946291870874,0.0027542630321195673,0.2758718457612702,0.7241281542387298,0.04054437198752481
5142,26.0,1208,27772,28980,258,1210,38318,11033,27285,38318,2732,0.03152565373975677,0.7247768672686465,0.006733128033822224,0.28793256433007985,0.7120674356699201,0.031577848530716636
5143,,305,8779,9084,58,263,11648,3473,8175,11648,903,0.026184752747252748,0.7536916208791209,0.004979395604395604,0.29816277472527475,0.7018372252747253,0.022578983516483516
5144,,759,17798,18557,244,1083,24740,7192,17548,24740,1848,0.030679062247372674,0.7194017784963622,0.009862570735650769,0.29070331447049313,0.7092966855295069,0.043775262732417136
5145,,222,2701,2923,216,389,4476,1108,3368,4476,249,0.049597855227882036,0.6034405719392315,0.04825737265415549,0.24754244861483468,0.7524575513851653,0.08690795352993744
5146,17.0,120,4812,4932,24,317,6698,1832,4866,6698,557,0.017915795759928337,0.7184234099731263,0.0035831591519856674,0.27351448193490596,0.7264855180650941,0.047327560465810686
5147,26.0,972,30335,31307,82,1385,41014,11922,29092,41014,2905,0.023699224654995854,0.739625493733847,0.0019993173062856587,0.2906812307992393,0.7093187692007608,0.03376895694153216
5148,24.0,247,5676,5923,22,75,7624,2192,5432,7624,551,0.032397691500524656,0.7444910807974816,0.0028856243441762854,0.28751311647429173,0.7124868835257083,0.009837355718782791
5149,13.0,213,2894,3107,5,381,4434,1197,3237,4434,262,0.04803788903924222,0.6526838069463239,0.0011276499774470004,0.2699594046008119,0.7300405953991881,0.08592692828146144
5150,,112,4688,4800,7,111,6133,1900,4233,6133,540,0.01826186205772053,0.7643893689874449,0.0011413663786075331,0.3097994456220447,0.6902005543779554,0.018098809717919453
5151,25.0,1312,37788,39100,154,1794,51657,15207,36450,51657,4276,0.025398300327157983,0.7315175097276264,0.0029812029347426293,0.29438411057552705,0.705615889424473,0.03472907834369011
5152,45.0,1769,32943,34712,167,1653,45697,13320,32377,45697,3319,0.03871151279077401,0.7209007155830799,0.003654506860406591,0.2914852178479988,0.7085147821520013,0.03617305293564129
5153,,1296,35829,37125,174,2167,49897,14024,35873,49897,3788,0.025973505421167605,0.7180592019560295,0.0034871835982123174,0.2810589815018939,0.7189410184981061,0.04342946469727639
5154,15.0,231,6374,6605,16,864,9398,2481,6917,9398,559,0.024579697808044264,0.6782294105128751,0.0017024898914662695,0.2639923387954884,0.7360076612045116,0.09193445413917854
5155,26.0,10,1940,1950,5,98,2750,765,1985,2750,238,0.0036363636363636364,0.7054545454545454,0.0018181818181818182,0.2781818181818182,0.7218181818181818,0.03563636363636364
5156,23.0,739,21219,21958,77,1007,28981,8340,20641,28981,2211,0.025499465166833442,0.732169352334288,0.002656913149994824,0.2877747489734654,0.7122252510265347,0.034746903143438805
5157,,170,5317,5487,34,311,7287,2038,5249,7287,551,0.0233292164127899,0.7296555509811994,0.00466584328255798,0.2796761355839166,0.7203238644160834,0.042678742966927405
5158,35.0,41400,752104,793504,5834,27451,1045200,301148,744054,1045202,62918,0.03960956829397571,0.7195776510186548,0.005581696169735611,0.28812420948295164,0.7118757905170484,0.026263822686906454
5159,15.0,232,4004,4236,31,303,5896,1588,4308,5896,385,0.03934871099050204,0.6791044776119403,0.005257801899592945,0.2693351424694708,0.7306648575305291,0.05139077340569878
5160,26.0,99,2118,2217,20,83,2840,849,1991,2840,171,0.03485915492957747,0.745774647887324,0.007042253521126761,0.298943661971831,0.701056338028169,0.029225352112676056
5161,24.0,58,1588,1646,7,53,2146,651,1495,2146,157,0.02702702702702703,0.7399813606710158,0.0032618825722274,0.30335507921714816,0.6966449207828518,0.024697110904007457
5162,23.0,163,3617,3780,44,252,5109,1498,3611,5109,360,0.031904482286161676,0.7079663339205324,0.008612252887062048,0.2932080642004306,0.7067919357995693,0.04932472108044627
5163,25.0,298,3142,3440,54,206,5246,1291,3955,5246,186,0.05680518490278307,0.5989325200152497,0.010293556995806329,0.24609226077011057,0.7539077392298894,0.03926801372474266
5164,,8500,74476,82976,424,5121,110498,30655,79843,110498,6982,0.07692446922116238,0.6740031493782693,0.003837173523502688,0.27742583576173324,0.7225741642382667,0.04634473022136147
5165,37.0,114,2709,2823,2,160,3755,1043,2712,3755,248,0.0303595206391478,0.7214380825565913,0.0005326231691078562,0.27776298268974703,0.722237017310253,0.0426098535286285
5166,25.0,901,21649,22550,87,1308,29531,8354,21177,29531,2190,0.03051031119840168,0.7330940367749145,0.002946056686194169,0.28288916731570213,0.7171108326842979,0.04429243845450544
5167,15.0,292,12724,13016,7,766,17392,4906,12486,17392,1523,0.016789328426862926,0.7316007359705612,0.00040248390064397425,0.28208371665133397,0.7179162833486661,0.04404323827046918
5168,,506,14008,14514,72,1075,19910,5902,14008,19910,602,0.02541436464088398,0.7035660472124561,0.003616273229532898,0.296433952787544,0.7035660472124561,0.05399296835760924
5169,17.0,1950,22267,24217,71,1546,32485,9049,23436,32485,2052,0.06002770509465907,0.6854548253039865,0.002185624134215792,0.2785593350777282,0.7214406649222718,0.04759119593658612
5170,23.0,80,1914,1994,16,116,2908,731,2177,2908,202,0.027510316368638238,0.6581843191196699,0.005502063273727648,0.2513755158184319,0.7486244841815681,0.039889958734525444
5171,38.0,1421,34915,36336,84,2618,48829,13334,35495,48829,2904,0.029101558500071678,0.7150463863687563,0.0017202891724180302,0.2730754264883573,0.7269245735116426,0.05361567920702861
5172,,4198,90043,94241,1762,8396,133483,35923,97560,133483,8732,0.03144969771431568,0.6745653004502447,0.013200182794812823,0.26912041233715156,0.7308795876628484,0.06289939542863136
5173,,675,11063,11738,41,1067,17078,4457,12621,17078,990,0.03952453448881602,0.6477924815552173,0.00240074950228364,0.26097903735800443,0.7390209626419956,0.06247804192528399
5174,23.0,382,15801,16183,63,848,21196,6092,15104,21196,1762,0.018022268352519345,0.7454708435553878,0.00297225891677675,0.2874127193810153,0.7125872806189847,0.040007548594074356
5175,23.0,939,21121,22060,109,959,29183,8484,20700,29184,2091,0.03217516447368421,0.723718475877193,0.003734923245614035,0.29070723684210525,0.7092927631578947,0.03286047149122807
5176,39.0,61,1980,2041,12,50,2727,767,1960,2727,230,0.022368903557022368,0.7260726072607261,0.0044004400440044,0.2812614594792813,0.7187385405207187,0.018335166850018333
5177,,256,5695,5951,43,244,8258,2254,6004,8258,529,0.031000242189392103,0.689634294017922,0.005207071930249455,0.2729474449019133,0.7270525550980868,0.02954710583676435
5178,36.0,691,5176,5867,18,491,8175,2180,5995,8175,441,0.08452599388379205,0.6331498470948013,0.0022018348623853213,0.26666666666666666,0.7333333333333333,0.060061162079510705
5179,23.0,28,2710,2738,8,125,3576,1012,2564,3576,296,0.007829977628635347,0.7578299776286354,0.0022371364653243847,0.2829977628635347,0.7170022371364653,0.03495525727069351
5180,23.0,2155,51782,53937,348,2571,72204,20536,51670,72206,5454,0.029845165221726727,0.7171426197268925,0.0048195440822092345,0.28440849790876105,0.715591502091239,0.035606459297011325
5181,15.0,76,2267,2343,0,109,3053,880,2173,3053,238,0.024893547330494595,0.7425483131346217,0.0,0.2882410743530953,0.7117589256469047,0.03570258761873567
5182,,141,2180,2321,10,172,3276,826,2450,3276,204,0.04304029304029304,0.6654456654456654,0.0030525030525030525,0.25213675213675213,0.7478632478632479,0.052503052503052504
5183,16.0,64,4241,4305,29,363,5888,1592,4296,5888,387,0.010869565217391304,0.7202785326086957,0.004925271739130435,0.2703804347826087,0.7296195652173914,0.061650815217391304
5184,,29,6029,6058,15,186,7858,2288,5570,7858,749,0.003690506490201069,0.7672435734283533,0.0019088826673453805,0.2911682361924154,0.7088317638075846,0.023670145075082718
5185,23.0,45,1539,1584,15,236,2437,595,1842,2437,143,0.018465326220763235,0.6315141567501026,0.006155108740254411,0.24415264669675832,0.7558473533032417,0.09684037751333607
5186,17.0,10126,163092,173218,1643,10422,235020,65697,169325,235022,15023,0.04308532818204253,0.6939435457106143,0.006990834900562501,0.2795355328437338,0.7204644671562662,0.04434478474355592
5187,14.0,13,4671,4684,27,536,6319,1722,4597,6319,261,0.0020572875454977053,0.739199240386137,0.004272827979110619,0.27251147333438835,0.7274885266656117,0.08482354802975155
5188,41.0,305,2704,3009,12,427,4315,1099,3216,4315,246,0.07068366164542295,0.6266512166859791,0.0027809965237543454,0.25469293163383544,0.7453070683661646,0.09895712630359212
5189,26.0,176,7422,7598,10,401,9777,2681,7096,9777,601,0.018001431932085508,0.7591285670451059,0.0010228086325048584,0.27421499437455255,0.7257850056254475,0.04101462616344482
5190,34.0,1466,40245,41711,240,1697,55791,15640,40151,55791,4539,0.026276639601369396,0.72135290638275,0.004301769102543421,0.28033195318241294,0.7196680468175871,0.030417092362567438
5191,15.0,2634,22781,25415,419,3526,37299,9741,27558,37299,1573,0.07061851524169549,0.6107670446928872,0.011233545135258318,0.2611598166170675,0.7388401833829326,0.09453336550577764
5192,,86,1698,1784,41,101,2540,692,1848,2540,192,0.03385826771653543,0.668503937007874,0.016141732283464567,0.27244094488188975,0.7275590551181103,0.03976377952755906
5193,,3,3493,3496,0,228,4625,1296,3329,4625,373,0.0006486486486486486,0.7552432432432432,0.0,0.28021621621621623,0.7197837837837838,0.049297297297297295
5194,,893,11567,12460,46,616,17164,4682,12482,17164,1450,0.05202749941738522,0.673910510370543,0.0026800279655092053,0.27278023770682824,0.7272197622931718,0.03588907014681892
5195,25.0,1329,27853,29182,217,1791,38838,10837,28001,38838,2606,0.03421906380349143,0.7171584530614347,0.00558731139605541,0.2790308460785828,0.7209691539214171,0.04611463000154488
5196,24.0,372,6934,7306,13,548,9848,2840,7008,9848,831,0.03777416734362307,0.704102355808286,0.0013200649878147847,0.2883834281072299,0.7116165718927701,0.05564581640942323
5197,,411,8343,8754,58,394,12438,3253,9185,12438,851,0.033043897732754464,0.670767004341534,0.0046631291204373695,0.26153722463418555,0.7384627753658144,0.03167711850779868
5198,24.0,129,3091,3220,4,139,4156,1231,2925,4156,307,0.031039461020211743,0.7437439846005774,0.0009624639076034649,0.2961982675649663,0.7038017324350336,0.03344562078922041
5199,35.0,163,5477,5640,8,279,7387,2130,5257,7387,586,0.02206579125490727,0.7414376607553811,0.0010829836198727495,0.2883443887911195,0.7116556112088804,0.037769053743062136
5200,27.0,69,2239,2308,7,148,3286,898,2388,3286,256,0.020998174071819843,0.6813755325623859,0.002130249543517955,0.2732805842970176,0.7267194157029824,0.04503956177723676
5201,24.0,7174,155572,162746,1904,5951,208375,62796,145579,208375,13585,0.03442831433713257,0.7465962807438512,0.0091373725254949,0.30136052789442114,0.6986394721055789,0.028559088182363527
5202,,175,3955,4130,11,257,5777,1575,4202,5777,426,0.030292539380301194,0.684611389994807,0.0019041024753332178,0.27263285442271074,0.7273671455772892,0.04448675783278518
5203,13.0,301,4827,5128,15,259,6728,1996,4732,6728,507,0.0447384066587396,0.7174494649227111,0.0022294887039239,0.2966706302021403,0.7033293697978596,0.03849583828775267
5204,36.0,78,2977,3055,4,63,3873,1208,2665,3873,289,0.020139426800929512,0.7686547895688097,0.0010327911179963851,0.31190291763490835,0.6880970823650917,0.016266460108443067
5205,24.0,486,8236,8722,383,454,12105,3185,8920,12105,747,0.04014869888475837,0.6803800082610492,0.031639818256918625,0.2631144155307724,0.7368855844692276,0.03750516315572078
5206,,700,12365,13065,50,825,17692,5006,12686,17692,1144,0.03956590549400859,0.6989034591905946,0.0028261361067148994,0.28295274700429573,0.7170472529957043,0.04663124576079584
5207,14.0,508,5540,6048,53,1008,8867,2375,6492,8867,401,0.057291079282733734,0.6247885417841434,0.005977218901545055,0.26784707341829256,0.7321529265817075,0.11367993684447954
5208,,904,16030,16934,36,716,22940,6656,16284,22940,1743,0.03940714908456844,0.6987794245858762,0.0015693112467306015,0.2901482127288579,0.7098517872711421,0.03121185701830863
5209,,61,1688,1749,6,130,2576,681,1895,2576,185,0.023680124223602484,0.65527950310559,0.002329192546583851,0.2643633540372671,0.7356366459627329,0.05046583850931677
5210,23.0,629,27553,28182,67,874,37005,10660,26345,37005,3489,0.01699770301310634,0.7445750574246723,0.0018105661397108499,0.2880691798405621,0.7119308201594379,0.023618429941899742
5211,34.0,131,2775,2906,15,193,3905,1092,2813,3905,276,0.03354673495518566,0.7106274007682458,0.0038412291933418692,0.2796414852752881,0.7203585147247119,0.04942381562099872
5212,,106,2505,2611,10,50,3309,992,2317,3309,254,0.03203384708371109,0.757026291931097,0.0030220610456331218,0.2997884557268057,0.7002115442731943,0.015110305228165609
5213,,250,8724,8974,3,574,12154,3421,8733,12154,961,0.020569359881520487,0.7177883824255389,0.00024683231857824587,0.28147112061872637,0.7185288793812736,0.04722725028797104
5214,,57,1549,1606,2,63,2123,619,1504,2123,152,0.026848798869524258,0.7296278850682996,0.0009420631182289214,0.29156853509185116,0.7084314649081489,0.02967498822421102
5215,23.0,530,18902,19432,61,746,26027,7541,18486,26027,2235,0.02036346870557498,0.7262458216467514,0.002343719983094479,0.28973758020517154,0.7102624197948284,0.028662542744073462
5216,17.0,280,5920,6200,4,187,8067,2408,5659,8067,696,0.03470930953266394,0.7338539729763233,0.0004958472790380563,0.2985000619809099,0.7014999380190902,0.02318086029502913
5217,27.0,452,10681,11133,90,650,15189,4173,11016,15189,1056,0.029758377773388637,0.7032062676937257,0.005925340707090658,0.2747382974521035,0.7252617025478965,0.04279412732898808
5218,,1550,33506,35056,160,1305,45280,13221,32059,45280,2673,0.034231448763250884,0.7399734982332156,0.0035335689045936395,0.2919832155477032,0.7080167844522968,0.028820671378091873
5219,25.0,4124,104911,109035,777,6841,146565,41385,105180,146565,11671,0.028137686350765873,0.7157984511991267,0.0053014021082796025,0.28236618565141747,0.7176338143485825,0.046675536451403814
5220,25.0,127,4287,4414,9,205,5841,1674,4167,5841,481,0.021742852251326827,0.733949666153056,0.0015408320493066256,0.28659476117103233,0.7134052388289677,0.035096730011984247
5221,17.0,0,1712,1712,3,139,2386,636,1750,2386,176,0.0,0.7175188600167645,0.0012573344509639564,0.26655490360435874,0.7334450963956413,0.05825649622799665
5222,,383,5135,5518,11,322,7427,2110,5317,7427,511,0.051568601050222165,0.6913962569004982,0.0014810825366904537,0.2840985593106234,0.7159014406893766,0.043355325164938736
5223,24.0,381,12187,12568,12,410,16412,4813,11599,16412,1344,0.02321472093590056,0.7425664148184256,0.00073117231294175,0.2932610285157202,0.7067389714842798,0.024981720692176457
5224,,96,1524,1620,5,142,2246,590,1656,2246,153,0.0427426536064114,0.678539626001781,0.002226179875333927,0.26268922528940336,0.7373107747105966,0.06322350845948353
5225,25.0,1070,18625,19695,233,758,26425,7290,19135,26425,1752,0.04049195837275307,0.7048249763481551,0.00881740775780511,0.27587511825922423,0.7241248817407758,0.028684957426679283
5226,15.0,144,12221,12365,59,525,16354,4650,11704,16354,1493,0.008805185275773512,0.7472789531613061,0.0036076800782683135,0.28433410786351965,0.7156658921364804,0.03210223798459093
5227,,143,2866,3009,15,157,3886,1128,2758,3886,229,0.03679876479670612,0.7375193000514668,0.0038600102933607824,0.2902727740607308,0.7097272259392692,0.04040144107050952
5228,,253,6872,7125,39,327,9358,2729,6629,9358,731,0.027035691387048515,0.7343449455011755,0.004167557170335541,0.2916221414832229,0.708377858516777,0.03494336396665954
5229,16.0,225,5651,5876,13,339,7723,2194,5529,7723,570,0.029133756312313866,0.7317104752039363,0.0016832836980448013,0.2840864948854072,0.7159135051145927,0.04389485951055289
5230,16.0,873,16267,17140,37,928,23135,6618,16517,23135,1866,0.037735033499027446,0.7031337799870326,0.0015993084071752755,0.28606008212664796,0.7139399178733521,0.040112383834017724
5231,13.0,859,7738,8597,78,732,11922,2973,8949,11922,467,0.07205166918302298,0.6490521724542861,0.006542526421741319,0.2493709109209864,0.7506290890790136,0.06139909411172622
5232,15.0,221,5005,5226,31,236,6951,1987,4964,6951,556,0.031793986476765936,0.7200402819738168,0.004459789958279384,0.2858581499064883,0.7141418500935117,0.03395194935980435
5233,14.0,1098,19409,20507,146,940,27340,7786,19554,27340,2246,0.0401609363569861,0.709912216532553,0.005340160936356986,0.28478419897585955,0.7152158010241405,0.03438185808339429
5234,14.0,472,12882,13354,32,405,17820,5134,12686,17820,1828,0.02648709315375982,0.7228956228956229,0.0017957351290684624,0.28810325476992144,0.7118967452300785,0.022727272727272728
5235,24.0,509,11345,11854,50,878,15981,4527,11454,15981,1079,0.031850322257680995,0.7099055127964458,0.0031287153494775045,0.28327388774169326,0.7167261122583067,0.05494024153682498
5236,17.0,329,10026,10355,84,365,13474,4116,9358,13474,1011,0.0244173964672703,0.7440997476621641,0.006234228885260502,0.30547721537776457,0.6945227846222354,0.027089208846667656
5237,24.0,534,11782,12316,59,446,16229,4672,11557,16229,1240,0.032904060632201616,0.7259843490048679,0.0036354673732207775,0.28787972148622837,0.7121202785137717,0.027481668617906217
5238,14.0,2014,56056,58070,231,2453,78824,22404,56420,78824,6543,0.02555059372779864,0.7111539632599209,0.002930579518928245,0.284228153861768,0.715771846138232,0.031119963462904698
5239,17.0,335,5670,6005,21,290,7933,2291,5642,7933,558,0.042228665069960925,0.7147359132736669,0.0026471700491617293,0.288793646791882,0.711206353208118,0.03655615782175722
5240,25.0,1891,143727,145618,420,9401,194663,53709,140954,194663,14378,0.009714224069288976,0.7383375371796387,0.002157574885828329,0.2759075941498898,0.7240924058501101,0.048293717861124096
5241,13.0,342,7302,7644,32,339,9971,2894,7077,9971,774,0.034299468458529735,0.7323237388426437,0.003209306990271788,0.29024170093270485,0.7097582990672952,0.03399859592819176
5242,15.0,6259,203199,209458,558,11379,277436,79788,197648,277436,20380,0.022560158018425872,0.7324175665739125,0.002011274672356868,0.28759065153765195,0.712409348462348,0.04101486468951398
5243,14.0,183,3266,3449,10,123,4592,1328,3264,4592,289,0.03985191637630662,0.7112369337979094,0.0021777003484320556,0.289198606271777,0.710801393728223,0.026785714285714284
5244,,277,4070,4357,18,373,6182,1636,4547,6183,308,0.044800258774057904,0.658256509784894,0.002911208151382824,0.2645964742034611,0.7354035257965389,0.06032670224809963
5245,17.0,57,11149,11206,69,1078,15517,4164,11353,15517,1085,0.003673390474962944,0.718502287813366,0.004446735838113038,0.26835084101308243,0.7316491589869176,0.06947219178965006
5246,17.0,344,5602,5946,40,799,8642,2197,6445,8642,492,0.039805600555426986,0.6482295764869244,0.004628558204119417,0.25422355936125896,0.745776440638741,0.09245545012728536
5247,26.0,4930,97364,102294,809,4650,134365,39140,95225,134365,9363,0.03669110259368139,0.7246232277750903,0.006020913184236966,0.2912960964536896,0.7087039035463104,0.03460722658430395
5248,23.0,1695,33718,35413,154,2128,46913,13683,33230,46913,3195,0.03613071003772941,0.7187346790868203,0.0032826721804190737,0.2916675548355466,0.7083324451644534,0.045360561038518106
5249,14.0,765,15742,16507,68,1499,23502,6245,17257,23502,1550,0.03255042124074547,0.6698153348651179,0.0028933707769551527,0.2657220662071313,0.7342779337928687,0.06378180580376139
5250,,1904,40371,42275,201,2816,56322,15640,40682,56322,3569,0.033805617698235146,0.7167891765207202,0.0035687653137317565,0.2776890025212173,0.7223109974787827,0.04999822449486879
5251,,89,2427,2516,10,171,3373,928,2445,3373,222,0.026386006522383636,0.7195375037058998,0.0029647198339756895,0.27512600059294395,0.724873999407056,0.05069670916098429
5252,,367,10384,10751,28,680,14385,4083,10302,14385,921,0.02551268682655544,0.721863051790059,0.0019464720194647203,0.28383733055265903,0.716162669447341,0.04727146332985749
5253,34.0,334,10449,10783,51,425,13686,4126,9560,13686,943,0.024404500949875785,0.7634809294169224,0.003726435773783428,0.3014759608358907,0.6985240391641093,0.031053631448195236
5254,15.0,96,4289,4385,25,184,5778,1635,4143,5778,476,0.016614745586708203,0.7422983731394946,0.004326756663205262,0.2829698857736241,0.7170301142263759,0.031844929041190725
5255,25.0,448,8182,8630,20,296,11602,3304,8298,11602,967,0.03861403206343734,0.7052232373728667,0.0017238407171177384,0.28477848646785037,0.7152215135321496,0.025512842613342527
5256,25.0,162,5525,5687,8,246,7537,2053,5484,7537,595,0.021493963115297863,0.733050285259387,0.0010614302772986599,0.2723895449117686,0.7276104550882314,0.03263898102693379
5257,,376,7877,8253,34,526,11164,3115,8049,11164,824,0.03367968470082408,0.7055714797563597,0.003045503403797922,0.27902185596560375,0.7209781440343963,0.04711572912934432
5258,,1080,29414,30494,174,1143,40543,11620,28923,40543,3025,0.02663838393804109,0.7255013195866118,0.004291739634462176,0.28660927903707173,0.7133907209629282,0.028192289667760155
5259,16.0,1973,82910,84883,364,4299,116108,33311,82797,116108,10121,0.01699279980707617,0.7140765494195059,0.0031350122299927652,0.2868966823991456,0.7131033176008543,0.0370258724635684
5260,40.0,182,3330,3512,5,130,4636,1340,3296,4636,299,0.039257981018119066,0.7182916307161346,0.0010785159620362382,0.28904227782571185,0.7109577221742882,0.028041415012942193
5261,24.0,127,8360,8487,12,355,11010,3195,7815,11010,877,0.01153496821071753,0.7593097184377838,0.0010899182561307902,0.2901907356948229,0.7098092643051771,0.03224341507720254
5262,23.0,568,12369,12937,248,582,17105,5006,12099,17105,1123,0.033206664717918735,0.7231218941829874,0.014498684595147618,0.2926629640456007,0.7073370359543993,0.034025138848289976
5263,33.0,1039,27287,28326,120,1900,37344,10381,26963,37344,2515,0.027822407883461867,0.7306930162810625,0.003213367609254499,0.2779830762639246,0.7220169237360754,0.0508783204798629
5264,17.0,68,2053,2121,3,191,2881,790,2091,2881,220,0.023602915654286707,0.7125997917389795,0.0010413051023950017,0.2742103436306838,0.7257896563693162,0.06629642485248177
5265,,284,8041,8325,46,344,11025,3186,7839,11025,830,0.025759637188208617,0.7293424036281179,0.004172335600907029,0.2889795918367347,0.7110204081632653,0.031201814058956917
5266,25.0,123,2511,2634,4,174,3672,991,2681,3672,284,0.03349673202614379,0.6838235294117647,0.0010893246187363835,0.269880174291939,0.730119825708061,0.04738562091503268
5267,27.0,332,15025,15357,24,546,19818,5947,13871,19818,1495,0.01675244727015844,0.7581491573317186,0.0012110202845897668,0.30008073468563934,0.6999192653143607,0.027550711474417195
5268,,106,11472,11578,68,650,15811,4342,11469,15811,1324,0.006704193283157295,0.7255708051356651,0.00430080323825185,0.2746189361836696,0.7253810638163304,0.041110619189172096
5269,27.0,592,21136,21728,123,1566,28965,8256,20709,28965,2130,0.020438460210599,0.7297082686000346,0.004246504401864319,0.2850336613153806,0.7149663386846193,0.05406525116519938
5270,,877,11563,12440,224,569,16380,4685,11695,16380,1020,0.05354090354090354,0.705921855921856,0.013675213675213675,0.286019536019536,0.713980463980464,0.03473748473748474
5271,26.0,414,6731,7145,28,423,9590,2708,6882,9590,691,0.04316996871741397,0.7018769551616267,0.00291970802919708,0.2823774765380605,0.7176225234619396,0.04410844629822732
5272,25.0,14673,330252,344926,1148,13711,463155,132212,330944,463156,36755,0.031680470511015725,0.7130470079195779,0.002478646503553878,0.28545889505911615,0.7145411049408839,0.02960341655943138
5273,24.0,5810,103099,108909,683,6182,147552,41260,106292,147552,10009,0.03937594881804381,0.6987299392756452,0.004628876599436131,0.27963023205378446,0.7203697679462155,0.04189709390587725
5274,23.0,259,7121,7380,13,369,9506,2823,6683,9506,699,0.027245949926362298,0.7491058278981696,0.001367557332211235,0.2969703345255628,0.7030296654744372,0.03881758889122659
5275,24.0,547,4473,5020,94,215,6649,1951,4698,6649,316,0.08226801022710183,0.6727327417656791,0.01413746428034291,0.2934275830952023,0.7065724169047977,0.032335689577380054
5276,25.0,76,2074,2150,0,98,2841,813,2028,2841,195,0.026751143963393172,0.7300246392115453,0.0,0.28616684266103487,0.7138331573389651,0.034494896163322776
5277,,1249,35655,36904,85,1927,48420,14124,34296,48420,3579,0.025795125980999586,0.7363692688971499,0.001755472945064023,0.2916976456009913,0.7083023543990087,0.03979760429574556
5278,,3361,53330,56691,966,3195,77910,21585,56347,77932,5471,0.043127341785146024,0.6843145306164349,0.012395421649643279,0.2769722322024329,0.7230277677975671,0.040997279679720784
5279,,951,14245,15196,386,1314,21459,5766,15693,21459,1552,0.044317069760939465,0.6638240365347873,0.017987790670581108,0.26869844820355093,0.7313015517964491,0.06123304907032014
5280,17.0,183,2480,2663,0,50,3686,1008,2678,3686,251,0.04964731416169289,0.672816060770483,0.0,0.2734671730873576,0.7265328269126424,0.013564839934888768
5281,,1423,29430,30853,117,2335,42310,11217,31093,42310,2816,0.03363271094303947,0.6955802410777594,0.0027653037107066886,0.2651146301110848,0.7348853698889152,0.05518789884188135
5282,17.0,2995,29842,32837,894,2796,46336,12769,33567,46336,2949,0.06463656767955801,0.6440348756906077,0.01929385359116022,0.275574067679558,0.724425932320442,0.06034185082872928
5283,,102,2310,2412,24,116,3310,908,2402,3310,268,0.03081570996978852,0.6978851963746223,0.0072507552870090634,0.2743202416918429,0.7256797583081571,0.035045317220543805
5284,15.0,165,3392,3557,8,445,4950,1375,3575,4950,266,0.03333333333333333,0.6852525252525252,0.0016161616161616162,0.2777777777777778,0.7222222222222222,0.0898989898989899
5285,24.0,140,3676,3816,0,233,5108,1449,3659,5108,371,0.0274079874706343,0.7196554424432263,0.0,0.283672670321065,0.716327329678935,0.04561472200469851
5286,41.0,124,4488,4612,20,157,5917,1749,4168,5917,384,0.020956565827277337,0.758492479296941,0.0033800912624640865,0.29558898090248437,0.7044110190975156,0.026533716410343078
5287,38.0,254,6221,6475,40,183,8109,2456,5653,8109,503,0.031323221112344306,0.7671722777161178,0.004932790726353434,0.3028733505981009,0.6971266494018992,0.022567517573066964
5288,24.0,769,15775,16544,49,1356,24311,6290,18021,24311,1425,0.03163177162601292,0.648883221586936,0.0020155485171321624,0.2587306157706388,0.7412693842293612,0.05577722018839209
5289,43.0,329,7734,8063,89,256,10362,3053,7309,10362,672,0.031750627292028565,0.7463810075275044,0.008589075468056359,0.29463424049411313,0.7053657595058869,0.024705655278903685
5290,14.0,167,4488,4655,64,318,6633,1839,4794,6633,503,0.025177144580129655,0.6766169154228856,0.009648726066636514,0.2772501130710086,0.7227498869289914,0.04794210764360018
5291,,600,14878,15478,72,1075,20810,5900,14910,20810,1493,0.028832292167227293,0.7149447381066795,0.003459875060067275,0.28351753964440174,0.7164824603555983,0.05165785679961557
5292,16.0,49,1602,1651,6,85,2182,642,1540,2182,183,0.022456461961503207,0.7341888175985335,0.002749770852428964,0.29422548120989916,0.7057745187901008,0.03895508707607699
5293,16.0,305,7212,7517,9,566,10318,2837,7481,10318,799,0.029559992246559412,0.6989726691219229,0.000872262066291917,0.2749563868966854,0.7250436131033146,0.054855592169025004
5294,16.0,323,8557,8880,25,862,12468,3352,9116,12468,784,0.02590632017965993,0.6863169714469041,0.002005133140840552,0.2688482515239012,0.7311517484760988,0.06913699069618223
5295,,2551,72433,74984,169,3424,99078,28299,70779,99078,7395,0.025747390944508366,0.731070469730919,0.0017057268011061992,0.2856234481923333,0.7143765518076667,0.034558630573891275
5296,17.0,153,3056,3209,10,157,4238,1211,3027,4238,299,0.03610193487494101,0.7210948560641812,0.0023596035865974517,0.2857479943369514,0.7142520056630486,0.03704577630957999
5297,23.0,126,7573,7699,0,206,9938,3063,6875,9938,754,0.012678607365667137,0.7620245522237875,0.0,0.3082109076272892,0.6917890923727108,0.020728516804185953
5298,,3427,97405,100832,511,4798,133514,38428,95095,133523,10637,0.025665990129041437,0.7294997865536275,0.003827056012821761,0.2878006036413202,0.7121993963586798,0.03593388404993896
5299,36.0,708,17467,18175,58,1637,24551,6529,18022,24551,1538,0.02883792920858621,0.7114577817604171,0.0023624292289519777,0.2659362144108183,0.7340637855891817,0.06667752841024806
5300,17.0,32,7450,7482,45,286,9902,2852,7050,9902,903,0.0032316703696222983,0.7523732579276914,0.004544536457281357,0.28802262169258736,0.7119773783074126,0.028883053928499294
5301,27.0,614,14379,14993,45,482,19755,5600,14155,19755,1360,0.0310807390534042,0.7278663629460896,0.002277904328018223,0.28347253859782334,0.7165274614021767,0.02439888635788408
5302,,101,2400,2501,3,162,3275,895,2380,3275,253,0.03083969465648855,0.732824427480916,0.000916030534351145,0.2732824427480916,0.7267175572519083,0.04946564885496183
5303,26.0,808,29256,30064,95,1292,38862,11624,27238,38862,2766,0.02079151870722042,0.7528176624980701,0.002444547372754876,0.2991096701147651,0.7008903298852349,0.033245844269466314
5304,,136,1972,2108,50,116,2851,786,2065,2851,191,0.047702560505085936,0.691687127323746,0.017537706068046298,0.2756927393896878,0.7243072606103121,0.04068747807786741
5305,23.0,88,3306,3394,34,512,4897,1242,3655,4897,297,0.017970185828057993,0.675107208494997,0.006943026342658771,0.25362466816418217,0.7463753318358178,0.1045538084541556
5306,25.0,5952,253967,259919,1512,13343,349168,98989,250180,349169,28003,0.01704618680352494,0.7273469294238607,0.0043302813250889974,0.2834988214875891,0.7165011785124109,0.03821358711684027
5307,,2378,95983,98361,257,5752,132072,37541,94531,132072,10527,0.018005330425828334,0.7267475316494033,0.0019459082924465443,0.28424647162153976,0.7157535283784602,0.043552001938336665
5308,16.0,191,4400,4591,4,200,6018,1763,4255,6018,459,0.03173811897640412,0.7311399135925557,0.0006646726487205051,0.29295446992356267,0.7070455300764373,0.03323363243602526
5309,23.0,120,1758,1878,47,134,2562,718,1844,2562,169,0.0468384074941452,0.6861826697892272,0.01834504293520687,0.28024980483996875,0.7197501951600312,0.05230288836846214
5310,40.0,1744,33258,35002,518,1977,47927,13067,34878,47945,3040,0.036375013035770155,0.6936698300135572,0.010804046303055585,0.2725414537490875,0.7274585462509126,0.04123474814892064
5311,23.0,326,10084,10410,81,302,13354,4011,9346,13357,958,0.024406678146290335,0.7549599460956802,0.006064235981133488,0.30029198173242494,0.699708018267575,0.022609867485213746
5312,36.0,225,6218,6443,19,229,8392,2466,5926,8392,608,0.026811248808388942,0.7409437559580553,0.0022640610104861774,0.2938512869399428,0.7061487130600572,0.02728789323164919
5313,16.0,7012,161800,168812,971,15031,234438,63793,170645,234438,16610,0.02990982690519455,0.690161151349184,0.004141820012114077,0.2721103234117336,0.7278896765882664,0.06411503254591833
5314,,1296,14490,15786,86,1129,22794,5976,16818,22794,1319,0.056857067649381414,0.6356936035798895,0.0037729226989558656,0.26217425638325875,0.7378257436167412,0.049530578222339215
5315,14.0,211,2414,2625,8,240,3832,1017,2815,3832,252,0.05506263048016701,0.6299582463465553,0.0020876826722338203,0.2653966597077244,0.7346033402922756,0.06263048016701461
5316,25.0,386,11204,11590,32,691,15445,4309,11136,15445,1224,0.02499190676594367,0.7254127549368727,0.002071867918420201,0.27898996438977014,0.7210100356102298,0.04473939786338621
5317,34.0,182,3364,3546,11,199,4816,1287,3529,4816,296,0.0377906976744186,0.6985049833887044,0.0022840531561461796,0.267234219269103,0.732765780730897,0.04132059800664452
5318,26.0,168,5642,5810,38,113,7572,2196,5376,7572,640,0.022187004754358162,0.7451135763338615,0.005018489170628632,0.2900158478605388,0.7099841521394612,0.014923402007395668
5319,,299,6726,7025,0,479,9325,2372,6953,9325,566,0.03206434316353887,0.7212868632707775,0.0,0.25436997319034854,0.7456300268096515,0.051367292225201075
5320,,92,1999,2091,3,111,2778,781,1997,2778,210,0.03311735061195104,0.7195824334053276,0.0010799136069114472,0.2811375089992801,0.71886249100072,0.03995680345572354
5321,26.0,189,1434,1623,28,107,2298,599,1699,2298,133,0.08224543080939947,0.6240208877284595,0.012184508268059183,0.2606614447345518,0.7393385552654482,0.04656222802436902
5322,23.0,231,7563,7794,22,280,9949,2982,6967,9949,678,0.023218413910945822,0.7601769022012262,0.0022112775153281736,0.2997286159413006,0.7002713840586994,0.028143532013267664
5323,15.0,928,14634,15562,52,1075,20993,5848,15145,20993,1387,0.044205211260896486,0.6970895060258181,0.0024770161482398894,0.27856904682513217,0.7214309531748678,0.05120754537226695
5324,,32,2382,2414,0,103,3207,962,2245,3207,334,0.009978172747115684,0.7427502338634238,0.0,0.29996881821016524,0.7000311817898347,0.03211724352977861
5325,24.0,214,5494,5708,45,202,7647,2177,5470,7647,638,0.02798483065254348,0.7184516803975415,0.005884660651235779,0.28468680528311757,0.7153131947168825,0.02641558781221394
5326,17.0,1480,31773,33253,57,1513,43124,12560,30564,43124,2732,0.03431963639736574,0.7367823021983119,0.0013217697801688156,0.29125313050737406,0.7087468694926259,0.035084871533252945
5327,14.0,55,2358,2413,0,83,3628,925,2703,3628,263,0.01515986769570011,0.6499448732083792,0.0,0.25496141124586547,0.7450385887541345,0.022877618522601985
5328,42.0,1845,50821,52666,355,1779,67815,20431,47384,67815,4995,0.027206370272063702,0.7494064734940648,0.0052348300523483,0.3012755290127553,0.6987244709872447,0.026233134262331342
5329,,362,9315,9677,89,430,12699,3715,8984,12699,911,0.028506181589101506,0.7335223245924876,0.007008425860303961,0.29254271989920466,0.7074572801007953,0.033860933931805656
5330,34.0,6198,161340,167538,651,6994,218573,63675,154898,218573,16242,0.028356658873694374,0.7381515557731284,0.0029784099591440845,0.29132143494393176,0.7086785650560682,0.03199846275615012
5331,,860,17456,18316,54,1466,25152,6795,18357,25152,1816,0.03419211195928753,0.6940203562340967,0.0021469465648854963,0.2701574427480916,0.7298425572519084,0.05828562340966921
5332,17.0,313,12229,12542,0,498,16361,4854,11507,16361,1236,0.019130859971884358,0.7474481999877758,0.0,0.2966811319601491,0.7033188680398509,0.030438237271560416
5333,17.0,492,48989,49481,545,1725,65085,19185,45900,65085,5508,0.007559345471306753,0.7526926327110701,0.008373665207036952,0.2947683798110164,0.7052316201889837,0.026503802719520627
5334,25.0,2073,108623,110696,104,4773,143401,43167,100234,143401,11366,0.014455966136916758,0.7574772839798886,0.0007252390150696299,0.30102300541837224,0.6989769945816278,0.033284286720455226
5335,17.0,765,13803,14568,7,599,19503,5639,13864,19503,1398,0.03922473465620674,0.7077372711890478,0.00035891914064502896,0.2891350048710455,0.7108649951289545,0.030713223606624623
5336,,536,14290,14826,10,583,19625,5714,13911,19625,1387,0.027312101910828026,0.7281528662420382,0.0005095541401273885,0.2911592356687898,0.7088407643312102,0.02970700636942675
5337,41.0,71,3371,3442,23,144,4567,1270,3297,4567,411,0.015546310488285527,0.7381213050142326,0.0050361287497262975,0.2780818918327129,0.7219181081672871,0.03153054521567769
5338,,152,3378,3530,7,179,4761,1314,3447,4761,351,0.03192606595253098,0.7095148078134845,0.0014702793530770846,0.27599243856332706,0.724007561436673,0.03759714345725688
5339,,101,5443,5544,14,562,7559,2081,5478,7559,538,0.013361555761344093,0.7200687921682762,0.0018520968382061118,0.2753009657362085,0.7246990342637915,0.07434845879084535
5340,15.0,175,8070,8245,56,880,11755,3121,8634,11755,879,0.014887282007656316,0.6865163760102084,0.004763930242450021,0.2655040408336878,0.7344959591663122,0.07486176095278604
5341,,188,4691,4879,35,207,6422,1846,4576,6422,527,0.029274369355341015,0.7304578013080038,0.0054500155714730615,0.2874493927125506,0.7125506072874493,0.03223294923699782
5342,25.0,278,3926,4204,40,245,5621,1612,4009,5621,407,0.04945739192314535,0.6984522326988081,0.007116171499733144,0.2867817114392457,0.7132182885607543,0.043586550435865505
5343,25.0,882,15129,16011,8,709,22039,6191,15848,22039,1751,0.04001996460819456,0.6864649031262762,0.0003629928762648033,0.28091111211942466,0.7190888878805753,0.032170243658968194
5344,,465,8113,8578,59,721,11905,3294,8611,11905,934,0.039059218815623686,0.6814783704325913,0.0049559008819823605,0.27669046619067617,0.7233095338093238,0.06056278874422512
5345,,601,12817,13418,56,616,17968,5091,12877,17968,1360,0.033448352626892254,0.7133236865538736,0.003116651825467498,0.28333704363312556,0.7166629563668745,0.03428317008014248
5346,17.0,378,7266,7644,17,1009,10681,2978,7703,10681,438,0.03538994476172643,0.6802733826420747,0.001591611272352776,0.2788128452392098,0.7211871547607902,0.09446681022376183
5347,14.0,933,16000,16933,25,901,22572,6367,16205,22572,1876,0.041334396597554494,0.708842814105972,0.0011075668970405813,0.28207513733829526,0.7179248626617047,0.03991671096934255
5348,,3864,113035,116899,381,4565,155246,44428,110818,155246,11329,0.024889530165028408,0.7281024953944063,0.002454169511613826,0.2861780657794726,0.7138219342205274,0.029404944410806075
5349,41.0,456,11386,11842,5,708,15572,4567,11005,15572,1060,0.029283329052144876,0.7311841767274595,0.0003210891343436938,0.29328281530952993,0.7067171846904701,0.04546622142306704
5350,23.0,817,28563,29380,50,1257,39377,11201,28176,39377,3134,0.02074815247479493,0.7253726794829469,0.001269776773243264,0.28445539274195597,0.715544607258044,0.03192218807933565
5351,,85,4649,4734,37,1316,7588,1695,5893,7588,370,0.011201897733263046,0.6126779124934106,0.004876120189773327,0.22337901950448075,0.7766209804955192,0.17343173431734318
5352,14.0,666,12698,13364,308,725,18478,5100,13378,18478,1472,0.036042861781578096,0.6871955839376556,0.01666847061370278,0.27600389652559804,0.723996103474402,0.039235848035501675
5353,37.0,180,2901,3081,27,140,4195,1168,3027,4195,348,0.04290822407628129,0.6915375446960668,0.006436233611442193,0.27842669845053636,0.7215733015494636,0.033373063170441
5354,23.0,168,4358,4526,9,221,5876,1715,4161,5876,427,0.02859087814840027,0.7416609938733832,0.0015316541865214432,0.29186521443158614,0.7081347855684139,0.03761061946902655
5355,33.0,688,10886,11574,64,569,15157,4387,10770,15157,994,0.04539156825229267,0.7182160058058983,0.00422247146532955,0.28943722372501157,0.7105627762749884,0.03754041037144554
5356,15.0,244,3779,4023,15,828,6075,1506,4594,6100,257,0.04,0.6195081967213115,0.002459016393442623,0.24688524590163935,0.7531147540983607,0.13573770491803278
5357,,168,3949,4117,46,217,5450,1579,3871,5450,412,0.030825688073394496,0.7245871559633027,0.008440366972477064,0.2897247706422018,0.7102752293577982,0.03981651376146789
5358,17.0,438,57170,57608,197,3963,77539,22036,55503,77539,4474,0.005648770296238022,0.7373063877532596,0.002540656959723494,0.28419247088561883,0.7158075291143812,0.05110976411870156
5359,16.0,306,7834,8140,10,409,10678,3041,7637,10678,833,0.028657051882374978,0.7336579883873384,0.0009365049634763064,0.2847911593931448,0.7152088406068552,0.038303053006180934
5360,23.0,377,5950,6327,64,395,8715,2380,6335,8715,581,0.04325874928284567,0.6827309236947792,0.007343660355708549,0.27309236947791166,0.7269076305220884,0.045324153757888695
5361,16.0,213,6217,6430,20,457,8725,2418,6307,8725,511,0.024412607449856735,0.7125501432664757,0.002292263610315186,0.277134670487106,0.722865329512894,0.05237822349570201
5362,,522,5877,6399,18,385,9891,2283,7608,9891,522,0.052775250227479524,0.5941765241128298,0.0018198362147406734,0.2308158932362754,0.7691841067637246,0.038924274593064405
5363,16.0,625,19083,19708,120,1062,26655,7675,18980,26655,2019,0.023447758394297503,0.7159257175014069,0.004501969611705121,0.28793847308197335,0.7120615269180266,0.03984243106359032
5364,,542,15888,16430,47,770,22232,6347,15885,22232,1796,0.024379273119827276,0.7146455559553796,0.002114069809283915,0.28548938467074486,0.7145106153292551,0.034634760705289674
5365,15.0,36,3213,3249,19,472,4733,1243,3490,4733,356,0.007606169448552715,0.6788506232833298,0.004014367208958377,0.2626241284597507,0.7373758715402493,0.09972533276991337
5366,23.0,400,9198,9598,66,379,13100,3647,9453,13100,1043,0.030534351145038167,0.7021374045801527,0.005038167938931298,0.2783969465648855,0.7216030534351145,0.028931297709923663
5367,,445,9570,10015,70,441,13886,3800,10086,13886,932,0.03204666570646694,0.6891833501368284,0.005041048538095924,0.27365692063949304,0.726343079360507,0.03175860579000432
5368,,840,29480,30320,21,1019,39341,11335,28006,39341,3449,0.02135177041763046,0.7493454665616024,0.0005337942604407616,0.2881218067664777,0.7118781932335223,0.025901731018530286
5369,,255,2672,2927,0,146,3963,1085,2878,3963,265,0.0643451930355791,0.6742366893767348,0.0,0.2737824880141307,0.7262175119858693,0.03684077718899823
5370,26.0,342,8128,8470,106,437,10875,3145,7730,10875,687,0.03144827586206896,0.7474022988505747,0.00974712643678161,0.2891954022988506,0.7108045977011495,0.04018390804597701
5371,,1638,45315,46953,150,2007,60851,17784,43067,60851,4162,0.02691821005406649,0.7446878440781581,0.0024650375507386897,0.29225485201557905,0.707745147984421,0.03298220242888367
5372,37.0,628,12526,13154,151,700,18006,4893,13113,18006,1166,0.03487726313451072,0.6956570032211485,0.008386093524380762,0.2717427524158614,0.7282572475841386,0.03887593024547373
5373,24.0,189,4408,4597,21,190,6341,1811,4530,6341,482,0.02980602428639016,0.6951584923513642,0.0033117804762655733,0.2856016401198549,0.7143983598801451,0.029963728118593283
5374,,3725,68807,72532,435,4592,97822,27509,70313,97822,6702,0.03807936864917912,0.7033898305084746,0.004446852446279978,0.28121485964302506,0.7187851403569749,0.0469424055938337
5375,27.0,841,19206,20047,105,1031,26855,7472,19383,26855,2229,0.03131632843045988,0.7151740830385404,0.003909886427108546,0.27823496555576244,0.7217650344442376,0.03839136101284677
5376,23.0,212,6987,7199,8,314,9415,2743,6672,9415,739,0.02251725969198088,0.742113648433351,0.0008497079129049389,0.29134360063728093,0.7086563993627191,0.033351035581518855
5377,16.0,51,5238,5289,137,557,7661,2023,5638,7661,583,0.0066570943741025975,0.683722751599008,0.0178827829265109,0.2640647435060697,0.7359352564939303,0.07270591306617935
5378,,420,10276,10696,72,615,14867,4067,10800,14867,1181,0.028250487657227416,0.6911952646801641,0.0048429407412389856,0.27355888881415213,0.7264411111858479,0.041366785498083
5379,24.0,847,23000,23847,42,1757,31843,8635,23208,31843,2397,0.02659925258298527,0.7222937537292341,0.0013189712024620796,0.27117419841095375,0.7288258015890463,0.055176961969663665
5380,17.0,116,2957,3073,9,147,3992,1191,2801,3992,281,0.02905811623246493,0.7407314629258517,0.0022545090180360722,0.29834669338677355,0.7016533066132264,0.03682364729458918
5381,,258,6937,7195,13,516,9745,2764,6981,9745,747,0.02647511544381734,0.711852231913802,0.0013340174448435095,0.2836326321190354,0.7163673678809646,0.05295023088763468
5382,25.0,848,14176,15024,109,773,20644,5605,15039,20644,1435,0.041077310598721176,0.6866886262352258,0.005279984499128076,0.27150745979461344,0.7284925402053866,0.03744429374152296
5383,,695,16564,17259,48,867,22818,6658,16160,22818,1790,0.03045841002717153,0.725918134805855,0.002103602419142782,0.2917871855552634,0.7082128144447366,0.0379963186957665
5384,14.0,667,10303,10970,26,550,14827,4081,10746,14827,1062,0.044985499426721524,0.6948809604100628,0.001753557698792743,0.275241114183584,0.724758885816416,0.037094489782154176
5385,25.0,1741,42367,44108,902,2930,60962,16781,44181,60962,4470,0.028558774318427873,0.6949739181785375,0.014796102490075786,0.27526984022833895,0.724730159771661,0.0480627276008005
5386,,60,2056,2116,7,124,2860,795,2065,2860,212,0.02097902097902098,0.7188811188811188,0.0024475524475524478,0.27797202797202797,0.722027972027972,0.043356643356643354
5387,41.0,130,4391,4521,19,307,6239,1686,4553,6239,413,0.02083667254367687,0.7037986856868088,0.0030453598333066195,0.27023561468184004,0.72976438531816,0.04920660362237538
5388,,210,5266,5476,11,236,7375,2085,5290,7375,606,0.02847457627118644,0.7140338983050848,0.0014915254237288136,0.28271186440677964,0.7172881355932204,0.032
5389,,28,2028,2056,1,85,2773,777,1996,2773,201,0.01009736747205193,0.7313379011900469,0.0003606202668589975,0.28020194734944104,0.719798052650559,0.030652722683014784
5390,15.0,497,11032,11529,63,853,15331,4352,10979,15331,1014,0.03241797664862044,0.7195877633552932,0.0041093209836279435,0.2838692844563303,0.7161307155436697,0.055638901571978344
5391,,2624,35866,38490,148,2626,52465,14298,38167,52465,3671,0.05001429524444868,0.6836176498618126,0.0028209282378728676,0.2725245401696369,0.7274754598303631,0.050052415896311826
5392,,230,6246,6476,9,476,8869,2462,6407,8869,668,0.025933025143759163,0.7042507610779118,0.0010147705491036193,0.2775961213214568,0.7224038786785433,0.05367008681925809
5393,44.0,205,4689,4894,57,178,6346,1871,4475,6346,443,0.032303813425780016,0.7388906397730854,0.008982035928143712,0.2948313898518752,0.7051686101481248,0.02804916482823826
5394,26.0,189,5498,5687,4,208,7408,2168,5240,7408,547,0.02551295896328294,0.7421706263498921,0.0005399568034557236,0.29265658747300216,0.7073434125269978,0.028077753779697623
5395,17.0,90,7390,7480,45,946,10457,2792,7665,10457,644,0.008606674954575882,0.7067036434923974,0.004303337477287941,0.2669981830352874,0.7330018169647127,0.09046571674476428
5396,25.0,91,3802,3893,17,229,5052,1497,3555,5052,308,0.01801266825019794,0.7525732383214568,0.0033650039588281866,0.29631828978622327,0.7036817102137767,0.045328582739509106
5397,,245,5687,5932,12,229,7548,2246,5302,7548,537,0.032458929517753046,0.7534446210916799,0.001589825119236884,0.29756226815050346,0.7024377318494965,0.03033916269210387
5398,,214,6595,6809,4,264,8906,2636,6270,8906,716,0.024028744666516954,0.7405120143723333,0.00044913541432741973,0.2959802380417696,0.7040197619582305,0.0296429373456097
5399,24.0,379,15296,15675,64,743,21166,5977,15189,21166,1793,0.01790607578191439,0.7226684305017481,0.0030237172824340926,0.2823868468298214,0.7176131531701786,0.035103467825758294
5400,23.0,314,31539,31853,132,2179,42783,12244,30539,42783,2528,0.007339363765981815,0.737185330621976,0.0030853376341070052,0.28618843933338006,0.7138115606666199,0.05093144473272094
5401,17.0,78,3457,3535,10,338,4958,1387,3571,4958,258,0.01573215006050827,0.6972569584509883,0.002016942315449778,0.27974989915288423,0.7202501008471158,0.0681726502622025
5402,27.0,987,19101,20088,119,859,27389,7452,19937,27389,1898,0.03603636496403666,0.6973967651246851,0.004344809960203001,0.2720800321296871,0.7279199678703129,0.031362955931213264
5403,,41,14428,14469,48,373,19119,5497,13622,19119,2143,0.0021444636225744023,0.7546419791830117,0.002510591558135886,0.2875150373973534,0.7124849626026466,0.019509388566347614
5404,44.0,364,9329,9693,21,380,12725,3665,9060,12725,1016,0.028605108055009824,0.7331237721021611,0.001650294695481336,0.2880157170923379,0.7119842829076621,0.02986247544204322
5405,26.0,352,6810,7162,9,699,9993,2495,7498,9993,613,0.03522465726008206,0.6814770339237466,0.0009006304413089162,0.24967477234063845,0.7503252276593616,0.06994896427499249
5406,,188,3388,3576,15,160,4774,1334,3440,4774,405,0.03937997486384583,0.7096774193548387,0.003142019271051529,0.2794302471721827,0.7205697528278173,0.033514872224549644
5407,23.0,59,2712,2771,2,193,3708,1058,2650,3708,275,0.015911542610571736,0.7313915857605178,0.0005393743257820927,0.2853290183387271,0.714670981661273,0.052049622437971954
5408,,277,8436,8713,21,458,11606,3262,8344,11606,948,0.02386696536274341,0.7268654144408064,0.0018094089264173703,0.2810615199034982,0.7189384800965019,0.03946234706186455
5409,15.0,1476,19369,20845,331,1945,29600,7701,21899,29600,1581,0.04986486486486486,0.6543581081081081,0.011182432432432433,0.2601689189189189,0.7398310810810811,0.06570945945945945
5410,,845,18112,18957,173,1196,26078,7170,18908,26078,1824,0.032402791625124626,0.6945317892476417,0.006633944320883503,0.27494439757650124,0.7250556024234988,0.045862412761714856
5411,,20,9087,9107,53,1175,12878,3001,9877,12878,924,0.0015530361857431277,0.7056219909923901,0.004115545892219289,0.23303307967075632,0.7669669203292436,0.09124087591240876
5412,,54,3098,3152,17,170,4240,1130,3110,4240,374,0.012735849056603774,0.7306603773584905,0.004009433962264151,0.2665094339622642,0.7334905660377359,0.04009433962264151
5413,,1097,22370,23467,315,1536,32505,8814,23691,32505,2281,0.03374865405322258,0.6882018151053684,0.009690816797415782,0.27115828334102443,0.7288417166589756,0.047254268574065526
5414,17.0,511,16472,16983,93,1232,24725,6479,18246,24725,1651,0.020667340748230536,0.6662082912032355,0.003761375126390293,0.26204246713852375,0.7379575328614763,0.04982810920121335
5415,26.0,2511,74228,76739,236,3595,100500,29194,71306,100500,7114,0.02498507462686567,0.738587064676617,0.0023482587064676615,0.29048756218905475,0.7095124378109453,0.03577114427860697
5416,,494,11277,11771,49,573,15694,4476,11218,15694,1205,0.031476997578692496,0.7185548617305977,0.0031222123104371097,0.28520453676564295,0.714795463234357,0.03651076844654008
5417,14.0,332,4817,5149,16,318,7196,2012,5184,7196,541,0.04613674263479711,0.6693996664813785,0.0022234574763757642,0.27959977765425237,0.7204002223457476,0.04419121734296832
5418,,57,1892,1949,10,73,2571,759,1812,2571,177,0.022170361726954493,0.7359004278490859,0.0038895371450797353,0.2952158693115519,0.704784130688448,0.028393621159082068
5419,24.0,72,3450,3522,19,458,5058,1332,3726,5058,337,0.014234875444839857,0.6820877817319099,0.003756425464610518,0.26334519572953735,0.7366548042704626,0.09054962435745353
5420,,105,2046,2151,2,141,2968,826,2142,2968,251,0.03537735849056604,0.6893530997304582,0.0006738544474393531,0.2783018867924528,0.7216981132075472,0.047506738544474396
5421,25.0,364,9013,9377,18,567,12457,3607,8850,12457,985,0.029220518583928715,0.7235289395520591,0.001444970699205266,0.28955607289074414,0.7104439271092559,0.045516577024965886
5422,27.0,645,19422,20067,30,888,26020,7646,18374,26020,1855,0.024788624135280553,0.7464258262874712,0.0011529592621060721,0.2938508839354343,0.7061491160645658,0.03412759415833974
5423,17.0,266,5665,5931,81,881,9122,2088,7034,9122,415,0.029160271870203903,0.621026090769568,0.008879631659723745,0.22889717167287876,0.7711028283271213,0.09657969743477307
5424,17.0,238,4203,4441,8,195,6081,1741,4340,6081,424,0.03913829962177273,0.6911692155895411,0.001315573096530176,0.2863015951323795,0.7136984048676205,0.03206709422792304
5425,33.0,38,3071,3109,1,87,4050,1259,2791,4050,283,0.009382716049382716,0.7582716049382716,0.0002469135802469136,0.3108641975308642,0.6891358024691357,0.02148148148148148
5426,,1630,35176,36806,180,1621,49121,14196,34925,49121,3937,0.03318336353087274,0.7161091997312758,0.0036644205126117138,0.28900063109464386,0.7109993689053562,0.03300014250524216
5427,,448,12673,13121,290,634,17487,5019,12468,17487,1117,0.02561903128037971,0.724709784411277,0.01658374792703151,0.28701320981300393,0.7129867901869961,0.036255504088751646
5428,15.0,0,2311,2311,19,252,3220,837,2383,3220,250,0.0,0.7177018633540373,0.005900621118012423,0.25993788819875774,0.7400621118012423,0.0782608695652174
5429,15.0,85,3736,3821,20,407,5546,1397,4149,5546,302,0.015326361341507392,0.6736386584926073,0.003606202668589975,0.25189325640100974,0.7481067435989902,0.07338622430580599
5430,14.0,89,2204,2293,4,118,3106,857,2249,3106,223,0.02865421764327109,0.7095943335479716,0.00128783000643915,0.2759175788795879,0.7240824211204121,0.037990985189954925
5431,17.0,17271,348300,365571,1298,16692,478653,141230,337467,478697,34647,0.03607918996776667,0.7276001311894581,0.002711527333574265,0.295030050324109,0.704969949675891,0.03486965658861451
5432,,204,7444,7648,30,204,10208,2872,7336,10208,835,0.019984326018808778,0.72923197492163,0.002938871473354232,0.28134796238244514,0.7186520376175548,0.019984326018808778
5433,15.0,865,3843,4708,174,667,6697,1746,4951,6697,191,0.12916231148275348,0.5738390324025683,0.025981782887860235,0.2607137524264596,0.7392862475735404,0.09959683440346424
5434,27.0,508,9703,10211,32,569,13753,3757,9996,13753,863,0.03693739547735039,0.7055187958990765,0.002326765069439395,0.273176761433869,0.7268232385661311,0.04137279139096924
5435,,1881,22747,24821,170,1631,33858,9233,24625,33858,2347,0.05555555555555555,0.6718353121861894,0.005020969933250635,0.2726977376100183,0.7273022623899816,0.04817177624195168
5436,13.0,909,36532,37441,114,1359,48149,14488,33661,48149,3202,0.018878896757980435,0.7587281148102765,0.002367650418492596,0.3008992917817608,0.6991007082182392,0.028224885252030155
5437,23.0,212,3287,3499,19,221,4929,1296,3633,4929,306,0.043010752688172046,0.6668695475755732,0.003854737269222966,0.26293365794278756,0.7370663420572124,0.04483668086833029
5438,23.0,305,2955,3260,29,136,4951,1224,3727,4951,213,0.06160371642092507,0.5968491213896182,0.005857402544940416,0.24722278327610583,0.7527772167238942,0.02746919814178954
5439,,291,5406,5697,18,262,7880,2178,5702,7880,593,0.036928934010152285,0.6860406091370559,0.002284263959390863,0.2763959390862944,0.7236040609137055,0.033248730964467
5440,24.0,172,2540,2712,28,136,3677,1032,2645,3677,130,0.04677726407397335,0.690780527604025,0.007614903453902638,0.2806635844438401,0.7193364155561599,0.03698667391895567
5441,14.0,10,5168,5178,25,619,7341,1941,5400,7341,596,0.0013622122326658493,0.7039912818417109,0.0034055305816646235,0.26440539436044136,0.7355946056395587,0.08432093720201607
5442,,183,33307,33490,236,1978,44092,12317,31775,44092,3445,0.004150412773292207,0.7553978045904018,0.005352444887961535,0.27934772747890774,0.7206522725210922,0.04486074571350812
5443,,115,3718,3833,2,352,5257,1478,3779,5257,444,0.021875594445501235,0.7072474795510748,0.00038044512079132587,0.2811489442647898,0.7188510557352102,0.06695834125927334
5444,25.0,140,3324,3464,0,172,4614,1349,3265,4614,392,0.03034243606415258,0.7204161248374512,0.0,0.29237104464672736,0.7076289553532726,0.03727785002167317
5445,17.0,403,15975,16378,14,536,20523,6215,14308,20523,1452,0.019636505384203088,0.7783949714953954,0.0006821614773668567,0.30283097013107246,0.6971690298689276,0.026117039419188227
5446,27.0,4,18887,18891,11,893,24913,7131,17782,24913,2475,0.00016055874443061857,0.7581182515152731,0.000441536547184201,0.28623610163368524,0.7137638983663148,0.03584473969413559
5447,16.0,396,8448,8844,53,508,11725,3309,8416,11725,792,0.03377398720682303,0.7205117270788912,0.004520255863539446,0.2822174840085288,0.7177825159914712,0.04332622601279318
5448,16.0,803,14178,14981,47,950,21261,5700,15561,21261,1557,0.0377686844456987,0.6668548045717511,0.002210620384742016,0.2680965147453083,0.7319034852546917,0.044682752457551385
5449,23.0,301,15852,16153,53,1280,21433,6469,14964,21433,744,0.014043764288713666,0.7396071478561097,0.002472822283394765,0.30182428964680635,0.6981757103531937,0.059720990995194324
5450,,309,7745,8054,17,323,10519,3097,7422,10519,858,0.02937541591406027,0.7362867192698925,0.0016161232056279113,0.2944196216370377,0.7055803783629623,0.030706340906930318
5451,,110,4130,4240,11,186,5579,1603,3976,5579,431,0.019716795124574298,0.740276035131744,0.00197167951245743,0.28732747804265996,0.71267252195734,0.03333930811973472
5452,26.0,93,2642,2735,32,193,3771,1066,2705,3771,285,0.024661893396976928,0.7006099177936886,0.008485812781755503,0.2826836382922302,0.7173163617077698,0.05118005833996288
5453,34.0,222,9648,9870,44,336,12650,3787,8863,12650,1048,0.017549407114624507,0.7626877470355731,0.0034782608695652175,0.29936758893280635,0.7006324110671937,0.026561264822134386
5454,15.0,688,7858,8546,60,505,11640,3311,8329,11640,617,0.05910652920962199,0.675085910652921,0.005154639175257732,0.28445017182130583,0.7155498281786942,0.04338487972508591
5455,,18028,540174,558202,365,19776,713015,207803,509163,716966,59905,0.025144846478075668,0.7534164800004464,0.0005090896918403383,0.28983661707807623,0.7101633829219238,0.027582897933793236
5456,23.0,154,4463,4617,2,340,6229,1703,4526,6229,426,0.02472306951356558,0.7164873976561246,0.00032107882485150104,0.27339861936105314,0.7266013806389469,0.05458340022475518
5457,36.0,2447,73586,76033,638,3189,95593,29135,66463,95598,5804,0.025596769806899726,0.7697441369066298,0.006673779786187995,0.3047657900792904,0.6952342099207096,0.03335843846105567
5458,16.0,771,14815,15800,30,719,20689,5941,14748,20689,1393,0.03726618009570303,0.716081009231959,0.0014500459181207405,0.28715742665184396,0.712842573348156,0.034752767170960416
5459,15.0,2759,47330,50089,336,3695,67137,19061,48076,67137,4569,0.04109507425115808,0.7049763915575614,0.005004691898654989,0.28391200083411533,0.7160879991658847,0.055036715968839835
5460,33.0,8308,189985,198293,770,9994,261912,74624,187288,261912,20182,0.03172057790402883,0.7253772259384832,0.0029399187513363266,0.28492012584379484,0.7150798741562051,0.038157854546565256
5461,17.0,3747,74535,78282,497,3899,104836,29993,74843,104836,7622,0.035741539165935365,0.7109676065473692,0.004740737914456866,0.2860944713647984,0.7139055286352016,0.03719142279369682
5462,23.0,4797,83502,88299,654,4809,122211,33276,88935,122211,8171,0.039251785845791295,0.6832609175933426,0.005351400446768294,0.2722831823649262,0.7277168176350738,0.039349976679676955
5463,24.0,4119,87979,92098,314,4278,121518,35036,86482,121518,8817,0.03389621290672987,0.7239997366645271,0.002583979328165375,0.288319425928669,0.711680574071331,0.035204661037870934
5464,17.0,1431,32543,33974,166,3696,47364,12899,34465,47364,2952,0.030212819863187232,0.6870830166371084,0.0035047715564563804,0.2723376404019931,0.727662359598007,0.07803394983531796
5465,25.0,712,14364,15076,128,717,20748,5674,15074,20748,1465,0.034316560632350106,0.6923076923076923,0.006169269327164064,0.2734721418931945,0.7265278581068054,0.03455754771544245
5466,,4334,94305,98639,616,4643,133933,37620,96317,133937,9384,0.03235849690526143,0.7040996886595937,0.0045991772251133,0.28087832339084795,0.719121676609152,0.034665551714612095
5467,,6,1983,1989,12,154,2798,755,2043,2798,162,0.002144388849177984,0.7087205146533238,0.004288777698355968,0.26983559685489633,0.7301644031451037,0.055039313795568263
5468,16.0,28606,482941,511547,2867,26823,705956,197537,508419,705956,51040,0.04052093898203288,0.6840950427505397,0.004061159619013083,0.27981488931321497,0.720185110686785,0.03799528582517891
5469,45.0,129,1576,1705,9,79,2295,658,1637,2295,155,0.05620915032679739,0.6867102396514161,0.00392156862745098,0.2867102396514161,0.7132897603485838,0.03442265795206972
5470,15.0,805,17558,18363,26,1581,25363,7100,18263,25363,2110,0.031739147577179355,0.6922682647951741,0.0010251153254741158,0.2799353388794701,0.7200646611205299,0.06233489729132989
5471,,19,2654,2673,9,392,3769,1034,2735,3769,183,0.0050411249668347044,0.7041655611568055,0.0023879013000795966,0.2743433271424781,0.7256566728575219,0.1040063677368002
5472,17.0,136,2433,2569,2,104,3671,976,2695,3671,258,0.037047126123672024,0.6627621901389267,0.0005448106782892945,0.2658676110051757,0.7341323889948242,0.028330155271043312
5473,,452,9628,10080,51,418,13585,3712,9873,13585,1000,0.03327199116672801,0.7087228560912772,0.0037541405962458595,0.2732425469267575,0.7267574530732426,0.03076923076923077
5474,16.0,2254,64154,66408,83,3050,88708,25367,63341,88708,7575,0.025409207737746315,0.7232042205888984,0.0009356540560039681,0.28596067998376695,0.714039320016233,0.03438246832303738
5475,,369,12061,12430,28,595,16564,4746,11843,16589,1255,0.02224365543432395,0.7270480438845017,0.0016878654530110314,0.28609319428536983,0.7139068057146302,0.03586714087648442
5476,17.0,556,54442,54998,172,3242,73573,20864,52709,73573,5822,0.007557120139181493,0.7399725442757533,0.0023378141437755697,0.2835822924170552,0.7164177075829449,0.044065078221630215
5477,37.0,1038,32367,33405,54,1026,43123,12659,30464,43123,3140,0.024070681538853975,0.7505739396609697,0.001252231987570438,0.2935556431602625,0.7064443568397375,0.023792407763838324
5478,,30,4653,4683,5,224,6116,1738,4378,6116,495,0.004905166775670372,0.7607913669064749,0.0008175277959450621,0.2841726618705036,0.7158273381294964,0.03662524525833878
5479,,186,4357,4543,30,264,6028,1694,4334,6028,410,0.03085600530856005,0.7227936297279363,0.004976775049767751,0.28102189781021897,0.718978102189781,0.043795620437956206
5480,,1595,24839,26434,178,2001,37433,10040,27393,37433,2479,0.04260946223920071,0.6635588918868378,0.004755162557102022,0.2682125397376646,0.7317874602623353,0.05345550717281543
5481,13.0,123,2479,2602,4,171,3481,955,2526,3481,244,0.03533467394426889,0.7121516805515656,0.0011490950876185005,0.27434645216891695,0.725653547831083,0.04912381499569089
5482,26.0,172,5065,5237,17,190,6861,2063,4798,6861,559,0.025069231890394988,0.7382305786328524,0.0024777729193995045,0.30068503133653984,0.6993149686634601,0.02769275615799446
5483,,131,3291,3422,3,147,4544,1341,3203,4544,290,0.028829225352112676,0.7242517605633803,0.0006602112676056338,0.2951144366197183,0.7048855633802817,0.032350352112676055
5484,,62,2407,2469,6,145,3259,909,2350,3259,242,0.019024240564590365,0.7385701135317582,0.001841055538508745,0.27891991408407485,0.7210800859159251,0.04449217551396134
5485,15.0,391,18508,18899,78,798,25198,7184,18014,25198,2183,0.015517104532105723,0.7345027383125645,0.0030954837685530597,0.28510199222160487,0.7148980077783951,0.031669180093658225
5486,24.0,209,4806,5015,19,306,6714,1931,4783,6714,490,0.031128984212094132,0.7158176943699732,0.002829907655644921,0.28760798331843906,0.7123920166815609,0.045576407506702415
5487,,514,17899,18413,388,2825,27970,6721,21249,27970,1810,0.018376832320343223,0.6399356453342867,0.01387200572041473,0.24029317125491598,0.759706828745084,0.10100107257776189
5488,26.0,5819,126653,132472,634,6827,176022,50662,125361,176023,11946,0.03305817989694529,0.7195252893087836,0.0036018020372337706,0.2878146605841282,0.7121853394158718,0.03878470427160087
5489,,29624,287276,316959,9568,28512,449707,119093,330799,449892,24537,0.06584691437056005,0.638544361757933,0.021267326380553554,0.26471464262534117,0.7352853573746588,0.06337521005041209
5490,14.0,360,4114,4474,35,311,6090,1668,4422,6090,374,0.059113300492610835,0.6755336617405583,0.005747126436781609,0.2738916256157635,0.7261083743842365,0.05106732348111658
5491,,21,5614,5635,31,367,7708,2168,5540,7708,713,0.0027244421380384016,0.7283341982355994,0.004021795537104307,0.2812662169174883,0.7187337830825117,0.04761286974571873
5492,26.0,136,2703,2839,67,183,4027,1098,2929,4027,272,0.033772038738515024,0.6712192699279861,0.016637695555003724,0.27265954805065806,0.7273404519493419,0.04544325800844301
5493,17.0,1076,17294,19169,146,1309,25767,6934,18849,25783,1449,0.04173292479540783,0.6707520459217313,0.005662645929488423,0.26893689640460766,0.7310631035953923,0.05076988713493387
5494,25.0,952,22375,23327,90,1074,30532,8850,21682,30532,2054,0.031180400890868598,0.7328376785012446,0.0029477269749770734,0.2898598192060789,0.7101401807939212,0.03517620856805974
5495,,181,3836,4017,18,242,5428,1507,3921,5428,386,0.033345615327929255,0.7067059690493737,0.003316138540899042,0.27763448784082534,0.7223655121591747,0.04458364038319823
5496,17.0,31,2150,2181,14,94,2993,819,2174,2993,250,0.010357500835282325,0.7183427998663549,0.004677581022385567,0.27363848980955563,0.7263615101904444,0.031406615436017374
5497,15.0,132,4093,4225,5,146,5823,1592,4231,5823,470,0.02266872746007213,0.7029022840460244,0.000858663918942126,0.27339859179117293,0.726601408208827,0.02507298643311008
5498,46.0,225,5122,5347,8,163,6915,2017,4899,6916,511,0.03253325621746674,0.7406015037593985,0.001156737998843262,0.2916425679583574,0.7083574320416426,0.023568536726431465
5499,45.0,61,1738,1799,5,96,2446,690,1756,2446,170,0.024938675388389207,0.7105478331970564,0.002044153720359771,0.2820932134096484,0.7179067865903516,0.039247751430907606
5500,,2,7233,7235,14,339,9576,2756,6820,9576,833,0.00020885547201336674,0.7553258145363408,0.0014619883040935672,0.2878028404344194,0.7121971595655806,0.03540100250626566
5501,,221,6861,7082,23,234,9300,2717,6583,9300,752,0.023763440860215052,0.737741935483871,0.0024731182795698927,0.2921505376344086,0.7078494623655914,0.025161290322580646
5502,43.0,395,9489,9884,37,239,12806,3758,9048,12806,969,0.03084491644541621,0.7409807902545682,0.002889270654380759,0.2934561924098079,0.7065438075901921,0.018663126659378415
5503,15.0,115,1383,1498,12,108,2137,538,1599,2137,118,0.05381375760411792,0.6471689284043051,0.005615348619560131,0.25175479644361254,0.7482452035563875,0.05053813757604118
5504,23.0,156,3994,4150,11,158,5422,1608,3814,5422,377,0.028771670970121725,0.7366285503504242,0.002028771670970122,0.2965695315381778,0.7034304684618222,0.029140538546661748
5505,23.0,280,6009,6289,25,262,8399,2437,5962,8399,665,0.03333730205976902,0.7154423145612573,0.002976544826765091,0.2901535897130611,0.709846410286939,0.031194189784498155
5506,24.0,149,4878,5027,0,241,6659,1888,4771,6659,535,0.02237573209190569,0.7325424237873555,0.0,0.2835260549632077,0.7164739450367923,0.03619162036341793
5507,,1321,5349,6670,142,176,9514,2631,6883,9514,599,0.13884801345385747,0.562224090813538,0.014925373134328358,0.27653983603111204,0.7234601639688879,0.018499054025646416
5508,13.0,71,3670,3741,27,313,5152,1398,3754,5152,352,0.013781055900621118,0.7123447204968945,0.005240683229813665,0.2713509316770186,0.7286490683229814,0.06075310559006211
5509,17.0,26,3117,3169,28,387,4557,1172,3385,4557,355,0.005705508009655475,0.6840026333113891,0.006144393241167435,0.25718674566600835,0.7428132543339917,0.08492429229756418
5510,,3545,96083,99628,388,4715,132076,37684,94392,132076,10113,0.026840606923286593,0.7274826614979254,0.002937702534904146,0.2853205730034223,0.7146794269965777,0.03569914291771405
5511,34.0,73,2284,2357,19,79,3154,912,2242,3154,291,0.023145212428662017,0.7241597970830691,0.006024096385542169,0.2891566265060241,0.7108433734939759,0.025047558655675334
5512,,326,2329,2655,7,277,3655,1036,2619,3655,267,0.08919288645690834,0.6372093023255814,0.0019151846785225718,0.2834473324213406,0.7165526675786593,0.07578659370725034
5513,17.0,398,13118,13516,154,821,18624,5011,13613,18624,1577,0.021370274914089347,0.7043599656357389,0.008268900343642612,0.2690614261168385,0.7309385738831615,0.04408290378006873
5514,15.0,575,9321,9896,140,1097,14044,3896,10148,14044,986,0.04094275135289092,0.663699800626602,0.009968669894616918,0.27741384221019655,0.7225861577898035,0.07811164910281972
5515,,111,2995,3106,12,240,4156,1176,2980,4156,258,0.02670837343599615,0.7206448508180944,0.0028873917228103944,0.2829643888354187,0.7170356111645814,0.05774783445620789
5516,,108,3071,3179,5,158,4276,1205,3071,4276,309,0.025257249766136577,0.7181945743685687,0.0011693171188026192,0.28180542563143124,0.7181945743685687,0.03695042095416277
5517,14.0,613,27693,28306,84,2546,40605,10569,30036,40605,2987,0.015096662972540328,0.6820096047284817,0.002068710749907647,0.2602881418544514,0.7397118581455486,0.06270163772934367
5518,23.0,125,4419,4544,18,214,6126,1757,4369,6126,523,0.02040483186418544,0.7213516160626836,0.002938295788442703,0.2868103166829905,0.7131896833170095,0.03493307215148547
5519,27.0,1350,34403,35753,138,1738,47630,13510,34120,47630,3443,0.028343480999370146,0.7222968717195045,0.002897333613268948,0.2836447617048079,0.7163552382951921,0.03648960739030023
5520,25.0,895,20332,21227,68,940,27969,7992,19977,27969,2041,0.03199971396903715,0.7269476920876685,0.002431263184239694,0.28574493188887695,0.714255068111123,0.033608638135078125
5521,,20,2023,2043,1,74,2709,802,1907,2709,216,0.007382798080472499,0.7467700258397932,0.00036913990402362494,0.29605020302694723,0.7039497969730528,0.027316352897748246
5522,17.0,10136,215322,225458,617,9464,291220,85578,205649,291227,20575,0.034804465245324094,0.7393613916292102,0.0021186222431299295,0.293853248496877,0.706146751503123,0.03249698688651808
5523,26.0,512,13601,14113,32,497,18175,5343,12832,18175,1211,0.028170563961485557,0.7483356258596974,0.0017606602475928473,0.2939752407152682,0.7060247592847317,0.02734525447042641
5524,,403,26069,26472,82,1488,35910,10117,25793,35910,3627,0.011222500696184906,0.7259537733221944,0.0022834864940128098,0.2817321080478975,0.7182678919521025,0.041436925647451966
5525,16.0,118,5066,5184,56,374,7254,1973,5281,7254,565,0.01626688723462917,0.6983733112765371,0.007719878687620623,0.2719878687620623,0.7280121312379377,0.05155776123518059
5526,23.0,1240,28194,29434,52,1428,38575,11185,27390,38575,2752,0.0321451717433571,0.7308878807517822,0.0013480233311730396,0.2899546338302009,0.7100453661697991,0.03701879455605962
5527,,58,5210,5268,75,527,7433,2030,5403,7433,574,0.007803040495089466,0.7009282927485537,0.010090138571236378,0.2731064173281313,0.7268935826718687,0.07090004036055428
5528,,71,3539,3610,24,216,5308,1393,3915,5308,432,0.013376036171816126,0.6667294649585531,0.00452147701582517,0.2624340617935192,0.7375659382064808,0.04069329314242653
5529,13.0,80,9015,9095,13,468,12972,3366,9606,12972,993,0.006167129201356768,0.6949583718778909,0.0010021584952204748,0.25948196114708605,0.740518038852914,0.036077705827937095
5530,,533,8239,8772,218,267,11780,3225,8555,11780,762,0.045246179966044145,0.6994057724957555,0.018505942275042445,0.2737691001697793,0.7262308998302207,0.02266553480475382
5531,13.0,181,4299,4480,24,300,6008,1672,4336,6008,460,0.030126498002663114,0.7155459387483355,0.0039946737683089215,0.2782956058588549,0.7217043941411452,0.049933422103861515
5532,43.0,4487,83269,87756,278,5184,119306,33308,85998,119306,7745,0.03760917305081052,0.6979447806480814,0.0023301426583742643,0.279181264982482,0.720818735017518,0.04345129331299348
5533,33.0,185,3383,3568,18,244,4899,1352,3547,4899,319,0.03776280873647683,0.6905490916513575,0.003674219228413962,0.27597468871198205,0.724025311288018,0.049806082874055926
5534,26.0,780,10580,11360,58,843,15682,4441,11241,15682,1056,0.04973855375589848,0.6746588445351358,0.003698507843387323,0.28319091952557074,0.7168090804744293,0.05375589848233644
5535,17.0,785,19865,20650,131,949,27331,7878,19453,27331,2009,0.028721964070103547,0.7268303391752955,0.0047930920932274705,0.28824411840035125,0.7117558815996488,0.034722476308953205
5536,16.0,976,23212,24188,281,1834,32687,9230,23457,32687,2259,0.02985896533790192,0.7101294092452657,0.00859668981552299,0.28237525621806836,0.7176247437819316,0.05610793281732799
5537,,454,6773,7227,107,787,10059,2781,7278,10059,635,0.04513371110448355,0.6733273685256984,0.010637240282334228,0.27646883388010735,0.7235311661198927,0.07823839347847698
5538,,3406,89669,93075,336,4369,121580,35726,85854,121580,8917,0.028014476065142294,0.7375308438887975,0.002763612436255963,0.2938476723145254,0.7061523276854745,0.035935186708340186
5539,23.0,820,18791,19611,503,1148,26546,7501,19045,26546,2056,0.030889776237474572,0.7078655918029082,0.01894824078957282,0.28256611165524,0.7174338883447601,0.0432456867324644
5540,,2583,16064,18647,241,1154,25180,6642,18538,25180,1080,0.10258141382049245,0.6379666401906274,0.009571088165210484,0.26378077839555203,0.736219221604448,0.04583002382843527
5541,13.0,197,1981,2178,6,242,3376,783,2593,3376,144,0.05835308056872038,0.5867890995260664,0.0017772511848341231,0.23193127962085308,0.768068720379147,0.07168246445497631
5542,14.0,81,2101,2182,4,61,2907,790,2117,2907,251,0.02786377708978328,0.7227382180942552,0.0013759889920880633,0.2717578259373925,0.7282421740626075,0.020983832129342964
5543,,67,2538,2605,0,38,3300,1018,2282,3300,287,0.020303030303030302,0.769090909090909,0.0,0.3084848484848485,0.6915151515151515,0.011515151515151515
5544,14.0,1234,23807,25041,97,959,33974,9433,24541,33974,2538,0.03632189321245658,0.7007417436863483,0.0028551245069759227,0.2776534997350915,0.7223465002649084,0.028227468063813505
5545,,322,6668,6990,35,254,9398,2642,6756,9398,712,0.03426260906575867,0.7095126622685678,0.003724196637582464,0.28112364332836776,0.7188763566716323,0.02702702702702703
5546,,1278,24176,25454,339,2019,34894,9394,25500,34894,2258,0.03662520777210982,0.6928411761334327,0.009715137272883591,0.2692153378804379,0.7307846621195621,0.057860950306642976
5547,23.0,605,9108,9713,284,438,12642,3602,9040,12642,634,0.047856351843062805,0.7204556241101091,0.022464799873437746,0.2849232716342351,0.7150767283657649,0.03464641670621737
5548,25.0,370,2658,3028,36,103,4617,1139,3478,4617,109,0.08013861815031406,0.5756985055230669,0.007797270955165692,0.24669698938704787,0.7533030106129521,0.02230885856616851
5549,13.0,1766,40926,42692,62,2500,57489,16160,41329,57489,3826,0.030718920141244412,0.7118927099097219,0.0010784671850267008,0.2810972533876046,0.7189027466123954,0.04348658004139922
5550,26.0,1679,40332,42011,143,1544,54424,15897,38527,54424,4189,0.030850360135234456,0.7410701161252389,0.0026275172717918566,0.29209539908863735,0.7079046009113626,0.028369836836689696
5551,47.0,481,18665,19146,42,2511,26187,5956,20231,26187,1551,0.01836789246572727,0.7127582388207889,0.0016038492381716118,0.22744109672738383,0.7725589032726162,0.09588727231068851
5552,25.0,717,23299,24146,37,996,31340,9238,22112,31350,2389,0.022870813397129187,0.7431897926634768,0.0011802232854864433,0.29467304625199364,0.7053269537480064,0.031770334928229664
5553,16.0,573,11634,12207,58,788,16943,4618,12325,16943,1242,0.03381927639733223,0.6866552558578765,0.003423242637077259,0.27256093962108247,0.7274390603789176,0.04650888272442897
5554,,810,45827,46637,67,1990,60328,18041,42287,60328,5116,0.013426601246519029,0.7596306855854661,0.001110595411749105,0.2990485346770985,0.7009514653229014,0.032986341334040575
5555,,101,2008,2109,14,130,2862,821,2041,2862,227,0.035290006988120196,0.7016072676450035,0.004891684136967156,0.28686233403214534,0.7131376659678547,0.045422781271837874
5556,23.0,1455,24999,26454,171,3102,36807,9898,26909,36807,2404,0.03953052408509251,0.6791914581465482,0.004645855407938707,0.2689162387589317,0.7310837612410682,0.08427744722471268
5557,,216,12080,12296,50,553,16327,4685,11642,16327,1446,0.013229619648435107,0.739878728486556,0.0030624119556562747,0.28694800024499295,0.713051999755007,0.0338702762295584
5558,38.0,55,2639,2694,34,128,3611,1006,2605,3611,258,0.015231237884242592,0.7308224868457491,0.009415674328440876,0.2785931874826918,0.7214068125173082,0.03544724453060094
5559,16.0,116,4575,4691,26,284,6284,1741,4543,6284,534,0.018459579885423297,0.7280394653087205,0.004137492043284532,0.27705283259070657,0.7229471674092934,0.04519414385741566
5560,,296,14657,14953,23,393,19401,5707,13694,19401,1729,0.015256945518272254,0.7554765218287717,0.0011855059017576413,0.2941600948404721,0.7058399051595279,0.02025668779959796
5561,,73,2126,2199,0,107,2910,807,2103,2910,227,0.025085910652920963,0.7305841924398625,0.0,0.277319587628866,0.722680412371134,0.03676975945017182
5562,23.0,1791,43727,45518,307,2402,61515,17293,44222,61515,4771,0.029114850036576444,0.7108347557506299,0.004990652686336666,0.281118426400065,0.718881573599935,0.03904738681622368
5563,13.0,8,1971,1979,11,188,2765,751,2014,2765,225,0.0028933092224231465,0.7128390596745027,0.003978300180831827,0.27160940325497285,0.7283905967450272,0.06799276672694395
5564,23.0,517,16721,17238,13,443,22198,6624,15575,22199,1878,0.023289337357538627,0.7532321275733141,0.0005856119645029056,0.29839181945132665,0.7016081805486734,0.019955853867291318
5565,15.0,120,2928,3048,34,289,4396,1160,3236,4396,283,0.0272975432211101,0.6660600545950864,0.0077343039126478615,0.26387625113739765,0.7361237488626023,0.06574158325750683
5566,15.0,84,1928,2012,25,109,2766,759,2007,2766,187,0.03036876355748373,0.6970354302241504,0.009038322487346349,0.27440347071583515,0.7255965292841648,0.03940708604483008
5567,15.0,670,10922,11592,60,727,15817,4308,11509,15817,1099,0.04235948662831131,0.690522855155845,0.0037933868622368337,0.27236517670860466,0.7276348232913953,0.0459632041474363
5568,,3750,44125,47875,306,3403,65236,17939,47297,65236,4542,0.05748359801336685,0.67639033662395,0.004690661597890735,0.27498620393647677,0.7250137960635232,0.05216444907719664
5569,,39,1905,1944,0,30,2498,740,1758,2498,223,0.015612489991993595,0.7626100880704564,0.0,0.2962369895916733,0.7037630104083267,0.01200960768614892
5570,,653,16683,17336,25,1079,23535,6623,16912,23535,2106,0.027745910346292757,0.7088591459528362,0.0010622477161674102,0.28141066496707035,0.7185893350329297,0.045846611429785425
5571,17.0,1178,26217,27395,155,1378,36489,10178,26311,36489,2778,0.03228370193757023,0.7184905039875031,0.004247855518101346,0.2789333771821645,0.7210666228178355,0.037764805831894545
5572,16.0,482,9801,10283,18,625,13590,3926,9664,13590,974,0.035467255334805006,0.7211920529801324,0.0013245033112582781,0.28888888888888886,0.7111111111111111,0.045989698307579104
5573,,171,4080,4251,27,209,5651,1626,4025,5651,462,0.030260130950274286,0.7219961068837374,0.004777915413201203,0.28773668377278355,0.7122633162272164,0.03698460449477969
5574,26.0,574,13562,14136,56,873,19155,5223,13932,19155,1346,0.029966066301226835,0.7080135734795092,0.002923518663534325,0.27267032106499606,0.7273296789350039,0.04557556773688332
5575,25.0,326,9809,10135,49,463,13171,3914,9257,13171,938,0.0247513476577329,0.7447422367322147,0.0037202945865917546,0.29716802065143116,0.7028319793485688,0.03515298762432617
5576,27.0,700,12839,13539,103,1650,18882,5211,13671,18882,1145,0.03707234403135261,0.6799597500264802,0.00545493062175617,0.2759771210676835,0.7240228789323165,0.08738481093104544
5577,24.0,1094,26927,28021,176,1989,37491,10144,27347,37491,2585,0.02918033661412072,0.7182257075031341,0.004694460003734229,0.27057160385159107,0.7294283961484089,0.053052732655837403
5578,25.0,457,14353,14810,53,829,19578,5569,14009,19578,1428,0.023342527326591072,0.7331188068239861,0.002707120237000715,0.28445193584635814,0.7155480641536418,0.04234344672591685
5579,,64,2654,2718,4,117,3537,1057,2480,3537,271,0.018094430308170765,0.7503534068419565,0.0011309018942606728,0.2988408255583828,0.7011591744416172,0.03307888040712468
5580,24.0,45,1560,1605,3,49,2082,590,1492,2082,172,0.021613832853025938,0.7492795389048992,0.001440922190201729,0.28338136407300674,0.7166186359269933,0.023535062439961577
5581,16.0,121,4407,4528,19,166,5937,1714,4223,5937,561,0.020380663634832406,0.7422940879231935,0.0032002694963786426,0.2886979956206838,0.7113020043793161,0.027960249284150245
5582,26.0,186,8044,8230,15,322,10789,3145,7644,10789,950,0.017239781258689406,0.7455741959403096,0.0013903049402168876,0.2915006024654741,0.708499397534526,0.029845212716655852
5583,33.0,559,16590,17149,28,1115,22971,6397,16574,22971,1537,0.024335031126202604,0.7222149666971399,0.0012189282138348352,0.27848156371076577,0.7215184362892343,0.0485394628009229
5584,,185,6800,6985,24,272,9110,2740,6370,9110,750,0.02030735455543359,0.7464324917672887,0.0026344676180021956,0.300768386388584,0.6992316136114161,0.029857299670691548
5585,,196,3614,3810,11,149,4935,1459,3476,4935,381,0.03971631205673759,0.7323201621073961,0.0022289766970618034,0.2956433637284701,0.7043566362715299,0.030192502532928066
5586,24.0,667,13617,14284,60,689,18887,5356,13531,18887,1310,0.0353152962355059,0.720972097209721,0.0031767882670620004,0.28358129930640125,0.7164187006935988,0.036480118600095306
5587,,129,4598,4727,48,270,6489,1715,4774,6489,579,0.019879796578825704,0.7085837571274465,0.007397133610725843,0.26429341963322545,0.7357065803667745,0.04160887656033287
5588,36.0,426,9873,10299,11,458,13574,3991,9583,13574,1171,0.031383527331663476,0.7273463975246796,0.0008103727714748784,0.29401797554147635,0.7059820244585236,0.03374097539413585
5589,,880,6073,6953,2897,1788,13857,2627,11230,13857,479,0.0635058093382406,0.43826225012628994,0.20906401096918525,0.18957927401313415,0.8104207259868659,0.12903225806451613
5590,,3987,77111,81098,482,3271,107980,30957,77023,107980,7443,0.0369235043526579,0.7141229857380996,0.004463789590664938,0.2866919799962956,0.7133080200037044,0.030292646786441935
5591,16.0,221,5747,5968,17,258,7776,2238,5538,7776,555,0.028420781893004114,0.7390689300411523,0.0021862139917695473,0.28780864197530864,0.7121913580246914,0.033179012345679014
5592,,1093,44694,45787,381,3346,62178,17409,44779,62188,4542,0.017575738084517914,0.7186917090113848,0.00612658390686306,0.279941467807294,0.720058532192706,0.05380459252588924
5593,,24896,485477,510373,2221,26138,688046,195911,492135,688046,52621,0.03618362725747988,0.7055879984768461,0.0032279818500507234,0.28473532292899023,0.7152646770710098,0.037988739125000365
5594,24.0,91,3360,3451,2,174,4559,1328,3231,4559,374,0.019960517657381004,0.737003728887914,0.0004386926957666155,0.2912919499890327,0.7087080500109674,0.03816626453169555
5595,23.0,2442,40802,43244,162,1879,57412,16355,41057,57412,3988,0.042534661743189574,0.710687661116143,0.0028217097470912005,0.28487075872639867,0.7151292412736013,0.03272834947397756
5596,,2216,26236,28452,23,1495,37831,10805,27026,37831,2894,0.05857629985990325,0.6935053263196849,0.0006079670111813064,0.2856123285136528,0.7143876714863472,0.039517855726784915
5597,,251,5832,6083,15,292,8003,2342,5661,8003,606,0.03136323878545545,0.728726727477196,0.001874297138573035,0.29264025990253656,0.7073597400974635,0.036486317630888415
5598,,1036,27132,28168,95,2002,37467,10340,27127,37467,2612,0.02765099954626738,0.7241572583873809,0.0025355646302079164,0.27597619238263005,0.72402380761737,0.053433688312381565
5599,17.0,564,5838,6402,13,383,8921,2476,6445,8921,634,0.06322161192691403,0.6544109404775249,0.0014572357359040466,0.2775473601614169,0.7224526398385831,0.04293240668086537
5600,16.0,300,5261,5561,19,519,7948,2099,5849,7948,482,0.0377453447408153,0.6619275289380976,0.0023905385002516355,0.2640915953699044,0.7359084046300957,0.06529944640161046
5601,27.0,221,4171,4392,29,285,6042,1676,4366,6042,375,0.03657729228732208,0.6903343263819928,0.004799735187024164,0.27739159218801723,0.7226084078119828,0.04716981132075472
5602,33.0,3403,83916,87319,330,4131,114765,33387,81378,114765,7174,0.029651897355465518,0.7311985361390668,0.002875441118807999,0.29091622010194745,0.7090837798980525,0.03599529473271468
5603,25.0,20,5026,5046,3,437,6791,1937,4854,6791,627,0.0029450743631276688,0.7400971874539832,0.00044176115446915035,0.28523045206891473,0.7147695479310853,0.06434987483433957
5604,13.0,53,4374,4427,14,619,6418,1645,4773,6418,463,0.008258024306637583,0.6815207229666563,0.0021813649111872857,0.2563103770645061,0.7436896229354939,0.09644749143035214
5605,23.0,236,5684,5920,7,285,8007,2215,5792,8007,655,0.02947421006619208,0.7098788560009991,0.0008742350443362058,0.27663294617209944,0.7233670538279006,0.035593855376545525
5606,,693,14848,15541,373,706,20972,5641,15331,20972,1258,0.033044058744993325,0.7079916078580966,0.017785618920465384,0.26897768453175663,0.7310223154682434,0.03366393286286477
5607,39.0,768,24768,25536,48,547,32828,9744,23084,32828,2568,0.02339466309248203,0.7544778847325454,0.0014621664432801268,0.2968197879858657,0.7031802120141343,0.01666260509321311
5608,15.0,335,21965,22300,786,1363,30829,8302,22527,30829,2169,0.010866392033474975,0.7124785104933666,0.025495475039735316,0.26929190048331114,0.7307080995166888,0.044211618930228035
5609,,425,8247,8672,37,635,11874,3274,8600,11874,835,0.03579248778844534,0.6945426983324912,0.0031160518780528885,0.27572848239851777,0.7242715176014822,0.05347818763685363
5610,,330,4045,4375,24,227,5980,1665,4315,5980,366,0.05518394648829431,0.6764214046822743,0.004013377926421404,0.27842809364548493,0.7215719063545151,0.037959866220735786
5611,,153,1822,1975,53,161,2797,722,2075,2797,138,0.05470146585627458,0.6514122273864855,0.01894887379335002,0.25813371469431534,0.7418662853056847,0.05756167322130854
5612,13.0,701,12966,13667,56,766,18145,5245,12900,18145,1296,0.03863323229539818,0.7145770184623863,0.003086249655552494,0.28906034720308627,0.7109396527969137,0.042215486359878755
5613,,141,2042,2183,41,150,2911,802,2109,2911,174,0.04843696324287187,0.7014771556166266,0.014084507042253521,0.2755066987289591,0.7244933012710408,0.05152868430092752
5614,,302,4456,4762,17,679,7149,1751,5398,7149,380,0.04224367044341866,0.6233039585956078,0.0023779549587354875,0.24492936074975521,0.7550706392502448,0.09497831864596447
5615,,1031,20348,21379,91,1290,28980,8063,20917,28980,1920,0.035576259489302965,0.7021394064872326,0.003140096618357488,0.2782263630089717,0.7217736369910283,0.044513457556935816
5616,15.0,2802,56088,58890,295,3194,78139,22464,55675,78139,5703,0.03585917403601275,0.7177977706395015,0.003775323462035603,0.28748768220734844,0.7125123177926516,0.04087587504319226
5617,,163,3585,3748,8,214,5038,1448,3590,5038,359,0.032354108773322746,0.7115919015482334,0.0015879317189360857,0.2874156411274315,0.7125843588725684,0.042477173481540294
5618,,8912,134149,143061,161,11709,199036,54728,144313,199041,11983,0.04477469466089901,0.6739767183645581,0.0008088785727563668,0.27495842565099654,0.7250415743490035,0.05882707582859813
5619,25.0,1081,26129,27210,126,1843,37542,10396,27146,37542,2317,0.028794416919716584,0.6959938202546482,0.003356241010068723,0.2769165201640829,0.7230834798359171,0.04909168398060838
5620,17.0,39,1512,1551,3,34,2036,610,1426,2036,203,0.019155206286836934,0.7426326129666012,0.0014734774066797642,0.29960707269155207,0.7003929273084479,0.01669941060903733
5621,,4,1596,1600,10,239,2306,589,1717,2306,162,0.0017346053772766695,0.6921075455333912,0.004336513443191674,0.2554206418039896,0.7445793581960104,0.10364267129228101
5622,15.0,145,2311,2456,0,66,3278,950,2328,3278,249,0.044234289200732156,0.7050030506406345,0.0,0.28981086028065894,0.7101891397193411,0.020134228187919462
5623,41.0,84,1660,1744,5,101,2326,666,1660,2326,163,0.03611349957007739,0.7136715391229579,0.0021496130696474634,0.2863284608770421,0.7136715391229579,0.043422184006878764
5624,14.0,220,3596,3816,20,240,5150,1473,3677,5150,348,0.04271844660194175,0.698252427184466,0.003883495145631068,0.2860194174757282,0.7139805825242719,0.04660194174757282
5625,24.0,274,6972,7246,38,481,9826,2662,7164,9826,655,0.02788520252391614,0.7095461021778954,0.0038672908609810705,0.2709139018929371,0.7290860981070629,0.04895176063504987
5626,14.0,57,3144,3201,11,55,4221,1257,2986,4243,349,0.01343389111477728,0.7409851520150836,0.002592505302851756,0.2962526514258779,0.7037473485741221,0.01296252651425878
5627,,98,2847,2945,7,116,4006,1124,2882,4006,320,0.024463305042436344,0.7106839740389416,0.001747378931602596,0.28057913130304546,0.7194208686969545,0.02895656515227159
5628,24.0,81,5720,5801,12,242,7762,2226,5536,7762,598,0.010435454779695954,0.7369234733316156,0.001545993300695697,0.2867817572790518,0.7132182427209482,0.03117753156402989
5629,,341,8885,9226,6,505,12335,3488,8847,12335,904,0.027644912849614917,0.720308066477503,0.00048642075395216865,0.2827725982975274,0.7172274017024727,0.04094041345764086
5630,,274,10055,10329,87,446,13623,3808,9815,13623,854,0.020113044116567568,0.7380899948616311,0.006386258533362696,0.27952727005799016,0.7204727299420098,0.032738750642296116
5631,15.0,342,5494,5836,11,211,7539,2208,5331,7539,638,0.04536410664544369,0.7287438652341159,0.001459079453508423,0.29287703939514526,0.7071229606048548,0.027987796790025204
5632,15.0,229,3952,4181,10,270,5823,1545,4278,5823,329,0.039326807487549374,0.6786879615318564,0.001717327837884252,0.26532715095311693,0.734672849046883,0.04636785162287481
5633,15.0,132,4084,4216,17,144,5595,1619,3976,5595,487,0.02359249329758713,0.7299374441465595,0.0030384271671134943,0.28936550491510277,0.7106344950848972,0.025737265415549597
5634,,242,4414,4656,5,249,7659,1864,5795,7659,511,0.03159681420550986,0.5763154458806633,0.0006528267397832616,0.2433738085911999,0.7566261914088,0.03251077164120642
5635,17.0,1748,4721,6469,53,441,8976,2475,6501,8976,272,0.1947415329768271,0.5259581105169341,0.005904634581105169,0.2757352941176471,0.7242647058823529,0.04913101604278075
5636,27.0,188,8265,8453,7,311,11108,3192,7916,11108,873,0.01692473892689953,0.7440583363341736,0.0006301764494058336,0.28736046092906015,0.7126395390709399,0.02799783939503061
5637,16.0,18,8068,8086,21,950,11245,3026,8219,11245,766,0.0016007114273010226,0.7174744330813695,0.0018674966651845266,0.2690973766118275,0.7309026233881725,0.08448199199644287
5638,13.0,696,34776,35472,126,1332,45741,13822,32041,45863,3184,0.01517563177288882,0.7582582909971001,0.0027473126485402176,0.30137583673113405,0.698624163268866,0.029043019427425158
5639,23.0,3781,79509,83290,626,4931,110964,31501,79463,110964,7634,0.03407411412710429,0.7165296853033416,0.0056414693053602975,0.2838848635593526,0.7161151364406474,0.044437835694459464
5640,,118,1813,1931,14,104,2754,728,2026,2754,155,0.042846768336964415,0.6583151779230211,0.005083514887436456,0.2643427741466957,0.7356572258533043,0.03776325344952796
5641,26.0,1281,34388,35669,94,1722,46265,13537,32728,46265,3241,0.027688317302496487,0.7432832594834108,0.002031773478871717,0.29259699556900465,0.7074030044309954,0.03722036096401167
5642,23.0,199,7679,7878,34,555,10730,2802,7928,10730,486,0.01854613233923579,0.7156570363466915,0.003168685927306617,0.26113699906803356,0.7388630009319664,0.05172413793103448
5643,26.0,348,6473,6821,40,218,8989,2524,6465,8989,669,0.038713983757926354,0.7201023473133831,0.004449883190566248,0.2807876293247302,0.7192123706752698,0.02425186338858605
5644,17.0,371,8786,9157,50,738,12392,3559,8833,12392,906,0.029938670109748225,0.7090058102001291,0.004034861200774694,0.28720142027114265,0.7127985797288573,0.05955455132343447
5645,24.0,76,9429,9505,24,837,12837,3453,9384,12837,921,0.005920386383111318,0.7345174106099556,0.0018695956999298902,0.2689880813274129,0.7310119186725871,0.06520215003505492
5646,,397,6851,10052,219,1059,14218,2828,11390,14218,603,0.02792235194823463,0.4818539879026586,0.015403010268673512,0.19890279926853285,0.8010972007314672,0.07448304965536644
5647,,2059,42444,44503,337,2004,58556,16871,41685,58556,3908,0.035162920964546755,0.7248445932099187,0.00575517453377963,0.2881173577430152,0.7118826422569847,0.03422364915636314
5648,35.0,1231,46172,47403,106,1839,61143,18331,42812,61143,4747,0.020133130530068856,0.7551477683463357,0.0017336408092504456,0.29980537428650866,0.7001946257134913,0.030077032530297827
5649,,178,3168,3346,0,223,4554,1280,3274,4554,318,0.03908651734738691,0.6956521739130435,0.0,0.2810715854194115,0.7189284145805885,0.048967940272288096
5650,23.0,221,4808,5029,10,242,6780,1903,4877,6780,520,0.03259587020648968,0.7091445427728613,0.0014749262536873156,0.28067846607669616,0.7193215339233038,0.03569321533923304
5651,17.0,566,17798,18364,97,886,24528,6990,17538,24528,1743,0.023075668623613828,0.7256196999347684,0.003954664057403783,0.28498043052837574,0.7150195694716243,0.03612198303979126
5652,24.0,353,8166,8519,61,563,11469,3145,8324,11469,824,0.030778620629523062,0.7120062777923097,0.005318685151277356,0.2742174557502834,0.7257825442497167,0.04908884819949429
5653,14.0,1692,23171,24863,112,2773,35549,9691,25858,35549,2255,0.047596275563306985,0.6518045514641763,0.0031505808883512897,0.272609637401896,0.7273903625981041,0.07800500717319755
5654,16.0,4529,53933,58462,290,4575,80584,22589,57995,80584,4859,0.056202223766504515,0.6692767795095801,0.0035987292762831333,0.280316191799861,0.719683808200139,0.05677305668619081
5655,,622,22101,22723,64,1093,30518,9002,21524,30526,2720,0.020376072855926096,0.7240057655768852,0.0020965734128284086,0.29489615409814585,0.7051038459018542,0.03580554281596016
5656,17.0,211,4024,4235,12,363,5765,1575,4190,5765,355,0.036600173460537726,0.6980052038161318,0.0020815264527320036,0.2732003469210755,0.7267996530789246,0.06296617519514311
5657,46.0,178,4807,4985,48,149,6555,1882,4673,6555,480,0.02715484363081617,0.7333333333333333,0.007322654462242563,0.28710907704042715,0.7128909229595728,0.02273073989321129
5658,14.0,25,1681,1706,10,312,2559,636,1923,2559,127,0.009769441187964049,0.6568972254787027,0.003907776475185619,0.2485345838218054,0.7514654161781946,0.12192262602579132
5659,16.0,120,2324,2444,9,194,3403,874,2529,3403,244,0.03526300323244196,0.6829268292682927,0.002644725242433147,0.2568322068762856,0.7431677931237144,0.05700852189244784
5660,,352,9141,9493,10,358,12536,3719,8817,12536,927,0.028079132099553285,0.7291799617102744,0.000797702616464582,0.2966656030631781,0.703334396936822,0.028557753669432036
5661,,118,7533,7651,16,585,10427,2853,7574,10427,824,0.011316773760429654,0.7224513282823439,0.00153447779802436,0.2736165723602187,0.7263834276397814,0.056104344490265655
5662,14.0,303,10122,10425,26,223,13751,4025,9726,13751,1324,0.022034761108283035,0.7360919205875937,0.0018907715802487092,0.2927059850192713,0.7072940149807286,0.016217002399825466
5663,25.0,1504,40134,41638,160,1858,54641,15887,38754,54641,4305,0.027525118500759505,0.7345033948866236,0.002928204095825479,0.29075236543987115,0.7092476345601288,0.03400377006277337
5664,14.0,77,1588,1665,10,108,2404,647,1757,2404,182,0.032029950083194675,0.6605657237936772,0.004159733777038269,0.269134775374376,0.730865224625624,0.04492512479201331
5665,,155,5602,5757,0,228,7836,2188,5648,7836,553,0.019780500255232262,0.7149055640632976,0.0,0.2792240939254722,0.7207759060745278,0.02909647779479326
5666,27.0,95,2025,2120,4,76,2840,778,2062,2840,211,0.03345070422535211,0.7130281690140845,0.0014084507042253522,0.273943661971831,0.726056338028169,0.02676056338028169
5667,23.0,38,2255,2293,35,87,3341,892,2449,3341,319,0.011373840167614486,0.6749476204729123,0.010475905417539658,0.26698593235558216,0.7330140676444178,0.02604010775217001
5668,27.0,40,2747,2787,18,158,3780,1055,2725,3780,317,0.010582010582010581,0.7267195767195768,0.004761904761904762,0.2791005291005291,0.7208994708994709,0.0417989417989418
5669,17.0,532,4747,5279,213,357,7309,1975,5334,7309,351,0.07278697496237516,0.6494732521548775,0.029142153509372007,0.2702148036667123,0.7297851963332878,0.0488438910931728
5670,,13347,241785,255132,1310,13469,348215,96505,251710,348215,23809,0.038329767528681995,0.6943554987579512,0.003762043565038841,0.27714199560616287,0.7228580043938372,0.038680125784357366
5671,16.0,283,2159,2442,3,299,3712,906,2806,3712,211,0.07623922413793104,0.5816271551724138,0.0008081896551724138,0.24407327586206898,0.755926724137931,0.08054956896551724
5672,27.0,661,15897,16558,194,603,21546,6358,15188,21546,1630,0.03067854822240787,0.7378167641325536,0.00900399146013181,0.29508957579133016,0.7049104242086698,0.027986633249791143
5673,15.0,628,6184,6812,34,378,9407,2604,6803,9407,780,0.06675879664079941,0.6573828000425215,0.003614329754438184,0.2768151376634421,0.7231848623365579,0.04018284256404805
5674,23.0,120,2102,2222,33,173,3009,795,2214,3009,222,0.03988035892323031,0.6985709538052509,0.010967098703888335,0.2642073778664008,0.7357926221335992,0.05749418411432369
5675,24.0,271,18351,18622,88,710,24870,7117,17753,24870,2100,0.010896662645757942,0.7378769601930036,0.003538399678327302,0.28616807398472055,0.7138319260152794,0.028548451950140732
5676,25.0,175,3961,4136,12,324,5587,1557,4030,5587,400,0.03132271344191874,0.7089672453910865,0.0021478432074458565,0.2786826561660999,0.7213173438339001,0.05799176660103812
5677,14.0,4842,148176,153018,434,12228,204669,57144,147525,204669,15078,0.0236577107427114,0.7239787168550196,0.0021204969975912326,0.2792020286413673,0.7207979713586328,0.059745247204022106
5678,,3650,10575,14225,57,748,18466,7029,11437,18466,1124,0.1976605653633705,0.5726741037582584,0.0030867540344416767,0.3806455106682552,0.6193544893317449,0.04050687750460306
5679,,2921,56287,59208,472,5701,81920,22327,59593,81920,6242,0.03565673828125,0.68709716796875,0.00576171875,0.27254638671875,0.72745361328125,0.06959228515625
5680,,384,13699,14083,42,583,18551,5350,13201,18551,1489,0.020699692738935908,0.7384507573715703,0.002264028893321115,0.28839415664923723,0.7116058433507627,0.031426877257290715
5681,24.0,574,3511,4085,137,123,5451,1505,3946,5451,349,0.10530177949000183,0.6441019996330949,0.025133003118693816,0.27609612915061454,0.7239038708493855,0.022564667033571822
5682,13.0,520,8719,9239,394,610,12948,3451,9497,12948,776,0.040160642570281124,0.6733858510966945,0.030429409947482236,0.26652764905776954,0.7334723509422305,0.04711152301513747
5683,25.0,1501,41458,42959,58,1681,57580,16592,40988,57580,4207,0.02606807919416464,0.7200069468565474,0.001007294199374783,0.28815560958666203,0.7118443904133379,0.029194164640500175
5684,,804,20140,20944,103,966,28161,8019,20142,28161,1778,0.028550122509854052,0.7151734668513192,0.0036575405702922482,0.28475551294343243,0.7152444870565676,0.0343027591349739
5685,23.0,79,2383,2462,13,188,3403,915,2488,3403,238,0.023214810461357625,0.7002644725242433,0.003820158683514546,0.26888039964737,0.73111960035263,0.05524537173082574
5686,25.0,130,4108,4238,11,166,5556,1596,3960,5556,425,0.02339812814974802,0.7393808495320374,0.0019798416126709864,0.28725701943844495,0.712742980561555,0.029877609791216703
5687,,33,6130,6163,21,179,8082,2317,5765,8082,785,0.004083147735708983,0.7584756248453353,0.0025983667409057165,0.2866864637465974,0.7133135362534027,0.02214798317248206
5688,,149,4524,4673,13,281,6217,1771,4446,6217,411,0.023966543348882097,0.72768216181438,0.002091040694868908,0.2848640823548335,0.7151359176451665,0.04519864886601255
5689,,9044,167691,176735,1494,11460,239767,67133,172634,239767,16376,0.03771995312115512,0.6993914925740407,0.006231049310372153,0.2799926595403037,0.7200073404596963,0.04779640234060567
5690,15.0,362,5324,5686,20,363,8100,2150,5950,8100,519,0.04469135802469136,0.657283950617284,0.0024691358024691358,0.2654320987654321,0.7345679012345679,0.044814814814814814
5691,23.0,67,1851,1918,6,115,2537,741,1796,2537,164,0.02640914465904612,0.7296018919984233,0.002364998029168309,0.2920772566022862,0.7079227433977139,0.04532912889239259
5692,16.0,187,4908,5095,15,208,6837,1953,4884,6837,566,0.027351177416995758,0.717858709960509,0.002193944712593243,0.2856516015796402,0.7143483984203598,0.030422700014626297
5693,17.0,1048,25084,26132,83,1421,35612,9846,25766,35612,2629,0.029428282601370325,0.7043693137144783,0.0023306750533528026,0.27647983825676736,0.7235201617432326,0.039902280130293157
5694,14.0,93,2960,3053,0,73,4087,1167,2920,4087,386,0.022755077073648152,0.724247614387081,0.0,0.28553951553706874,0.7144604844629312,0.01786151211157328
5695,26.0,1064,19016,20080,124,1061,26937,7586,19351,26937,1729,0.03949957307792256,0.7059434977911423,0.004603333704569923,0.28162007647473736,0.7183799235252627,0.039388202101199095
5696,17.0,422,7461,7883,37,480,10536,3022,7514,10536,765,0.04005315110098709,0.7081435079726651,0.0035117691723614273,0.2868261199696279,0.7131738800303721,0.04555808656036447
5697,27.0,445,10291,10736,33,460,14093,4123,9970,14093,992,0.03157595969630313,0.7302206769318101,0.002341588022422479,0.29255658837720855,0.7074434116227915,0.03264031788831335
5698,,79,1796,1875,0,178,2516,653,1863,2516,173,0.031399046104928455,0.7138314785373608,0.0,0.2595389507154213,0.7404610492845787,0.07074721780604133
5699,,429,18355,18784,10,710,24211,7172,17039,24211,1894,0.017719218537028625,0.7581264714386022,0.00041303539713353436,0.2962289868241708,0.7037710131758291,0.02932551319648094
5700,23.0,273,6771,7044,41,331,9411,2671,6740,9411,671,0.029008606949314633,0.7194772075231113,0.004356603974072893,0.28381681011582194,0.7161831898841781,0.035171607693125065
5701,45.0,625,23792,24417,73,902,31370,9207,22163,31370,2241,0.019923493783869938,0.7584316225693337,0.002327064073956009,0.29349697162894484,0.7065030283710552,0.028753586228881096
5702,,1025,28474,29499,102,1574,39621,10933,28688,39621,2891,0.025870119381136265,0.7186592968375356,0.002574392367683804,0.2759395270185003,0.7240604729814997,0.039726407713081446
5703,48.0,52,1510,1562,2,119,2102,592,1510,2102,178,0.024738344433872503,0.7183634633682208,0.0009514747859181732,0.28163653663177923,0.7183634633682208,0.056612749762131306
5704,26.0,18031,385398,403623,1700,18999,530494,152836,377660,530496,34577,0.03398894619375075,0.7264861563517915,0.003204548196404874,0.28810019302690315,0.7118998069730968,0.03581365363735071
5705,14.0,6101,5054,11155,3,465,14706,4383,10323,14706,492,0.4148646810825513,0.34366925064599485,0.0002039983680130559,0.29804161566707466,0.7019583843329253,0.031619747042023666
5706,17.0,65,2019,2084,39,268,3015,749,2266,3015,161,0.02155887230514096,0.6696517412935323,0.012935323383084577,0.248424543946932,0.751575456053068,0.08888888888888889
5707,13.0,2320,52620,54940,81,3311,74067,20689,53378,74067,5004,0.03132299134567351,0.7104378468143707,0.0010936044392239458,0.2793281758407928,0.7206718241592072,0.04470276911445043
5708,35.0,177,4544,4721,25,99,6076,1814,4262,6076,491,0.02913100724160632,0.7478604344963792,0.004114549045424622,0.2985516787360105,0.7014483212639895,0.0162936142198815
5709,,307,4819,5126,29,300,6878,1946,4932,6878,475,0.04463506833381797,0.700639720849084,0.004216341959872056,0.2829310846176214,0.7170689153823786,0.043617330619366096
5710,,297,8169,8466,6,336,11109,3184,7925,11109,913,0.026735079665136375,0.7353497164461248,0.0005401026194977045,0.2866144567467819,0.7133855432532181,0.030245746691871456
5711,26.0,317,6939,7256,30,377,9911,2794,7117,9911,729,0.03198466350519625,0.700131167389769,0.0030269397638986984,0.28190899001109876,0.7180910099889012,0.038038543032993644
5712,,523,10399,10922,306,599,15381,4082,11299,15381,979,0.034002990702815164,0.6760938820622846,0.01989467524868344,0.2653923672062935,0.7346076327937066,0.03894415187569079
5713,14.0,545,6048,6593,35,326,8641,2506,6135,8641,403,0.06307140377271149,0.6999189908575396,0.004050457123018169,0.2900127300081009,0.7099872699918991,0.037727114917254945
5714,,130,8228,8358,33,774,11364,3101,8263,11364,742,0.011439633931714184,0.7240408306934178,0.002903907074973601,0.27287926786342837,0.7271207321365716,0.06810982048574446
5715,24.0,291,6099,6390,24,478,8540,2451,6089,8540,556,0.03407494145199063,0.714168618266979,0.002810304449648712,0.2870023419203747,0.7129976580796253,0.05597189695550351
5716,14.0,818,19735,20553,31,729,26600,7781,18819,26600,2004,0.03075187969924812,0.7419172932330828,0.0011654135338345865,0.2925187969924812,0.7074812030075188,0.027406015037593986
5717,26.0,47,1593,1640,5,46,2155,620,1535,2155,184,0.021809744779582366,0.7392111368909513,0.002320185614849188,0.2877030162412993,0.7122969837587007,0.02134570765661253
5718,,1684,56966,58650,154,2887,78112,22088,56024,78112,6057,0.0215587873822204,0.7292861532158951,0.0019715280622695616,0.28277345350266286,0.7172265464973372,0.03695975010241704
5719,,112,4312,4424,0,159,5653,1736,3917,5653,406,0.01981248894392358,0.7627808243410579,0.0,0.3070935786308155,0.6929064213691845,0.02812665841146294
5720,37.0,1167,22230,23397,145,1322,31235,8829,22406,31235,2282,0.03736193372818953,0.7117016167760525,0.004642228269569394,0.28266367856571156,0.7173363214342885,0.04232431567152233
5721,14.0,151,4962,5113,17,628,7517,1924,5593,7517,580,0.02008780098443528,0.6601037647997872,0.0022615405081814555,0.2559531728083012,0.7440468271916988,0.08354396700811494
5722,24.0,1463,57764,59227,164,3302,79894,22303,57592,79895,6047,0.0183115338882283,0.722998936103636,0.0020526941610864258,0.2791538894799424,0.7208461105200575,0.04132924463358158
5723,,103,3985,4088,11,479,5732,1555,4177,5732,337,0.017969295184926726,0.6952198185624564,0.0019190509420795533,0.27128401953942777,0.7287159804605722,0.08356594556873692
5724,24.0,409,9074,9483,64,361,12928,3700,9228,12928,1183,0.031636757425742575,0.7018873762376238,0.0049504950495049506,0.28620049504950495,0.713799504950495,0.027923886138613862
5725,,167,3913,4080,9,188,5441,1555,3886,5441,405,0.0306928873368866,0.7191692703547142,0.001654107700790296,0.2857930527476567,0.7142069472523433,0.03455247197206396
5726,14.0,279,4225,4504,31,505,6192,1724,4468,6192,393,0.04505813953488372,0.6823320413436692,0.005006459948320413,0.2784237726098191,0.7215762273901809,0.08155684754521964
5727,16.0,192,3907,4099,1,234,5516,1578,3938,5516,416,0.03480783176214648,0.7083031182015953,0.00018129079042784627,0.2860768672951414,0.7139231327048586,0.04242204496011603
5728,26.0,1085,32686,33771,109,1553,44164,12539,31625,44164,3145,0.024567521057875193,0.7401050629471968,0.0024680735440630376,0.2839190290734535,0.7160809709265465,0.03516438728376053
5729,13.0,157,2459,2616,31,259,3654,1037,2617,3654,199,0.042966611932129174,0.6729611384783799,0.008483853311439518,0.2837985769020252,0.7162014230979749,0.07088122605363985
5730,23.0,4510,103888,108398,491,6596,145433,41257,104176,145433,10098,0.031010843481190653,0.7143358109920032,0.0033761250885287384,0.28368389567704716,0.7163161043229528,0.04535421809355511
5731,17.0,377,2552,2929,9,215,4197,1128,3069,4197,247,0.0898260662377889,0.6080533714558017,0.002144388849177984,0.2687634024303074,0.7312365975696926,0.05122706695258518
5732,,74,2363,2437,15,375,3645,922,2723,3645,181,0.02030178326474623,0.6482853223593964,0.00411522633744856,0.2529492455418381,0.7470507544581618,0.102880658436214
5733,15.0,1936,58785,60721,555,5274,84409,22913,61496,84409,6844,0.022935942849696123,0.6964304754232369,0.006575128244618465,0.27145209634043765,0.7285479036595623,0.06248148894075276
5734,34.0,194,3808,4002,22,201,5255,1547,3708,5255,419,0.036917221693625116,0.7246431969552807,0.0041864890580399616,0.29438629876308275,0.7056137012369172,0.038249286393910564
5735,46.0,347,9326,9673,34,408,12677,3625,9052,12677,1032,0.027372406720833006,0.7356630117535694,0.002682022560542715,0.2859509347637454,0.7140490652362547,0.03218427072651258
5736,,172,3651,3823,15,226,5139,1436,3703,5139,373,0.03346954660439774,0.7104495037945125,0.002918855808523059,0.27943179606927415,0.7205682039307258,0.043977427515080755
5737,,845,22639,23484,203,971,32138,8632,23506,32138,2157,0.026292862032484907,0.7044308917792022,0.006316510050407617,0.2685916983010766,0.7314083016989233,0.030213454477565498
5738,41.0,741,10831,11572,48,614,15634,4320,11314,15634,1024,0.04739669950108737,0.6927849558654215,0.0030702315466291418,0.27632083919662276,0.7236791608033772,0.03927337853396444
5739,23.0,379,7475,7854,14,517,10444,3031,7413,10444,703,0.0362887782458828,0.715721945614707,0.0013404825737265416,0.2902144772117963,0.7097855227882037,0.04950210647261585
5740,15.0,129,2531,2660,0,128,3718,987,2731,3718,218,0.03469607315761162,0.6807423345884884,0.0,0.26546530392684237,0.7345346960731576,0.03442711135018827
5741,,154,3245,3399,10,461,4910,1276,3634,4910,281,0.03136456211812627,0.6608961303462322,0.002036659877800407,0.259877800407332,0.740122199592668,0.09389002036659878
5742,23.0,119,2072,2191,3,62,2971,820,2151,2971,215,0.04005385392123864,0.6974082800403905,0.0010097610232245036,0.276001346348031,0.723998653651969,0.020868394479973074
5743,24.0,2174,69970,72144,224,3468,96956,27707,69249,96956,7701,0.022422542184083502,0.7216675605429267,0.0023103263335946204,0.285768802343331,0.714231197656669,0.035768802343331
5744,,1211,19563,20774,54,1622,28619,7978,20641,28619,1800,0.04231454628044306,0.6835668611761417,0.0018868583807959748,0.278765854851672,0.7212341451483281,0.056675635067612425
5745,16.0,1,3442,3443,0,33,4556,1335,3221,4556,488,0.00021949078138718174,0.7554872695346796,0.0,0.2930201931518876,0.7069798068481123,0.007243195785776997
5746,16.0,360,6828,7188,11,414,9637,2719,6918,9637,673,0.037356023658814984,0.7085192487288575,0.001141434056241569,0.2821417453564387,0.7178582546435612,0.04295942720763723
5747,16.0,108,3952,4060,13,148,5405,1533,3872,5405,482,0.01998149861239593,0.7311748381128584,0.0024051803885291397,0.2836262719703978,0.7163737280296022,0.02738205365402405
5748,35.0,5451,125727,131178,894,4406,173107,50086,123021,173107,12871,0.03148919454441473,0.7262964524831462,0.005164435869144518,0.2893354976979556,0.7106645023020444,0.02545246581594043
5749,27.0,395,21859,22254,108,678,28604,8356,20248,28604,2379,0.013809257446510978,0.7641938190462872,0.003775695706894141,0.292126975248217,0.7078730247517829,0.023702978604390995
5750,,143,4082,4225,11,221,5646,1637,4009,5646,426,0.02532766560396741,0.7229897272405242,0.0019482819695359546,0.28993978037548707,0.7100602196245129,0.03914275593340418
5751,,209,4915,5124,5,230,6860,1983,4877,6860,619,0.030466472303206996,0.7164723032069971,0.0007288629737609329,0.289067055393586,0.710932944606414,0.033527696793002916
5752,17.0,159,4462,4621,4,162,5901,1758,4143,5901,418,0.026944585663446874,0.75614302660566,0.0006778512116590408,0.2979156075241485,0.7020843924758515,0.027452974072191154
5753,,5160,268416,273576,1288,14846,360535,103761,256774,360535,25958,0.014312064015976258,0.7444935997892022,0.003572468692359965,0.28779730123289,0.71220269876711,0.04117769425991929
5754,17.0,2557,48630,51187,199,4132,70645,19424,51222,70646,4928,0.036194547461993604,0.6883616906831244,0.0028168615349772105,0.27494833394672025,0.7250516660532798,0.05848880332927554
5755,,2399,56661,59060,135,3347,79593,22219,57374,79593,6264,0.03014084153129044,0.7118842109230711,0.0016961290565753269,0.27915771487442365,0.7208422851255764,0.042051436684130514
5756,,2,2862,2864,34,92,3778,1070,2708,3778,326,0.0005293806246691371,0.7575436739015352,0.008999470619375331,0.2832186341979884,0.7167813658020117,0.024351508734780307
5757,,60,1724,1784,0,72,2307,674,1633,2307,186,0.02600780234070221,0.7472908539228436,0.0,0.29215431296055483,0.7078456870394452,0.031209362808842653
5758,,128,6647,6775,40,586,9307,2550,6757,9307,719,0.013753089072740948,0.7141936177071022,0.004297840335231546,0.27398732137101106,0.7260126786289889,0.06296336091114216
5759,25.0,3318,56178,59496,300,4372,81350,22830,58520,81350,5705,0.04078672403196067,0.6905716041794714,0.0036877688998156115,0.280639213275968,0.7193607867240319,0.05374308543331285
5760,17.0,3215,104826,108041,788,5513,145923,41670,104253,145923,12386,0.02203216765006202,0.7183651651898604,0.005400108276282697,0.2855615632902284,0.7144384367097716,0.03778019914612501
5761,,794,18567,19361,140,811,24864,7189,17675,24864,1323,0.031933719433719435,0.746742277992278,0.00563063063063063,0.28913288288288286,0.7108671171171171,0.03261743886743887
5762,33.0,3753,49952,53705,1396,3266,73472,19528,53944,73472,4104,0.05108068379790941,0.6798780487804879,0.019000435540069686,0.2657883275261324,0.7342116724738676,0.04445230836236934
5763,23.0,211,2976,3187,8,319,4521,1162,3359,4521,225,0.046671090466710904,0.6582614465826144,0.0017695200176952002,0.2570227825702278,0.7429772174297722,0.0705596107055961
5764,43.0,1564,38165,39729,201,1759,51770,14966,36804,51770,3437,0.030210546648638207,0.7372030133281824,0.0038825574657137337,0.28908634344214795,0.710913656557852,0.033977206876569445
5765,26.0,267,5816,6083,116,406,8279,2308,5971,8279,548,0.03225027177195314,0.7025003019688368,0.014011354028264283,0.27877763014856866,0.7212223698514313,0.04903973909892499
5766,17.0,1821,42981,44802,146,3062,58698,16309,42389,58698,3992,0.03102320351630379,0.7322395993049167,0.0024873079150908037,0.27784592320010904,0.722154076799891,0.05216532079457562
5767,35.0,1168,59345,60513,123,3262,81068,22947,58121,81068,6769,0.014407657768786698,0.7320397690827454,0.001517244782158188,0.28305866679824343,0.7169413332017566,0.04023782503577244
5768,,1037,27270,28307,250,1481,38808,10893,27915,38808,2912,0.026721294578437436,0.7026901669758813,0.006441970727685014,0.2806895485466914,0.7193104514533086,0.03816223459080602
5769,,322,9340,9662,44,324,12584,3774,8810,12584,914,0.025588048315321042,0.742212333121424,0.0034965034965034965,0.29990464081373175,0.7000953591862683,0.02574698029243484
5770,17.0,154,3002,3156,3,179,4220,1186,3034,4220,313,0.036492890995260666,0.7113744075829384,0.0007109004739336493,0.28104265402843603,0.718957345971564,0.04241706161137441
5771,,237,6468,6705,7,670,9090,2292,6798,9090,576,0.026072607260726074,0.7115511551155116,0.0007700770077007701,0.25214521452145217,0.7478547854785479,0.0737073707370737
5772,,6556,101643,108199,538,6649,141944,40438,101506,141944,9964,0.04618722876627402,0.716078171673336,0.0037902271318266357,0.28488699768922954,0.7151130023107705,0.04684241672772361
5773,16.0,1643,19620,21263,119,1489,28865,8142,20723,28865,2094,0.05692014550493677,0.6797159189329638,0.004122639875281483,0.28207171314741036,0.7179282868525897,0.051584964489866623
5774,,124,4148,4272,10,167,5621,1607,4014,5621,480,0.022060131649172744,0.737946984522327,0.001779042874933286,0.28589219000177907,0.714107809998221,0.029710016011385874
5775,,825,15067,15892,54,830,21300,6028,15272,21300,1670,0.03873239436619718,0.7073708920187793,0.0025352112676056337,0.28300469483568075,0.7169953051643192,0.03896713615023474
5776,25.0,2635,80957,83592,564,3631,107826,32505,75321,107826,7932,0.024437519707677182,0.7508114925899134,0.005230649379555951,0.3014579044015358,0.6985420955984641,0.03367462393114833
5777,,105,4325,4430,9,649,6027,1328,4699,6027,391,0.017421602787456445,0.7176041148166584,0.0014932802389248383,0.22034179525468725,0.7796582047453128,0.10768209722913556
5778,,667,14421,15088,163,796,19983,5748,14235,19983,1272,0.033378371615873495,0.7216634139018165,0.008156933393384377,0.28764449782314966,0.7123555021768503,0.03983385877996297
5779,,5397,130897,136294,1519,4895,172824,53977,118848,172825,8599,0.031228120931578188,0.7573962100390569,0.008789237668161434,0.3123217127151743,0.6876782872848257,0.02832344857514827
5780,15.0,42,1711,1775,0,140,2490,664,1826,2490,205,0.016867469879518072,0.6871485943775101,0.0,0.26666666666666666,0.7333333333333333,0.05622489959839357
5781,15.0,112,3132,3244,9,331,4555,1245,3310,4555,305,0.024588364434687156,0.687596048298573,0.0019758507135016466,0.27332601536772777,0.7266739846322722,0.07266739846322723
5782,23.0,870,22704,23574,80,1232,30936,8950,21986,30936,2367,0.028122575640031032,0.7339022498060512,0.002585983966899405,0.289306956296871,0.710693043703129,0.03982415309025084
5783,,129,3810,3939,7,226,5269,1471,3798,5269,438,0.02448282406528753,0.7230973619282597,0.0013285253368760675,0.2791801100778136,0.7208198899221864,0.042892389447713036
5784,26.0,334,15508,15842,34,492,20631,6019,14612,20631,1544,0.01618922979981581,0.7516843584896515,0.0016480054287237652,0.29174543163201005,0.70825456836799,0.023847607968590954
5785,,2332,51552,53884,3750,3389,76667,20762,55905,76667,5806,0.030417259055395413,0.6724144677631836,0.04891283081377907,0.2708075182281816,0.7291924817718184,0.044204155634105936
5786,,470,14826,15296,220,1568,21883,5690,16193,21883,1436,0.021477859525659188,0.6775122241009003,0.010053466160946854,0.26001919298085274,0.7399808070191473,0.07165379518347575
5787,,608,5592,6200,60,874,9220,2361,6859,9220,419,0.06594360086767896,0.6065075921908893,0.006507592190889371,0.25607375271149674,0.7439262472885032,0.09479392624728851
5788,,836,8778,9614,245,593,15742,3618,12124,15742,824,0.05310633972811587,0.5576165671452166,0.015563460805488502,0.22983102528268326,0.7701689747173167,0.03766992758226401
5789,13.0,132,3212,3344,6,109,4400,1268,3132,4400,332,0.03,0.73,0.0013636363636363637,0.2881818181818182,0.7118181818181818,0.024772727272727273
5790,15.0,104,5116,5220,17,623,7305,1880,5425,7305,435,0.014236824093086927,0.7003422313483915,0.002327173169062286,0.25735797399041754,0.7426420260095825,0.08528405201916496
5791,25.0,44,2005,2049,10,150,2857,779,2078,2857,203,0.015400770038501925,0.7017850892544627,0.0035001750087504373,0.2726636331816591,0.7273363668183409,0.052502625131256565
5792,16.0,644,11267,11911,63,631,16297,4469,11828,16297,1124,0.039516475424924834,0.6913542369761306,0.003865742161133951,0.2742222494937719,0.7257777505062282,0.03871878259802418
5793,33.0,393,6897,7290,125,440,9688,2780,6908,9688,686,0.04056564822460776,0.7119116432700248,0.012902559867877786,0.286952931461602,0.713047068538398,0.04541701073492981
5794,13.0,1701,30669,32370,102,1559,43638,12170,31468,43638,3496,0.03897978825794033,0.7028048948164444,0.002337412347036986,0.27888537513176587,0.7211146248682341,0.03572574361794766
5795,24.0,16933,280103,297036,2994,19247,410243,112444,297799,410243,28460,0.04127553669410569,0.6827733806548801,0.007298113557086898,0.27409120935640585,0.7259087906435941,0.046916096069890285
5796,15.0,354,4039,4393,41,342,6103,1717,4386,6103,419,0.05800426019990169,0.661805669342946,0.006718007537276749,0.28133704735376047,0.7186629526462396,0.056038014091430444
5797,,109,2255,2364,2,82,3164,889,2275,3164,262,0.034450063211125155,0.7127054361567636,0.0006321112515802782,0.2809734513274336,0.7190265486725663,0.025916561314791402
5798,16.0,783,12227,13010,44,1245,18580,4931,13649,18580,1126,0.04214208826695371,0.6580731969860064,0.0023681377825618944,0.2653928955866523,0.7346071044133476,0.0670075349838536
5799,,472,9815,10287,12,691,14205,3952,10253,14205,1031,0.0332277367124252,0.6909538894755368,0.0008447729672650475,0.27821189721928896,0.721788102780711,0.04864484336501232
5800,24.0,90,3329,3419,22,241,4688,1298,3390,4688,342,0.019197952218430035,0.7101109215017065,0.00469283276450512,0.27687713310580203,0.7231228668941979,0.05140784982935154
5801,24.0,604,16024,16628,30,1248,22829,6388,16441,22829,1285,0.02645757589031495,0.7019142318980245,0.0013141180077971002,0.27981952779359587,0.7201804722064041,0.05466730912435937
5802,17.0,140,4435,4577,15,310,6166,1701,4465,6166,425,0.02270515731430425,0.7192669477781382,0.002432695426532598,0.27586766136879665,0.7241323386312034,0.0502757054816737
5803,,176,3003,3179,7,179,4188,1176,3012,4188,261,0.04202483285577841,0.7170487106017192,0.0016714422158548234,0.2808022922636103,0.7191977077363897,0.04274116523400191
5804,,3897,73038,76935,255,4573,101973,28844,73129,101973,7045,0.038215998352505075,0.7162484186990674,0.0025006619399252743,0.2828591882164887,0.7171408117835113,0.04484520412265992
5805,,422,2588,3010,24,366,6036,942,5094,6036,106,0.06991385023194169,0.42876076872100727,0.003976143141153081,0.15606361829025844,0.8439363817097415,0.06063618290258449
5806,14.0,45769,290346,336115,5607,37958,483841,127793,356048,483841,23459,0.09459512525809098,0.6000855652993442,0.011588517715530515,0.26412189128246677,0.7358781087175332,0.07845139208955008
5807,15.0,1299,41774,43073,186,1841,57707,16604,41103,57707,5015,0.022510267385239226,0.7238983138960612,0.0032231791637063094,0.28772939158161054,0.7122706084183894,0.031902542152598475
5808,,1042,37668,38710,130,1975,49192,14891,34301,49192,2989,0.021182306066026998,0.7657342657342657,0.002642706131078224,0.30271182306066025,0.6972881769393398,0.04014880468368841
5809,,129,1813,1942,27,152,2718,745,1973,2718,148,0.04746136865342163,0.6670345842531273,0.009933774834437087,0.2740986019131714,0.7259013980868285,0.05592347314201619
5810,16.0,61,1898,1959,15,173,2728,699,2029,2728,213,0.022360703812316716,0.6957478005865103,0.005498533724340176,0.2562316715542522,0.7437683284457478,0.06341642228739003
5811,23.0,1739,26231,27970,324,1911,37411,10321,27090,37411,2543,0.04648365454010853,0.701157413594932,0.008660554382400898,0.27588142524925824,0.7241185747507417,0.051081232792494186
5812,,3522,112324,115846,582,4667,150472,44104,106368,150472,10857,0.023406348024881705,0.7464777500132915,0.0038678292306874367,0.2931043649316816,0.7068956350683183,0.031015737147110426
5813,14.0,209,2819,3028,10,174,4095,1148,2947,4095,307,0.05103785103785104,0.6884004884004884,0.002442002442002442,0.28034188034188035,0.7196581196581197,0.04249084249084249
5814,17.0,281,7587,7868,50,380,10706,2952,7754,10706,713,0.026246964319073418,0.7086680366149822,0.0046702783485895755,0.27573323370072855,0.7242667662992714,0.03549411544928078
5815,17.0,295,12124,12419,33,410,16405,4672,11733,16405,1592,0.017982322462663822,0.7390429747028345,0.0020115818348064615,0.28479122218835723,0.7152087778116428,0.024992380371837854
5816,,597,15299,15896,145,1195,21641,6002,15639,21641,1492,0.027586525576452105,0.706945150408946,0.006700244905503442,0.27734393050228734,0.7226560694977127,0.055219259738459404
5817,,305,3677,3982,25,534,5919,1512,4407,5919,273,0.05152897448893394,0.6212198006420003,0.004223686433519175,0.2554485554992397,0.7445514445007603,0.0902179422199696
5818,,118,3077,3195,15,122,4199,1217,2982,4199,322,0.0281019290307216,0.7327935222672065,0.00357227911407478,0.2898309121219338,0.7101690878780662,0.029054536794474874
5819,16.0,838,14313,15151,23,3162,23803,5818,17985,23803,1617,0.03520564634709911,0.6013107591480066,0.0009662647565432928,0.24442297189429904,0.7555770281057009,0.13284039826912575
5820,17.0,277,5710,5987,4,285,7969,2384,5585,7969,683,0.03475969381352742,0.7165265403438323,0.0005019450370184465,0.2991592420629941,0.7008407579370058,0.03576358388756431
5821,17.0,4457,82209,86666,119,4005,117664,33870,83794,117664,8465,0.037879045417459886,0.6986758906717433,0.001011354364971444,0.2878535490889312,0.7121464509110688,0.034037598585803644
5822,14.0,71,2121,2192,4,123,2908,818,2090,2908,191,0.024415405777166437,0.7293672627235214,0.001375515818431912,0.281292984869326,0.718707015130674,0.042297111416781295
5823,15.0,137,5465,5602,22,238,7433,2053,5380,7433,621,0.018431319790125116,0.7352347638907575,0.0029597739808960044,0.2762007264899771,0.7237992735100228,0.032019373066056775
5824,14.0,214,2739,2953,8,243,4204,1126,3078,4204,256,0.05090390104662226,0.6515223596574691,0.0019029495718363464,0.26784015223596574,0.7321598477640342,0.05780209324452902
5825,24.0,658,23806,24464,31,1375,32009,8861,23148,32009,2706,0.020556718422943546,0.7437283264081977,0.0009684776156705927,0.27682839201474585,0.7231716079852542,0.04295666843700209
5826,25.0,839,36610,37449,294,3500,51800,13628,38172,51800,3756,0.016196911196911197,0.7067567567567568,0.005675675675675676,0.2630888030888031,0.7369111969111969,0.06756756756756757
5827,17.0,401,5679,6080,100,648,8150,2303,5847,8150,493,0.049202453987730065,0.6968098159509203,0.012269938650306749,0.2825766871165644,0.7174233128834356,0.07950920245398772
5828,17.0,467,4695,5162,13,495,7199,2002,5197,7199,412,0.06487012085011808,0.6521739130434783,0.0018058063619947214,0.2780941797471871,0.7219058202528129,0.06875954993749132
5829,,73,1631,1704,7,84,2277,657,1620,2277,170,0.032059727711901624,0.7162933684672815,0.0030742204655248135,0.2885375494071146,0.7114624505928854,0.03689064558629776
5830,23.0,57,2168,2225,0,95,2917,862,2055,2917,223,0.019540623928693865,0.7432293452176894,0.0,0.29550908467603704,0.704490915323963,0.03256770654782311
5831,,370,7087,7457,48,368,9787,2780,7007,9787,719,0.0378052518647185,0.7241238377439461,0.004904465106774293,0.28405027076734446,0.7159497292326555,0.03760089915193624
5832,25.0,113,4639,4752,17,260,6373,1849,4524,6373,450,0.017731052879334692,0.7279146398870234,0.0026675035305193787,0.2901302369370783,0.7098697630629217,0.040797112819708145
5833,14.0,25684,296977,322661,1516,27336,465737,124981,340756,465737,27499,0.055147003566390476,0.6376495747600041,0.0032550559650618266,0.2683510221433985,0.7316489778566014,0.05869406982910956
5834,,369,11347,11716,129,790,16259,4497,11762,16259,1277,0.022695122701273142,0.6978903991635402,0.007934067285810935,0.2765852758472231,0.723414724152777,0.04858847407589643
5835,,192,3868,4060,15,290,5427,1424,4003,5427,378,0.035378662244333885,0.7127326331306431,0.002763957987838585,0.2623917449788097,0.7376082550211903,0.05343652109821264
5836,43.0,169,3059,3228,11,102,4369,1192,3177,4369,299,0.03868162050812543,0.7001602197299153,0.0025177386129549098,0.272831311512932,0.727168688487068,0.023346303501945526
5837,34.0,5012,145962,150974,242,5300,198237,57563,140674,198237,17024,0.025282868485701458,0.73630048880885,0.0012207610082880592,0.290374652562337,0.709625347437663,0.026735674974903777
5838,27.0,193,5769,5962,12,298,7848,2313,5535,7848,590,0.024592252803261976,0.7350917431192661,0.0015290519877675841,0.2947247706422018,0.7052752293577982,0.03797145769622834
5839,14.0,13609,267208,280817,673,18874,377699,106747,271221,377968,25696,0.03600569360369132,0.7069593193074546,0.001780574016847987,0.2824233797570165,0.7175766202429835,0.04993544427041443
5840,,3458,73570,77028,346,5772,105635,29386,76249,105635,7052,0.03273536233256023,0.6964547735125669,0.003275429545131822,0.278184313911109,0.721815686088891,0.05464098073555167
5841,33.0,372,11132,11504,92,408,15014,4324,10690,15014,1082,0.024776874916744372,0.7414413214333289,0.0061276142267217264,0.28799786865592114,0.7120021313440789,0.02717463700546157
5842,17.0,227,9914,10141,34,344,12922,3837,9085,12922,1048,0.01756694010215137,0.7672186967961616,0.002631171645256152,0.2969354589072899,0.7030645410927101,0.026621266057885777
5843,26.0,23,2032,2055,2,99,2656,769,1887,2656,217,0.008659638554216868,0.7650602409638554,0.0007530120481927711,0.2895331325301205,0.7104668674698795,0.03727409638554217
5844,24.0,416,9308,9724,30,551,12955,3747,9208,12955,997,0.03211115399459668,0.7184870706291008,0.0023157082207641835,0.28923195677344654,0.7107680432265534,0.04253184098803551
5845,,594,11427,12021,57,560,15864,4587,11277,15864,1132,0.03744326777609682,0.7203101361573374,0.0035930408472012103,0.2891452344931921,0.7108547655068078,0.03530005042864347
5846,44.0,538,9311,9849,102,337,12898,3740,9159,12899,895,0.04170865958601442,0.7218389022404837,0.007907589735638421,0.2899449569734088,0.7100550430265912,0.026126056283432824
5847,17.0,5,2685,2690,3,114,3559,1033,2526,3559,295,0.0014048890137679123,0.7544254003933689,0.0008429334082607474,0.2902500702444507,0.7097499297555493,0.0320314695139084
5848,,949,15092,16041,71,797,20556,6023,14533,20556,1391,0.04616656937147305,0.7341895310371668,0.003453979373418953,0.2930044755789064,0.7069955244210936,0.03877213465654797
5849,24.0,208,7132,7340,18,202,9628,2822,6806,9628,832,0.02160365600332364,0.7407561279601164,0.0018695471541337765,0.29310344827586204,0.7068965517241379,0.02098047361861238
5850,15.0,1417,12359,13776,72,800,19085,5103,13982,19085,1080,0.07424679067330364,0.6475766308619335,0.003772596279800891,0.2673827613308881,0.7326172386691119,0.041917736442232116
5851,,989,19977,20966,51,1525,28264,8194,20070,28264,2357,0.0349915086328899,0.7068001698273422,0.0018044155108972544,0.2899094254174922,0.7100905745825078,0.05395556184545712
5852,16.0,239,2115,2354,10,245,3409,910,2499,3409,178,0.07010853622763273,0.6204165444411851,0.002933411557641537,0.2669404517453799,0.7330595482546202,0.07186858316221766
5853,24.0,1327,37745,39072,131,1495,51612,14659,36953,51612,4304,0.025711074943811515,0.7313221731380299,0.0025381694179648145,0.2840230954041696,0.7159769045958304,0.028966131907308377
5854,,65,2015,2080,25,86,2732,792,1940,2732,158,0.023792093704245974,0.7375549048316252,0.009150805270863836,0.28989751098096633,0.7101024890190337,0.0314787701317716
5855,45.0,69,2012,2081,3,96,2695,794,1901,2695,176,0.025602968460111317,0.7465677179962894,0.0011131725417439704,0.29461966604823747,0.7053803339517625,0.03562152133580705
5856,,92,21524,21616,56,971,28358,8218,20140,28358,2530,0.003244234431201072,0.759009803230129,0.0019747513929050005,0.2897947669088088,0.7102052330911912,0.03424077861626349
5857,25.0,456,8397,8853,70,509,12193,3289,8904,12193,767,0.03739850734027721,0.6886738292462888,0.005740998933814484,0.26974493561879764,0.7302550643812024,0.0417452636758796
5858,23.0,2044,38945,40989,276,1811,52256,15545,36711,52256,3302,0.039115125535823636,0.7452732700551132,0.00528169014084507,0.29747780159216164,0.7025221984078384,0.034656307409675444
5859,23.0,5549,139073,144622,591,6506,192079,54429,137650,192079,15540,0.02888915498310591,0.724040629116145,0.0030768590007236606,0.2833677809651237,0.7166322190348763,0.033871479963973154
5860,15.0,149,4998,5147,13,232,6680,1952,4728,6680,490,0.022305389221556886,0.7482035928143712,0.0019461077844311378,0.29221556886227545,0.7077844311377246,0.03473053892215569
5861,13.0,13943,74282,88225,558,5712,125478,37121,88357,125478,7297,0.11111908063564928,0.5919922217440508,0.004446994692296658,0.2958367203812621,0.7041632796187379,0.04552192416200449
5862,36.0,263,5177,5440,47,306,7323,2052,5271,7323,579,0.03591424279666803,0.7069507032636897,0.006418134644271474,0.2802130274477673,0.7197869725522327,0.04178615321589513
5863,36.0,230,13433,13663,86,503,17726,5221,12505,17726,1485,0.01297529053367934,0.7578133814735417,0.00485163037346271,0.29453909511452103,0.705460904885479,0.02837639625409004
5864,,84,1478,1562,19,85,2264,602,1662,2264,136,0.037102473498233215,0.6528268551236749,0.008392226148409895,0.2659010600706714,0.7340989399293286,0.037544169611307424
5865,,614,11540,12154,73,592,16224,4665,11559,16224,1311,0.03784516765285996,0.7112919132149902,0.004499506903353058,0.2875369822485207,0.7124630177514792,0.03648915187376726
5866,16.0,125,2888,3013,9,130,4003,1160,2843,4003,298,0.031226580064951288,0.7214589058206345,0.0022483137646764927,0.28978266300274796,0.7102173369972521,0.032475643267549335
5867,41.0,1129,28715,29844,180,1742,39665,11481,28184,39665,2806,0.02846338081431993,0.7239379805874196,0.004538005798562965,0.2894491365183411,0.7105508634816589,0.043917811672759356
5868,,517,12139,12656,42,759,16774,4808,11966,16774,1030,0.030821509478955525,0.7236795039942768,0.0025038750447120544,0.2866340765470371,0.7133659234529629,0.04524859902229641
5869,13.0,58,1976,2034,27,371,3251,802,2449,3251,156,0.017840664410950478,0.6078129806213473,0.008305136880959704,0.246693325130729,0.7533066748692709,0.1141187326976315
5870,16.0,9003,159347,168350,1044,10234,225891,63731,162160,225891,14842,0.03985550553142887,0.7054154437317113,0.004621698075620542,0.28213164756453335,0.7178683524354667,0.04530503649990482
5871,23.0,799,20311,21110,57,1161,27844,7946,19898,27844,2130,0.028695589714121533,0.7294569745726188,0.0020471196667145525,0.2853756644160322,0.7146243355839679,0.04169659531676483
5872,26.0,151,3082,3233,25,249,4471,1170,3301,4471,326,0.03377320509953031,0.6893312458063073,0.005591590248266607,0.26168642361887723,0.7383135763811228,0.0556922388727354
5873,,1842,37471,39313,326,2501,53684,15079,38605,53684,3387,0.03431189926235005,0.6979919529096192,0.006072572833618955,0.28088443484092096,0.719115565159079,0.046587437597794504
5874,,1513,23736,25249,55,2840,34753,9721,25032,34753,2739,0.04353580985814174,0.6829913964262078,0.0015825971858544586,0.2797168589762035,0.7202831410237965,0.08171956377866658
5875,42.0,441,12502,12943,74,365,16119,4842,11277,16119,935,0.027359017308766054,0.775606427197717,0.004590855512128544,0.30039084310441094,0.699609156895589,0.022644084620634036
5876,24.0,276,9818,10094,17,502,13177,3880,9297,13177,930,0.02094558700766487,0.7450861349320786,0.001290126735979358,0.2944524550352888,0.7055475449647113,0.03809668361539045
5877,17.0,10564,209643,220207,2526,13745,304189,83445,220744,304189,22492,0.03472840898257334,0.6891866569797067,0.008304047812379802,0.274319584205872,0.725680415794128,0.045185723349628025
5878,26.0,380,9361,9741,63,526,13156,3738,9418,13156,1063,0.028884159318941928,0.7115384615384616,0.004788689571298267,0.28412891456369715,0.7158710854363028,0.03998175737306172
5879,,90,2486,2576,31,163,3350,914,2436,3350,220,0.026865671641791045,0.742089552238806,0.009253731343283582,0.2728358208955224,0.7271641791044776,0.048656716417910445
5880,25.0,499,14421,14920,81,584,19440,5648,13805,19453,1561,0.025651570451858324,0.7413252454634247,0.004163882177556161,0.2903408214671259,0.7096591785328741,0.030021076440651828
5881,15.0,1435,20614,22049,174,933,29611,8246,21365,29611,2203,0.0484617203066428,0.696160210732498,0.005876194657390835,0.2784775927864645,0.7215224072135356,0.03150856100773361
5882,16.0,51,1790,1841,6,78,2731,705,2026,2731,179,0.01867447821310875,0.6554375686561699,0.0021969974368363236,0.25814719882826803,0.7418528011717319,0.02856096667887221
5883,16.0,1118,40466,41584,159,2382,55278,15732,39546,55278,4564,0.020225044321429863,0.7320452983103586,0.0028763703462498643,0.2845978508629111,0.7154021491370889,0.04309128405513948
5884,,1000,34251,35251,170,2395,47209,13442,33767,47209,3662,0.02118240166070029,0.7255184392806456,0.0036010082823190494,0.2847338431231333,0.7152661568768667,0.050731851977377194
5885,27.0,460,16494,16954,88,623,22247,6460,15787,22247,1795,0.020676945206095206,0.7414033352811615,0.003955589517687778,0.29037623050298916,0.7096237694970108,0.028003775789994155
5886,41.0,97,5051,5148,13,97,6742,1970,4772,6742,489,0.01438742212993177,0.7491842183328389,0.001928211213289825,0.2921981607831504,0.7078018392168496,0.01438742212993177
5887,16.0,117,2913,3030,1,126,4018,1141,2877,4018,369,0.029118964659034345,0.724987555998009,0.00024888003982080636,0.28397212543554007,0.7160278745644599,0.0313588850174216
5888,,1806,33745,35551,178,1328,50425,13733,36692,50425,3460,0.0358155676747645,0.6692117005453644,0.0035299950421417946,0.2723450669310858,0.7276549330689143,0.02633614278631631
5889,17.0,1933,47891,49824,251,2699,66162,18540,47622,66162,4152,0.029216166379492762,0.7238445028868535,0.0037937184486563284,0.2802212750521447,0.7197787249478552,0.04079380913515311
5890,42.0,1648,57824,59472,112,2373,75733,22827,52908,75735,5171,0.021760084505182544,0.763504324288638,0.001478840694526969,0.30140621905327786,0.6985937809467221,0.03133293721529016
5891,27.0,836,22038,22874,118,1166,30895,8690,22205,30895,2337,0.02705939472406538,0.7133193073312833,0.003819388250525975,0.2812752872633112,0.7187247127366888,0.03774073474672277
5892,35.0,2408,90500,92908,219,2394,118745,35747,82998,118745,10058,0.02027874857888753,0.7621373531517116,0.0018442881805549706,0.30104004379131755,0.6989599562086825,0.020160848877847488
5893,17.0,140,6650,6790,6,321,8750,2445,6305,8750,634,0.016,0.76,0.0006857142857142857,0.2794285714285714,0.7205714285714285,0.03668571428571429
5894,40.0,568,15026,15594,54,697,20593,6059,14534,20593,1690,0.02758218812217744,0.7296654202884475,0.0026222502792210946,0.294226193366678,0.705773806633322,0.033846452678094496
5895,24.0,349,10141,10490,8,684,14037,3918,10119,14037,1124,0.024862862434993232,0.7224478164850039,0.000569922348080074,0.27911946997221626,0.7208805300277837,0.048728360760846336
5896,16.0,126,3362,3488,3,200,4643,1356,3287,4643,307,0.027137626534568166,0.724100796898557,0.0006461339651087659,0.29205255222916215,0.7079474477708378,0.04307559767391773
5897,25.0,1367,31347,32714,133,1461,43010,12405,30605,43010,3042,0.03178330620785864,0.7288305045338294,0.003092304115322018,0.288421297372704,0.711578702627296,0.033968844454777956
5898,44.0,495,6517,7012,43,218,9045,2638,6407,9045,677,0.05472636815920398,0.7205085682697623,0.004754007739082366,0.2916528468767275,0.7083471531232726,0.02410171365395246
5899,15.0,7574,133553,141127,596,9095,193212,53784,139428,193212,12619,0.039200463739312255,0.6912251827008674,0.003084694532430698,0.27836780324203464,0.7216321967579653,0.047072645591371136
5900,23.0,170,6557,6727,6,239,8752,2598,6154,8752,678,0.01942413162705667,0.7492001828153565,0.0006855575868372943,0.2968464351005484,0.7031535648994516,0.027308043875685556
5901,23.0,7971,196457,204428,1925,9192,266297,78056,188241,266297,17135,0.029932744266739766,0.7377364371359798,0.0072287708836374425,0.29311633251595026,0.7068836674840497,0.034517850370075515
5902,,3025,31058,34083,707,1741,45804,12766,33038,45804,3012,0.06604226705091258,0.6780630512618985,0.015435333158676097,0.2787092830320496,0.7212907169679504,0.038009780805169854
5903,14.0,2635,58739,61374,570,3998,81664,23311,58353,81664,5797,0.032266359717868336,0.7192765478056427,0.006979819749216301,0.2854501371473354,0.7145498628526645,0.04895670062695925
5904,,911,18283,19194,88,940,25473,7308,18165,25473,1906,0.03576335728025753,0.7177403525301299,0.0034546382444156556,0.2868920032976092,0.7131079967023908,0.0369018176108036
5905,13.0,942,11031,11973,168,911,16672,4526,12146,16672,1059,0.056501919385796545,0.6616482725527831,0.010076775431861805,0.27147312859884837,0.7285268714011516,0.05464251439539347
5906,23.0,473,13362,13835,22,741,17785,5275,12510,17785,1106,0.02659544560022491,0.7513072814169244,0.0012369974697779027,0.29659825695811076,0.7034017430418892,0.04166432386842845
5907,37.0,641,21166,21807,56,980,28757,8294,20463,28757,2460,0.022290224988698405,0.7360294884723719,0.0019473519490906563,0.2884167333171054,0.7115832666828946,0.03407865910908648
5908,13.0,35,2124,2159,2,83,2916,833,2083,2916,231,0.012002743484224965,0.7283950617283951,0.0006858710562414266,0.28566529492455417,0.7143347050754458,0.028463648834019206
5909,23.0,209,5216,5425,14,298,7305,2130,5175,7305,585,0.02861054072553046,0.714031485284052,0.0019164955509924709,0.2915811088295688,0.7084188911704312,0.04079397672826831
5910,15.0,545,9238,9783,21,726,13316,3738,9578,13316,892,0.04092820666866927,0.6937518774406729,0.0015770501652147791,0.2807149294082307,0.7192850705917693,0.054520877140282364
5911,16.0,1019,19317,20336,82,903,26690,7758,18939,26697,1951,0.038169082668464624,0.7235644454433082,0.0030715061617410198,0.29059444881447355,0.7094055511855265,0.03382402517136757
5912,,3410,51429,54839,285,3710,74737,20552,54185,74737,4887,0.04562666416901936,0.6881330532400284,0.0038133722252699466,0.27499096832894016,0.7250090316710599,0.04964074019561931
5913,14.0,112,1662,1774,29,80,2370,666,1704,2370,200,0.04725738396624472,0.7012658227848101,0.012236286919831224,0.2810126582278481,0.7189873417721518,0.03375527426160337
5914,48.0,652,14016,14668,242,729,19808,5512,14296,19808,1446,0.03291599353796446,0.7075928917609047,0.012217285945072699,0.2782714054927302,0.7217285945072698,0.03680331179321486
5915,13.0,268,9564,9832,66,670,13365,3777,9588,13365,1169,0.020052375607931164,0.7156004489337823,0.0049382716049382715,0.2826038159371493,0.7173961840628508,0.05013093901982791
5916,45.0,89,2426,2515,16,79,3293,977,2316,3293,227,0.02702702702702703,0.7367142423322198,0.004858791375645309,0.29668994837534163,0.7033100516246583,0.02399028241724871
5917,,32,4918,4950,6,308,6685,1840,4845,6685,702,0.004786836200448766,0.7356768885564697,0.0008975317875841437,0.275243081525804,0.724756918474196,0.04607329842931937
5918,17.0,1934,70008,71942,344,4625,96501,26963,69538,96501,6485,0.02004124309592647,0.7254639848291727,0.0035647298991720294,0.2794064310214402,0.7205935689785599,0.04792696448741464
5919,,280,9119,9399,87,276,12165,3589,8576,12165,907,0.02301685162351007,0.7496095355528155,0.007151664611590629,0.29502671598849156,0.7049732840115084,0.022688039457459928
5920,15.0,267,5911,6178,10,1519,9234,1505,7729,9234,478,0.028914879792072773,0.6401342863331168,0.0010829542993285683,0.16298462204894953,0.8370153779510505,0.16450075806800954
5921,,196,7564,7760,9,295,10154,2922,7232,10154,768,0.019302737837305496,0.7449281071498917,0.0008863502068150482,0.28776836714595233,0.7122316328540477,0.029052590112271025
5922,,412,5708,6120,30,184,7864,2334,5530,7864,584,0.05239064089521872,0.7258392675483215,0.0038148524923702952,0.29679552390640895,0.703204476093591,0.023397761953204477
5923,,132,12071,12203,77,1494,16760,4454,12306,16760,1142,0.007875894988066826,0.7202267303102625,0.004594272076372315,0.26575178997613363,0.7342482100238663,0.08914081145584725
5924,13.0,216,2383,2599,7,139,3789,1002,2787,3789,281,0.057007125890736345,0.6289258379519662,0.0018474531538664556,0.2644497228820269,0.735550277117973,0.03668514119820533
5925,,222,4557,4779,12,207,7162,1867,5295,7162,464,0.030996928232337337,0.6362747835800056,0.0016755096341803965,0.26068137391790003,0.7393186260821,0.02890254118961184
5926,17.0,158,3644,3802,39,112,4870,1437,3433,4870,361,0.0324435318275154,0.7482546201232033,0.008008213552361396,0.2950718685831622,0.7049281314168377,0.02299794661190965
5927,25.0,210,6702,6912,74,385,9379,2629,6750,9379,682,0.022390446742723103,0.7145751146177631,0.00788996694743576,0.2803070689839002,0.7196929310160998,0.04104915236165903
5928,,439,11797,12236,57,373,16234,4723,11511,16234,1242,0.02704201059504743,0.7266847357398053,0.003511149439448072,0.2909326105704078,0.7090673894295922,0.0229764691388444
5929,16.0,3167,46992,50159,788,4988,69863,17390,52473,69863,3986,0.04533157751599559,0.6726307201236706,0.011279217897885862,0.24891573508151668,0.7510842649184833,0.07139687674448564
5930,,629,14926,15555,62,713,20771,5983,14788,20771,1719,0.030282605555823024,0.7185980453516922,0.0029849309132925716,0.28804583313273313,0.7119541668672669,0.03432670550286457
5931,23.0,335,9428,9763,66,298,12495,3707,8788,12495,992,0.026810724289715888,0.7545418167266906,0.005282112845138055,0.29667867146858745,0.7033213285314126,0.02384953981592637
5932,15.0,1078,17329,18407,167,1560,25428,6930,18498,25428,1710,0.042394211105867545,0.6814928425357873,0.006567563316029573,0.27253421425200564,0.7274657857479944,0.06134969325153374
5933,16.0,1386,16285,17671,74,1282,24004,6552,17452,24004,1717,0.05774037660389935,0.6784285952341277,0.0030828195300783203,0.2729545075820696,0.7270454924179304,0.053407765372437924
5934,15.0,1232,20152,21384,272,1729,29158,8044,21114,29158,1881,0.042252555044927635,0.6911310789491735,0.009328486178750258,0.2758762603745113,0.7241237396254887,0.05929761986418822
5935,23.0,1683,52118,53801,251,1942,72042,20884,51158,72042,6016,0.023361372532689266,0.7234391049665473,0.003484078731850865,0.2898864551234002,0.7101135448765997,0.026956497598623026
5936,14.0,336,10629,10965,78,714,14867,3989,10878,14867,1117,0.02260039012578193,0.7149391269254053,0.005246519136342234,0.2683123696778099,0.7316876303221901,0.04802582901728661
5937,24.0,81,1781,1862,9,91,2468,675,1793,2468,166,0.032820097244732574,0.7216369529983793,0.003646677471636953,0.27350081037277146,0.7264991896272285,0.03687196110210697
5938,,675,14766,15441,148,933,20669,5693,14976,20669,1562,0.03265760317383521,0.7144032125405196,0.007160481881077943,0.27543664424984277,0.7245633557501573,0.045140064831390006
5939,24.0,2650,63332,65982,337,3070,87554,24865,62689,87554,6340,0.030267035201133014,0.7233478767389269,0.0038490531557667266,0.28399616236836694,0.716003837631633,0.03506407474244466
5940,,1182,24369,25551,364,813,34442,9673,24769,34442,2343,0.034318564543290166,0.7075373090993554,0.010568491957493757,0.28084896347482724,0.7191510365251728,0.023604900992973694
5941,,656,13734,14390,207,683,18904,5424,13482,18906,1396,0.03469797947741458,0.7264360520469693,0.010948905109489052,0.2868930498254522,0.7131069501745477,0.03612609753517402
5942,24.0,29800,783464,813269,3644,52538,1097545,313734,783811,1097545,75618,0.027151506316369717,0.7138331457935666,0.003320137215330579,0.28585069404899116,0.7141493059510089,0.047868652310383626
5943,,3275,53496,56771,309,3828,80389,21820,58569,80389,5725,0.04073940464491411,0.6654641804226946,0.0038438094764209033,0.2714301707945117,0.7285698292054883,0.04761845526129197
5944,38.0,1780,25637,27417,815,2115,38288,10100,28188,38288,2524,0.04648976180526536,0.6695831592143753,0.021286042624320937,0.2637902214793147,0.7362097785206854,0.05523923944839114
5945,14.0,496,13150,13646,16,838,17985,5214,12771,17985,1293,0.02757853767028079,0.7311648596052266,0.0008896302474284126,0.28990825688073396,0.710091743119266,0.04659438420906311
5946,,181,3715,3896,10,136,5086,1543,3543,5086,355,0.03558788832088085,0.7304364923318915,0.001966181675186787,0.3033818324813213,0.6966181675186788,0.026740070782540308
5947,23.0,154,4415,4569,26,309,6239,1710,4529,6239,425,0.0246834428594326,0.7076454560025646,0.004167334508735374,0.2740823849975958,0.7259176150024043,0.049527167815355023
5948,25.0,110,3833,3943,2,291,5606,1494,4112,5606,470,0.01962183374955405,0.6837317160185515,0.00035676061362825543,0.2665001783803068,0.7334998216196932,0.051908669282911164
5949,15.0,459,30229,30688,315,1852,41905,11507,30398,41905,3355,0.010953346855983773,0.7213697649445173,0.007517002744302589,0.27459730342441235,0.7254026965755876,0.04419520343634411
5950,17.0,214,5829,6043,17,286,8286,2265,6021,8286,578,0.025826695631185132,0.7034757422157857,0.0020516533912623702,0.27335264301230994,0.7266473569876901,0.034516051170649285
5951,,6432,118161,124593,608,5326,167031,46567,120464,167031,10149,0.03850782190132371,0.7074195807963791,0.0036400428662942807,0.27879255946500947,0.7212074405349905,0.03188629655572918
5952,26.0,106,2629,2735,1,86,3644,1044,2600,3644,276,0.029088913282107574,0.7214599341383096,0.00027442371020856203,0.2864983534577388,0.7135016465422612,0.023600439077936335
5953,37.0,394,9503,9897,21,690,13231,3809,9422,13231,919,0.02977855037412138,0.718237472602222,0.0015871816189252513,0.2878845136422039,0.7121154863577961,0.05215025319325826
5954,24.0,127,9770,9897,33,551,13116,3731,9385,13116,1032,0.009682830131137542,0.744891735285148,0.002516010978956999,0.28446172613601706,0.7155382738639829,0.04200975907288808
5955,27.0,476,10716,11192,38,605,15135,4233,10902,15135,1087,0.031450280806078625,0.7080277502477701,0.002510736703006277,0.2796828543111992,0.7203171456888008,0.039973571192599935
5956,,1441,112449,113890,294,9264,155885,42814,113071,155885,12870,0.009243993969913718,0.7213586939089713,0.0018860057093370113,0.27465118516855375,0.7253488148314463,0.05942842480033358
5957,17.0,71,15155,15226,24,2228,21008,5495,15513,21008,983,0.00337966488956588,0.7213918507235338,0.0011424219345011425,0.2615670220868241,0.738432977913176,0.10605483625285606
5958,33.0,43,1426,1469,7,403,2326,577,1749,2326,104,0.018486672398968184,0.6130696474634566,0.0030094582975064487,0.2480653482373173,0.7519346517626827,0.17325881341358557
5959,17.0,119,2744,2863,10,195,3960,1083,2877,3960,273,0.03005050505050505,0.692929292929293,0.0025252525252525255,0.2734848484848485,0.7265151515151516,0.04924242424242424
5960,,285,7779,8064,14,364,10851,3038,7813,10851,924,0.026264860381531654,0.716892452308543,0.001290203667864713,0.2799741959266427,0.7200258040733573,0.03354529536448254
5961,25.0,1070,23206,24276,99,1103,32961,9106,23855,32961,2448,0.03246260732380692,0.7040441734170687,0.003003549649585874,0.2762658899912017,0.7237341100087983,0.03346379054033555
5962,16.0,495,22165,22660,239,821,29914,8661,21253,29914,2612,0.0165474359831517,0.7409574112455707,0.007989570100956075,0.28952998595975127,0.7104700140402487,0.027445343317510196
5963,,306,10685,10991,35,529,14492,4093,10399,14492,1136,0.021115097985095223,0.7373033397736682,0.0024151255865304997,0.2824316864476953,0.7175683135523048,0.03650289815070384
5964,48.0,808,6535,7343,221,350,9834,2853,6982,9835,288,0.08215556685307575,0.6644636502287747,0.022470767666497204,0.29008642602948653,0.7099135739705135,0.03558718861209965
5965,,281,5579,5860,22,287,7741,2277,5464,7741,550,0.036300219609869525,0.7207079188735306,0.002842010076217543,0.2941480428885157,0.7058519571114843,0.037075313267019766
5966,23.0,165,5405,5570,17,149,7290,2155,5135,7290,585,0.02263374485596708,0.7414266117969822,0.0023319615912208505,0.2956104252400549,0.7043895747599451,0.020438957475994512
5967,,794,10524,11318,98,802,15564,4325,11239,15564,1043,0.051015163197121564,0.6761757902852737,0.006296581855564122,0.27788486250321254,0.7221151374967875,0.05152916987920843
5968,17.0,223,4191,4414,32,202,5824,1681,4143,5824,489,0.03828983516483517,0.7196085164835165,0.005494505494505495,0.28863324175824173,0.7113667582417582,0.034684065934065936
5969,15.0,43,3424,3467,0,413,5093,1352,3741,5093,486,0.008442960926762222,0.6722953072845081,0.0,0.26546239937168664,0.7345376006283134,0.08109169448262321
5970,,3400,78488,81888,207,4587,107534,30982,76567,107549,7622,0.03161349710364578,0.7297882825502794,0.0019247040883690226,0.28807334331328044,0.7119266566867195,0.04265032682777153
5971,17.0,58,1708,1766,12,112,2449,682,1767,2449,151,0.023683135973866884,0.6974275214373213,0.004899959167006942,0.27848101265822783,0.7215189873417721,0.045732952225398124
5972,16.0,31,5353,5384,9,176,7121,2089,5032,7121,742,0.00435332116275804,0.7517202640078641,0.0012638674343491082,0.2933576744839208,0.7066423255160792,0.024715629827271452
5973,23.0,149,9159,9308,24,500,12861,3512,9349,12861,1031,0.011585413264909417,0.7121530207604385,0.0018661068346162819,0.2730736334655159,0.7269263665344841,0.03887722572117254
5974,25.0,53,2674,2727,1,148,3535,1001,2534,3535,248,0.014992927864214993,0.7564356435643564,0.0002828854314002829,0.28316831683168314,0.7168316831683168,0.04186704384724187
5975,,1990,58692,60682,476,2527,79129,23216,55913,79129,6148,0.025148807643215507,0.7417255367817108,0.006015493687522906,0.29339433077632726,0.7066056692236727,0.03193519442934954
5976,23.0,165,2727,2892,6,218,4040,1098,2942,4040,258,0.04084158415841584,0.675,0.0014851485148514852,0.2717821782178218,0.7282178217821782,0.05396039603960396
5977,,524,10418,10942,55,680,14531,4046,10485,14531,1050,0.03606083545523364,0.7169499690317253,0.003785011355034065,0.2784391989539605,0.7215608010460395,0.046796504025875714
5978,,4858,121422,126280,294,4335,166219,48022,118197,166219,12323,0.029226502385407204,0.7304941071718636,0.0017687508648229144,0.288908006906551,0.711091993093449,0.026080051017031747
5979,15.0,2206,60759,62965,248,3492,83587,23833,59754,83587,6045,0.026391663775467478,0.7268953306136121,0.0029669685477406774,0.28512807015444985,0.7148719298455501,0.041776831325445345
5980,27.0,228,8230,8458,48,307,10747,3279,7468,10747,785,0.02121522285288918,0.7657951056108682,0.004466362705871406,0.30510840234484043,0.6948915976551596,0.0285661114729692
5981,27.0,956,27768,28724,299,1305,37834,10993,26841,37834,2685,0.025268277210974258,0.7339430142200137,0.007902944441507638,0.2905587566738912,0.7094412433261088,0.03449278426811862
5982,16.0,113,20688,20801,53,1016,27548,7883,19665,27548,2535,0.004101931174676928,0.7509801074488166,0.0019239146217511253,0.28615507477856833,0.7138449252214317,0.036881080296210254
5983,13.0,480,3893,4373,18,440,6241,1671,4570,6241,335,0.07691075148213428,0.6237782406665598,0.0028841531805800353,0.26774555359717994,0.7322544464028201,0.07050152219195642
5984,,6178,132418,138596,1480,6486,184807,52370,132437,184807,15329,0.03342946966294567,0.7165204781204175,0.008008354661890513,0.28337671192108527,0.7166232880789147,0.03509607320069045
5985,25.0,95,2445,2540,5,68,3294,947,2347,3294,281,0.028840315725561626,0.7422586520947176,0.0015179113539769277,0.2874924104432301,0.7125075895567698,0.020643594414086218
5986,27.0,6056,146446,152502,937,7387,205716,58044,147672,205716,14417,0.029438643566859164,0.7118843454082328,0.004554823154251492,0.2821559820334831,0.717844017966517,0.03590872853837329
5987,24.0,3412,110747,114159,273,3634,150031,43626,106405,150031,11914,0.022741966660223555,0.7381607801054448,0.001819623944384827,0.29077990548619953,0.7092200945138005,0.02422166085675627
5988,,48,2185,2233,1,178,3115,868,2247,3115,217,0.015409309791332263,0.7014446227929374,0.00032102728731942215,0.2786516853932584,0.7213483146067415,0.05714285714285714
5989,23.0,298,3601,3899,21,225,5596,1431,4165,5596,271,0.05325232308791994,0.6434953538241601,0.0037526804860614723,0.25571837026447464,0.7442816297355254,0.040207290922087205
5990,17.0,470,13096,13566,105,661,18106,5267,12839,18106,1510,0.025958245885341874,0.7232961449243345,0.005799182591406164,0.29089804484701204,0.7091019551529879,0.03650723517066166
5991,,3497,60049,63546,353,2622,85978,24206,61772,85978,6930,0.04067319546860825,0.6984228523575798,0.004105701458512643,0.28153713740724373,0.7184628625927563,0.030496173439717136
5992,,626,8862,9488,200,489,13614,3510,10104,13614,994,0.04598207727339503,0.6509475539885412,0.014690759512266784,0.25782282944028206,0.742177170559718,0.035918907007492284
5993,24.0,1660,5324,6984,635,623,10539,2622,7917,10539,536,0.15751020020874845,0.5051712686213113,0.0602523958629851,0.24879020779960148,0.7512097922003985,0.05911376790966885
5994,17.0,283,5488,5771,11,436,7776,2233,5543,7776,459,0.0363940329218107,0.7057613168724279,0.0014146090534979425,0.2871656378600823,0.7128343621399177,0.05606995884773663
5995,37.0,311,9293,9604,59,497,12721,3595,9126,12721,1005,0.024447763540602154,0.7305243298482824,0.004638000157220344,0.28260356890181587,0.7173964310981841,0.03906925556166968
5996,16.0,177,4031,4208,13,409,5826,1525,4301,5826,398,0.03038105046343975,0.6918983865430828,0.0022313765877102643,0.26175763817370407,0.7382423618262959,0.07020254033642293
5997,,55,2833,2888,11,113,3842,1084,2758,3842,338,0.014315460697553357,0.7373763664757939,0.0028630921395106715,0.2821447162935971,0.717855283706403,0.029411764705882353
5998,26.0,1053,24535,25588,65,1517,33843,9768,24075,33843,2363,0.031114262919953905,0.7249652808557161,0.0019206335135774015,0.2886268947788317,0.7113731052211684,0.044824631386106435
5999,13.0,966,8573,9539,51,954,13662,3641,10021,13662,664,0.0707070707070707,0.6275069535939101,0.003732981993851559,0.2665056360708535,0.7334943639291466,0.06982872200263504
6000,16.0,283,6712,6995,16,471,9609,2667,6942,9609,670,0.02945155583307316,0.6985118118430638,0.001665105630138412,0.2775522947236965,0.7224477052763034,0.049016546987199504
6001,13.0,152,4248,4400,8,264,5971,1673,4298,5971,434,0.025456372466923463,0.7114386199966505,0.001339809077206498,0.2801875732708089,0.7198124267291911,0.044213699547814435
6002,33.0,274,3812,4086,65,268,5566,1470,4096,5566,325,0.04922745238950772,0.6848724398131513,0.01167804527488322,0.26410348544735895,0.735896514552641,0.048149478979518504
6003,14.0,126,2761,2887,9,151,3864,1077,2787,3864,273,0.03260869565217391,0.714544513457557,0.002329192546583851,0.27872670807453415,0.7212732919254659,0.03907867494824017
6004,23.0,927,19033,19960,162,1573,27419,7508,19911,27419,1797,0.03380867281811882,0.6941536890477407,0.005908311754622707,0.27382472008461284,0.7261752799153871,0.05736897771618221
6005,16.0,708,14574,15282,38,1069,20481,5808,14673,20481,1470,0.034568624578877986,0.7115863483228358,0.0018553781553635076,0.28357990332503297,0.7164200966749671,0.05219471705483131
6006,,390,11003,11393,11,663,15159,4248,10911,15159,1198,0.02572729071838512,0.7258394353189525,0.0007256415330826572,0.28022956659410253,0.7197704334058975,0.0437363942212547
6007,25.0,1334,29053,30387,91,1280,39822,11796,28026,39822,3204,0.03349907086535081,0.729571593591482,0.0022851690020591633,0.2962181708603285,0.7037818291396716,0.03214303651248054
6008,,914,20826,21740,88,1774,31297,8165,23132,31297,2289,0.029204077068089595,0.665431191488002,0.0028117710962712083,0.260887625011982,0.7391123749880181,0.05668274914528549
6009,,566,14768,15334,41,557,19810,5899,13911,19810,1461,0.02857142857142857,0.7454820797576981,0.0020696617869762745,0.297778899545684,0.702221100454316,0.02811711256940939
6010,,407,5923,6369,19,423,8855,2304,6565,8869,508,0.045890179276130344,0.6678317735934153,0.0021422933814409743,0.25978126057052653,0.7402187394294735,0.04769421580787011
6011,15.0,702,17648,18350,33,1091,24578,7000,17578,24578,2281,0.028562128733013264,0.7180405240458947,0.0013426641712100252,0.2848075514687932,0.7151924485312068,0.044389291236064776
6012,,548,12415,12963,27,674,17226,4869,12357,17226,1330,0.03181237663996285,0.7207128758852896,0.001567398119122257,0.2826541274817137,0.7173458725182863,0.03912690119586671
6013,33.0,1289,30746,32035,127,1456,42489,12219,30270,42489,2905,0.030337263762385557,0.7236225846689731,0.002989008919955753,0.2875803149050342,0.7124196850949658,0.03426769281461084
6014,14.0,133,6105,6238,26,189,8271,2367,5904,8271,849,0.016080280498125984,0.7381211461733769,0.0031435134808366584,0.28618063112078346,0.7138193688792165,0.022850924918389554
6015,,267,6546,6813,24,955,11385,2365,9020,11385,546,0.02345191040843215,0.5749670619235837,0.002108036890645586,0.20772946859903382,0.7922705314009661,0.08388230127360562
6016,,10510,160164,170674,1134,9482,229358,65578,163784,229362,17476,0.04582276052702715,0.6983022471028331,0.004944149423182567,0.2859148420400938,0.7140851579599061,0.04134076263722849
6017,,2407,71159,73566,152,4608,98388,27708,70680,98388,7631,0.024464365573037362,0.7232487701752246,0.0015449038500630159,0.28161970972069766,0.7183802902793024,0.04683497987559458
6018,,20,3157,3177,8,372,4398,1178,3220,4398,251,0.004547521600727604,0.7178262846748522,0.0018190086402910413,0.26784902228285584,0.7321509777171441,0.08458390177353342
6019,17.0,8128,121243,129371,1156,6503,174326,48398,125928,174326,12530,0.04662528825304315,0.6954957952342163,0.006631254087170015,0.27762926930004705,0.722370730699953,0.0373036724298154
6020,36.0,10340,174738,185078,1093,8258,247509,69662,177847,247509,14026,0.04177625864109992,0.705986448977613,0.004416001034305823,0.28145239163020336,0.7185476083697967,0.03336444331317245
6021,,2005,31376,33381,99,1931,44584,12691,31893,44584,2953,0.04497129014893235,0.7037502242957114,0.002220527543513368,0.2846536874214965,0.7153463125785035,0.043311501884083975
6022,26.0,789,15775,16564,22,578,21304,6426,14878,21304,1609,0.037035298535486295,0.7404712730003755,0.0010326699211415697,0.3016334960570785,0.6983665039429215,0.027131055200901238
6023,17.0,156,3515,3671,82,167,4931,1399,3532,4931,377,0.031636584871222874,0.7128371527073616,0.01662948691948895,0.283715270736159,0.716284729263841,0.03386736970188603
6024,,1903,42343,44246,131,2768,59810,16446,43364,59810,4396,0.03181742183581341,0.7079585353619796,0.0021902691857548905,0.27497074067881627,0.7250292593211838,0.04627988630663769
6025,27.0,96,4212,4308,18,166,5581,1643,3938,5581,464,0.017201218419638058,0.7547034581616198,0.003225228453682136,0.29439168607776384,0.7056083139222361,0.02974377351729081
6026,16.0,505,13170,13675,58,604,17985,5257,12728,17985,1229,0.02807895468445927,0.7322768974145121,0.0032249096469279957,0.2922991381706978,0.7077008618293021,0.03358354184042257
6027,17.0,1006,24106,25112,116,1366,33911,9643,24268,33911,2511,0.029665890124148508,0.7108607826369024,0.0034207189407566866,0.2843620064285925,0.7156379935714076,0.04028191442304857
6028,17.0,310,6703,7013,31,379,9477,2710,6767,9477,661,0.03271077345151419,0.7072913369209666,0.0032710773451514194,0.28595547114065634,0.7140445288593437,0.039991558510077026
6029,,457,8952,9409,327,1063,13267,3337,9934,13271,586,0.03443598824504559,0.6745535377891644,0.024640192901815988,0.2514505312335167,0.7485494687664833,0.08009946499886972
6030,25.0,173,5646,5819,16,211,7461,2231,5230,7461,517,0.023187240316311485,0.756735022114998,0.0021444846535316983,0.2990215788768262,0.7009784211231739,0.02828039136844927
6031,16.0,158,2491,2649,17,167,3669,969,2700,3669,274,0.04306350504224584,0.6789315889888253,0.0046334150994821474,0.26410466067048244,0.7358953393295176,0.04551648950667757
6032,35.0,152,4952,5104,11,305,6787,1897,4890,6787,489,0.02239575659348755,0.7296301753351997,0.0016207455429497568,0.2795049359068808,0.7204950640931193,0.044938853690879625
6033,17.0,459,9262,9721,85,640,13384,3657,9727,13384,1021,0.03429468021518231,0.6920203227734608,0.006350866706515242,0.2732367005379558,0.7267632994620442,0.04781829049611477
6034,27.0,559,4747,5306,42,218,7031,2029,5002,7031,591,0.07950504906841133,0.6751528943251316,0.005973545726070261,0.28857914948087043,0.7114208505191296,0.031005546863888494
6035,15.0,2572,19973,22545,172,2260,31220,8808,22412,31220,1513,0.08238308776425368,0.6397501601537476,0.005509288917360666,0.2821268417680974,0.7178731582319027,0.0723894939141576
6036,37.0,246,3462,3708,39,372,5193,1409,3784,5193,353,0.04737146158290006,0.6666666666666666,0.007510109763142692,0.2713267860581552,0.7286732139418448,0.07163489312536106
6037,,127,2653,2780,12,104,3659,1080,2579,3659,302,0.03470893686799672,0.7250614922109866,0.003279584585952446,0.29516261273572014,0.7048373872642799,0.028423066411587865
6038,15.0,289,6600,6889,21,445,9642,2632,7010,9642,698,0.029973034640116157,0.6845052893590542,0.0021779713752333543,0.27297241236258035,0.7270275876374196,0.04615225057042108
6039,24.0,743,27891,28634,72,1519,36263,10695,25568,36263,2046,0.020489203871714972,0.7691310702368805,0.001985494857016794,0.2949287152193696,0.7050712847806304,0.04188842621956264
6040,14.0,309,2917,3226,21,284,4537,1240,3297,4537,224,0.06810667842186467,0.6429358607009037,0.0046286092131364335,0.2733083535375799,0.7266916464624201,0.06259642935860701
6041,24.0,118,8623,8741,9,449,11339,3435,7904,11339,977,0.010406561425169767,0.7604727048240586,0.0007937207866654908,0.3029367669106623,0.6970632330893377,0.03959784813475615
6042,,244,4651,4895,25,335,6709,1916,4793,6709,477,0.03636905649128037,0.6932478759874795,0.0037263377552541363,0.285586525562677,0.714413474437323,0.04993292592040543
6043,,349,9316,9665,113,1440,14417,3645,10772,14417,803,0.024207532773808698,0.6461815911770826,0.00783796906429909,0.2528265242422141,0.7471734757577859,0.09988208365124505
6044,24.0,2147,54607,56754,128,2263,73173,21491,51682,73173,5004,0.02934142374919711,0.7462725322181679,0.0017492791056810573,0.2937012285952469,0.7062987714047532,0.030926707938720568
6045,17.0,67,1424,1491,2,115,1993,561,1432,1993,137,0.03361766181635725,0.7145007526342197,0.0010035122930255895,0.2814851981936779,0.7185148018063221,0.0577019568489714
6046,16.0,1527,17897,19424,113,1423,26164,7459,18705,26164,1627,0.058362635682617334,0.6840314936554044,0.004318911481424858,0.2850863782296285,0.7149136217703715,0.05438770830148296
6047,27.0,110,4329,4439,10,328,6070,1671,4399,6070,543,0.018121911037891267,0.7131795716639209,0.0016474464579901153,0.2752883031301483,0.7247116968698517,0.05403624382207578
6048,,317,10362,10679,64,537,14154,3947,10207,14154,1113,0.022396495690264237,0.7320898685883849,0.004521689981630634,0.27886109933587677,0.7211389006641232,0.03793980500211954
6049,,172,4088,4260,25,296,5632,1693,3939,5632,327,0.030539772727272728,0.7258522727272727,0.004438920454545455,0.3006036931818182,0.6993963068181818,0.052556818181818184
6050,23.0,1059,21100,22159,88,1054,29474,8434,21040,29474,2179,0.035929972178869514,0.7158851869444256,0.0029856822962611115,0.2861505055302979,0.7138494944697021,0.03576033113930922
6051,23.0,2306,49939,52245,185,3464,71011,19638,51374,71012,4957,0.032473384780037175,0.7032473384780037,0.002605193488424492,0.2765448093280009,0.7234551906719991,0.04878048780487805
6052,15.0,1113,8301,9414,13,984,13229,3553,9676,13229,641,0.08413334341220047,0.6274850706780558,0.000982689545695064,0.26857661198881244,0.7314233880111876,0.07438203945876483
6053,26.0,183,8965,9148,0,291,11686,3446,8240,11686,809,0.015659763819955503,0.7671572822180387,0.0,0.29488276570255006,0.70511723429745,0.024901591648125963
6054,14.0,4702,98367,103069,821,4326,135898,38846,97052,135898,8489,0.03459947902103048,0.7238296369335825,0.006041295677640584,0.2858467379946725,0.7141532620053275,0.031832698052951476
6055,13.0,377,5132,5509,1,363,7684,2193,5491,7684,533,0.04906298802706924,0.6678813118167621,0.0001301405517959396,0.2853982300884956,0.7146017699115044,0.04724102030192608
6056,,1069,16142,17211,201,788,22764,6496,16268,22764,1646,0.04696011245826744,0.7091020910209103,0.008829731154454401,0.2853628536285363,0.7146371463714637,0.03461606044631875
6057,16.0,2579,12173,14752,89,859,19564,5633,13931,19564,1169,0.1318237579227152,0.6222142711102024,0.004549171948476794,0.2879268043344919,0.7120731956655081,0.043907176446534454
6058,,274,7405,7679,27,352,10111,2895,7216,10111,779,0.02709919889229552,0.7323706853921471,0.0026703590149342303,0.28632182771239245,0.7136781722876075,0.034813569379883294
6059,16.0,408,10215,10623,52,561,14004,4044,9960,14004,979,0.02913453299057412,0.7294344473007712,0.0037132247929163096,0.2887746358183376,0.7112253641816624,0.04005998286203942
6060,13.0,553,5754,6307,176,543,8979,2408,6571,8979,466,0.06158815012807662,0.6408286000668226,0.01960129190332999,0.2681813119501058,0.7318186880498943,0.060474440360841965
6061,26.0,2498,51753,54251,173,4868,72843,19488,53355,72843,4477,0.034292931372952785,0.7104732095053746,0.002374970827670469,0.2675342860672954,0.7324657139327045,0.06682865889653089
6062,,406,7731,8137,51,451,11627,3107,8520,11627,786,0.034918723660445516,0.6649178635933602,0.0043863421346865055,0.26722284338178376,0.7327771566182162,0.03878902554399243
6063,14.0,90,1358,1448,21,98,2035,564,1471,2035,143,0.044226044226044224,0.6673218673218673,0.010319410319410319,0.27714987714987716,0.7228501228501228,0.04815724815724816
6064,,30032,785264,815296,13189,31355,1038026,312088,725989,1038077,68428,0.028930416529794997,0.7564602625816774,0.01270522321561888,0.3006405112530188,0.6993594887469812,0.030204888462031235
6065,,252,5313,5565,33,394,7446,2155,5291,7446,256,0.03384367445608381,0.7135374697824335,0.004431909750201451,0.28941713671770075,0.7105828632822992,0.052914316411496104
6066,23.0,456,9964,10420,24,473,13749,3923,9826,13749,998,0.03316604843988654,0.7247072514364681,0.0017455814968361336,0.2853298421703397,0.7146701578296604,0.03440250200014547
6067,,365,6411,6776,29,330,9132,2584,6548,9132,706,0.03996933858957512,0.7020367936925098,0.003175646079719667,0.2829610162067455,0.7170389837932545,0.03613666228646518
6068,39.0,405,3241,3646,66,111,4511,1383,3131,4514,129,0.089720868409393,0.7179884802835622,0.014621178555604785,0.3063801506424457,0.6936198493575543,0.02459016393442623
6069,40.0,493,9206,9699,43,576,13087,3696,9391,13087,935,0.037670971192786736,0.7034461679529304,0.0032857033697562465,0.2824176663864904,0.7175823336135095,0.044013142813479025
6070,17.0,501,12960,13461,27,841,18259,5018,13241,18259,1395,0.027438523467878853,0.7097869543786626,0.0014787228216222136,0.27482337477408403,0.725176625225916,0.04605947751793636
6071,,214,7010,7224,24,523,10203,2720,7483,10203,881,0.020974223267666372,0.6870528275997255,0.0023522493384298734,0.2665882583553857,0.7334117416446143,0.051259433499951
6072,16.0,468,12497,12965,64,1733,18587,4877,13710,18587,1078,0.025178888470436325,0.6723516436218863,0.003443266799375908,0.26238769032119225,0.7376123096788078,0.09323720880185075
6073,,659,21895,22554,186,956,29556,8534,21022,29556,2143,0.022296657193124916,0.7407971308702125,0.006293138449045879,0.2887400189470835,0.7112599810529165,0.0323453782649885
6074,,179,13008,13187,47,1198,18077,4977,13100,18077,1398,0.009902085523040328,0.7195884272832882,0.0025999889362172926,0.2753222326713503,0.7246777673286496,0.0662720584167727
6075,16.0,9669,167887,177556,908,8561,233621,68646,164977,233623,16601,0.041387192185700895,0.7186235944234942,0.0038866036306356823,0.2938323709566267,0.7061676290433733,0.036644508460211535
6076,27.0,350,10228,10578,11,526,13958,4007,9951,13958,1096,0.025075225677031094,0.7327697377847829,0.0007880785212781201,0.28707551225103883,0.7129244877489612,0.037684482017481015
6077,35.0,1425,34706,36131,162,1492,46883,13897,32986,46883,3304,0.03039481261864642,0.7402683275387667,0.003455410276646119,0.29641874453426614,0.7035812554657338,0.03182390205404944
6078,26.0,2980,140566,143546,505,8859,190873,55379,135494,190873,14248,0.015612475310808758,0.7364373169594443,0.00264573826575786,0.2901353255829793,0.7098646744170207,0.04641305999277006
6079,16.0,125,2794,2919,18,154,4050,1109,2941,4050,283,0.030864197530864196,0.6898765432098766,0.0044444444444444444,0.27382716049382716,0.7261728395061728,0.03802469135802469
6080,23.0,224,4715,4939,11,211,6528,1869,4659,6528,498,0.03431372549019608,0.7222732843137255,0.0016850490196078432,0.28630514705882354,0.7136948529411765,0.03232230392156863
6081,16.0,403,6341,6744,228,524,9379,2662,6717,9379,614,0.042968333511035295,0.6760848704552724,0.02430962789209937,0.2838255677577567,0.7161744322422433,0.055869495681842414
6082,26.0,235,6484,6719,4,198,8801,2579,6222,8801,826,0.02670151119191001,0.7367344619929553,0.0004544938075218725,0.2930348823997273,0.7069651176002727,0.02249744347233269
6083,,108,1551,1659,14,86,2254,645,1609,2254,155,0.04791481810115351,0.6881100266193434,0.006211180124223602,0.28615794143744455,0.7138420585625554,0.038154392191659274
6084,13.0,6849,100446,107295,870,5194,144151,40496,103655,144151,9188,0.047512677678267924,0.6968109829276246,0.006035337944239027,0.2809276383791996,0.7190723616208005,0.03603166124411208
6085,14.0,392,10424,10816,56,850,14842,4180,10662,14842,1090,0.02641153483358038,0.7023312222072498,0.0037730764047971973,0.2816332030723622,0.7183667969276378,0.057269909715671745
6086,16.0,363,9038,9401,15,830,13654,3605,10049,13654,994,0.02658561593672184,0.6619305697963966,0.001098579170938919,0.2640251940823202,0.7359748059176798,0.06078804745862018
6087,26.0,3331,50282,53613,153,2633,70459,20630,49829,70459,5338,0.047275720631856824,0.7136348798592089,0.0021714756099291787,0.2927943910643069,0.7072056089356931,0.037369250202245276
6088,14.0,651,6475,7126,54,724,10659,2629,8030,10659,630,0.06107514776245426,0.607467867529787,0.0050661412890515055,0.24664602683178535,0.7533539731682146,0.06792382024580167
6089,,33,1950,1983,22,147,2778,756,2022,2778,158,0.011879049676025918,0.7019438444924406,0.007919366450683946,0.27213822894168466,0.7278617710583153,0.052915766738660906
6090,,94,3483,3577,15,143,4739,1378,3361,4739,355,0.019835408313990294,0.7349651825279595,0.0031652247309558977,0.29077864528381514,0.7092213547161849,0.030175142435112892
6091,27.0,2306,45266,47572,232,2349,62485,18318,44167,62485,4716,0.03690485716571977,0.7244298631671601,0.003712891093862527,0.29315835800592144,0.7068416419940786,0.037593022325358084
6092,15.0,114,3308,3422,0,181,4615,1349,3266,4615,357,0.024702058504875408,0.7167930660888407,0.0,0.2923076923076923,0.7076923076923077,0.03921993499458288
6093,14.0,77,1933,2010,0,112,2661,776,1885,2661,202,0.02893649004133784,0.7264186396091695,0.0,0.291619691845171,0.708380308154829,0.04208944006012777
6094,17.0,140,5329,5469,27,492,7559,2062,5497,7559,543,0.018520968382061118,0.7049874322000265,0.0035719010451117873,0.2727874057415002,0.7272125942584998,0.06508797459981479
6095,17.0,140,4389,4529,7,236,5838,1719,4119,5838,421,0.023980815347721823,0.7517985611510791,0.001199040767386091,0.2944501541623844,0.7055498458376156,0.04042480301473107
6096,13.0,272,5148,5420,23,277,7366,2150,5216,7366,614,0.03692641868042357,0.698886777083899,0.0031224545207711105,0.2918816182459951,0.7081183817540049,0.037605213141460765
6097,23.0,294,6114,6408,129,405,8707,2365,6342,8707,689,0.033765935454232225,0.7021936373033192,0.014815665556448834,0.271620535201562,0.7283794647984381,0.04651429884001378
6098,24.0,2379,41747,44146,122,2370,58923,16613,42312,58925,3959,0.04037335596096733,0.7084768773865082,0.0020704285108188373,0.2819346627068307,0.7180653372931692,0.0402206194314807
6099,26.0,294,7558,7852,58,478,10593,2942,7651,10593,819,0.027754177286887567,0.7134900405928444,0.00547531388652884,0.27773057679599733,0.7222694232040027,0.04512413858208251
6100,,76,3634,3710,0,678,5529,1286,4243,5529,386,0.013745704467353952,0.6572617109784771,0.0,0.23259178875022607,0.7674082112497739,0.12262615301139447
6101,26.0,783,21820,22603,40,633,29263,8694,20569,29263,2449,0.026757338618733556,0.7456515053138776,0.0013669138502545876,0.29709872535283466,0.7029012746471653,0.02163141168027885
6102,,496,20848,21344,146,655,27889,8229,19660,27889,2399,0.01778478970203306,0.7475348703790025,0.005235038904227473,0.2950625694718348,0.7049374305281653,0.023485962207321884
6103,,233,4813,5046,26,402,6984,1874,5110,6984,521,0.03336197021764032,0.6891466208476518,0.0037227949599083618,0.2683276059564719,0.731672394043528,0.05756013745704467
6104,48.0,121,3479,3600,5,134,4587,1409,3178,4587,355,0.026378896882494004,0.7584477872247657,0.0010900370612600828,0.30717244386309134,0.6928275561369086,0.02921299324177022
6105,,1204,35808,37012,100,2961,49398,13992,35406,49398,3524,0.024373456415239483,0.7248876472731689,0.0020243734564152397,0.2832503340216203,0.7167496659783797,0.05994169804445524
6106,16.0,413,11194,11607,32,656,16771,4438,12333,16771,1132,0.02462584222765488,0.667461689821716,0.001908055572118538,0.26462345715818975,0.7353765428418103,0.039115139228430025
6107,,133,3341,3474,1,201,4811,1319,3492,4811,322,0.027644980253585534,0.6944502182498441,0.00020785699438786114,0.27416337559758885,0.7258366244024111,0.04177925587196009
6108,17.0,181,5454,5635,0,259,7303,2202,5101,7303,558,0.024784335204710392,0.7468163768314391,0.0,0.3015199233191839,0.6984800766808161,0.03546487744762426
6109,26.0,191,3036,3227,0,140,4317,1203,3114,4317,317,0.04424368774611999,0.7032661570535094,0.0,0.2786657400972898,0.7213342599027102,0.03242992819087329
6110,23.0,489,12897,13386,32,811,17498,4936,12562,17498,1186,0.027946050977254545,0.7370556635044005,0.001828780432049377,0.2820893816436164,0.7179106183563836,0.0463481540747514
6111,24.0,219,3422,3641,9,200,5098,1366,3732,5098,399,0.042958022754021184,0.6712436249509611,0.0017653981953707335,0.26794821498626914,0.7320517850137309,0.03923107100823853
6112,25.0,55,5259,5314,50,300,7211,1948,5263,7211,603,0.007627236166967134,0.7293024545832756,0.006933851060879213,0.2701428373318541,0.7298571626681459,0.041603106365275276
6113,34.0,232,5786,6018,25,231,8249,2282,5967,8249,683,0.028124621166201964,0.7014183537398473,0.0030306703842890048,0.27663959267790034,0.7233604073220996,0.028003394350830404
6114,,8,2020,2028,28,91,2649,786,1863,2649,188,0.003020007550018875,0.762551906379766,0.010570026425066062,0.29671574178935445,0.7032842582106456,0.034352585881464705
6115,23.0,272,5106,5378,13,287,7046,2026,5020,7046,488,0.0386034629577065,0.7246664774340051,0.0018450184501845018,0.2875390292364462,0.7124609707635537,0.04073233040022708
6116,33.0,378,23015,23393,178,1166,31089,8791,22298,31089,2093,0.012158641320081058,0.7402939946604908,0.005725497764482615,0.28276882498632955,0.7172311750136704,0.03750522692913892
6117,16.0,686,41146,41832,142,1320,55169,15882,39287,55169,4980,0.012434519385887001,0.7458173974514674,0.002573909260635502,0.28787906251699324,0.7121209374830068,0.023926480450977904
6118,,299,6658,6957,48,284,9136,2649,6487,9136,612,0.0327276707530648,0.7287653239929948,0.005253940455341506,0.2899518388791594,0.7100481611208407,0.031085814360770576
6119,38.0,71,4497,4568,7,218,6206,1770,4436,6206,599,0.011440541411537221,0.7246213341927167,0.0011279407025459234,0.2852078633580406,0.7147921366419594,0.03512729616500161
6120,16.0,286,5855,6141,16,237,8403,2426,5977,8403,575,0.03403546352493157,0.6967749613233369,0.0019040818755206475,0.2887064143758182,0.7112935856241819,0.02820421278114959
6121,,74,2743,2817,10,260,4929,1105,3824,4929,308,0.01501318725907892,0.5565023331304524,0.002028809089064719,0.22418340434165146,0.7758165956583486,0.052749036315682694
6122,17.0,85,1981,2066,7,72,2752,772,1980,2752,215,0.030886627906976744,0.7198401162790697,0.002543604651162791,0.2805232558139535,0.7194767441860465,0.02616279069767442
6123,,474,34351,34825,142,4009,49759,13127,36632,49759,2635,0.009525914909865553,0.6903474748286742,0.0028537550995799757,0.26381157177596015,0.7361884282240398,0.08056833939588819
6124,23.0,806,19930,20736,211,1090,27274,7840,19434,27274,1990,0.029551954242135366,0.7307325658135954,0.007736305639070177,0.28745325218156487,0.7125467478184352,0.03996480164259001
6125,,13349,226291,239640,1836,22802,332954,90666,242288,332954,23210,0.04009262540771398,0.6796464376460412,0.0055142752452290705,0.2723078863746944,0.7276921136253056,0.06848393471770875
6126,26.0,114,2469,2583,2,101,3378,963,2415,3378,250,0.03374777975133215,0.7309058614564832,0.0005920663114268798,0.28507992895204265,0.7149200710479574,0.02989934872705743
6127,26.0,492,5464,5956,192,282,8114,2081,6033,8114,407,0.0606359378851368,0.6734039930983485,0.023662805028346067,0.2564702982499384,0.7435297017500616,0.03475474488538329
6128,,529,3968,4497,43,362,6372,1700,4672,6372,412,0.08301946013810421,0.6227244193345888,0.00674827369742624,0.2667922159447583,0.7332077840552417,0.05681104833647207
6129,,6262,85820,92082,1647,4793,125066,33531,91535,125066,6565,0.05006956327059313,0.6861976876209361,0.013169046743319528,0.2681064397997857,0.7318935602002142,0.03832376505205252
6130,25.0,63,3049,3112,4,138,3996,1178,2818,3996,331,0.015765765765765764,0.763013013013013,0.001001001001001001,0.2947947947947948,0.7052052052052052,0.03453453453453453
6131,,2946,54154,57100,173,3610,76715,21920,54795,76715,5871,0.03840187707749462,0.7059114905820244,0.002255100045623411,0.2857329075148276,0.7142670924851724,0.04705728996936714
6132,,160,3268,3428,25,138,4656,1336,3320,4656,376,0.03436426116838488,0.7018900343642611,0.0053694158075601375,0.2869415807560137,0.7130584192439863,0.029639175257731958
6133,16.0,80,4089,4169,20,396,5864,1579,4285,5864,460,0.013642564802182811,0.697305593451569,0.0034106412005457027,0.2692701227830832,0.7307298772169167,0.06753069577080491
6134,35.0,1481,29986,31467,135,1498,40949,11865,29084,40949,2870,0.036166939363598626,0.7322767344745903,0.0032967838042443037,0.289750665461916,0.7102493345380839,0.03658208991672569
6135,,57,1463,1520,0,86,2090,586,1504,2090,176,0.02727272727272727,0.7,0.0,0.28038277511961723,0.7196172248803828,0.04114832535885168
6136,34.0,1788,43724,45512,122,2253,59379,17392,41987,59379,4137,0.03011165563583085,0.7363546034793446,0.0020545984270533353,0.29289816265009516,0.7071018373499048,0.0379427070176325
6137,,2088,112923,115011,593,10065,156815,43001,113814,156815,11884,0.013315052769186621,0.7201033064438989,0.0037815260019768517,0.2742148391416637,0.7257851608583362,0.0641839109779039
6138,15.0,1132,23517,24649,183,2015,34141,9399,24814,34213,2521,0.033086838336304915,0.6873702978400024,0.005348844006664134,0.2747201356209628,0.7252798643790372,0.05889574138485371
6139,,288,7614,7902,41,1355,11374,2907,8467,11374,678,0.025320907332512747,0.6694214876033058,0.0036047125021979954,0.25558290838755054,0.7444170916124494,0.11913135220678742
6140,17.0,395,3681,4076,3,237,5445,1554,3891,5445,384,0.07254361799816346,0.6760330578512397,0.0005509641873278236,0.28539944903581266,0.7146005509641873,0.04352617079889807
6141,14.0,149,3350,3499,0,125,4473,1325,3148,4473,364,0.033310976972948804,0.7489380728817349,0.0,0.2962217750950145,0.7037782249049854,0.027945450480661747
6142,,66,3025,3091,2,113,3947,1172,2775,3947,290,0.016721560678996706,0.7664048644540157,0.0005067139599695972,0.29693438054218396,0.7030656194578161,0.028629338738282238
6143,,194,4562,4756,19,238,6167,1789,4378,6167,433,0.03145775904005189,0.7397437976325604,0.003080914545159721,0.29009242743635477,0.7099075725636452,0.03859250851305335
6144,24.0,321,60466,60787,132,2424,79061,23147,55914,79061,6480,0.004060156082012623,0.7648018618535055,0.0016695968935379012,0.2927739340509227,0.7072260659490773,0.03065987022678691
6145,,9363,180193,189556,735,19253,256665,72266,184399,256665,18142,0.03647945765881597,0.7020552081507023,0.0028636549587984336,0.28155767245241853,0.7184423275475815,0.07501217540373639
6146,35.0,83,2096,2179,3,88,2867,833,2034,2867,227,0.028950122078828043,0.7310777816532962,0.0010463899546564353,0.2905476107429369,0.7094523892570631,0.03069410533658877
6147,15.0,7324,153437,160761,565,10323,220977,61425,159552,220977,15886,0.0331437208397254,0.694357331305973,0.002556827181109346,0.2779701054860913,0.7220298945139086,0.046715269009896955
6148,16.0,384,11177,11561,86,672,15540,4338,11202,15540,1181,0.02471042471042471,0.7192406692406692,0.005534105534105534,0.27915057915057917,0.7208494208494208,0.043243243243243246
6149,,8,1796,1804,26,466,2875,669,2206,2875,105,0.002782608695652174,0.6246956521739131,0.009043478260869564,0.23269565217391305,0.7673043478260869,0.16208695652173913
6150,25.0,9464,919065,928529,1070,46235,1226974,350631,876343,1226974,99926,0.007713284878082176,0.7490501021211533,0.000872064118718082,0.285768891598355,0.714231108401645,0.037682135073766845
6151,16.0,92,2520,2612,2,89,3403,1021,2382,3403,304,0.027034969144872172,0.7405230678812812,0.0005877167205406994,0.30002938583602706,0.699970614163973,0.02615339406406112
6152,39.0,123,2954,3077,25,126,3956,1170,2786,3956,254,0.03109201213346815,0.7467138523761375,0.006319514661274014,0.29575328614762386,0.7042467138523761,0.03185035389282103
6153,23.0,2501,33336,35837,153,2093,48386,13371,35015,48386,3751,0.051688504939445296,0.6889596164179721,0.003162071673624602,0.27634026371264414,0.7236597362873558,0.043256313809779685
6154,14.0,99,9538,9637,37,671,13058,3627,9431,13058,1175,0.007581559197426865,0.7304334507581559,0.0028335120232807474,0.2777607596875479,0.7222392403124521,0.05138612344922653
6155,,126,1800,1926,3,60,2606,775,1831,2606,263,0.04834996162701458,0.6907137375287797,0.0011511895625479663,0.29739063699155793,0.702609363008442,0.023023791250959325
6156,,586,14293,14879,117,799,20121,5628,14532,20160,1629,0.02906746031746032,0.7089781746031746,0.005803571428571429,0.2791666666666667,0.7208333333333333,0.039632936507936506
6157,,1201,19371,20572,354,1636,27947,7523,20424,27947,1910,0.04297420116649372,0.6931334311375102,0.012666833649407808,0.2691881060578953,0.7308118939421047,0.058539378108562634
6158,,4152,57181,61333,387,3827,84072,23502,60570,84072,5217,0.04938624036540108,0.6801432105814064,0.0046031972594918645,0.2795461033399943,0.7204538966600057,0.04552050623275288
6159,27.0,94,3709,3803,4,176,4976,1432,3544,4976,411,0.018890675241157555,0.7453778135048231,0.0008038585209003215,0.2877813504823151,0.7122186495176849,0.03536977491961415
6160,23.0,1083,24222,25305,82,1947,37458,9776,27682,37458,2634,0.028912381867691815,0.6466442415505366,0.002189118479363554,0.26098563724705004,0.73901436275295,0.05197821560147365
6161,16.0,412,5036,5448,50,349,7375,2070,5305,7375,482,0.055864406779661015,0.6828474576271186,0.006779661016949152,0.28067796610169493,0.7193220338983051,0.04732203389830508
6162,17.0,233,5203,5436,29,243,7056,2037,5019,7056,521,0.03302154195011338,0.7373866213151927,0.004109977324263038,0.28869047619047616,0.7113095238095238,0.03443877551020408
6163,23.0,615,16870,17485,96,1379,24136,6460,17676,24136,1755,0.02548060987736162,0.6989559164733179,0.003977461054027179,0.2676499834272456,0.7323500165727543,0.05713457076566125
6164,,176,3312,3488,8,133,4569,1345,3224,4569,360,0.03852046399649814,0.7248850952068286,0.0017509301816590063,0.29437513679142047,0.7056248632085795,0.02910921427008098
6165,24.0,473,17149,17622,55,1359,23861,6919,16942,23861,1684,0.019823142366204267,0.7187041616026152,0.0023050165542097983,0.28997108251959264,0.7100289174804073,0.056954863584929384
6166,17.0,105,1908,2013,11,178,2895,729,2166,2895,173,0.03626943005181347,0.6590673575129534,0.0037996545768566492,0.25181347150259065,0.7481865284974093,0.0614853195164076
6167,24.0,112,2548,2660,20,189,3554,1020,2534,3554,187,0.031513787281935844,0.7169386606640406,0.005627462014631401,0.28700056274620145,0.7129994372537986,0.05317951603826674
6168,25.0,977,33281,34258,421,2186,46672,12792,33880,46672,3795,0.020933321906067878,0.7130827905382242,0.009020397668837847,0.27408296194720605,0.725917038052794,0.04683750428522455
6169,25.0,126,3003,3129,19,240,4188,1193,2995,4188,305,0.03008595988538682,0.7170487106017192,0.004536771728748806,0.28486150907354346,0.7151384909264565,0.05730659025787966
6170,33.0,60,1982,2042,0,39,2642,806,1836,2642,243,0.022710068130204392,0.7501892505677517,0.0,0.30507191521574567,0.6949280847842544,0.014761544284632853
6171,17.0,1932,57354,59286,57,3404,78126,22534,55592,78126,5953,0.024729283465171645,0.7341218032409185,0.0007295906612395361,0.2884315080766966,0.7115684919233034,0.04357064229577862
6172,17.0,82,1876,1958,13,136,2632,734,1898,2632,161,0.03115501519756839,0.7127659574468085,0.004939209726443769,0.27887537993920974,0.7211246200607903,0.05167173252279635
6173,,143,3504,3647,59,239,5039,1407,3632,5039,385,0.02837864655685652,0.6953760666798968,0.011708672355626117,0.27922206787060927,0.7207779321293908,0.04743004564397698
6174,,180,3370,3550,21,179,4882,1365,3517,4882,424,0.0368701351904957,0.6902908643998361,0.0043015157722244984,0.2795985251945924,0.7204014748054076,0.03666530110610405
6175,,101,1631,1732,48,125,2438,630,1808,2438,149,0.041427399507793276,0.6689909762100082,0.019688269073010665,0.258408531583265,0.7415914684167351,0.05127153404429861
6176,23.0,123,1486,1609,0,72,2394,643,1751,2394,173,0.05137844611528822,0.620718462823726,0.0,0.26858813700918965,0.7314118629908104,0.03007518796992481
6177,23.0,63,2152,2215,3,109,2892,850,2042,2892,229,0.021784232365145227,0.7441217150760719,0.001037344398340249,0.2939142461964039,0.7060857538035962,0.03769017980636238
6178,15.0,282,4865,5147,39,350,7298,1896,5402,7298,555,0.03864072348588654,0.6666209920526172,0.00534392984379282,0.25979720471362017,0.7402027952863798,0.04795834475198685
6179,34.0,164,4521,4685,43,271,6254,1741,4513,6254,483,0.02622321714102974,0.7228973456987527,0.006875599616245603,0.27838183562519986,0.7216181643748001,0.043332267348896704
6180,,169,4831,5000,13,201,6617,1891,4726,6617,551,0.025540275049115914,0.7300891642738401,0.0019646365422396855,0.285779053951942,0.7142209460480581,0.030376303460782832
6181,,265,4342,4607,28,408,6482,1679,4803,6482,395,0.04088244369021907,0.6698549830299291,0.004319654427645789,0.25902499228633136,0.7409750077136686,0.06294353594569577
6182,27.0,394,14837,15231,70,1196,20389,5743,14646,20389,1484,0.01932414537250478,0.7276963068321154,0.0034332237971455197,0.28167148952866744,0.7183285104713326,0.05865908087694345
6183,26.0,573,16817,17390,18,922,23203,6578,16625,23203,1797,0.02469508253243115,0.7247769684954531,0.0007757617549454812,0.28349782355729863,0.7165021764427014,0.03973624100331854
6184,24.0,374,8797,9171,20,571,12941,3511,9430,12941,834,0.02890039409628313,0.6797774515107025,0.0015454756201220925,0.27130824511243334,0.7286917548875667,0.044123328954485744
6185,35.0,391,9527,9918,78,427,13127,3868,9259,13127,868,0.029785937380970517,0.7257560752647215,0.0059419517025977,0.29465986135446026,0.7053401386455397,0.0325283766283233
6186,33.0,2828,54373,57201,328,3784,77512,21616,55900,77516,4996,0.036482790649672324,0.7014422828835337,0.004231384488363693,0.278858558233139,0.721141441766861,0.04881572836575675
6187,17.0,71,2343,2414,3,109,3167,923,2244,3167,235,0.02241869276918219,0.7398168613830123,0.000947268708556994,0.2914430059993685,0.7085569940006315,0.03441742974423745
6188,24.0,540,6257,6797,15,473,11640,2201,9439,11640,347,0.04639175257731959,0.5375429553264605,0.001288659793814433,0.1890893470790378,0.8109106529209622,0.04063573883161512
6189,25.0,89,2529,2618,0,73,3495,1005,2490,3495,210,0.025464949928469243,0.7236051502145923,0.0,0.2875536480686695,0.7124463519313304,0.02088698140200286
6190,36.0,1141,33913,35054,125,1299,45606,13228,32378,45606,3696,0.025018637898522125,0.7436082971538832,0.002740867429724159,0.2900495548831294,0.7099504451168706,0.02848309432969346
6191,17.0,711,13138,13849,34,1078,18711,5159,13552,18711,1317,0.037999037999038,0.7021538132649244,0.0018171129282240394,0.2757201646090535,0.7242798353909465,0.05761316872427984
6192,,99,2973,3072,12,74,4025,1174,2851,4025,322,0.024596273291925465,0.7386335403726708,0.0029813664596273293,0.2916770186335404,0.7083229813664597,0.018385093167701864
6193,,265,6866,7131,14,293,9269,2680,6589,9269,759,0.028589923400582588,0.7407487323335851,0.001510411047577948,0.28913582910777863,0.7108641708922214,0.03161074549573848
6194,16.0,252,3095,3347,8,224,4659,1293,3366,4659,367,0.0540888602704443,0.6643056449881949,0.0017171066752522,0.2775273663876368,0.7224726336123631,0.048078986907061604
6195,14.0,748,22862,23610,151,1661,32814,8597,24217,32814,2468,0.022795148412263058,0.696714816846468,0.0046016943987322485,0.2619918327543122,0.7380081672456879,0.05061863838605473
6196,24.0,639,10801,11440,55,891,16253,4326,11927,16253,1067,0.039315818618101274,0.6645542361410202,0.003383990647880391,0.26616624623146495,0.733833753768535,0.05482064849566234
6197,,1413,44608,46021,117,1665,58887,17374,41513,58887,4352,0.023995109277090018,0.7575186373902559,0.0019868561821794286,0.29503965221525974,0.7049603477847403,0.028274491823322635
6198,45.0,799,12986,13785,42,861,19204,5243,13961,19204,1263,0.041605915434284525,0.6762132888981462,0.0021870443657571337,0.2730160383253489,0.7269839616746511,0.04483440949802125
6199,17.0,479,14938,15417,40,519,20281,5954,14327,20281,1921,0.023618164784773927,0.7365514520980228,0.0019722893348454217,0.29357526749174107,0.706424732508259,0.025590454119619348
6200,,185,4324,4509,12,285,6726,1704,5022,6726,472,0.027505203687184062,0.6428783823966696,0.001784121320249777,0.25334522747546834,0.7466547725245317,0.0423728813559322
6201,16.0,520,28325,28845,247,3304,40627,11162,29465,40627,2784,0.012799369877175278,0.6971964457134417,0.006079700691658257,0.27474339724813546,0.7252566027518645,0.08132522706574445
6202,35.0,74,1793,1867,2,75,2486,693,1793,2486,182,0.029766693483507644,0.7212389380530974,0.0008045052292839903,0.27876106194690264,0.7212389380530974,0.030168946098149636
6203,17.0,525,9333,9858,50,716,13510,3721,9789,13510,929,0.038860103626943004,0.6908216136195411,0.003700962250185048,0.2754256106587713,0.7245743893412288,0.05299777942264989
6204,,408,11486,11894,90,792,16668,4476,12192,16668,1220,0.024478041756659467,0.6891048716102712,0.005399568034557235,0.2685385169186465,0.7314614830813535,0.047516198704103674
6205,,1080,46460,47540,46,1706,60905,18072,42833,60905,4493,0.01773253427469009,0.76282735407602,0.0007552746079960594,0.29672440686314755,0.7032755931368525,0.02801083654872342
6206,,287,6495,6782,28,261,8744,2625,6119,8744,697,0.03282250686184812,0.7427950594693504,0.003202195791399817,0.30020585544373285,0.6997941445562672,0.02984903934126258
6207,16.0,58,10295,10353,186,385,14382,3689,10693,14382,938,0.004032818801279377,0.7158253372270894,0.012932832707551106,0.2565011820330969,0.7434988179669031,0.026769573077457934
6208,24.0,71,2904,2975,0,112,3905,1119,2786,3905,348,0.01818181818181818,0.7436619718309859,0.0,0.2865556978233035,0.7134443021766965,0.028681177976952625
6209,,161,3561,3722,10,185,5100,1441,3659,5100,387,0.031568627450980394,0.6982352941176471,0.00196078431372549,0.2825490196078431,0.7174509803921568,0.03627450980392157
6210,48.0,246,5465,5711,27,273,7596,2170,5426,7596,555,0.03238546603475513,0.7194576092680358,0.0035545023696682463,0.2856766719325961,0.714323328067404,0.03593996840442338
6211,13.0,60,5313,5373,55,572,7803,2068,5735,7803,387,0.007689350249903883,0.6808919646289888,0.0070485710624118925,0.26502627194668715,0.7349737280533128,0.07330513904908369
6212,26.0,456,11699,12155,46,679,16012,4563,11449,16012,1103,0.028478641019235574,0.7306395203597302,0.0028728453659755183,0.28497376967274546,0.7150262303272545,0.042405695728203845
6213,15.0,4393,75838,80231,370,6281,109993,31323,78670,109993,6989,0.03993890520305838,0.6894802396516142,0.003363850426845345,0.28477266735155876,0.7152273326484413,0.057103633867609756
6214,17.0,253,8852,9105,60,396,11631,3529,8102,11631,704,0.021752213911099647,0.7610695554982375,0.005158627805003869,0.3034132920643109,0.6965867079356891,0.034046943513025535
6215,,1280,32852,34132,126,2041,46218,13011,33207,46218,3385,0.02769483750919555,0.7108053139469471,0.002726210567311437,0.28151369596261194,0.718486304037388,0.04416028387208447
6216,16.0,6474,171512,177986,508,9181,238516,66547,171969,238516,17263,0.027142833185195125,0.719079642455852,0.0021298361535494474,0.2790043435241242,0.7209956564758758,0.03849217662546747
6217,16.0,432,10410,10842,111,2018,15638,3982,11656,15638,644,0.027625015986699065,0.6656861491239289,0.007098094385471288,0.2546361427292493,0.7453638572707507,0.12904463486379333
6218,14.0,225,4284,4509,4,180,6345,1679,4666,6345,494,0.03546099290780142,0.675177304964539,0.0006304176516942475,0.26461780929866036,0.7353821907013396,0.028368794326241134
6219,24.0,1382,28899,30281,66,1694,40156,11609,28547,40156,2823,0.03441577846399044,0.7196682936547465,0.0016435899990038848,0.28909751967327424,0.7109024803267258,0.042185476641099715
6220,15.0,134,7009,7143,9,538,9861,2792,7069,9861,745,0.01358888550856911,0.7107798397728425,0.0009126863401277761,0.28313558462630567,0.7168644153736944,0.054558361220971505
6221,,7567,179492,187059,388,8008,243715,72218,171539,243757,17975,0.03104321106675911,0.736356289255283,0.0015917491600241224,0.2962704660789229,0.7037295339210772,0.03285238988008549
6222,,240,5833,6073,28,366,7873,2313,5560,7873,508,0.03048393242728312,0.7408865743680935,0.0035564587831830308,0.29378889876794106,0.706211101232059,0.046487996951606755
6223,,178,4155,4333,12,140,5940,1623,4317,5940,505,0.029966329966329967,0.6994949494949495,0.00202020202020202,0.2732323232323232,0.7267676767676767,0.02356902356902357
6224,15.0,235,4805,5040,27,214,6570,1905,4665,6570,485,0.03576864535768645,0.7313546423135464,0.00410958904109589,0.2899543378995434,0.7100456621004566,0.03257229832572298
6225,,8,2574,2582,7,34,3540,1018,2522,3540,336,0.0022598870056497176,0.7271186440677966,0.0019774011299435027,0.28757062146892653,0.7124293785310735,0.0096045197740113
6226,,1468,95376,96844,435,8169,137794,36461,101333,137794,10400,0.010653584336037854,0.6921636646007808,0.003156886366605222,0.264605135201823,0.735394864798177,0.05928414880183462
6227,39.0,110,4091,4201,12,146,5484,1630,3854,5484,435,0.020058351568198397,0.7459883296863603,0.002188183807439825,0.29722830051057625,0.7027716994894238,0.02662290299051787
6228,25.0,375,10284,10659,26,595,14525,4104,10421,14525,1033,0.025817555938037865,0.7080206540447505,0.0017900172117039587,0.2825473321858864,0.7174526678141135,0.04096385542168675
6229,,106,4289,4395,24,305,6127,1573,4554,6127,517,0.017300473314835974,0.7000163212012405,0.00391708829769871,0.25673249551166966,0.7432675044883303,0.04977966378325445
6230,16.0,4111,65120,69231,190,4765,94171,26319,67852,94171,5997,0.043654628282592305,0.6915080014017054,0.002017606269446008,0.2794809442397341,0.7205190557602659,0.050599441441632774
6231,15.0,90,1599,1689,4,86,2283,644,1639,2283,173,0.03942181340341656,0.7003942181340341,0.0017520805957074025,0.2820849759088918,0.7179150240911082,0.037669732807709154
6232,23.0,720,18417,19137,55,892,24652,7371,17281,24652,1657,0.029206555249067012,0.7470793444750933,0.0022310563037481745,0.2990021093623235,0.7009978906376765,0.03618367678078858
6233,17.0,125,8755,8880,46,803,12382,3364,9018,12382,1013,0.010095299628492973,0.7070747859796479,0.0037150702632854143,0.2716847036020029,0.7283152963979971,0.06485220481343887
6234,,239,5758,5997,14,187,7801,2267,5534,7801,612,0.030637097807973336,0.7381104986540187,0.0017946417126009485,0.29060376874759647,0.7093962312524036,0.023971285732598383
6235,16.0,781,18356,19137,14,1916,26329,7008,19321,26329,1849,0.02966310911922215,0.6971780166356489,0.0005317330699988606,0.26617038246800107,0.7338296175319989,0.07277146872270121
6236,25.0,146,3669,3815,20,173,4981,1402,3579,4981,387,0.02931138325637422,0.7365990764906645,0.004015257980325236,0.28146958442079906,0.7185304155792009,0.03473198152981329
6237,25.0,9,8573,8582,28,242,11287,3234,8053,11287,1053,0.0007973775139541065,0.7595463807920617,0.0024807300434127755,0.2865243200141756,0.7134756799858244,0.021440595375210418
6238,,164,2350,2514,8,86,3379,1038,2341,3379,214,0.04853506954720332,0.6954720331459011,0.0023675643681562593,0.30719147676827463,0.6928085232317254,0.025451316957679788
6239,,298,5768,6066,14,359,8125,2376,5749,8125,621,0.03667692307692308,0.7099076923076924,0.001723076923076923,0.2924307692307692,0.7075692307692307,0.044184615384615385
6240,,115,3172,3287,0,41,4264,1249,3015,4264,338,0.026969981238273922,0.7439024390243902,0.0,0.2929174484052533,0.7070825515947468,0.009615384615384616
6241,,493,21365,21858,36,990,28826,8329,20502,28831,2123,0.017099649682633278,0.7410426277270993,0.0012486559605979675,0.2888904304394575,0.7111095695605425,0.0343380389164441
6242,26.0,239,8467,8706,7,316,11487,3383,8104,11487,989,0.020806128667188995,0.7370941063811265,0.0006093845216331506,0.29450683381213544,0.7054931661878645,0.02750935840515365
6243,,133,3289,3422,2,181,4542,1287,3255,4542,331,0.02928225451343021,0.7241303390576839,0.00044033465433729633,0.28335535006605017,0.7166446499339498,0.039850286217525316
6244,,509,17718,18227,51,1059,24544,6675,17869,24544,1613,0.020738265971316817,0.721887222946545,0.0020779009126466754,0.27196056062581486,0.7280394393741851,0.04314700130378096
6245,27.0,272,2350,2622,48,174,4233,999,3234,4233,191,0.0642570281124498,0.5551618237656508,0.011339475549255847,0.23600283486888732,0.7639971651311127,0.041105598866052445
6246,27.0,178,3305,3483,29,207,4723,1325,3398,4723,379,0.03768791022655092,0.6997670971839932,0.006140165149269532,0.2805420283717976,0.7194579716282025,0.04382807537582045
6247,,280,5395,5675,29,375,7680,2166,5514,7680,556,0.036458333333333336,0.7024739583333334,0.0037760416666666667,0.28203125,0.71796875,0.048828125
6248,35.0,349,7720,8069,16,516,10695,2898,7797,10695,854,0.03263207106124357,0.7218326320710613,0.001496026180458158,0.2709677419354839,0.7290322580645161,0.0482468443197756
6249,17.0,1002,29925,30927,103,1255,40221,11739,28482,40221,2988,0.024912359215335272,0.7440143208771537,0.0025608512965863603,0.2918624599090028,0.7081375400909973,0.031202605604037693
6250,,2076,51042,53118,451,2083,69820,20066,49754,69820,4979,0.029733600687482098,0.7310512747063879,0.006459467201374964,0.28739616155829273,0.7126038384417073,0.029833858493268403
6251,17.0,2022,55475,57497,1036,3829,80924,21876,59048,80924,5473,0.024986406999159706,0.6855197469230389,0.012802135336859276,0.270327714892986,0.729672285107014,0.047316000197716375
6252,16.0,183,6216,6399,16,252,8139,2467,5672,8139,567,0.02248433468485072,0.7637301879837818,0.001965843469713724,0.3031084899864848,0.6968915100135151,0.030962034647991153
6253,16.0,82,1797,1879,2,136,2489,707,1782,2489,172,0.03294495781438329,0.721976697468863,0.0008035355564483728,0.2840498192044998,0.7159501807955002,0.05464041783848935
6254,,112,4920,5032,6,204,6629,1936,4693,6629,589,0.01689545934530095,0.7421933926685774,0.0009051138934982652,0.29205008296877355,0.7079499170312264,0.030773872378941018
6255,,976,20550,21526,40,1603,29522,8355,21167,29522,2348,0.03306009077975747,0.6960910507418197,0.0013549217532687486,0.28300928121400987,0.7169907187859901,0.054298489262245106
6256,23.0,11346,215381,226727,907,12487,303010,86674,216336,303010,22982,0.037444308768687505,0.7108049239299034,0.002993300551136926,0.2860433649054487,0.7139566350945513,0.041209861060691064
6257,23.0,463,14777,15240,18,498,20309,5782,14527,20309,1777,0.02279777438574031,0.7276084494559063,0.0008863065635924959,0.28470136392732287,0.7152986360726772,0.02452114825939239
6258,15.0,1697,37475,39172,161,951,49883,14942,34941,49883,3874,0.03401960587775395,0.7512579435879959,0.00322755247278632,0.29954092576629315,0.7004590742337069,0.019064611190185033
6259,24.0,1861,29585,31446,833,2648,42994,11687,31307,42994,2624,0.043285109550169794,0.6881192724566219,0.01937479648323022,0.271828627250314,0.728171372749686,0.061589989300832676
6260,24.0,2564,73751,76315,503,5441,100204,27134,73070,100204,7397,0.02558780088619217,0.7360085425731507,0.005019759690231927,0.2707875933096483,0.7292124066903517,0.05429922957167378
6261,,2345,82314,84659,216,2404,111854,32154,79700,111854,9367,0.020964829152287805,0.7359057342607327,0.0019310887406798149,0.28746401559175355,0.7125359844082465,0.021492302465714236
6262,,51,1418,1469,3,78,2010,570,1440,2010,184,0.025373134328358207,0.7054726368159204,0.0014925373134328358,0.2835820895522388,0.7164179104477612,0.03880597014925373
6263,24.0,228,4870,5098,2,278,6823,1945,4878,6823,518,0.03341638575406713,0.7137622746592408,0.0002931261908251502,0.2850652205774586,0.7149347794225414,0.04074454052469588
6264,33.0,109,3196,3305,43,165,4462,1263,3199,4462,295,0.02442850739578664,0.7162707306140744,0.009636934110264455,0.2830569251456746,0.7169430748543254,0.036978933213805465
6265,,117,3011,3128,0,379,4483,1196,3287,4483,329,0.026098594691055098,0.6716484496988624,0.0,0.2667856346196743,0.7332143653803257,0.08454160160606737
6266,23.0,368,6892,7260,12,503,9796,2793,7003,9796,665,0.037566353613719884,0.70355247039608,0.0012249897917517355,0.2851163740302164,0.7148836259697836,0.05134748877092691
6267,14.0,279,5095,5374,4,681,7400,2053,5347,7400,347,0.0377027027027027,0.6885135135135135,0.0005405405405405405,0.27743243243243243,0.7225675675675676,0.09202702702702703
6268,,491,11462,11953,118,1028,16545,4552,11993,16545,1191,0.029676639468117254,0.6927772741009368,0.007132064067694168,0.2751284375944394,0.7248715624055606,0.06213357509821699
6269,24.0,1236,34721,35957,35,1270,46160,13683,32477,46160,3439,0.02677642980935875,0.7521880415944541,0.0007582322357019064,0.2964254766031196,0.7035745233968804,0.027512998266897747
6270,,212,3833,4045,30,232,5481,1483,3998,5481,369,0.038679073161831785,0.699324940704251,0.005473453749315818,0.27057106367451195,0.729428936325488,0.042328042328042326
6271,16.0,58,1750,1808,8,82,2523,746,1777,2523,191,0.022988505747126436,0.6936187078874356,0.0031708283789139914,0.2956797463337297,0.7043202536662703,0.03250099088386841
6272,14.0,870,11934,12804,159,768,17366,4776,12590,17366,1023,0.05009789243349073,0.6872048831049177,0.009155821720603478,0.2750201543245422,0.7249798456754578,0.04422434642404699
6273,17.0,592,13406,14169,66,1467,19893,5316,14588,19904,1269,0.0297427652733119,0.6735329581993569,0.003315916398713826,0.2670819935691318,0.7329180064308681,0.07370377813504823
6274,,682,20643,21325,72,1031,28457,8122,20335,28457,2161,0.02396598376497874,0.7254102681238359,0.002530133183399515,0.28541307938292865,0.7145869206170714,0.03623010155673472
6275,17.0,156,3540,3696,45,450,5417,1251,4166,5417,372,0.02879822780136607,0.6534982462617686,0.008307181096547905,0.23093963448403176,0.7690603655159682,0.08307181096547905
6276,15.0,103,4180,4283,4,211,6038,1613,4425,6038,475,0.017058628684995032,0.6922822126531964,0.000662471016893011,0.2671414375621067,0.7328585624378934,0.03494534614110632
6277,24.0,139,3863,4002,32,197,5488,1553,3935,5488,398,0.02532798833819242,0.703899416909621,0.0058309037900874635,0.2829810495626822,0.7170189504373178,0.035896501457725945
6278,17.0,96,5591,5687,45,512,7879,2037,5842,7879,562,0.012184287346109912,0.7096078182510471,0.005711384693489021,0.2585353471252697,0.7414646528747303,0.06498286584591953
6279,,231,5938,6169,42,542,8230,2206,6024,8230,531,0.028068043742405832,0.7215066828675577,0.005103280680437424,0.26804374240583234,0.7319562575941677,0.06585662211421628
6280,,357,11701,12058,29,555,16030,4687,11343,16030,1267,0.0222707423580786,0.7299438552713662,0.0018091079226450406,0.2923892701185278,0.7076107298814722,0.03462258265751716
6281,26.0,121,3384,3505,10,137,4696,1371,3325,4696,380,0.025766609880749573,0.7206132879045997,0.002129471890971039,0.2919505962521295,0.7080494037478705,0.029173764906303235
6282,27.0,8159,175308,183467,1403,8802,245036,69423,175661,245084,16024,0.03329062688710809,0.7152976122472295,0.0057245679032494985,0.2832620652510976,0.7167379347489025,0.035914217166359286
6283,24.0,159,4304,4463,0,238,5923,1745,4178,5923,449,0.02684450447408408,0.7266587877764646,0.0,0.29461421576903596,0.705385784230964,0.04018234003039001
6284,33.0,413,10981,11394,86,331,15074,4317,10757,15074,1292,0.02739816903277166,0.7284728671885365,0.005705187740480297,0.2863871566936447,0.7136128433063553,0.021958338861616026
6285,17.0,187,4075,4262,5,186,5678,1664,4014,5678,495,0.03293413173652695,0.7176822824938358,0.0008805917576611482,0.29306093694963015,0.7069390630503698,0.03275801338499472
6286,36.0,2462,15435,17897,599,1571,25313,6409,18904,25313,601,0.09726227630071504,0.6097657330225575,0.023663730099158536,0.2531900604432505,0.7468099395567495,0.0620629715956228
6287,,472,10816,11288,33,885,15645,4289,11356,15645,1161,0.030169383189517417,0.6913390859699584,0.002109300095877277,0.2741450942793225,0.7258549057206776,0.05656759348034516
6288,26.0,156,1563,1719,6,125,3093,531,2562,3093,72,0.0504364694471387,0.5053346265761397,0.0019398642095053346,0.1716779825412221,0.8283220174587779,0.0404138376980278
6289,23.0,2130,49963,52093,142,2418,69729,19595,50134,69729,5368,0.03054683130404853,0.7165311419925713,0.002036455420269902,0.2810165067618925,0.7189834932381075,0.03467710708600439
6290,,371,4337,4708,27,493,7195,1792,5403,7195,448,0.051563585823488536,0.6027797081306463,0.0037526059763724807,0.24906184850590687,0.7509381514940932,0.06851980542043086
6291,26.0,949,20745,21694,34,889,28954,8306,20648,28954,1877,0.032776127650756375,0.7164813151896111,0.0011742764384886372,0.2868688264143124,0.7131311735856877,0.030703875112247012
6292,23.0,51,1773,1824,2,103,2394,683,1711,2394,190,0.021303258145363407,0.7406015037593985,0.000835421888053467,0.285296574770259,0.7147034252297411,0.04302422723475355
6293,,5564,101530,107094,2618,5666,140749,40129,100620,140749,8670,0.039531364343618786,0.7213550362702399,0.01860048739245039,0.2851103737859594,0.7148896262140406,0.04025605865761036
6294,33.0,209,5483,5692,13,188,7554,2110,5444,7554,544,0.027667460947842202,0.7258406142441091,0.0017209425469949695,0.27932221339687585,0.7206777866031242,0.024887476833465715
6295,17.0,152,3284,3436,26,192,4674,1288,3386,4674,416,0.032520325203252036,0.7026101839965768,0.005562687205819427,0.27556696619597776,0.7244330338040222,0.0410783055198973
6296,25.0,2570,56597,59167,298,3447,79342,22406,56936,79342,5779,0.032391419424768725,0.7133296362582239,0.003755892213455673,0.28239772125734164,0.7176022787426584,0.043444833757656724
6297,,213,4231,4444,21,216,5891,1718,4173,5891,433,0.03615684943133594,0.718214225089119,0.0035647598030894585,0.29163130198608045,0.7083686980139196,0.036666100831777286
6298,,1537,37442,38979,267,2295,51520,14809,36711,51520,3736,0.02983307453416149,0.7267468944099379,0.005182453416149068,0.2874417701863354,0.7125582298136646,0.04454580745341615
6299,,123,3783,3906,4,169,5316,1477,3839,5316,360,0.023137697516930022,0.7116252821670429,0.0007524454477050414,0.2778404815650865,0.7221595184349134,0.031790820165538
6300,15.0,118,5084,5202,16,499,7480,1784,5696,7480,441,0.015775401069518715,0.6796791443850267,0.0021390374331550803,0.23850267379679144,0.7614973262032085,0.06671122994652406
6301,15.0,12,1933,1945,7,117,2558,709,1849,2558,227,0.004691164972634871,0.7556684910086005,0.002736512900703675,0.27716966379984365,0.7228303362001564,0.045738858483189995
6302,17.0,319,5465,5784,69,268,7649,2185,5464,7649,593,0.041704798012812135,0.7144724800627533,0.009020787030984443,0.285658255981174,0.714341744018826,0.035037259772519286
6303,25.0,7645,305800,313445,1971,16760,420589,116700,303898,420598,29447,0.018176501077037933,0.7270600430815173,0.00468618490815458,0.2774620896913442,0.7225379103086558,0.03984802590597197
6304,,193,4111,4304,24,179,5782,1649,4133,5782,482,0.033379453476305776,0.7109996540989277,0.0041508128675198895,0.28519543410584575,0.7148045658941543,0.030958145970252506
6305,38.0,100,2254,2354,4,127,3112,928,2184,3112,228,0.032133676092544985,0.724293059125964,0.0012853470437017994,0.2982005141388175,0.7017994858611826,0.040809768637532134
6306,,379,6988,7367,226,384,10840,2742,8098,10840,632,0.03496309963099631,0.644649446494465,0.02084870848708487,0.2529520295202952,0.7470479704797048,0.035424354243542434
6307,14.0,199,5223,5422,0,205,7014,2048,4966,7014,480,0.02837182777302538,0.7446535500427716,0.0,0.2919874536641004,0.7080125463358996,0.029227259766181922
6308,,1125,25529,26654,250,1536,36150,10074,26076,36150,2613,0.03112033195020747,0.7061964038727524,0.006915629322268326,0.2786721991701245,0.7213278008298755,0.042489626556016596
6309,27.0,3576,101085,104661,351,4330,137722,39849,97873,137722,10695,0.02596535048866557,0.7339785945600558,0.0025486124221257315,0.2893437504538128,0.7106562495461872,0.03144014754360233
6310,,1347,34065,35412,202,1914,47032,13285,33747,47032,3084,0.028640074842660318,0.7242940976356523,0.004294948120428644,0.2824672563361116,0.7175327436638884,0.040695696547031805
6311,,66,3919,3985,25,219,5283,1511,3772,5283,418,0.01249290176036343,0.7418133636191557,0.00473215975771342,0.28601173575619915,0.7139882642438009,0.04145371947756956
6312,,78,1441,1519,9,104,2087,587,1500,2087,142,0.037374221370388115,0.6904647819837086,0.004312410158121706,0.28126497364638237,0.7187350263536176,0.04983229516051749
6313,,227,5621,5848,21,234,7753,2219,5534,7753,539,0.02927898877853734,0.7250096736747066,0.002708628917838256,0.28621178898490907,0.7137882110150909,0.030181865084483426
6314,15.0,10889,153353,164242,2642,10209,223481,62676,160805,223481,15262,0.04872450006935713,0.6862015115378935,0.01182203408790904,0.28045337187501396,0.719546628124986,0.04568173580751831
6315,24.0,488,13712,14200,30,380,18533,5515,13018,18533,1715,0.02633140883828846,0.7398694221119085,0.0016187341498947823,0.29757729455565746,0.7024227054443425,0.020503965898667244
6316,,193,9966,10159,43,1130,14820,3850,10970,14820,507,0.01302294197031039,0.6724696356275304,0.002901484480431849,0.25978407557354927,0.7402159244264508,0.07624831309041835
6317,24.0,348,5110,5458,11,347,7249,2075,5174,7249,302,0.04800662160297972,0.7049248172161677,0.0015174506828528073,0.28624637881087045,0.7137536211891296,0.04786867154090219
6318,,780,18282,19062,63,1222,25421,7119,18302,25421,1831,0.030683293340151845,0.719169190826482,0.002478266000550726,0.28004405806223204,0.719955941937768,0.04807049289957122
6319,33.0,5916,91470,97386,36,6663,132284,34639,97645,132284,7326,0.04472196183967827,0.691466844062774,0.0002721417556167035,0.26185328535574975,0.7381467146442503,0.05036890326872486
6320,25.0,264,9715,9979,40,407,12918,3858,9060,12918,859,0.020436600092893636,0.7520514011456881,0.003096454559529339,0.2986530422666047,0.7013469577333953,0.031506425143211024
6321,23.0,353,8829,9182,36,362,11767,3535,8232,11767,824,0.029999150165717685,0.7503186878558681,0.003059403416333815,0.3004164187983343,0.6995835812016656,0.03076400101980114
6322,,150,3025,3175,3,173,4460,1189,3271,4460,294,0.033632286995515695,0.6782511210762332,0.0006726457399103139,0.2665919282511211,0.7334080717488789,0.03878923766816143
6323,27.0,276,4245,4521,93,1370,7473,1720,5753,7473,402,0.03693295865114412,0.5680449618627057,0.012444801284624649,0.2301619162317677,0.7698380837682323,0.1833266425799545
6324,34.0,97,2190,2287,128,279,3692,920,2772,3692,186,0.02627302275189599,0.5931744312026003,0.03466955579631636,0.24918743228602383,0.7508125677139762,0.07556879739978331
6325,23.0,3178,62201,65379,235,2709,88013,24964,63049,88013,7594,0.03610830218263211,0.7067251428766205,0.0026700601047572516,0.28363991683046824,0.7163600831695318,0.030779543931010192
6326,24.0,65,1907,1972,2,63,2578,771,1807,2578,232,0.0252133436772692,0.7397207137315749,0.0007757951900698216,0.29906904577191623,0.7009309542280838,0.024437548487199378
6327,16.0,89,1934,2023,36,117,2745,778,1967,2745,216,0.03242258652094718,0.7045537340619308,0.013114754098360656,0.28342440801457197,0.7165755919854281,0.04262295081967213
6328,27.0,350,9090,9440,37,415,12440,3595,8845,12440,828,0.028135048231511254,0.7307073954983923,0.0029742765273311897,0.2889871382636656,0.7110128617363344,0.033360128617363344
6329,,4708,145569,150277,359,7304,200647,57143,143504,200647,14939,0.02346409365701954,0.7254980139249527,0.001789211899505101,0.2847936924050696,0.7152063075949304,0.0364022387576191
6330,33.0,464,11336,11800,0,154,15124,4553,10571,15124,974,0.030679714361280086,0.7495371594816186,0.0,0.3010446971700608,0.6989553028299391,0.010182491404390374
6331,25.0,109,2341,2450,7,152,3296,929,2367,3296,239,0.03307038834951456,0.710254854368932,0.00212378640776699,0.2818567961165049,0.7181432038834952,0.04611650485436893
6332,23.0,205,4602,4807,19,292,6515,1845,4670,6515,453,0.031465848042977744,0.7063699155794321,0.0029163468917881813,0.2831926323867997,0.7168073676132003,0.04481964696853415
6333,16.0,722,17051,17773,112,1220,24459,6628,17831,24459,1779,0.029518786540741648,0.6971258023631383,0.004579091540946073,0.2709840958338444,0.7290159041661556,0.04987938999959115
6334,,4227,80805,85032,418,3406,111340,32585,78755,111340,8484,0.03796479252739357,0.7257499550925094,0.0037542662116040954,0.29266211604095566,0.7073378839590444,0.03059098257589366
6335,37.0,127,3682,3809,8,159,5006,1468,3538,5006,395,0.025369556532161407,0.735517379145026,0.0015980823012385138,0.2932481022772673,0.7067518977227327,0.03176188573711546
6336,,10,2770,2780,10,80,3624,1059,2565,3624,401,0.0027593818984547464,0.7643487858719646,0.0027593818984547464,0.29221854304635764,0.7077814569536424,0.02207505518763797
6337,23.0,1286,33496,34782,131,2353,48079,13170,34909,48079,3911,0.026747644501757525,0.6966867031344246,0.002724682293724911,0.27392416647600826,0.7260758335239917,0.04894028577965432
6338,17.0,26,10262,10288,82,519,14469,3988,10481,14469,1395,0.0017969451931716084,0.7092404450895017,0.005667288686156611,0.2756237473218605,0.7243762526781394,0.03586979058677172
6339,23.0,2286,171374,173660,575,10464,234674,66252,168424,234676,19126,0.009741089843017607,0.7302578874703847,0.002450186640304079,0.2823126352929145,0.7176873647070855,0.04458913565937719
6340,17.0,93,2657,2750,6,248,3841,1066,2775,3841,273,0.02421244467586566,0.6917469409008071,0.0015620932048945586,0.2775318927362666,0.7224681072637335,0.06456651913564176
6341,39.0,8777,160046,168823,1791,9189,237719,63605,174114,237719,14642,0.03692174373945709,0.673257080839142,0.00753410539334256,0.2675638043235921,0.7324361956764078,0.03865488244523997
6342,24.0,437,10685,11138,25,747,15015,4083,10932,15015,931,0.029104229104229103,0.7116217116217116,0.001665001665001665,0.27192807192807195,0.7280719280719281,0.04975024975024975
6343,,160,5415,5575,7,477,7897,2149,5748,7897,614,0.020260858553881222,0.6857034316829176,0.0008864125617323034,0.27212865645181716,0.7278713435481828,0.06040268456375839
6344,24.0,1169,42892,44061,144,2117,57342,16556,40786,57342,4218,0.020386453210561196,0.7480032088172718,0.0025112482996756304,0.2887237975654843,0.7112762024345157,0.03691883785009243
6345,,2733,47963,50696,180,2913,69229,19174,50055,69229,5007,0.03947767554059715,0.6928165942018518,0.0026000664461425125,0.2769648557685363,0.7230351442314636,0.042077741986739664
6346,,515,12727,13242,115,575,17502,4981,12521,17502,1325,0.02942520854759456,0.7271740372528854,0.006570677636841504,0.2845960461661524,0.7154039538338476,0.03285338818420752
6347,,651,9780,10431,82,753,14507,4055,10452,14507,995,0.044874887985110634,0.6741573033707865,0.00565244364789412,0.2795202316123251,0.7204797683876749,0.051905976425174055
6348,,1167,35258,36425,31,1738,47821,13689,34132,47821,3514,0.024403504736412875,0.7372911482403128,0.0006482507684908304,0.2862549925764831,0.7137450074235169,0.03634386566571172
6349,,237,6590,6827,33,568,9642,2617,7025,9642,728,0.024579962663347853,0.6834681601327526,0.003422526446795271,0.271416718523128,0.728583281476872,0.05890894005393072
6350,43.0,9394,212033,221427,939,11427,293290,84657,208633,293290,22916,0.03202973166490504,0.7229465716526305,0.0032016093286508234,0.2886460499846568,0.7113539500153432,0.038961437485083024
6351,17.0,1564,29259,30823,66,2061,42080,11466,30614,42080,3041,0.037167300380228134,0.6953184410646388,0.0015684410646387833,0.2724809885931559,0.727519011406844,0.04897813688212928
6352,13.0,860,23141,24001,1239,2910,36426,9058,27368,36426,2133,0.023609509690880142,0.6352879811123923,0.03401416570581453,0.24866853346510734,0.7513314665348927,0.07988799209355954
6353,38.0,269,7580,7849,25,323,10319,2966,7353,10319,830,0.026068417482314178,0.7345673030332397,0.0024227153793972282,0.28743095261168716,0.7125690473883128,0.03130148270181219
6354,14.0,5431,59435,64866,674,4680,88952,24848,64104,88952,5780,0.061055400665527476,0.6681693497616692,0.007577120244626315,0.27934166741613453,0.7206583325838655,0.05261264502203435
6355,24.0,54,2507,2561,0,109,3374,1071,2303,3374,310,0.016004742145820983,0.7430349733254298,0.0,0.31742738589211617,0.6825726141078838,0.03230586840545347
6356,13.0,63,1570,1633,2,58,2241,683,1558,2241,158,0.028112449799196786,0.7005800981704596,0.000892458723784025,0.30477465417224453,0.6952253458277554,0.025881302989736725
6357,16.0,111,2270,2381,3,174,3595,888,2707,3595,239,0.030876216968011128,0.631432545201669,0.0008344923504867872,0.24700973574408902,0.752990264255911,0.04840055632823366
6358,,94,2440,2534,9,122,3267,961,2306,3267,238,0.028772574227119683,0.7468625650443832,0.0027548209366391185,0.29415365779002145,0.7058463422099786,0.03734312825221916
6359,17.0,17271,348300,365571,1298,16692,478653,141230,337467,478697,34647,0.03607918996776667,0.7276001311894581,0.002711527333574265,0.295030050324109,0.704969949675891,0.03486965658861451
6360,14.0,1416,62644,64523,315,8077,88263,24049,64214,88263,3770,0.01604296250977193,0.7097424741964357,0.0035688793718772305,0.2724697778230969,0.7275302221769031,0.09151059900524569
6361,,534,13596,14130,84,616,22177,5373,16804,22177,1342,0.02407900076655995,0.613067592550841,0.0037877079857510034,0.2422780358028588,0.7577219641971412,0.02777652522884069
6362,,794,15443,16237,49,873,21458,6299,15159,21458,1549,0.03700251654394631,0.719684965980054,0.002283530617951347,0.2935501910709293,0.7064498089290707,0.04068412713207195
6363,24.0,180,4102,4282,11,182,5553,1650,3903,5553,417,0.03241491085899514,0.7386998019088781,0.0019809112191608138,0.2971366828741221,0.7028633171258779,0.03277507653520619
6364,25.0,507,21916,22423,127,898,29816,8585,21231,29816,2313,0.017004292997048566,0.735041588408908,0.004259458009122619,0.28793265360880066,0.7120673463911994,0.030118057418835525
6365,24.0,678,15407,16085,88,830,21662,6221,15441,21662,1653,0.03129904902594405,0.7112454990305604,0.004062413442895393,0.28718493213922996,0.71281506786077,0.03831594497276337
6366,,388,8320,8708,39,421,11596,3320,8276,11596,865,0.03345981372887202,0.7174887892376681,0.0033632286995515697,0.2863056226284926,0.7136943773715074,0.03630562262849259
6367,,63,6039,6102,5,489,7997,2279,5718,7997,432,0.007877954232837313,0.7551581843191196,0.0006252344629235964,0.2849818682005752,0.7150181317994247,0.06114793047392772
6368,38.0,894,19999,20893,72,1090,27622,8003,19619,27622,2068,0.03236550575628123,0.7240243284338571,0.0026066179132575485,0.2897328216638911,0.7102671783361089,0.03946129896459344
6369,,70,2043,2113,0,64,2682,810,1872,2682,191,0.02609992542878449,0.761744966442953,0.0,0.30201342281879195,0.697986577181208,0.023862788963460103
6370,,61,3541,3602,12,129,4723,1377,3346,4723,391,0.01291551979673936,0.7497353377090832,0.0025407579928011857,0.29155197967393603,0.7084480203260639,0.027313148422612746
6371,16.0,80,4687,4767,19,1051,6929,1579,5350,6929,205,0.011545677586953384,0.6764323856256313,0.002742098426901429,0.22788281137249242,0.7721171886275076,0.1516813392986001
6372,38.0,452,10681,11133,90,650,15189,4173,11016,15189,1056,0.029758377773388637,0.7032062676937257,0.005925340707090658,0.2747382974521035,0.7252617025478965,0.04279412732898808
6373,26.0,5255,135668,140923,464,6538,185375,53799,131603,185402,14890,0.0283438150613262,0.7317504665537589,0.0025026698741113904,0.2901748632700834,0.7098251367299167,0.03526391301064714
6374,13.0,449,8473,8922,24,358,12467,3350,9117,12467,867,0.03601507981070025,0.6796342343787599,0.00192508221705302,0.268709392796984,0.731290607203016,0.028715809737707546
6375,,155,5410,5565,23,195,7298,2137,5161,7298,648,0.021238695533022746,0.7412989860235681,0.0031515483694162785,0.2928199506714168,0.7071800493285831,0.0267196492189641
6376,,345,8280,8625,27,489,11517,3222,8295,11517,949,0.02995571763480073,0.7189372232352175,0.0023443605105496223,0.2797603542589216,0.7202396457410785,0.04245897369106538
6377,24.0,37,1782,1819,1,106,2459,690,1769,2459,227,0.015046766978446523,0.7246848312322082,0.00040666937779585197,0.2806018706791379,0.7193981293208621,0.04310695404636031
6378,,531,17522,18053,143,827,23740,6852,16888,23740,1868,0.02236731255265375,0.7380791912384161,0.006023588879528223,0.2886267902274642,0.7113732097725358,0.03483572030328559
6379,36.0,251,5558,5809,94,424,8008,2140,5868,8008,442,0.031343656343656344,0.6940559440559441,0.011738261738261738,0.26723276723276723,0.7327672327672328,0.052947052947052944
6380,,321,8043,8364,23,429,10994,3164,7830,10994,751,0.02919774422412225,0.731580862288521,0.0020920502092050207,0.28779334182281247,0.7122066581771875,0.039021284336911044
6381,,141,11521,11662,8,703,16235,4380,11855,16235,1275,0.008684939944564212,0.7096396673852787,0.0004927625500461965,0.26978749615029257,0.7302125038497074,0.04330150908530952
6382,,1022,12505,13527,521,572,17869,5280,12589,17869,670,0.05719402316861604,0.6998153226257765,0.029156639991045945,0.2954837987576249,0.704516201242375,0.03201074486540937
6383,14.0,100,2099,2199,0,102,2896,830,2066,2896,270,0.034530386740331494,0.724792817679558,0.0,0.2866022099447514,0.7133977900552486,0.03522099447513812
6384,,408,12116,12524,42,660,16311,4675,11636,16311,1261,0.025013794371896266,0.7428115995340567,0.0025749494206363803,0.2866163938446447,0.7133836061553552,0.04046349089571455
6385,,98,2433,2531,0,87,3332,983,2349,3332,286,0.029411764705882353,0.7301920768307323,0.0,0.2950180072028811,0.7049819927971188,0.02611044417767107
6386,24.0,309,8481,8790,27,330,11632,3406,8226,11632,977,0.0265646492434663,0.7291093535075653,0.0023211829436038515,0.2928129298486933,0.7071870701513068,0.028370013755158185
6387,23.0,219,3605,3824,10,206,5389,1436,3953,5389,358,0.04063833735386899,0.6689552792725924,0.0018556318426424198,0.2664687326034515,0.7335312673965485,0.03822601595843385
6388,23.0,274,8315,8589,30,368,11414,3272,8142,11414,1059,0.02400560714911512,0.7284913264412125,0.0026283511477133343,0.286665498510601,0.713334501489399,0.032241107411950236
6389,42.0,349,8284,8633,58,445,11441,3273,8168,11441,836,0.03050432654488244,0.7240625819421379,0.005069486932960406,0.28607639192378287,0.7139236080762171,0.03889520146840311
6390,15.0,126,2429,2555,1,187,3589,988,2601,3589,254,0.03510727222067428,0.6767901922541097,0.00027862914460852607,0.27528559487322374,0.7247144051267762,0.052103650041794375
6391,15.0,118,6899,7017,27,398,9276,2619,6657,9276,730,0.012721000431220354,0.74374730487279,0.0029107373868046574,0.28234152652005173,0.7176584734799483,0.04290642518326865
6392,17.0,3250,70139,73389,722,9999,100632,27280,73352,100632,5415,0.03229588997535575,0.6969850544558391,0.007174656172986724,0.2710867318546784,0.7289132681453215,0.09936203195802527
6393,25.0,1936,39737,41673,253,1975,57508,15703,41807,57510,3628,0.03366371065901582,0.6909580942444792,0.00439923491566684,0.27304816553642847,0.7269518344635716,0.03434185359067988
6394,14.0,103,1622,1725,0,156,2279,633,1646,2279,113,0.0451952610794208,0.711715664765248,0.0,0.27775340061430454,0.7222465993856955,0.06845107503290918
6395,,166,17121,17287,66,869,23066,6548,16518,23066,2144,0.007196739790167346,0.7422613370328622,0.0028613543744038846,0.28388103702419143,0.7161189629758086,0.03767449926298448
6396,24.0,148,4595,4743,36,205,6194,1810,4384,6194,472,0.02389409105586051,0.7418469486599936,0.005812076202776881,0.2922182757507265,0.7077817242492734,0.033096545043590574
6397,37.0,176,4427,4603,23,225,6297,1767,4530,6297,448,0.02794981737335239,0.7030331904081308,0.00365253295219946,0.2806098141972368,0.7193901858027633,0.03573130061934254
6398,15.0,2400,17575,19975,170,1459,27121,7492,19629,27121,1429,0.08849231223037499,0.6480218281036835,0.006268205449651561,0.2762435013458206,0.7237564986541795,0.05379595147671546
6399,,2721,35349,38070,1025,2343,51817,14314,37503,51817,3234,0.05251172395159889,0.6821892429125577,0.01978115290348727,0.27624138796147985,0.7237586120385202,0.04521682073450798
6400,,126,2894,3020,46,102,3932,1114,2818,3932,223,0.03204476093591048,0.7360122075279756,0.011698880976602238,0.28331637843336727,0.7166836215666328,0.025940996948118005
6401,24.0,461,18436,18897,0,729,24215,6926,17289,24215,1883,0.01903778649597357,0.7613462729712988,0.0,0.2860210613256246,0.7139789386743753,0.030105306628123066
6402,33.0,10068,258569,268637,1102,10641,349960,102148,247812,349960,25875,0.02876900217167676,0.7388530117727741,0.0031489313064350212,0.2918847868327809,0.7081152131672191,0.03040633215224597
6403,24.0,153,5410,5563,25,263,7387,2107,5280,7387,649,0.020712061730066334,0.7323676729389468,0.003384323812102342,0.2852308108839854,0.7147691891160146,0.03560308650331664
6404,,3397,47889,51286,328,3796,70315,19382,50933,70315,4432,0.04831117115835881,0.6810637843987769,0.004664723032069971,0.27564531038896395,0.7243546896110361,0.0539856360662732
6405,17.0,222,5826,6048,29,502,8358,2214,6144,8358,609,0.02656137832017229,0.697056712132089,0.0034697296003828666,0.2648959081119885,0.7351040918880115,0.060062215841110315
6406,24.0,2707,73226,75933,197,4231,100693,29115,71578,100693,8409,0.026883695986811396,0.7272203628852055,0.0019564418579245827,0.2891462167181433,0.7108537832818568,0.04201880964913152
6407,,224,6049,6273,33,404,8346,2518,5828,8346,450,0.02683920440929787,0.7247783369278696,0.003953989935298346,0.30170141385094656,0.6982985861490535,0.04840642223819794
6408,,193,2903,3096,43,96,3997,1184,2813,3997,261,0.048286214660995745,0.7262947210407806,0.01075806855141356,0.29622216662496875,0.7037778333750313,0.0240180135101326
6409,16.0,1474,29285,30759,91,1976,40849,11600,29249,40849,2940,0.0360841146662097,0.7169086146539695,0.0022277167127714263,0.28397267986976427,0.7160273201302357,0.04837327719160812
6410,,1629,32530,34159,113,2144,46292,12986,33306,46292,3118,0.03518966560096777,0.7027132117860537,0.0024410265272617297,0.28052363259310464,0.7194763674068954,0.046314698003974766
6411,17.0,23,9539,9562,63,588,13366,3616,9750,13366,1279,0.0017207840790064341,0.7136764925931468,0.004713452042495885,0.27053718389944637,0.7294628161005536,0.04399221906329493
6412,36.0,202,5611,5813,3,519,7915,2062,5853,7915,485,0.025521162349968415,0.7089071383449147,0.0003790271636133923,0.2605180037902716,0.7394819962097283,0.06557169930511687
6413,,243,4937,5180,16,519,7010,1968,5042,7010,391,0.034664764621968616,0.7042796005706135,0.002282453637660485,0.28074179743223965,0.7192582025677603,0.07403708987161198
6414,24.0,488,6511,6999,18,297,9091,2687,6404,9091,598,0.05367946320536795,0.7162028379716203,0.001979980200197998,0.2955670443295567,0.7044329556704433,0.03266967330326697
6415,,3856,117397,121253,461,5029,157302,45471,111831,157302,10474,0.024513356473534982,0.7463160036108886,0.0029306683958245923,0.28906816187969636,0.7109318381203036,0.031970350027335954
6416,15.0,341,5193,5534,59,286,7981,2058,5923,7981,499,0.042726475379025186,0.6506703420623982,0.007392557323643654,0.2578624232552312,0.7421375767447689,0.03583510838240822
6417,34.0,1207,66709,67916,310,8156,93293,25247,68046,93293,6880,0.012937733806394906,0.7150482887247703,0.0033228645235976978,0.27062051815248733,0.7293794818475127,0.08742349372407361
6418,14.0,274,6224,6498,2765,611,13190,2540,10650,13190,627,0.020773313115996967,0.47187263078089464,0.20962850644427597,0.19257012888551933,0.8074298711144806,0.04632297194844579
6419,,37,2112,2149,3,93,3022,796,2226,3022,224,0.012243547319655858,0.698874917273329,0.0009927200529450694,0.2634017207147584,0.7365982792852416,0.030774321641297155
6420,,387,6185,6572,49,496,8886,2467,6419,8886,583,0.04355165428764349,0.696038712581589,0.005514292144947108,0.2776277290119289,0.7223722709880711,0.05581814089579113
6421,23.0,106,5920,6026,86,854,8992,2137,6855,8992,503,0.011788256227758007,0.6583629893238434,0.00956405693950178,0.23765569395017794,0.7623443060498221,0.09497330960854093
6422,,1249,40581,41830,45,1804,54121,15852,38269,54121,4151,0.023077917998558784,0.7498198481181058,0.0008314702241274182,0.2928992442859519,0.7071007557140482,0.03333271742946361
6423,14.0,268,6096,6364,59,368,8511,2403,6108,8511,686,0.031488661731876394,0.7162495593937258,0.006932205381271296,0.28234050052872756,0.7176594994712725,0.04323816237809893
6424,16.0,1177,76679,77856,221,4806,105015,29705,75313,105018,8476,0.011207602506237027,0.7301510217296082,0.002104401150279,0.28285627225808907,0.7171437277419109,0.045763583385705305
6425,23.0,237,6533,6770,10,266,8784,2619,6165,8784,494,0.02698087431693989,0.7437386156648452,0.001138433515482696,0.29815573770491804,0.701844262295082,0.03028233151183971
6426,,42,1704,1746,12,188,2515,630,1885,2515,115,0.016699801192842943,0.6775347912524851,0.004771371769383698,0.2504970178926441,0.7495029821073559,0.07475149105367793
6427,,138,3451,3589,6,238,4792,1355,3437,4792,351,0.028797996661101836,0.7201585976627712,0.0012520868113522537,0.28276293823038395,0.717237061769616,0.0496661101836394
6428,27.0,144,4539,4683,23,230,6117,1756,4361,6117,423,0.023540951446787643,0.7420304070622854,0.003760013078306359,0.28706882458721594,0.7129311754127841,0.037600130783063596
6429,13.0,157,1805,1962,30,183,2852,688,2164,2852,155,0.05504908835904628,0.6328892005610098,0.010518934081346423,0.24123422159887797,0.758765778401122,0.06416549789621319
6430,,1103,30727,31830,79,1343,42936,12280,30656,42936,3658,0.02568939817402646,0.7156465436929383,0.0018399478293273709,0.2860070803055711,0.7139929196944289,0.031279113098565306
6431,,3784,106590,110374,432,5639,140980,43465,97515,140980,5783,0.026840686622215917,0.7560646900269542,0.0030642644346715845,0.3083061427152788,0.6916938572847212,0.039998581359058025
6432,16.0,56,9342,9398,37,873,13238,3557,9681,13238,760,0.004230246260764466,0.7056957244296722,0.002794984136576522,0.26869617767034293,0.7313038223296571,0.06594651760084605
6433,27.0,229,3343,3572,51,188,4898,1368,3530,4898,353,0.0467537770518579,0.6825234789710086,0.01041241322988975,0.2792976725193957,0.7207023274806044,0.038383013474887706
6434,26.0,2051,37243,39294,553,2358,52787,14507,38280,52787,3658,0.03885426336029704,0.7055335593990945,0.010476064182469168,0.27482145225150134,0.7251785477484987,0.0446700892265141
6435,,533,5763,6296,12,286,8392,2446,5946,8392,559,0.06351286939942803,0.6867254528122021,0.0014299332697807435,0.29146806482364157,0.7085319351763585,0.034080076263107724
6436,15.0,140,4455,4595,2,285,5971,1736,4235,5971,389,0.023446658851113716,0.7461061798693687,0.0003349522693016245,0.29073856975381007,0.7092614302461899,0.047730698375481495
6437,,76,1891,1967,21,154,2736,749,1987,2736,199,0.027777777777777776,0.6911549707602339,0.007675438596491228,0.2737573099415205,0.7262426900584795,0.056286549707602336
6438,,658,6407,7065,31,584,9825,2644,7181,9825,544,0.06697201017811705,0.6521119592875319,0.0031552162849872775,0.2691094147582697,0.7308905852417302,0.05944020356234097
6439,40.0,57,2278,2335,0,164,3149,851,2298,3149,231,0.018100984439504603,0.723404255319149,0.0,0.2702445220704986,0.7297554779295015,0.05208002540489044
6440,,7152,45909,53061,74,3980,72551,20276,52275,72551,4365,0.09857893068324351,0.6327824564788908,0.0010199721575167814,0.27947237115959805,0.7205276288404019,0.05485796198536202
6441,33.0,415,8957,9372,24,381,13068,3574,9494,13068,636,0.031756963575145396,0.6854147535965718,0.0018365472910927456,0.273492500765228,0.726507499234772,0.029155188246097336
6442,,541,7900,8441,39,778,11328,3126,8202,11328,614,0.04775776836158192,0.6973870056497176,0.0034427966101694915,0.2759533898305085,0.7240466101694916,0.06867937853107345
6443,,419,11862,13651,46,1516,19649,4592,15057,19649,1049,0.021324240419359763,0.6036948445213497,0.0023410860603593057,0.23370146063412897,0.766298539365871,0.07715405364140669
6444,35.0,1097,16304,17401,181,883,24234,6348,17886,24234,1550,0.04526698027564579,0.6727737888916399,0.007468845423784765,0.26194602624411983,0.7380539737558802,0.036436411653049436
6445,25.0,290,35703,35993,158,1543,47558,13655,33903,47558,3806,0.006097817401909247,0.7507254300012616,0.0033222591362126247,0.28712309180369233,0.7128769081963077,0.03244459396946886
6446,,92,2597,2689,12,138,3638,1029,2609,3638,262,0.025288620120945574,0.7138537658053876,0.003298515667949423,0.282847718526663,0.717152281473337,0.03793293018141836
6447,24.0,890,13566,14456,65,1175,19449,5486,13963,19449,1171,0.045760707491387734,0.6975165818294,0.0033420741426294412,0.28207105763792484,0.7179289423620752,0.06041441719368605
6448,16.0,65,4817,4882,14,352,6595,1895,4700,6595,512,0.009855951478392721,0.730401819560273,0.0021228203184230476,0.287338893100834,0.7126611068991661,0.0533737680060652
6449,,86,2550,2636,6,126,3562,1006,2556,3562,273,0.024143739472206625,0.7158899494665918,0.0016844469399213925,0.2824256035934868,0.7175743964065132,0.03537338573834924
6450,17.0,1326,24143,25469,199,1039,34502,9612,24890,34502,2168,0.03843255463451394,0.699756535852994,0.005767781577879543,0.2785925453596893,0.7214074546403108,0.03011419627847661
6451,25.0,625,13110,13735,18,626,18182,5107,13075,18182,1194,0.03437465625343747,0.7210427895721043,0.000989990100098999,0.2808821911780882,0.7191178088219118,0.03442965570344297
6452,23.0,9707,192481,202188,4347,14288,281961,76151,205810,281961,20719,0.03442674696145921,0.6826511467898042,0.015417025758881547,0.2700763580778902,0.7299236419221098,0.05067367472806523
6453,,299,3530,3829,18,99,5029,1431,3598,5029,490,0.05945516007158481,0.7019288128852654,0.003579240405647246,0.28454961224895603,0.715450387751044,0.019685822231059854
6454,,206,4280,4486,5,223,5774,1724,4050,5774,314,0.03567717353654312,0.7412538967786629,0.0008659508139937652,0.2985798406650502,0.7014201593349497,0.038621406304121926
6455,27.0,485,14439,14924,476,586,20479,5709,14770,20479,1595,0.02368279701157283,0.7050637238146393,0.023243322427852924,0.2787733776063284,0.7212266223936715,0.028614678451096245
6456,,3710,36387,40097,272,2155,60634,15379,45255,60634,3546,0.06118679288847841,0.6001088498202328,0.004485931985354751,0.25363657353959823,0.7463634264604018,0.035541115545733415
6457,24.0,3030,67283,70313,382,5048,95529,26203,69326,95529,6382,0.0317181170115881,0.7043201540893341,0.003998785709051701,0.27429366998503074,0.7257063300149693,0.05284259230181411
6458,16.0,778,16979,17757,216,1946,25431,6633,18798,25431,1541,0.03059258385435099,0.6676497188470764,0.00849357083874012,0.2608234045063112,0.7391765954936889,0.07652078172309386
6459,24.0,83,2379,2462,3,110,3258,951,2307,3258,267,0.025475751995089013,0.7302025782688766,0.0009208103130755065,0.2918968692449355,0.7081031307550645,0.03376304481276857
6460,25.0,357,9829,10186,31,516,13991,3890,10101,13991,1042,0.02551640340218712,0.7025230505324852,0.002215710099349582,0.2780358802087056,0.7219641197912944,0.03688085197627046
6461,27.0,2784,30483,33267,340,1997,46576,12461,34115,46576,2773,0.05977327378907592,0.6544787014771556,0.0072998969426313984,0.26754122294744076,0.7324587770525592,0.04287615939539677
6462,17.0,60,2208,2268,6,216,3167,855,2312,3167,212,0.01894537417113988,0.6971897694979475,0.001894537417113988,0.26997158193874327,0.7300284180612567,0.06820334701610357
6463,26.0,1312,33840,35152,55,1478,46093,13257,32836,46093,3509,0.02846419195973358,0.7341678779858113,0.0011932397544095633,0.28761417134922873,0.7123858286507713,0.032065606491224266
6464,,447,13750,14197,15,696,18721,5546,13175,18721,1366,0.023876929651193847,0.7344693125367234,0.0008012392500400619,0.29624485871481226,0.7037551412851878,0.03717750120185888
6465,27.0,256,3414,3670,4,143,4821,1399,3422,4821,381,0.053101016386641775,0.7081518357187305,0.0008297033810412777,0.2901887575191869,0.7098112424808131,0.029661895872225678
6466,27.0,184,2739,2923,2,148,3828,1131,2697,3828,292,0.04806687565308255,0.7155172413793104,0.0005224660397074191,0.29545454545454547,0.7045454545454546,0.038662486938349006
6467,,1554,33445,34999,224,1871,46693,13235,33470,46705,3748,0.033272668879135,0.7160903543517825,0.004796060378974414,0.28337437105234986,0.7166256289476501,0.04005995075473718
6468,,59,1962,2021,1,90,2653,756,1897,2653,198,0.02223897474557105,0.7395401432340747,0.0003769317753486619,0.2849604221635884,0.7150395778364116,0.03392385978137957
6469,26.0,328,6968,7296,28,316,9419,2771,6648,9419,559,0.03482322964221255,0.7397812931309056,0.00297271472555473,0.2941925894468627,0.7058074105531372,0.03354920904554624
6470,35.0,3674,71330,75004,1176,5440,102071,28499,73572,102071,7194,0.035994552811278425,0.6988272868885383,0.011521391972254607,0.279207610388847,0.720792389611153,0.05329623497369478
6471,36.0,245,7155,7400,19,274,9809,2855,6954,9809,842,0.024977061881945154,0.7294321541441533,0.0019369966357426853,0.2910592313181772,0.7089407686818228,0.02793353043123662
6472,25.0,129,2680,2809,12,234,3678,1028,2650,3678,205,0.03507340946166395,0.7286568787384448,0.0032626427406199023,0.279499728113105,0.720500271886895,0.0636215334420881
6473,33.0,820,25329,26149,73,1600,34710,9762,24948,34710,2628,0.02362431575914722,0.7297320656871219,0.0021031403053874964,0.2812445980985307,0.7187554019014694,0.04609622587150677
6474,,199,3729,3928,17,187,5341,1500,3843,5343,410,0.03724499344937301,0.6979225154407637,0.003181733108740408,0.2807411566535654,0.7192588433464346,0.034999064196144486
6475,17.0,367,4946,5313,19,507,7385,2012,5373,7385,472,0.04969532836831415,0.6697359512525389,0.0025727826675693974,0.27244414353419094,0.7275558564658091,0.06865267433987814
6476,,149,4149,4298,81,229,5881,1603,4278,5881,379,0.02533582724026526,0.7054922632205407,0.013773167828600578,0.2725726917190954,0.7274273082809046,0.03893895595987077
6477,,795,10437,11232,138,470,15700,4362,11338,15700,1042,0.05063694267515924,0.6647770700636942,0.008789808917197453,0.2778343949044586,0.7221656050955414,0.029936305732484077
6478,14.0,138,1461,1599,0,104,2219,621,1598,2219,173,0.06219017575484453,0.658404686795854,0.0,0.27985579089680035,0.7201442091031997,0.04686795853988283
6479,,1655,46067,47722,431,1456,61061,18398,42663,61061,4325,0.02710404349748612,0.754442279032443,0.007058515255236567,0.30130525212492426,0.6986947478750758,0.02384500745156483
6480,,685,15501,16186,72,1212,22590,6135,16455,22590,1601,0.03032315183709606,0.6861885790172643,0.0031872509960159364,0.27158034528552455,0.7284196547144755,0.053652058432934926
6481,26.0,236,4778,5014,26,292,6766,1884,4882,6766,462,0.03488028377180018,0.7061779485663612,0.0038427431274017146,0.2784510789240319,0.7215489210759681,0.0431569612769731
6482,,98,6176,6274,170,308,8474,2367,6107,8474,617,0.011564786405475572,0.7288175595940524,0.02006136417276375,0.27932499409959877,0.7206750059004012,0.03634647156006608
6483,,288,6542,6830,30,237,9013,2588,6425,9013,650,0.03195384444691002,0.725840452679463,0.003328525463219794,0.2871407966270942,0.7128592033729058,0.02629535115943637
6484,23.0,424,9591,10015,24,280,13126,3804,9322,13126,1036,0.03230230077708365,0.7306871857382294,0.0018284321194575652,0.28980649093402405,0.7101935090659759,0.02133170806033826
6485,23.0,789,2019,2808,27,359,4486,1021,3465,4486,122,0.1758805171645118,0.4500668747213553,0.0060187249219794915,0.2275969683459652,0.7724030316540348,0.08002674988854214
6486,15.0,402,9640,10042,39,506,13354,3836,9518,13354,930,0.030103339823273925,0.7218810843193051,0.0029204732664370224,0.2872547551295492,0.7127452448704508,0.03789126853377265
6487,23.0,126,2391,2517,2,141,3392,977,2415,3392,284,0.03714622641509434,0.7048938679245284,0.0005896226415094339,0.28803066037735847,0.7119693396226415,0.041568396226415096
6488,24.0,157,3602,3759,13,150,4853,1432,3421,4853,324,0.03235112301669071,0.7422213064084072,0.002678755409025345,0.2950752112095611,0.7049247887904388,0.03090871625798475
6489,,155,3871,4026,3,199,5238,1494,3744,5238,361,0.029591447117220313,0.7390225276823215,0.000572737686139748,0.2852233676975945,0.7147766323024055,0.03799159984726995
6490,15.0,364,9438,9802,74,248,13151,3656,9495,13151,1260,0.027678503535852786,0.7176640559653258,0.005626948521025017,0.27800167287658734,0.7219983271234127,0.01885788152992168
6491,,490,13446,13936,38,887,18557,5192,13365,18557,1472,0.026405130139569973,0.7245783262380773,0.002047744786333998,0.2797866034380557,0.7202133965619443,0.04779867435469095
6492,26.0,126,6421,6547,2,316,8965,2509,6456,8965,733,0.014054656999442276,0.7162297824874512,0.0002230897936419409,0.27986614612381483,0.7201338538761851,0.03524818739542666
6493,17.0,283,6995,7278,81,1644,10703,2796,7907,10703,481,0.02644118471456601,0.6535550780155097,0.007567971596748575,0.26123516770998784,0.7387648322900121,0.1536017938895637
6494,,93,5913,6006,25,468,8334,2171,6163,8334,461,0.011159107271418287,0.7095032397408207,0.002999760019198464,0.26049916006719465,0.7395008399328054,0.056155507559395246
6495,,212,6892,7104,53,292,9310,2720,6590,9310,742,0.022771213748657357,0.7402792696025778,0.005692803437164339,0.2921589688506982,0.7078410311493019,0.031364124597207305
6496,25.0,40,915,1047,1,31,1378,379,999,1378,109,0.02902757619738752,0.6640058055152395,0.000725689404934688,0.27503628447024675,0.7249637155297532,0.022496371552975326
6497,36.0,694,16089,16783,97,636,22138,6395,15743,22138,1692,0.031348811997470416,0.7267594181949589,0.004381606287830879,0.2888698166049327,0.7111301833950673,0.028728882464540608
6498,,6,6890,6896,40,253,8977,2598,6379,8977,818,0.0006683747354350006,0.7675169878578589,0.00445583156956667,0.28940626044335527,0.7105937395566447,0.02818313467750919
6499,26.0,83,4749,4832,17,303,6504,1804,4700,6504,615,0.012761377613776138,0.7301660516605166,0.0026137761377613778,0.2773677736777368,0.7226322263222632,0.04658671586715867
6500,,812,19935,20747,24,1162,27851,7860,19991,27851,2359,0.029155147032422533,0.7157732217873685,0.0008617284837169222,0.282216078417292,0.717783921582708,0.041722020753294314
6501,,364,10815,11179,26,735,15102,4261,10841,15102,1163,0.0241027678453185,0.7161303138657131,0.0017216262746656073,0.28214805985962127,0.7178519401403788,0.048669050456893126
6502,16.0,538,13186,13724,40,561,18130,5141,12989,18130,1503,0.02967457253171539,0.7273028130170988,0.002206287920573635,0.2835631549917264,0.7164368450082735,0.03094318808604523
6503,16.0,2740,48751,51491,151,3241,70238,19833,50405,70238,4854,0.03901022238674222,0.6940829750277627,0.002149833423502947,0.28236851846578775,0.7176314815342123,0.04614311341439107
6504,,1852,36927,38779,217,1245,51608,14693,36915,51608,4006,0.03588590916137033,0.7155286002170206,0.004204774453573089,0.28470392187257787,0.7152960781274221,0.024124166795845604
6505,24.0,764,18578,19342,77,834,25606,7260,18346,25606,1747,0.029836757010075765,0.7255330781848004,0.0030071077091306723,0.2835272982894634,0.7164727017105366,0.03257049129110365
6506,15.0,1216,22704,23920,146,1889,32775,9014,23761,32775,2319,0.03710144927536232,0.6927231121281464,0.004454614797864226,0.27502669717772693,0.7249733028222731,0.057635392829900836
6507,40.0,1645,32143,33788,209,1897,46262,12806,33456,46262,2826,0.0355583416194717,0.6948035104405343,0.004517746746790022,0.2768146643033159,0.7231853356966841,0.04100557693139077
6508,26.0,245,7901,8146,25,533,11190,3105,8085,11190,829,0.021894548704200177,0.706076854334227,0.002234137622877569,0.2774798927613941,0.7225201072386059,0.047631814119749774
6509,,1423,27130,28553,508,1250,37069,10755,26314,37069,2112,0.038387871267096495,0.7318783889503359,0.013704173298443444,0.2901346138282662,0.7098653861717338,0.033720898864280126
6510,23.0,537,10933,11470,16,628,15428,4364,11064,15428,1122,0.034806844697951776,0.7086466165413534,0.0010370754472387865,0.28286232823437907,0.7171376717656209,0.04070521130412238
6511,,91,2784,2875,24,128,3919,1077,2842,3919,262,0.023220209237050267,0.7103853023730543,0.0061240112273539165,0.274815003827507,0.725184996172493,0.03266139321255422
6512,26.0,133,5441,5574,9,169,7261,2225,5036,7261,702,0.018317036220906212,0.7493458201349676,0.00123949869164027,0.3064316209888445,0.6935683790111555,0.02327503098746729
6513,27.0,280,5132,5412,14,239,7080,2042,5038,7080,483,0.03954802259887006,0.7248587570621469,0.0019774011299435027,0.2884180790960452,0.7115819209039548,0.033757062146892655
6514,,784,19095,19879,68,1400,26780,7470,19310,26780,1985,0.029275578790141896,0.7130321135175504,0.002539208364451083,0.2789395070948469,0.7210604929051531,0.05227781926811053
6515,25.0,1071,27137,28208,22,927,37350,10879,26471,37350,2841,0.028674698795180722,0.7265595716198125,0.0005890227576974565,0.29127175368139224,0.7087282463186078,0.024819277108433735
6516,24.0,1331,40844,42175,138,2243,55328,15950,39378,55328,4349,0.024056535569693463,0.7382157316367842,0.0024942163100057837,0.2882807981492192,0.7117192018507807,0.04054005205320995
6517,17.0,143,4477,4620,19,147,6152,1764,4388,6152,553,0.0232444733420026,0.7277308192457738,0.0030884265279583875,0.2867360208062419,0.7132639791937582,0.023894668400520156
6518,,522,21988,22510,54,691,29785,8428,21357,29785,2806,0.017525600134295785,0.7382239382239382,0.0018129931173409433,0.28296122209165686,0.7170387779083431,0.02319959711264059
6519,,163,3437,3600,33,173,4866,1361,3505,4866,356,0.033497739416358405,0.7063296341964652,0.006781750924784217,0.27969584874640363,0.7203041512535964,0.035552815454171806
6520,,1598,16045,17643,60,1048,24686,6649,18037,24686,1453,0.06473304707121445,0.6499635420886333,0.002430527424451106,0.26934294741959003,0.7306570525804099,0.042453212347079314
6521,,36,2812,2848,16,159,3887,1098,2789,3887,318,0.00926164136866478,0.7234370980190378,0.004116285052739903,0.2824800617442758,0.7175199382557242,0.04090558271160278
6522,,1144,2860,4004,35,490,5717,1459,4258,5717,33,0.20010495014867938,0.5002623753716985,0.006122092006297009,0.25520377820535245,0.7447962217946476,0.08570928808815813
6523,,255,7584,7839,61,280,10301,3130,7171,10301,734,0.024754878167168235,0.7362392000776624,0.005921755169401029,0.3038539947577905,0.6961460052422095,0.02718182700708669
6524,15.0,758,14126,14884,38,797,20792,5942,14850,20792,1380,0.03645632935744517,0.6793959215082724,0.0018276260100038477,0.2857829934590227,0.7142170065409773,0.03833205078876491
6525,17.0,9634,166966,176600,906,8438,232310,68280,164032,232312,16530,0.041470091945314924,0.7187144874134784,0.0038999276834601744,0.29391507972037606,0.706084920279624,0.03632184303867213
6526,26.0,690,17738,18428,33,1141,24741,6828,17913,24741,1766,0.027888929307627017,0.7169475768966493,0.0013338183581908573,0.2759791439311265,0.7240208560688736,0.04611778020290207
6527,15.0,249,6258,6507,20,243,8790,2435,6355,8790,783,0.02832764505119454,0.7119453924914676,0.0022753128555176336,0.2770193401592719,0.7229806598407281,0.02764505119453925
6528,,370,15762,16132,61,634,20813,6203,14610,20813,1436,0.017777350694277615,0.7573151395762264,0.0029308605198673904,0.2980348820448758,0.7019651179551242,0.030461730649113533
6529,24.0,405,6262,6667,244,383,9374,2515,6859,9374,531,0.043204608491572434,0.6680179219116705,0.026029443140601665,0.2682952848303819,0.7317047151696181,0.04085769148709196
6530,43.0,2987,87409,90396,354,3901,116372,34221,82151,116372,7688,0.025667686385041074,0.7511171072079195,0.003041968858488296,0.29406558278623723,0.7059344172137627,0.033521809369951534
6531,35.0,1402,31655,33057,248,2132,44302,12601,31701,44302,2994,0.03164642679788723,0.714527560832468,0.005597941402194032,0.2844341113268024,0.7155658886731976,0.04812423818337772
6532,27.0,291,8575,8866,53,466,11942,3318,8624,11942,911,0.024367777591693184,0.7180539273153576,0.004438117568246525,0.27784290738569756,0.7221570926143025,0.03902193937363926
6533,35.0,624,5008,5632,142,911,9427,1930,7497,9427,266,0.06619285032353878,0.5312400551607086,0.015063116580036067,0.20473109154556063,0.7952689084544394,0.09663731834093561
6534,26.0,280,4018,4298,2,201,5676,1670,4006,5676,445,0.04933051444679352,0.707892882311487,0.00035236081747709656,0.2942212825933756,0.7057787174066243,0.0354122621564482
6535,23.0,3040,70960,74000,359,5001,99257,28051,71206,99257,7285,0.03062756279154115,0.7149117946341316,0.0036168733691326555,0.2826097907452371,0.7173902092547629,0.05038435576332148
6536,25.0,143,4459,4602,10,257,6062,1704,4358,6062,496,0.023589574397888485,0.7355658198614319,0.001649620587264929,0.2810953480699439,0.718904651930056,0.04239524909270868
6537,15.0,333,6071,6404,74,424,9213,2442,6771,9213,621,0.03614457831325301,0.6589601649842614,0.008032128514056224,0.26506024096385544,0.7349397590361446,0.04602192553999783
6538,,345,17916,18261,35,549,24710,7022,17688,24710,2394,0.01396195872116552,0.7250505868069608,0.00141643059490085,0.28417644678267906,0.7158235532173209,0.022217725617159043
6539,,900,19275,20175,32,1172,27015,7785,19230,27015,2362,0.03331482509716824,0.7134925041643532,0.0011845271145659818,0.2881732370905053,0.7118267629094948,0.04338330557097909
6540,17.0,411,19954,20365,32,604,26190,7650,18540,26190,2294,0.015693012600229095,0.7618938526155021,0.001221840397098129,0.2920962199312715,0.7079037800687286,0.023062237495227185
6541,17.0,223,44197,44420,340,1944,57182,16742,40440,57182,4584,0.003899828617397083,0.7729180511349726,0.005945927039977615,0.2927844426567801,0.70721555734322,0.033996712252107306
6542,,951,23007,23958,34,1250,32243,8960,23283,32243,2660,0.02949477405948578,0.7135502279564556,0.0010544924479732034,0.27788977452470304,0.722110225475297,0.03876810470489719
6543,15.0,335,8377,8712,25,352,11477,3335,8142,11477,1045,0.029188812407423544,0.7298945717522001,0.002178269582643548,0.2905811623246493,0.7094188376753507,0.030670035723621154
6544,25.0,461,13848,14309,6,544,18902,5537,13365,18902,1498,0.0243889535498889,0.7326208866786583,0.0003174267273304412,0.2929319648714422,0.7070680351285579,0.028780023277960004
6545,23.0,1411,34809,36220,81,1653,47178,13769,33409,47178,3789,0.02990800796981644,0.7378227139768536,0.0017169019458222053,0.2918521344694561,0.7081478655305439,0.035037517486964265
6546,14.0,164,2780,2944,22,282,4672,1154,3518,4672,283,0.0351027397260274,0.5950342465753424,0.004708904109589041,0.24700342465753425,0.7529965753424658,0.06035958904109589
6547,14.0,142,1832,1974,9,114,2703,744,1959,2703,191,0.05253422123566408,0.6777654458009619,0.003329633740288568,0.27524972253052166,0.7247502774694784,0.042175360710321866
6548,,309,10015,10324,153,366,13774,3955,9819,13774,1071,0.022433570495135762,0.727094525918397,0.01110788441992159,0.28713518222738493,0.7128648177726151,0.02657180194569479
6549,27.0,788,28377,29165,94,1321,38324,11492,26832,38324,3137,0.02056152802421459,0.7404498486588039,0.0024527711094875274,0.29986431478968795,0.7001356852103121,0.03446926208120238
6550,,75,2697,2772,2,118,3667,1051,2616,3667,285,0.020452686119443685,0.735478592855195,0.000545404963185165,0.28661030815380417,0.7133896918461958,0.032178892827924736
6551,43.0,1928,26170,28098,286,1066,37534,10374,27160,37534,2209,0.05136676080353812,0.6972345073799755,0.007619758086002025,0.2763894069377098,0.7236105930622901,0.028400916502371185
6552,41.0,329,7378,7707,20,482,10335,2979,7356,10335,763,0.031833575229801646,0.7138848572810838,0.0019351717464925011,0.28824383164005807,0.7117561683599419,0.04663763909046928
6553,15.0,34,5288,5322,33,788,7600,2010,5590,7600,424,0.0044736842105263155,0.6957894736842105,0.0043421052631578945,0.2644736842105263,0.7355263157894737,0.1036842105263158
6554,25.0,3938,76007,79945,417,3512,111468,30391,81077,111468,6734,0.035328524778411745,0.6818728244877453,0.0037409839595220155,0.27264326981734666,0.7273567301826533,0.031506800157892846
6555,17.0,130,2275,2405,45,105,3150,928,2222,3150,225,0.04126984126984127,0.7222222222222222,0.014285714285714285,0.2946031746031746,0.7053968253968254,0.03333333333333333
6556,24.0,86,2179,2265,6,131,2999,881,2118,2999,200,0.02867622540846949,0.7265755251750583,0.0020006668889629878,0.2937645881960654,0.7062354118039347,0.0436812270756919
6557,16.0,3501,57530,61031,270,3597,83996,22923,61073,83996,5179,0.04168055621696271,0.6849135673127292,0.003214438782799181,0.27290585265965045,0.7270941473403495,0.0428234677841802
6558,,26,2352,2378,3,114,3124,913,2211,3124,264,0.008322663252240717,0.7528809218950064,0.0009603072983354673,0.29225352112676056,0.7077464788732394,0.03649167733674776
6559,,275,7705,7980,16,571,10553,3051,7502,10553,733,0.026058940585615465,0.7301241353169715,0.0015161565431630816,0.28911210082441013,0.7108878991755899,0.054107836634132475
6560,,4093,60760,64853,729,5409,93972,24544,69428,93972,5985,0.043555527178308434,0.646575575703401,0.0077576299323202655,0.2611841825224535,0.7388158174775465,0.05755969863363555
6561,,774,17983,18757,93,2137,26540,7032,19508,26540,1873,0.029163526752072344,0.6775810097965336,0.0035041446872645064,0.26495855312735495,0.735041446872645,0.08051996985681989
6562,25.0,1855,8779,10634,181,941,15117,4020,11097,15117,894,0.1227095323146127,0.5807369187008005,0.011973275120725012,0.26592577892438973,0.7340742210756103,0.062247800489515115
6563,,1066,23319,24385,125,1612,31974,9102,22872,31974,2072,0.033339588415587665,0.7293113154437981,0.0039094264089572775,0.28466879339463314,0.7153312066053669,0.050415962969913054
6564,26.0,8022,224987,233009,530,11387,305168,88387,216781,305168,22535,0.026287159859487232,0.7372561998636816,0.0017367482829130183,0.28963390656949617,0.7103660934305038,0.03731387301420857
6565,16.0,590,27168,27758,216,969,39231,10367,28893,39260,3110,0.015028018339276618,0.692002037697402,0.005501782985226694,0.2640601120733571,0.7359398879266429,0.02468160978094753
6566,,67,2496,2563,0,108,3397,952,2445,3397,297,0.01972328525169267,0.7347659699735061,0.0,0.2802472770091257,0.7197527229908743,0.03179275831616132
6567,27.0,100,2815,2915,2,95,3777,1094,2683,3777,281,0.026476039184537992,0.7453005030447445,0.0005295207836907599,0.2896478686788456,0.7103521313211544,0.025152237225311094
6568,14.0,379,7130,7509,20,407,10065,2881,7184,10065,778,0.03765524093392946,0.7083954297069052,0.001987083954297069,0.2862394436164928,0.7137605563835072,0.040437158469945354
6569,,636,6023,6659,10,279,8734,2515,6219,8734,640,0.07281886878864209,0.6896038470345776,0.001144950767117014,0.287955117929929,0.712044882070071,0.03194412640256469
6570,24.0,91,2007,2098,2,96,2768,784,1984,2768,232,0.0328757225433526,0.7250722543352601,0.000722543352601156,0.2832369942196532,0.7167630057803468,0.03468208092485549
6571,24.0,53,1521,1574,0,75,2049,572,1477,2049,165,0.025866276232308444,0.7423133235724744,0.0,0.27916056612981943,0.7208394338701806,0.036603221083455345
6572,16.0,1107,15948,17055,506,2753,25122,6337,18785,25122,1805,0.044064962980654404,0.6348220683066634,0.020141708462702013,0.2522490247591752,0.7477509752408248,0.10958522410636096
6573,26.0,212,7261,7473,210,477,10418,2912,7506,10418,782,0.02034939527740449,0.6969667882511038,0.020157419850259168,0.27951622192359377,0.7204837780764062,0.04578613937416011
6574,16.0,109,1900,2009,16,95,2657,763,1894,2657,180,0.04102371095220173,0.7150922092585623,0.0060218291305984195,0.2871659766654121,0.7128340233345879,0.03575461046292811
6575,25.0,410,14218,14628,14,649,18775,5501,13274,18775,1265,0.021837549933422105,0.7572836218375499,0.0007456724367509987,0.2929960053262317,0.7070039946737683,0.03456724367509987
6576,23.0,396,3604,4000,2,138,5272,1542,3730,5272,461,0.07511380880121396,0.6836115326251897,0.00037936267071320183,0.2924886191198786,0.7075113808801214,0.026176024279210924
6577,16.0,421,14487,14908,145,1057,20462,5420,15042,20462,855,0.02057472387840876,0.7079953083765028,0.007086306323917505,0.2648812432802268,0.7351187567197732,0.05165672954745382
6578,,899,9572,10471,84,800,14226,3955,10271,14226,998,0.0631941515534936,0.6728525235484325,0.005904681568958245,0.2780120905384507,0.7219879094615492,0.0562350625615071
6579,17.0,519,14128,14647,48,1618,19699,4932,14767,19699,1242,0.02634651505152546,0.7171937661810244,0.0024366719122798112,0.2503680389867506,0.7496319610132494,0.08213614904309864
6580,14.0,141,3529,3670,29,213,5572,1388,4184,5572,351,0.025305096913137114,0.6333452979181622,0.0052045944005743,0.24910265613783203,0.750897343862168,0.03822684852835607
6581,,1100,25643,26743,116,931,35274,10049,25225,35274,2703,0.031184441798491808,0.7269660373079322,0.0032885411351136814,0.2848840505754947,0.7151159494245053,0.0263933775585417
6582,15.0,217,4963,5180,70,147,6596,2003,4593,6596,483,0.03289872650090964,0.7524257125530625,0.010612492419648272,0.30366889023650695,0.696331109763493,0.02228623408126137
6583,26.0,204,3960,4164,22,304,5703,1605,4098,5703,488,0.03577064702788006,0.6943713834823777,0.0038576187971243207,0.2814308258811152,0.7185691741188848,0.053305277923899705
6584,26.0,2040,45902,47942,45,2385,63758,18165,45593,63758,4488,0.03199598481759152,0.7199410270083754,0.0007057937827409893,0.2849054236331127,0.7150945763668873,0.037407070485272434
6585,,103,3335,3438,0,173,4459,1315,3144,4459,346,0.023099349629961876,0.7479255438439112,0.0,0.2949091724601929,0.7050908275398071,0.038797936757120434
6586,35.0,161,2197,2358,16,112,3219,928,2291,3219,249,0.050015532774153465,0.6825100963031997,0.004970487729108419,0.2882882882882883,0.7117117117117117,0.034793414103758934
6587,38.0,833,27891,28724,126,1091,36879,10925,25962,36887,2711,0.02258248163309567,0.7561200422913221,0.003415837557947244,0.29617480413153685,0.7038251958684631,0.02957681568032098
6588,,26,39140,39166,141,2356,52580,14635,37945,52580,4787,0.0004944845949030049,0.7443895017116774,0.0026816279954355268,0.27833777101559526,0.7216622289844047,0.04480791175351845
6589,14.0,526,6236,6762,39,263,8830,2561,6269,8830,592,0.05956964892412231,0.7062287655719139,0.004416761041902605,0.2900339750849377,0.7099660249150623,0.029784824462061155
6590,26.0,131,3001,3132,11,166,4274,1222,3052,4274,295,0.030650444548432382,0.7021525503041647,0.0025737014506317267,0.28591483387927,0.71408516612073,0.03883949461862424
6591,23.0,4977,136181,141158,262,8414,187811,53794,134017,187811,14388,0.026500045258264958,0.7250959741442194,0.001395019461053932,0.28642624766387487,0.7135737523361252,0.044800357806518254
6592,25.0,121,3420,3541,7,178,4774,1388,3386,4774,379,0.02534562211981567,0.7163803937997486,0.001466275659824047,0.29074151654796815,0.7092584834520318,0.03728529534981148
6593,23.0,116,18975,19091,87,830,25197,7300,17897,25197,2015,0.004603722665396675,0.753065841171568,0.0034527919990475055,0.28971702980513553,0.7102829701948644,0.03294042941620034
6594,15.0,945,18265,19210,50,1045,25547,7275,18272,25547,1775,0.03699064469409324,0.7149567463890085,0.001957176967941441,0.2847692488354797,0.7152307511645203,0.040904998629976125
6595,23.0,956,21817,22773,81,1779,29913,7928,21985,29913,1685,0.031959348778123224,0.7293484438204125,0.0027078527730418213,0.26503526894661183,0.7349647310533881,0.059472470163474074
6596,14.0,791,19276,20067,38,1352,27447,7673,19774,27447,2227,0.028819178780923233,0.7022989762086931,0.0013844864648231137,0.2795569643312566,0.7204430356687433,0.049258571064232884
6597,,2032,50926,52958,136,2497,70135,20300,49835,70135,5292,0.028972695515790976,0.7261139231482142,0.001939117416411207,0.2894417908319669,0.710558209168033,0.035602766093961645
6598,17.0,276,19264,19540,25,526,24822,7613,17209,24822,2081,0.011119168479574571,0.7760857304004513,0.0010071710579324792,0.3067037305615986,0.6932962694384014,0.021190879058899364
6599,23.0,2770,56162,58932,238,4150,81758,22385,59373,81758,5839,0.03388047652829081,0.686929719415837,0.002911030113261088,0.2737958364930649,0.7262041635069351,0.050759558697619805
6600,23.0,1979,215500,222607,1166,15990,298977,82446,216667,299113,23931,0.006616228649373314,0.7204635037594488,0.0038981923219652773,0.27563496070047105,0.7243650392995289,0.05345805765713961
6601,34.0,886,16885,17771,48,996,23945,6830,17115,23945,1760,0.037001461683023595,0.7051576529546878,0.002004593860931301,0.285237001461683,0.7147629985383169,0.04159532261432449
6602,16.0,3,4008,4011,48,601,5688,1473,4215,5688,404,0.0005274261603375527,0.7046413502109705,0.008438818565400843,0.25896624472573837,0.7410337552742616,0.10566104078762306
6603,,248,3270,3518,11,255,5074,1319,3755,5074,329,0.04887662593614505,0.6444619629483642,0.0021679148600709497,0.2599527000394166,0.7400472999605834,0.05025620811982657
6604,25.0,239,7296,7535,23,289,9869,2979,6890,9869,770,0.0242172459215726,0.7392846286351201,0.0023305299422433884,0.3018542912149154,0.6981457087850846,0.02928361536123214
6605,27.0,533,17882,18415,50,1525,24958,7067,17891,24958,2068,0.021355877874829714,0.716483692603574,0.002003365654299223,0.2831557015786521,0.7168442984213479,0.06110265245612629
6606,,25,8412,8437,9,1074,11594,3115,8479,11594,885,0.002156287735035363,0.725547697084699,0.0007762635846127307,0.26867345178540625,0.7313265482145938,0.0926341210971192
6607,17.0,528,12925,13453,22,1010,18247,4854,13393,18247,1334,0.0289362634953691,0.7083356168137228,0.0012056776456403793,0.26601633145174547,0.7339836685482545,0.055351564640762865
6608,15.0,68,1724,1792,10,150,2569,599,1970,2569,194,0.02646944336317633,0.6710782405605293,0.003892565200467108,0.23316465550797977,0.7668353444920203,0.05838847800700662
6609,26.0,193,4045,4238,119,376,6177,1644,4533,6177,448,0.031244940909826775,0.6548486320220172,0.019265015379634126,0.2661486158329286,0.7338513841670714,0.060870972964222114
6610,15.0,435,9535,9970,43,579,13489,3758,9731,13489,898,0.032248498776781084,0.7068722662910519,0.0031877826377047966,0.2785973756394099,0.7214026243605901,0.04292386388909482
6611,,714,7504,8218,10,517,10700,3064,7636,10700,697,0.06672897196261682,0.7013084112149532,0.0009345794392523365,0.2863551401869159,0.7136448598130841,0.0483177570093458
6612,26.0,353,9019,9372,74,428,12068,3597,8480,12077,683,0.029229113190361845,0.7467914217106898,0.006127349507327979,0.29783886726836134,0.7021611327316386,0.03543926471805912
6613,,240,7081,7321,21,296,9667,2796,6871,9667,864,0.02482673011275473,0.7324919830350678,0.002172338884866039,0.28923140581359263,0.7107685941864074,0.030619633805730836
6614,,7443,155764,163207,422,8968,214525,61337,153188,214525,14091,0.03469525696305792,0.7260878685467894,0.0019671366973546206,0.28592005593753644,0.7140799440624636,0.041803985549469756
6615,23.0,359,13682,14041,43,530,18272,5532,12740,18272,773,0.01964754816112084,0.7487959719789843,0.002353327495621716,0.3027583187390543,0.6972416812609457,0.029006129597197897
6616,40.0,198,4906,5104,47,254,6802,1940,4862,6802,528,0.029109085563069684,0.72125845339606,0.006909732431637753,0.28521023228462217,0.7147897677153778,0.03734195824757424
6617,,8692,270663,279355,761,12050,368464,103362,265102,368464,28822,0.023589821529376005,0.7345710842850319,0.0020653306700247516,0.2805212992314039,0.7194787007685961,0.03270333058317773
6618,25.0,166,4328,4494,10,198,6007,1681,4326,6007,532,0.02763442650241385,0.7204927584484768,0.00166472448809722,0.27984018644914266,0.7201598135508573,0.032961544864324954
6619,17.0,2015,29217,31232,74,1778,41932,11898,30034,41932,3600,0.04805399217781169,0.6967709625107317,0.001764761995611943,0.28374511113230944,0.7162548888676905,0.042401984164838306
6620,23.0,2941,46732,49673,300,2493,65431,19179,46252,65431,4283,0.044948113279638095,0.7142180312084486,0.004584982653482294,0.2931179410371231,0.7068820589628769,0.038101205850437865
6621,23.0,484,16016,16500,68,1048,22836,6283,16555,22838,1808,0.021192748927226553,0.701287328137315,0.002977493650932656,0.27511165601190996,0.72488834398809,0.0458884315614327
6622,23.0,458,7768,8226,33,524,11107,3092,8015,11107,711,0.04123525704510669,0.6993787701449536,0.0029710993067434952,0.27838300171063296,0.7216169982893671,0.04717745565859368
6623,,154,2842,2996,7,176,4018,1158,2860,4018,273,0.03832752613240418,0.7073170731707317,0.0017421602787456446,0.2882030861124938,0.7117969138875062,0.043802887008461924
6624,23.0,272,7422,7694,57,471,10195,2925,7270,10195,792,0.02667974497302599,0.7280039234919078,0.0055909759686120645,0.28690534575772436,0.7130946542422756,0.046199117214320747
6625,,485,7172,7657,80,462,10566,2927,7639,10566,658,0.04590194964982018,0.678780995646413,0.007571455612341473,0.2770206322165436,0.7229793677834564,0.043725156161272004
6626,26.0,548,4095,4643,118,461,6444,1759,4685,6444,415,0.08504034761018,0.6354748603351955,0.01831160769708256,0.27296710117939166,0.7270328988206083,0.07153941651148354
6627,,306,7245,7551,14,451,10026,2885,7141,10026,877,0.03052064631956912,0.72262118491921,0.0013963694394574107,0.28775184520247354,0.7122481547975265,0.04498304408537802
6628,,810,11758,12568,158,528,16551,4709,11842,16551,855,0.048939641109298535,0.7104102471149779,0.009546250981813787,0.28451453084405776,0.7154854691559422,0.03190139568606126
6629,25.0,444,11214,11658,73,580,15640,4409,11550,15959,1117,0.027821292060906073,0.7026756062409926,0.004574221442446269,0.2762704430102137,0.7237295569897864,0.036343129268751176
6630,14.0,190,5308,5498,18,172,7282,2178,5104,7282,540,0.026091733040373523,0.7289206262015929,0.0024718483932985444,0.2990936555891239,0.7009063444108762,0.02361988464707498
6631,16.0,344,17980,18452,9,1056,26038,7279,18759,26038,2195,0.013211460173592442,0.6905292265150933,0.00034564866733236037,0.2795529610569168,0.7204470389430832,0.04055611030033029
6632,33.0,372,8720,9092,6,392,12076,3481,8595,12076,1004,0.03080490228552501,0.7220934084133819,0.0004968532626697582,0.28825770122557137,0.7117422987744286,0.03246107982775753
6633,,1892,11039,12931,2,547,17525,5146,12379,17525,979,0.10796005706134094,0.6299001426533524,0.00011412268188302425,0.2936376604850214,0.7063623395149786,0.031212553495007133
6634,16.0,4961,100860,105821,645,7489,147404,40534,106870,147404,11238,0.033655803098966104,0.6842419473012944,0.004375729288214702,0.27498575343952675,0.7250142465604733,0.0508059482782014
6635,25.0,75,1954,2029,11,82,2719,793,1926,2719,232,0.027583670467083488,0.7186465612357484,0.004045605001838912,0.29165134240529605,0.7083486575947039,0.03015814637734461
6636,14.0,643,13375,14018,8,703,19078,5429,13649,19078,1327,0.03370374253066359,0.7010692944753119,0.0004193311667889716,0.28456861306216585,0.7154313869378341,0.03684872628158088
6637,24.0,143,4077,4220,3,172,5487,1588,3899,5487,417,0.02606160014579916,0.7430289775833789,0.0005467468562055768,0.28941133588481865,0.7105886641151813,0.031346819755786404
6638,17.0,430,10858,11540,64,563,15518,4109,11436,15545,1174,0.0276616275329688,0.6984882598906401,0.0041170794467674495,0.2643293663557414,0.7356706336442586,0.0362174332582824
6639,25.0,2247,51410,53657,87,2524,69785,20906,48879,69785,5364,0.03219889661101956,0.7366912660313821,0.0012466862506269256,0.29957727305294835,0.7004227269470517,0.03616823099519954
6640,,88,2349,2437,16,59,3308,973,2335,3308,279,0.026602176541717048,0.7100967351874244,0.0048367593712212815,0.2941354292623942,0.7058645707376058,0.017835550181378477
6641,25.0,130,3784,3914,10,206,5163,1543,3620,5163,417,0.025179159403447608,0.7329072244818904,0.001936858415649816,0.2988572535347666,0.7011427464652334,0.03989928336238621
6642,23.0,194,3531,3725,14,271,5105,1403,3702,5105,416,0.03800195886385896,0.6916748285994123,0.002742409402546523,0.27482859941234083,0.7251714005876592,0.05308521057786484
6643,23.0,133,5706,5839,3,417,8335,2205,6130,8335,616,0.015956808638272344,0.6845830833833233,0.00035992801439712057,0.26454709058188364,0.7354529094181164,0.05002999400119976
6644,,1066,20558,21624,230,875,28408,8175,20233,28408,1831,0.037524640946212336,0.7236693889045339,0.008096310898338496,0.28777105040833567,0.7122289495916643,0.03080118276541819
6645,26.0,2189,44743,46932,181,2151,61882,17792,44097,61889,4522,0.03536977491961415,0.7229556140832781,0.0029245907996574513,0.28748242821826175,0.7125175717817382,0.03475577243128827
6646,,919,12642,13561,140,1445,19268,5114,14154,19268,1327,0.04769566119991696,0.6561137637533735,0.007265933153414989,0.2654141581897447,0.7345858418102553,0.07499481004774756
6647,,374,9283,9657,52,504,13032,3627,9405,13032,869,0.028698588090853284,0.7123235113566605,0.003990178023327195,0.27831491712707185,0.7216850828729282,0.03867403314917127
6648,23.0,119,3500,4456,2367,1958,9904,791,9147,9938,2,0.01197424028979674,0.35218353793519824,0.2381766955121755,0.0795934795733548,0.9204065204266452,0.19702153350774804
6649,,314,20841,21384,101,1706,29139,8004,21135,29139,1700,0.010775936030749167,0.7152270153402657,0.003466145028998936,0.2746834139812622,0.7253165860187377,0.05854696454922956
6650,,223,7852,8075,78,927,11743,3091,8652,11743,720,0.018990036617559398,0.6686536660137955,0.006642254960401941,0.2632206420846462,0.7367793579153539,0.07894064549093077
6651,,2567,63797,66364,235,4065,88173,25432,62741,88173,6372,0.029113220600410557,0.7235434883694555,0.002665214975105758,0.288432967008041,0.711567032991959,0.046102548399169815
6652,14.0,1332,33327,34659,104,1998,46245,13092,33153,46245,3473,0.028803113850145962,0.7206616931560169,0.0022488917720834686,0.28310087577035353,0.7168991242296464,0.043204670775218945
6653,17.0,1116,32730,33846,46,1969,45157,12870,32287,45157,3469,0.02471377638018469,0.7248045707199327,0.0010186682020506233,0.2850056469650331,0.714994353034967,0.04360342803994951
6654,15.0,1945,2363,4308,23,400,5912,1649,4263,5912,190,0.3289918809201624,0.3996955345060893,0.0038903924221921514,0.27892422192151556,0.7210757780784844,0.06765899864682003
6655,,132,3461,3593,6,105,4638,1346,3292,4638,367,0.028460543337645538,0.746226821905994,0.00129366106080207,0.29021129797326434,0.7097887020267356,0.022639068564036222
6656,23.0,150,5196,5346,14,241,6937,2072,4865,6937,490,0.021623180049012543,0.7490269568977944,0.0020181634712411706,0.29868819374369326,0.7013118062563067,0.03474124261208015
6657,17.0,249,6190,6439,32,440,8931,2475,6456,8931,597,0.027880416526704737,0.69309147911768,0.0035830254170865525,0.27712462210278804,0.722875377897212,0.049266599484940096
6658,,279,7281,7560,89,304,10165,2914,7251,10165,901,0.027447122479094935,0.7162813575996065,0.008755533694048205,0.2866699458927693,0.7133300541072307,0.029906542056074768
6659,34.0,178,5292,5470,24,158,7109,2110,4999,7109,462,0.025038683359122238,0.7444084962723309,0.003376002250668167,0.29680686453790966,0.7031931354620903,0.0222253481502321
6660,25.0,511,12868,13379,65,841,17717,4877,12840,17717,1154,0.02884235480047412,0.7263080656996106,0.0036687926849918156,0.27527233730315515,0.7247276626968449,0.04746853304735565
6661,,79,1726,1805,4,77,2602,670,1932,2602,217,0.030361260568793236,0.6633358954650269,0.0015372790161414297,0.25749423520368947,0.7425057647963106,0.02959262106072252
6662,,691,26564,27255,70,1162,35922,10361,25561,35922,2816,0.019236122710316796,0.7394911196481265,0.001948666555314292,0.2884304882801626,0.7115695117198374,0.03234786481821725
6663,,33,2747,2780,61,527,4061,1082,2979,4061,136,0.008126077320856932,0.6764343757695149,0.015020930805220389,0.2664368382171879,0.7335631617828121,0.1297709923664122
6664,,293,6015,6308,8,237,8753,2474,6279,8753,581,0.03347423740431852,0.687192962412887,0.0009139723523363418,0.2826459499600137,0.7173540500399863,0.027076430937964125
6665,,58,1894,1952,9,74,2558,740,1818,2558,204,0.022673964034401875,0.7404222048475372,0.003518373729476153,0.28928850664581707,0.7107114933541829,0.028928850664581705
6666,15.0,525,12985,13510,12,982,18116,4978,13138,18116,1182,0.028979907264296754,0.7167697063369397,0.0006623978803267829,0.2747847206888938,0.7252152793111062,0.05420622654007507
6667,16.0,1064,24254,25318,179,2003,34702,9448,25254,34702,2310,0.030661056999596564,0.698922252319751,0.005158204138090023,0.2722609647858913,0.7277390352141087,0.05772001613739842
6668,,139,2456,2595,5,86,3437,988,2449,3437,272,0.0404422461448938,0.7145766656968287,0.0014547570555717194,0.2874599941809718,0.7125400058190282,0.025021821355833578
6669,23.0,684,16554,17238,93,826,23046,6605,16441,23046,1723,0.029679770892996615,0.7183025253840146,0.00403540744597761,0.28660071162023776,0.7133992883797622,0.035841360756747376
6670,,86,3100,3186,6,100,4021,1224,2797,4021,315,0.021387714498880876,0.7709524993782642,0.0014921661278288984,0.3044018900770952,0.6955981099229047,0.02486943546381497
6671,24.0,145,3286,3431,14,175,4880,1296,3584,4880,343,0.02971311475409836,0.6733606557377049,0.0028688524590163933,0.26557377049180325,0.7344262295081967,0.035860655737704916
6672,13.0,5,1515,1520,34,85,2182,558,1624,2182,187,0.00229147571035747,0.6943171402383135,0.015582034830430797,0.25572868927589365,0.7442713107241063,0.03895508707607699
6673,,555,9004,9559,18,698,13038,3681,9357,13038,874,0.04256787850897377,0.6905967172879276,0.0013805798435342844,0.2823285780027612,0.7176714219972389,0.053535818377051694
6674,16.0,202,5333,5535,25,133,7263,2133,5130,7263,693,0.02781219881591629,0.7342695855707008,0.003442103813851026,0.2936802973977695,0.7063197026022305,0.018311992289687457
6675,23.0,334,7280,7614,55,352,10173,2837,7336,10173,680,0.03283200629116288,0.7156197778433108,0.0054064681018381995,0.27887545463481767,0.7211245453651823,0.03460139585176447
6676,40.0,1719,43236,44955,269,1543,58970,17088,41882,58970,4739,0.029150415465490926,0.7331863659487875,0.004561641512633542,0.2897744615906393,0.7102255384093606,0.02616584704086824
6677,13.0,2264,35422,37686,148,3731,51725,14394,37331,51725,3641,0.04376993716771387,0.6848139197680039,0.002861285645239246,0.27827936201063314,0.7217206379893668,0.07213146447559207
6678,,998,27982,28980,57,1058,39097,10986,28111,39097,2809,0.025526255211397293,0.7157070875003197,0.0014579123717932323,0.28099342660562193,0.7190065733943781,0.027060899813284908
6679,,2717,70776,73493,307,3827,98092,27928,70164,98092,7385,0.027698487134526772,0.7215267300085634,0.0031297149614647472,0.28471231089181587,0.7152876891081842,0.03901439464992048
6680,25.0,324,6389,6713,38,301,8906,2558,6348,8906,611,0.036379968560520996,0.7173815405344711,0.004266786436110487,0.2872220974623849,0.7127779025376151,0.033797439928138336
6681,14.0,208,4802,5010,18,448,6970,1903,5067,6970,552,0.029842180774748924,0.6889526542324247,0.002582496413199426,0.27302725968436153,0.7269727403156384,0.0642754662840746
6682,25.0,2750,60588,63338,321,3025,83662,24096,59566,83662,5682,0.032870359302909324,0.7241997561616983,0.003836867394994143,0.28801606464105567,0.7119839353589443,0.03615739523320026
6683,23.0,161,4466,4627,3,213,6071,1691,4380,6071,439,0.026519519024872346,0.7356283972986328,0.0004941525284137704,0.27853730851589525,0.7214626914841048,0.035084829517377694
6684,16.0,148,15038,15186,61,806,19662,5753,13909,19662,1213,0.007527209846404231,0.764825551825857,0.0031024310853422846,0.2925948530159699,0.7074051469840301,0.04099277794730953
6685,,27108,292400,319508,1423,20606,426121,122488,303633,426121,33832,0.06361573355924725,0.686190072772757,0.0033394270641437527,0.2874488701565987,0.7125511298434013,0.04835715677002542
6686,37.0,221,4776,4997,21,348,6785,1883,4902,6785,431,0.032571849668386145,0.7039056742815033,0.0030950626381724394,0.27752394988946205,0.722476050110538,0.051289609432571846
6687,25.0,183,4735,4918,0,400,6611,1803,4808,6611,469,0.02768113749810921,0.7162305248827712,0.0,0.2727272727272727,0.7272727272727273,0.060505218575102104
6688,,840,17390,18230,98,769,24763,6993,17770,24763,2344,0.03392157654565279,0.7022574001534547,0.003957517263659492,0.28239712474255946,0.7176028752574405,0.03105439567096071
6689,24.0,977,18310,19287,34,878,25513,7497,18016,25513,1828,0.03829420295535609,0.717673343001607,0.0013326539411280523,0.2938501940187355,0.7061498059812644,0.03441382824442441
6690,39.0,229,6497,6726,7,296,9007,2603,6404,9007,680,0.0254246697013434,0.721327856111913,0.0007771733096480515,0.28899744643055403,0.711002553569446,0.03286332852226046
6691,39.0,86,2448,2534,2,100,3324,964,2360,3324,280,0.025872442839951864,0.7364620938628159,0.0006016847172081829,0.29001203369434414,0.7099879663056559,0.030084235860409144
6692,27.0,386,9896,10282,40,448,13461,4040,9432,13472,862,0.028652019002375295,0.7345605700712589,0.0029691211401425177,0.2998812351543943,0.7001187648456056,0.0332541567695962
6693,38.0,594,13074,13668,56,941,19427,5151,14276,19427,1535,0.03057600247078808,0.6729809028671436,0.0028825860915221084,0.2651464456683997,0.7348535543316004,0.04843774128789829
6694,13.0,694,5371,6065,21,444,8464,2332,6132,8464,563,0.08199432892249528,0.634569943289225,0.00248109640831758,0.27551984877126656,0.7244801512287334,0.05245746691871456
6695,14.0,954,13630,14584,71,715,19170,5475,13695,19170,1295,0.04976525821596244,0.7110067814293166,0.003703703703703704,0.2856025039123631,0.7143974960876369,0.03729786124152321
6696,17.0,148,3659,3807,5,217,5033,1444,3589,5033,373,0.02940592092191536,0.7270017881978939,0.0009934432743890324,0.28690641764355257,0.7130935823564475,0.043115438108484005
6697,,1009,12794,13803,178,1275,20098,5172,14926,20098,1199,0.05020400039804956,0.6365807543039108,0.008856602647029555,0.25733903871031943,0.7426609612896805,0.06343914817394766
6698,16.0,82,1659,1741,4,74,2304,658,1646,2304,168,0.035590277777777776,0.7200520833333334,0.001736111111111111,0.2855902777777778,0.7144097222222222,0.03211805555555555
6699,16.0,1309,34082,35391,75,1930,46708,13536,33172,46708,3524,0.028025177699751647,0.7296822814078958,0.001605720647426565,0.2898004624475465,0.7101995375524536,0.04132054466044361
6700,15.0,364,9704,10068,21,767,13599,3614,9985,13599,950,0.02676667402014854,0.7135818810206633,0.001544231193470108,0.26575483491433194,0.7342451650856681,0.05640120597102728
6701,,26,9589,9615,33,721,13074,3715,9359,13074,1072,0.0019886798225485698,0.733440416093009,0.0025240936209270305,0.28415175156799755,0.7158482484320025,0.05514762123298149
6702,41.0,3284,90289,93573,263,2517,119833,36084,83749,119833,8380,0.027404805020319944,0.7534568941777307,0.0021947209867064998,0.3011190573548188,0.6988809426451812,0.02100423088798578
6703,24.0,76,2401,2477,5,98,3355,927,2428,3355,259,0.022652757078986587,0.7156482861400895,0.0014903129657228018,0.27630402384500746,0.7236959761549926,0.029210134128166917
6704,,80,2099,2179,3,115,2901,819,2082,2901,213,0.027576697690451568,0.7235436056532231,0.001034126163391934,0.2823164426059979,0.717683557394002,0.03964150293002413
6705,,1607,37353,38960,107,1752,51312,14745,36567,51312,3908,0.03131821016526349,0.7279583723105706,0.0020852821951980044,0.2873596819457437,0.7126403180542563,0.034144059869036486
6706,43.0,81,1554,1635,4,93,2132,626,1506,2132,150,0.03799249530956848,0.7288930581613509,0.001876172607879925,0.29362101313320826,0.7063789868667918,0.04362101313320826
6707,23.0,3214,52199,55413,677,3463,75478,21156,54322,75478,3646,0.04258194440764196,0.6915790031532367,0.008969501046662604,0.280293595484777,0.7197064045152229,0.045880918943268234
6708,23.0,323,7742,8065,14,414,10587,3103,7484,10587,772,0.03050911495229999,0.7312742042127137,0.001322376499480495,0.29309530556342683,0.7069046944365731,0.03910456219892321
6709,25.0,889,17849,18738,72,981,25305,7020,18285,25305,1826,0.0351313969571231,0.7053546729895278,0.002845287492590397,0.27741553052756374,0.7225844694724363,0.03876704208654416
6710,,184,6583,6767,34,455,9460,2534,6926,9460,614,0.01945031712473573,0.695877378435518,0.003594080338266385,0.2678646934460888,0.7321353065539112,0.04809725158562368
6711,,113,2419,2532,4,172,3421,959,2462,3421,226,0.033031277404267756,0.7071031862028646,0.001169248757673195,0.2803273896521485,0.7196726103478515,0.050277696579947385
6712,,2192,67477,69669,234,2917,92568,26738,65830,92568,6770,0.02367988937861896,0.7289452078472042,0.0025278714026445424,0.28884711779448624,0.7111528822055138,0.03151196957912021
6713,26.0,375,13034,13409,26,798,17508,4928,12580,17508,1268,0.02141877998629198,0.7444596755768791,0.0014850354123829106,0.2814713273931917,0.7185286726068083,0.04557916381082933
6714,37.0,124,3748,3872,32,142,5110,1463,3648,5111,343,0.024261396986891018,0.7333202895715124,0.006261005674036392,0.2862453531598513,0.7137546468401487,0.02778321267853649
6715,13.0,71,1689,1760,18,345,3003,631,2372,3003,89,0.023643023643023644,0.5624375624375625,0.005994005994005994,0.2101232101232101,0.7898767898767899,0.11488511488511488
6716,24.0,53,1679,1732,4,33,2326,645,1681,2326,214,0.022785898538263114,0.7218400687876182,0.0017196904557179708,0.27730008598452277,0.7226999140154772,0.014187446259673258
6717,41.0,219,6486,6705,24,328,8800,2648,6152,8800,646,0.024886363636363637,0.7370454545454546,0.0027272727272727275,0.3009090909090909,0.6990909090909091,0.03727272727272727
6718,16.0,104,3049,3153,40,127,4226,1165,3061,4226,233,0.024609559867486985,0.7214860388073828,0.00946521533364884,0.27567439659252246,0.7243256034074775,0.030052058684335067
6719,,89,3929,4018,17,177,5476,1511,3965,5476,453,0.016252739225712198,0.7174945215485756,0.00310445580715851,0.27593133674214754,0.7240686632578525,0.03232286340394448
6720,17.0,184,4358,4542,67,165,6052,1777,4275,6052,444,0.03040317250495704,0.7200925313945803,0.011070720423000661,0.2936219431592862,0.7063780568407139,0.027263714474553866
6721,,750,20972,21722,36,863,28062,8382,19680,28062,1987,0.026726534103057517,0.7473451642790963,0.0012828736369467607,0.2986957451357708,0.7013042548642292,0.03075333190791818
6722,,588,9745,10333,47,692,13720,3909,9811,13720,1027,0.04285714285714286,0.7102769679300291,0.003425655976676385,0.2849125364431487,0.7150874635568513,0.05043731778425656
6723,26.0,559,12079,12638,37,614,16829,4774,12055,16829,1280,0.03321647156693802,0.717749123536752,0.0021985857745558265,0.28367698615485176,0.7163230138451483,0.036484639610196684
6724,17.0,95,2608,2703,2,182,3615,999,2616,3615,259,0.02627939142461964,0.7214384508990318,0.0005532503457814661,0.27634854771784234,0.7236514522821577,0.05034578146611342
6725,15.0,365,27551,27916,99,2521,38477,10194,28283,38477,2325,0.009486186553005692,0.7160381526626296,0.0025729656678015436,0.26493749512695897,0.735062504873041,0.06551966109623932
6726,35.0,1409,29104,30513,248,1994,41317,11318,29999,41317,3122,0.03410218554106058,0.7044073867899412,0.006002371905026987,0.27393082750441705,0.7260691724955829,0.04826100636541859
6727,17.0,191,1928,2119,8,319,3768,753,3015,3768,153,0.05069002123142251,0.5116772823779193,0.0021231422505307855,0.1998407643312102,0.8001592356687898,0.08466029723991507
6728,16.0,115,4547,4662,35,421,6289,1772,4517,6289,413,0.018285896008904436,0.7230084274129432,0.00556527269836222,0.2817618063285101,0.7182381936714899,0.06694228017172842
6729,17.0,418,8510,8928,14,476,11659,3420,8239,11659,855,0.0358521314006347,0.7299082254052663,0.0012007890899734112,0.29333562055064755,0.7066643794493525,0.04082682905909598
6730,17.0,238,4790,5028,12,269,6837,1945,4892,6837,559,0.034810589439812786,0.7005996782214422,0.0017551557700745941,0.2844814977329238,0.7155185022670763,0.03934474184583882
6731,,798,17467,18265,12,1176,24561,6882,17679,24561,1723,0.032490533773054844,0.711168112047555,0.0004885794552339074,0.28020031757664593,0.7197996824233541,0.04788078661292293
6732,14.0,25,4228,4253,15,399,5835,1583,4252,5835,483,0.004284490145672665,0.7245929734361611,0.002570694087403599,0.27129391602399316,0.7287060839760069,0.06838046272493574
6733,13.0,441,6143,6584,18,596,9038,2426,6612,9038,580,0.04879398096924098,0.679685771188316,0.00199159105996902,0.26842221730471344,0.7315777826952866,0.06594379287452977
6734,14.0,167,3538,3705,60,210,5065,1361,3704,5065,330,0.03297137216189536,0.6985192497532083,0.011846001974333662,0.26870681145113523,0.7312931885488647,0.04146100691016782
6735,17.0,31,1512,1543,0,73,2065,581,1484,2065,177,0.015012106537530266,0.7322033898305085,0.0,0.28135593220338984,0.7186440677966102,0.035351089588377724
6736,15.0,4098,106353,110451,1087,5596,147404,42214,105190,147404,11567,0.027801145152098992,0.7215068790534857,0.007374291064014545,0.2863830018181325,0.7136169981818675,0.03796369162302244
6737,16.0,0,11302,11302,24,536,14809,4277,10532,14809,1209,0.0,0.7631845499358498,0.0016206360996691201,0.2888108582618678,0.7111891417381322,0.03619420622594368
6738,13.0,155,2065,2220,18,189,2951,812,2139,2951,146,0.052524567943070144,0.6997627922738054,0.006099627245001694,0.275160962385632,0.724839037614368,0.06404608607251779
6739,,145,3298,3443,33,330,4842,1246,3596,4842,357,0.029946303180503925,0.681123502684841,0.006815365551425031,0.2573316811235027,0.7426683188764973,0.06815365551425032
6740,15.0,310,8206,8516,2,654,11649,3291,8358,11649,978,0.026611726328440208,0.704438149197356,0.00017168855695767876,0.2825135204738604,0.7174864795261395,0.056142158125160956
6741,23.0,52,3788,3840,20,178,5179,1470,3709,5179,437,0.01004054836841089,0.7314153311450087,0.003861749372465727,0.28383857887623093,0.716161421123769,0.03436956941494497
6742,24.0,909,36532,37441,114,1359,48149,14488,33661,48149,3202,0.018878896757980435,0.7587281148102765,0.002367650418492596,0.3008992917817608,0.6991007082182392,0.028224885252030155
6743,,65,2761,2826,7,84,3736,1068,2668,3736,313,0.0173982869379015,0.7390256959314775,0.001873661670235546,0.28586723768736616,0.7141327623126338,0.022483940042826552
6744,,677,7691,8368,83,475,11478,3082,8396,11478,764,0.05898240111517686,0.6700644711622233,0.007231224952082244,0.2685136783411744,0.7314863216588255,0.04138351629203694
6745,15.0,4143,65801,69944,1057,3830,94869,26339,68532,94871,5927,0.04366982534177989,0.6935839192166204,0.011141444698590719,0.277629623383331,0.7223703766166689,0.04037060851050374
6746,24.0,223,6168,6391,74,444,8771,2414,6357,8771,603,0.02542469501767187,0.7032265420134535,0.008436894310796944,0.27522517386843004,0.72477482613157,0.050621365864781664
6747,16.0,733,20703,21436,88,1172,29575,7988,21587,29575,2197,0.024784446322907862,0.7000169061707523,0.0029754860524091294,0.2700929839391378,0.7299070160608622,0.039628064243448856
6748,,269,10111,10380,122,265,13037,3938,9099,13037,763,0.02063358134540155,0.7755618623916545,0.009357981130628213,0.30206335813454016,0.6979366418654599,0.02032676229193833
6749,26.0,3162,186193,189355,478,8711,254016,72171,181845,254016,21305,0.01244803476946334,0.7329971340388007,0.0018817712270093223,0.2841198979591837,0.7158801020408163,0.03429311539430587
6750,,479,6782,7261,75,561,10293,2770,7523,10293,624,0.04653648110366268,0.6588943942485184,0.00728650539201399,0.26911493247838336,0.7308850675216166,0.054503060332264645
6751,,198,3979,4177,12,227,5574,1587,3987,5574,429,0.03552206673842842,0.7138500179404378,0.002152852529601722,0.2847147470398278,0.7152852529601722,0.04072479368496591
6752,13.0,78,2544,2622,11,165,3661,974,2687,3661,272,0.021305654192843484,0.6948921059819722,0.003004643540016389,0.2660475279978148,0.7339524720021852,0.045069653100245834
6753,16.0,144,3335,3479,0,244,5087,1321,3766,5087,327,0.028307450363672104,0.6555926872419894,0.0,0.2596815411834087,0.7403184588165913,0.04796540200511107
6754,14.0,692,57765,58457,163,7180,83268,22778,60490,83268,4179,0.00831051544410818,0.6937238795215449,0.001957534707210453,0.2735504635634337,0.7264495364365663,0.0862276024403132
6755,23.0,2244,41264,43508,173,2250,56829,16732,40097,56829,4479,0.039486881697724754,0.7261081490084288,0.0030442203804395642,0.2944271410723398,0.7055728589276602,0.03959246159531225
6756,15.0,390,4197,4587,17,942,7143,1801,5342,7143,334,0.054598908021839566,0.5875682486350273,0.002379952400951981,0.252134957300854,0.747865042699146,0.13187736245275095
6757,37.0,48,2298,2346,8,80,3049,900,2149,3049,250,0.01574286651361102,0.7536897343391276,0.0026238110856018366,0.29517874713020664,0.7048212528697934,0.026238110856018366
6758,39.0,169,3474,3643,6,120,4675,1434,3241,4675,333,0.036149732620320854,0.7431016042780748,0.0012834224598930481,0.3067379679144385,0.6932620320855615,0.025668449197860963
6759,34.0,12052,280558,292610,1082,12194,384690,111585,273120,384705,26529,0.031327900599160394,0.7292808775555296,0.0028125446770902378,0.29005341755371,0.70994658244629,0.031697014595599225
6760,14.0,477,12692,13169,39,1454,18432,4863,13569,18432,1133,0.02587890625,0.6885850694444444,0.0021158854166666665,0.2638346354166667,0.7361653645833334,0.0788845486111111
6761,27.0,237,7091,7328,55,463,9632,2735,6897,9632,688,0.024605481727574752,0.7361918604651163,0.005710132890365449,0.28394933554817275,0.7160506644518272,0.04806893687707641
6762,,892,19749,20641,28,963,27856,7950,19906,27856,2210,0.03202182653647329,0.7089675473865594,0.0010051694428489374,0.28539632395175185,0.7146036760482481,0.03457064905226881
6763,17.0,55,2723,2778,4,193,3693,1072,2621,3693,303,0.014893040888166802,0.7373409152450582,0.001083130246412131,0.29027890603845113,0.7097210939615489,0.05226103438938532
6764,26.0,926,16604,17530,22,938,23085,6712,16373,23085,1565,0.04011262724713017,0.719254927442062,0.0009529997834091401,0.29075157028373405,0.709248429716266,0.04063244531080788
6765,26.0,2462,38595,41057,136,2901,56172,15387,40786,56173,3534,0.04382888576362309,0.6870738611076496,0.0024210919836932334,0.2739216349491749,0.7260783650508251,0.051644028269809336
6766,44.0,83,4017,4100,18,129,5187,1560,3627,5187,377,0.01600154231733179,0.7744360902255639,0.003470213996529786,0.3007518796992481,0.6992481203007519,0.024869866975130134
6767,,11127,217141,228268,1349,11124,305977,86746,219231,305977,22218,0.036365478450994686,0.7096644519032477,0.004408828114531484,0.2835049693277599,0.7164950306722401,0.0363556737924746
6768,17.0,1806,51365,53209,121,2874,70791,20422,50369,70791,5320,0.025511717591219223,0.7255865858654349,0.0017092568264327386,0.28848299925131726,0.7115170007486827,0.040598381150146204
6769,24.0,187,5678,5865,23,288,7848,2187,5661,7848,588,0.023827726809378186,0.7234964322120285,0.002930682976554536,0.2786697247706422,0.7213302752293578,0.03669724770642202
6770,26.0,5,2803,2808,13,78,3658,1059,2599,3658,338,0.001366867140513942,0.7662657189721159,0.003553854565336249,0.2895024603608529,0.7104975396391471,0.021323127392017496
6771,,930,26934,27864,72,2200,37579,10833,26750,37583,2789,0.02474523055636857,0.716653806242184,0.0019157597850091798,0.2882420243195062,0.7117579756804938,0.05853710454194716
6772,16.0,2264,9148,11412,2747,3321,22243,4264,17979,22243,786,0.10178483118284404,0.4112754574472868,0.12349952794137481,0.19170075978959672,0.8082992402104032,0.14930539945151283
6773,,94,1809,1903,4,112,2576,748,1828,2576,183,0.036490683229813664,0.702251552795031,0.0015527950310559005,0.29037267080745344,0.7096273291925466,0.043478260869565216
6774,15.0,538,7569,8107,95,715,11522,3044,8478,11522,754,0.04669328241624718,0.6569172018746745,0.008245096337441417,0.2641902447491755,0.7358097552508245,0.06205519875021698
6775,15.0,113,2375,2488,10,60,3249,950,2299,3249,261,0.034779932286857496,0.7309941520467836,0.0030778701138811943,0.29239766081871343,0.7076023391812866,0.018467220683287166
6776,15.0,139,2105,2244,13,27,2981,914,2067,2981,250,0.04662864810466286,0.7061388795706139,0.004360952700436095,0.30660852063066085,0.6933914793693392,0.009057363300905737
6777,26.0,4709,71960,76669,862,3163,100970,28839,72131,100970,5859,0.04663761513320788,0.7126869367138754,0.008537189264137863,0.28561949093790234,0.7143805090620976,0.03132613647618104
6778,15.0,134,1992,2126,9,211,3162,818,2344,3162,205,0.04237824161922834,0.6299810246679317,0.0028462998102466793,0.25869702719797594,0.7413029728020241,0.06672991777356103
6779,34.0,238,4356,4594,17,227,6467,1655,4812,6467,370,0.03680222668934591,0.6735735271377764,0.002628730477810422,0.25591464357507343,0.7440853564249266,0.03510128343899799
6780,24.0,310,5704,6014,13,383,7946,2215,5731,7946,597,0.039013340045305815,0.717845456833627,0.0016360432922225018,0.2787566070979109,0.721243392902089,0.048200352378555245
6781,17.0,10504,169874,180378,1290,11156,244563,69206,175357,244563,19025,0.04295007830293217,0.6946022088378045,0.005274714490744716,0.28297821011354946,0.7170217898864505,0.04561605803003725
6782,15.0,287,6398,6685,5,426,8758,2533,6225,8758,591,0.03277003882164878,0.730532084950902,0.0005709065996802923,0.2892212833980361,0.7107787166019639,0.04864124229276091
6783,33.0,128,4361,4489,13,195,5868,1702,4166,5868,414,0.021813224267211998,0.7431833674164963,0.0022154055896387186,0.2900477164280845,0.7099522835719154,0.033231083844580775
6784,23.0,2303,49768,52071,230,2545,69572,19787,49788,69575,4986,0.03310097017606899,0.7153144089112469,0.003305785123966942,0.284398131512756,0.7156018684872439,0.03657923104563421
6785,,74,3112,3186,6,137,4443,1250,3193,4443,435,0.016655413009227998,0.7004276389826694,0.0013504388926401081,0.2813414359666892,0.7186585640333109,0.030835021381949133
6786,,55,2533,2588,18,246,3499,919,2580,3499,180,0.015718776793369534,0.7239211203200915,0.005144326950557302,0.26264647042012,0.73735352957988,0.07030580165761646
6787,47.0,744,19648,20392,55,902,26983,7728,19255,26983,2200,0.027572916280621133,0.7281621761850053,0.0020383204239706482,0.2864025497535485,0.7135974502464515,0.03342845495311863
6788,17.0,829,15629,16458,53,1105,22042,6125,15917,22042,1358,0.0376100172398149,0.70905543961528,0.0024045004990472735,0.2778785954087651,0.7221214045912349,0.05013156700843843
6789,,531,9432,9963,69,703,13738,3729,10009,13738,970,0.03865191439802009,0.6865628184597466,0.005022565147765322,0.2714368903770563,0.7285631096229437,0.05117193186781191
6790,26.0,235,3161,3396,22,173,4525,1281,3244,4525,317,0.051933701657458566,0.6985635359116023,0.004861878453038674,0.2830939226519337,0.7169060773480663,0.038232044198895025
6791,33.0,79,1391,1470,0,88,2059,527,1532,2059,157,0.03836813987372511,0.6755706653715395,0.0,0.25594949004371054,0.7440505099562894,0.042739193783389993
6792,33.0,150,3991,4141,0,562,5666,1267,4399,5666,347,0.02647370278856336,0.7043769855277091,0.0,0.22361454288739852,0.7763854571126014,0.09918813978115072
6793,,124,2873,2997,8,164,3978,1154,2824,3978,301,0.03117144293614882,0.7222222222222222,0.002011060834590246,0.29009552538964306,0.709904474610357,0.04122674710910005
6794,,501,6425,6926,119,332,8856,2585,6271,8856,433,0.056571815718157184,0.7254968383017163,0.01343721770551039,0.2918925022583559,0.708107497741644,0.037488708220415536
6795,14.0,282,12929,13211,24,2135,18984,4896,14088,18984,602,0.014854614412136535,0.681047197640118,0.0012642225031605564,0.2579013906447535,0.7420986093552465,0.11246312684365782
6796,15.0,323,7060,7383,17,500,10013,2789,7224,10013,754,0.03225806451612903,0.7050833915909318,0.001697792869269949,0.2785379007290522,0.7214620992709477,0.04993508439029262
6797,15.0,20,2027,2047,15,109,2763,808,1955,2763,247,0.007238508867173362,0.7336228736880203,0.0054288816503800215,0.29243575823380386,0.7075642417661961,0.03944987332609482
6798,24.0,627,10684,11311,4,565,17168,4222,12946,17168,1004,0.03652143522833178,0.6223205964585274,0.00023299161230195712,0.24592264678471576,0.7540773532152842,0.03291006523765144
6799,,97,2432,2529,6,106,3629,936,2693,3629,224,0.026729126481124278,0.6701570680628273,0.0016533480297602646,0.25792229264260125,0.7420777073573988,0.029209148525764672
6800,15.0,517,6277,6794,73,539,9503,2574,6929,9503,522,0.054403872461328,0.6605282542355045,0.007681784699568557,0.2708618331053352,0.7291381668946648,0.05671893086393771
6801,16.0,7850,262681,270531,2352,9067,345179,103774,241412,345186,21710,0.022741362627684784,0.7609839332997282,0.006813717821696129,0.30063212297138353,0.6993678770286165,0.02626699808219337
6802,15.0,371,11609,11980,31,550,15656,4573,11083,15656,1215,0.023696985181400104,0.741504854368932,0.001980071538068472,0.29209248850281044,0.7079075114971896,0.03513030148185999
6803,15.0,370,28573,28943,22,1142,38138,11306,26832,38138,3797,0.009701609942839163,0.7492002726939011,0.000576852483087734,0.29644973517226914,0.7035502648277309,0.029943887985736013
6804,36.0,169,2866,3035,4,136,4233,1128,3105,4233,331,0.039924403496338294,0.6770611859201512,0.0009449562957713206,0.2664776754075124,0.7335223245924876,0.0321285140562249
6805,,82,2354,2436,8,108,3247,920,2327,3247,279,0.02525408068986757,0.7249769017554666,0.0024638127502309825,0.283338466276563,0.716661533723437,0.033261472128118266
6806,,90,7699,7789,19,345,10181,2990,7191,10181,687,0.008839996071112858,0.756212552794421,0.0018662213927904921,0.2936843139180827,0.7063156860819173,0.03388665160593262
6807,17.0,98,1885,1983,18,176,2817,752,2065,2817,223,0.034788782392616256,0.6691515796947107,0.006389776357827476,0.26695065672701457,0.7330493432729854,0.06247781327653532
6808,34.0,379,11951,12330,92,1978,16875,3440,13436,16876,736,0.02245792841905665,0.7081654420478787,0.005451528798293435,0.20383977245792842,0.7961602275420716,0.11720786916330884
6809,27.0,1061,22635,23696,72,980,30909,9076,21833,30909,2222,0.03432657154873985,0.7323109773852277,0.0023294186159371058,0.2936361577534052,0.7063638422465949,0.03170597560581061
6810,15.0,309,4960,5269,37,277,7054,1955,5099,7054,456,0.043804933371136945,0.7031471505528778,0.0052452509214629996,0.2771477176070315,0.7228522823929685,0.039268500141763536
6811,13.0,139,1926,2065,12,196,3011,797,2214,3011,191,0.04616406509465294,0.6396545998007307,0.003985386914646297,0.26469611424775824,0.7353038857522418,0.06509465293922286
6812,,99,3681,3780,0,198,4948,1414,3534,4948,266,0.020008084074373485,0.7439369442198869,0.0,0.28577202910266775,0.7142279708973323,0.04001616814874697
6813,16.0,6977,138013,144990,544,10340,191086,55161,135925,191086,6196,0.036512355693248066,0.7222559475838104,0.0028468856954460297,0.28867106957076916,0.7113289304292308,0.05411176119652931
6814,24.0,421,10699,11120,35,426,14544,4278,10266,14544,1156,0.028946644664466448,0.7356298129812981,0.0024064906490649067,0.29414191419141916,0.7058580858085809,0.02929042904290429
6815,,532,11430,11962,23,772,15773,4532,11241,15773,1151,0.03372852342610791,0.7246560578203258,0.0014581880428580485,0.2873264439231598,0.7126735560768401,0.04894439865593102
6816,,419,8291,8710,72,752,11980,3096,8884,11980,627,0.034974958263772955,0.6920701168614357,0.006010016694490818,0.2584307178631052,0.7415692821368948,0.06277128547579298
6817,16.0,569,17634,18203,37,809,23571,6964,16607,23571,1770,0.024139832845445675,0.7481226931398752,0.001569725510160791,0.2954477960205337,0.7045522039794663,0.03432183615459675
6818,26.0,1188,23544,24732,33,984,33195,9547,23648,33195,2803,0.03578852236782648,0.7092634432896521,0.0009941256213285134,0.2876035547522217,0.7123964452477782,0.02964301852688658
6819,,595,16246,16841,13,687,22828,6243,16585,22828,1757,0.0260644822148239,0.7116698790958472,0.0005694760820045558,0.27347993691957245,0.7265200630804275,0.03009462064131768
6820,16.0,378,9747,10125,99,1218,14163,3890,10273,14163,805,0.026689260749841136,0.6882016521923321,0.0069900444821012495,0.27465932358963496,0.725340676410365,0.08599872908282144
6821,,662,13063,13725,187,2520,18325,4143,14182,18325,33,0.036125511596180084,0.7128512960436562,0.010204638472032743,0.22608458390177352,0.7739154160982264,0.13751705320600272
6822,,221,2583,2804,6,255,4568,961,3607,4568,183,0.048380035026269703,0.5654553415061296,0.0013134851138353765,0.2103765323992995,0.7896234676007006,0.055823117338003506
6823,,376,5908,6284,27,547,8628,2398,6230,8628,621,0.04357904496986555,0.684747334260547,0.003129346314325452,0.2779323133982383,0.7220676866017617,0.06339823829392675
6824,,222,6404,6626,6,302,8761,2439,6322,8761,623,0.025339573108092685,0.7309667846136286,0.0006848533272457482,0.27839287752539665,0.7216071224746033,0.03447095080470266
6825,26.0,168,7933,8101,2,288,10513,3057,7456,10513,832,0.015980214971939504,0.754589555788072,0.00019024065442785123,0.29078284029297063,0.7092171597070294,0.027394654237610578
6826,23.0,385,12311,12696,38,712,16900,4845,12055,16900,1386,0.022781065088757397,0.7284615384615385,0.0022485207100591716,0.28668639053254436,0.7133136094674556,0.0421301775147929
6827,26.0,291,3576,3867,10,123,5110,1492,3618,5110,434,0.05694716242661448,0.6998043052837574,0.0019569471624266144,0.2919765166340509,0.7080234833659491,0.02407045009784736
6828,,328,6219,6547,54,397,8790,2442,6348,8790,668,0.03731513083048919,0.7075085324232082,0.0061433447098976105,0.27781569965870306,0.7221843003412969,0.04516496018202503
6829,14.0,1124,7651,8775,68,583,12326,3174,9152,12326,689,0.09118935583319812,0.6207204283628103,0.005516793769268213,0.2575044621126075,0.7424955378873925,0.047298393639461304
6830,17.0,1509,26414,27923,112,1880,37490,10456,27034,37490,2516,0.04025073352894105,0.7045612163243532,0.0029874633235529476,0.2789010402774073,0.7210989597225926,0.05014670578821019
6831,13.0,683,12696,13379,104,1064,18881,5073,13808,18881,1249,0.03617393146549441,0.6724220115459987,0.005508182829299295,0.2686828028176474,0.7313171971823527,0.05635294740744664
6832,17.0,205,3437,3642,17,310,4904,1310,3594,4904,322,0.04180261011419249,0.7008564437194127,0.003466557911908646,0.2671288743882545,0.7328711256117455,0.0632137030995106
6833,13.0,8,2140,2148,8,275,3198,819,2379,3198,224,0.0025015634771732333,0.6691682301438399,0.0025015634771732333,0.25609756097560976,0.7439024390243902,0.0859912445278299
6834,15.0,1629,29919,31548,112,3061,44230,11761,32469,44230,3537,0.036830205742708566,0.6764413294144246,0.0025322179516165497,0.2659054940085915,0.7340945059914086,0.06920642098123446
6835,,1031,20933,21964,59,1514,30121,8529,21592,30121,2107,0.03422861126788619,0.6949636466252781,0.0019587663092194814,0.2831579296836094,0.7168420703163906,0.050263935460310084
6836,25.0,516,18434,18950,15,1462,27555,7175,20380,27555,1831,0.018726183995645074,0.6689892941389948,0.0005443658138268917,0.26038831428052983,0.7396116857194701,0.05305752132099437
6837,14.0,433,5805,6238,20,559,8338,2316,6022,8338,509,0.0519309186855361,0.6962101223314944,0.0023986567522187576,0.2777644519069321,0.7222355480930679,0.06704245622451427
6838,27.0,7035,231873,238959,1261,9024,303244,92599,210651,303250,21101,0.02319868095630668,0.7646265457543281,0.004158285243198681,0.3053553173948887,0.6946446826051113,0.02975762572135202
6839,24.0,3568,72945,76513,580,3177,100727,29345,71382,100727,7583,0.03542247858071818,0.7241851737865717,0.005758138334309569,0.29133201624192123,0.7086679837580787,0.03154069911741638
6840,,77,2543,2620,50,118,3718,993,2725,3718,291,0.020710059171597635,0.6839698762775686,0.013448090371167294,0.2670790747713825,0.7329209252286175,0.03173749327595481
6841,37.0,138,3087,3225,31,155,4475,1236,3239,4475,329,0.030837988826815644,0.6898324022346368,0.006927374301675978,0.2762011173184358,0.7237988826815642,0.034636871508379886
6842,42.0,1348,34144,35492,143,1170,45754,13463,32291,45754,3708,0.029461904970057264,0.7462516938409757,0.003125409800236045,0.29424749748655854,0.7057525025134415,0.025571534729204003
6843,23.0,2192,67477,69669,234,2917,92568,26738,65830,92568,6770,0.02367988937861896,0.7289452078472042,0.0025278714026445424,0.28884711779448624,0.7111528822055138,0.03151196957912021
6844,,46,8823,8869,45,844,12190,3395,8795,12190,1093,0.0037735849056603774,0.7237899917965546,0.0036915504511894994,0.27850697292863,0.72149302707137,0.06923707957342083
6845,,295,5069,5364,45,518,8065,2056,6009,8065,461,0.0365778053316801,0.6285182889026658,0.005579665220086794,0.25492870427774333,0.7450712957222566,0.06422814631122133
6846,14.0,49,1751,1800,1,59,2360,654,1706,2360,204,0.02076271186440678,0.7419491525423729,0.000423728813559322,0.2771186440677966,0.7228813559322034,0.025
6847,40.0,738,12792,13530,43,788,17799,5069,12730,17799,1110,0.041463003539524694,0.7186920613517613,0.002415866059891005,0.28479128040901175,0.7152087195909883,0.0442721501207933
6848,,2753,27278,30031,1869,2520,44410,10578,33832,44410,1645,0.06199054267056969,0.6142310290475118,0.04208511596487278,0.23818959693762667,0.7618104030623734,0.05674397658185094
6849,17.0,169,2495,2664,28,239,3628,971,2657,3628,164,0.04658213891951488,0.6877067254685777,0.007717750826901874,0.26764057331863284,0.7323594266813671,0.06587651598676957
6850,23.0,484,15713,16197,108,533,21702,6228,15474,21702,2009,0.02230209197309004,0.7240346511842226,0.0049764998617638926,0.28697815869505117,0.7130218413049488,0.024559948391853284
6851,25.0,1601,43679,45280,101,1753,58549,17330,41219,58549,4715,0.027344617329074793,0.7460246972621223,0.0017250508121402586,0.2959913918256503,0.7040086081743497,0.029940733402790826
6852,25.0,474,13322,13796,34,750,18037,5190,12847,18037,1375,0.02627931474191939,0.7385928923878694,0.001885014137606032,0.28774186394633255,0.7122581360536675,0.041581194211897765
6853,23.0,98,2550,2648,1,139,3522,986,2536,3522,259,0.027825099375354913,0.7240204429301533,0.00028392958546280523,0.27995457126632595,0.720045428733674,0.03946621237932993
6854,13.0,205,8522,8727,42,349,11663,3323,8340,11663,1048,0.01757695275658064,0.730686787276001,0.0036011317842750577,0.28491811712252424,0.7150818828774758,0.02992369030266655
6855,25.0,629,16142,16772,104,943,22357,6582,15775,22357,976,0.028134365075815182,0.7220110032651966,0.004651786912376437,0.2944044370890549,0.7055955629109452,0.042179183253567114
6856,,211,5223,5434,8,311,7353,2142,5211,7353,528,0.028695770433836528,0.7103223174214607,0.0010879912960696314,0.2913096695226438,0.7086903304773562,0.042295661634706924
6857,24.0,7239,86676,93915,2305,5205,126659,34922,91737,126659,5565,0.057153459288325346,0.6843256302355143,0.01819846990738913,0.2757166881153333,0.7242833118846667,0.041094592567444875
6858,48.0,240,5426,5666,36,345,7622,2153,5469,7622,542,0.03148779847808974,0.7118866439254788,0.004723169771713461,0.28247179218053003,0.7175282078194699,0.045263710312254
6859,,58,4324,4382,0,75,5424,1702,3722,5424,429,0.010693215339233038,0.7971976401179941,0.0,0.3137905604719764,0.6862094395280236,0.013827433628318585
6860,37.0,145,4216,4361,13,151,5538,1700,3838,5538,404,0.026182737450343083,0.7612856626941134,0.002347417840375587,0.30697002527988443,0.6930299747201155,0.02726616106897797
6861,,560,10758,11318,98,720,15128,4233,10895,15128,990,0.0370174510840825,0.7111316763617134,0.006478053939714437,0.27981226864093073,0.7201877313590693,0.047593865679534636
6862,23.0,96,5025,5121,0,281,6659,1928,4731,6659,478,0.014416579065925814,0.7546178104820543,0.0,0.2895329629073434,0.7104670370926566,0.04219852830755369
6863,24.0,2519,62829,65348,310,2722,85522,24725,60797,85522,6765,0.02945440939173546,0.7346530717242347,0.00362479829751409,0.28910689647108345,0.7108931035289165,0.03182806763172049
6864,,587,6975,7562,13,1004,10748,2988,7760,10748,574,0.054614812058057315,0.6489579456643096,0.0012095273539263118,0.27800521027167846,0.7219947897283215,0.09341272794938593
6865,24.0,1137,20966,22112,39,1107,30461,8553,21911,30464,2238,0.037322741596638655,0.6882221638655462,0.0012801995798319328,0.2807576155462185,0.7192423844537815,0.03633797268907563
6866,16.0,127,2699,2826,1,174,3758,1060,2698,3758,286,0.03379457158062799,0.7182011708355508,0.00026609898882384245,0.282064928153273,0.717935071846727,0.04630122405534859
6867,26.0,822,16328,17150,197,651,22174,6548,15626,22174,1695,0.03707044286100839,0.7363578966356995,0.008884278885180842,0.29530080274195003,0.70469919725805,0.02935870839722197
6868,,13,1762,1775,2,119,2394,666,1728,2394,212,0.005430242272347535,0.7360066833751044,0.000835421888053467,0.2781954887218045,0.7218045112781954,0.049707602339181284
6869,,637,15400,16037,61,625,20898,6053,14845,20898,1562,0.0304813857785434,0.7369126232175328,0.0029189396114460715,0.28964494209972247,0.7103550579002775,0.029907168150062207
6870,,157,5880,6037,23,271,7872,2273,5599,7872,641,0.01994410569105691,0.7469512195121951,0.0029217479674796746,0.288744918699187,0.711255081300813,0.03442581300813008
6871,15.0,208,3301,3509,3,214,4923,1320,3603,4923,315,0.042250660166565104,0.6705261019703432,0.0006093845216331506,0.2681291895185862,0.7318708104814138,0.043469429209831406
6872,27.0,234,6120,6354,3,343,8568,2476,6092,8568,678,0.0273109243697479,0.7142857142857143,0.00035014005602240897,0.28898225957049484,0.7110177404295052,0.04003267973856209
6873,26.0,1646,48844,50490,64,1972,65227,19242,45985,65227,4371,0.025234948717555612,0.7488310055651801,0.000981188771520996,0.29500053658760944,0.7049994634123906,0.030232879022490687
6874,,87,1863,1950,8,66,2618,767,1851,2618,211,0.033231474407944994,0.7116119174942704,0.0030557677616501145,0.2929717341482047,0.7070282658517952,0.025210084033613446
6875,41.0,540,12455,12995,57,775,16993,4927,12066,16993,1084,0.03177779085505796,0.7329488612958277,0.003354322368033896,0.2899429176719826,0.7100570823280175,0.04560701465309245
6876,41.0,115,3760,3875,8,181,5178,1427,3751,5178,395,0.02220934723831595,0.7261490923136346,0.001544998068752414,0.27558903051371186,0.7244109694862881,0.03495558130552337
6877,,101,6783,6884,15,176,9274,2585,6689,9274,801,0.010890662065990942,0.7313996118179857,0.0016174250593055854,0.2787362518869959,0.7212637481130041,0.01897778736251887
6878,13.0,1479,15330,16809,160,1371,23255,6273,16982,23255,804,0.06359922597290905,0.659213072457536,0.006880240808428295,0.26974844119544183,0.7302515588045582,0.058955063427219956
6879,,124,10446,10570,137,1172,15157,3986,11171,15157,891,0.008181038464076005,0.6891865144817576,0.009038727980471069,0.2629808009500561,0.737019199049944,0.0773240087088474
6880,,133,1856,1989,0,342,3116,775,2341,3116,201,0.042682926829268296,0.5956354300385109,0.0,0.24871630295250322,0.7512836970474968,0.10975609756097561
6881,27.0,456,10654,11110,106,740,15335,4040,11295,15335,1032,0.029735898271926964,0.6947505705901532,0.006912292142158461,0.2634496250407564,0.7365503749592436,0.048255624388653405
6882,15.0,50,1516,1566,0,44,2035,614,1421,2035,189,0.02457002457002457,0.744963144963145,0.0,0.3017199017199017,0.6982800982800983,0.021621621621621623
6883,24.0,143,4509,4652,0,174,6021,1813,4208,6021,468,0.023750207606709848,0.7488789237668162,0.0,0.3011127719647899,0.6988872280352101,0.028898854010961636
6884,25.0,546,14769,15315,74,941,20797,5550,15247,20797,1738,0.026253786603837093,0.7101505024763187,0.003558205510410155,0.26686541328076163,0.7331345867192384,0.04524691061210752
6885,25.0,416,12491,12907,10,524,16638,4926,11712,16638,1208,0.02500300516889049,0.7507512922226229,0.0006010337780983291,0.29606923909123695,0.703930760908763,0.031494169972352444
6886,,832,19580,20412,38,985,26597,7709,18888,26597,2067,0.031281723502650675,0.7361732526224762,0.0014287325638229875,0.28984471932924766,0.7101552806707523,0.037034251983306385
6887,,670,17634,18304,101,1166,24940,7001,17939,24940,1782,0.0268644747393745,0.7070569366479551,0.00404971932638332,0.28071371291098635,0.7192862870890137,0.046752205292702485
6888,23.0,2428,47158,49586,253,3014,65838,18300,47538,65838,4358,0.03687839849327136,0.7162732768310095,0.0038427655761110605,0.2779549804064522,0.7220450195935478,0.04577903338497524
6889,15.0,170,3948,4118,36,350,5629,1548,4081,5629,375,0.030200746136081008,0.7013679161485166,0.006395452122934802,0.2750044412861965,0.7249955587138035,0.06217800675075502
6890,,165,1845,2010,3,83,3157,724,2433,3157,156,0.05226480836236934,0.5844155844155844,0.0009502692429521698,0.2293316439657903,0.7706683560342097,0.026290782388343363
6891,,556,19218,19774,177,731,25888,7515,18373,25888,1986,0.021477132262051914,0.7423516687268232,0.006837144622991348,0.2902889369592089,0.7097110630407911,0.028237021013597034
6892,,208,5114,5322,10,291,7141,2003,5138,7141,514,0.029127573169023944,0.7161461980114829,0.0014003640946646128,0.28049292816132193,0.719507071838678,0.040750595154740235
6893,44.0,296,6937,7233,25,220,9307,2791,6516,9307,768,0.031804018480713445,0.7453529601375309,0.0026861502095197162,0.29988180939078113,0.7001181906092189,0.023638121843773504
6894,,146,3466,3612,16,166,4827,1362,3465,4827,417,0.030246529935777915,0.7180443339548374,0.0033146882121400456,0.28216283405842135,0.7178371659415786,0.034389890200952976
6895,,113,1984,2097,12,127,2898,802,2096,2898,218,0.03899240855762595,0.6846100759144237,0.004140786749482402,0.27674258109040717,0.7232574189095928,0.04382332643202209
6896,15.0,857,22484,23341,115,1252,30986,8921,22065,30986,2458,0.0276576518427677,0.7256180210417608,0.003711353514490415,0.2879042148066869,0.7120957851933131,0.040405344349060866
6897,35.0,1593,33022,34615,148,1591,46577,13223,33354,46577,3615,0.0342014298902892,0.7089765334821908,0.0031775339759967367,0.2838954848959787,0.7161045151040213,0.03415849024196492
6898,14.0,111,2214,2325,3,263,3181,874,2307,3181,204,0.034894687205281355,0.6960075447972336,0.0009430996541967935,0.27475636592266584,0.7252436340773342,0.0826784030179189
6899,,158,2612,2770,23,133,3668,1056,2612,3668,239,0.0430752453653217,0.7121046892039259,0.0062704471101417665,0.28789531079607417,0.7121046892039259,0.03625954198473282
6900,24.0,1164,25359,26523,122,1004,34530,10180,24356,34536,2316,0.03370396108408617,0.734277275886032,0.0035325457493629833,0.29476488302061615,0.7052351169793838,0.0290711141996757
6901,25.0,87,2837,2924,82,324,4417,1124,3293,4417,269,0.019696626669685306,0.642291147837899,0.018564636631197645,0.25447136065202625,0.7455286393479738,0.07335295449400045
6902,33.0,1739,36154,37893,134,2041,50206,14440,35766,50206,3608,0.03463729434728917,0.7201131338883798,0.002669003704736486,0.2876150260924989,0.7123849739075011,0.04065251165199379
6903,17.0,377,4942,5319,10,237,6955,2049,4906,6955,461,0.05420560747663551,0.710567936736161,0.0014378145219266715,0.294608195542775,0.705391804457225,0.034076204169662117
6904,,104,2772,2876,22,162,3770,1211,2559,3770,263,0.027586206896551724,0.7352785145888594,0.005835543766578249,0.3212201591511936,0.6787798408488064,0.04297082228116711
6905,25.0,117,2303,2420,27,141,3333,916,2417,3333,231,0.0351035103510351,0.690969096909691,0.008100810081008101,0.27482748274827484,0.7251725172517252,0.0423042304230423
6906,17.0,124,2559,2683,5,160,3694,1048,2646,3694,238,0.033567948023822416,0.6927449918787223,0.0013535462912831618,0.28370330265295074,0.7162966973470493,0.04331348132106118
6907,15.0,250,5478,5728,16,262,7756,2153,5603,7756,564,0.03223310985043837,0.7062919030428055,0.0020629190304280558,0.2775915420319752,0.7224084579680248,0.03378029912325941
6908,26.0,500,12870,13370,104,634,17549,5010,12539,17549,1350,0.02849165194597983,0.7333751210895207,0.005926263604763804,0.2854863524987179,0.7145136475012821,0.036127414667502425
6909,24.0,714,20145,20859,67,1244,27599,7896,19703,27599,1969,0.02587050255444038,0.7299177506431392,0.0024276241892822203,0.2860973223667524,0.7139026776332476,0.04507409688756839
6910,23.0,308,3102,3410,12,241,4546,1295,3251,4546,282,0.06775186977562693,0.6823581170259568,0.0026396832380114386,0.28486581610206774,0.7151341838979323,0.05301363836339639
6911,,257,9058,9315,16,417,12469,3488,8981,12469,935,0.020611115566605182,0.7264415751062635,0.0012831822920843692,0.27973373967439247,0.7202662603256075,0.03344293848744887
6912,17.0,201,4281,4482,21,150,5883,1732,4151,5883,534,0.034166241713411524,0.7276899541050484,0.0035696073431922487,0.29440761516233216,0.7055923848376678,0.025497195308516064
6913,,133,6922,7055,59,736,10404,2545,7859,10404,594,0.012783544790465206,0.6653210303729334,0.005670895809304114,0.24461745482506728,0.7553825451749328,0.07074202229911572
6914,25.0,192,1797,1989,10,257,2828,768,2060,2828,171,0.06789250353606789,0.6354314002828855,0.003536067892503536,0.27157001414427157,0.7284299858557284,0.09087694483734088
6915,44.0,982,18475,19457,671,1010,27431,7293,20138,27431,2058,0.03579891363785498,0.6735080748058766,0.024461375815682987,0.26586708468521014,0.7341329153147899,0.036819656592905835
6916,,2565,49538,52103,33,1997,69154,20597,48557,69154,4372,0.037091129941868875,0.7163432339416375,0.00047719582381351765,0.2978424964571825,0.7021575035428175,0.028877577580472567
6917,24.0,396,8467,8863,3,445,11879,3372,8507,11879,831,0.03333613940567388,0.71277043522182,0.0002525465106490445,0.28386227796952607,0.716137722030474,0.03746106574627494
6918,17.0,25,1594,1619,2,182,2412,599,1813,2412,164,0.010364842454394693,0.6608623548922057,0.0008291873963515755,0.24834162520729686,0.7516583747927031,0.07545605306799337
6919,,339,8034,8373,27,596,11658,3205,8453,11658,861,0.02907874420998456,0.6891405043746783,0.0023160061760164694,0.2749185108938068,0.7250814891061932,0.051123691885400585
6920,,928,21502,22430,362,720,29474,8484,20990,29474,2077,0.031485376942389905,0.7295243265250729,0.012282011264165027,0.2878469159259008,0.7121530840740992,0.024428309696681822
6921,,1536,38591,40127,80,2662,52838,15496,37342,52838,4068,0.02906998750898974,0.7303645103902494,0.001514061849426549,0.29327378023392253,0.7067262197660774,0.05038040803966842
6922,15.0,326,7366,7692,45,222,10421,2910,7511,10421,605,0.03128298627770847,0.7068419537472411,0.004318203627291047,0.27924383456482105,0.720756165435179,0.02130313789463583
6923,48.0,1944,70492,72436,200,4221,93753,26681,67072,93753,6481,0.020735336469232986,0.7518906061672693,0.00213326506885113,0.28458822651008503,0.715411773489915,0.0450225592781031
6924,,1118,23620,24738,292,1498,33052,9363,23689,33052,2510,0.03382548711121869,0.71463148977369,0.008834563717778047,0.28328089071765705,0.716719109282343,0.04532252208640929
6925,39.0,441,18363,18804,10,816,24001,7362,16639,24001,1852,0.01837423440689971,0.7650931211199533,0.00041664930627890507,0.3067372192825299,0.69326278071747,0.03399858339235865
6926,25.0,1108,25003,26111,228,1337,35648,9952,25696,35648,2691,0.03108168761220826,0.7013857719928187,0.006395870736086176,0.2791741472172352,0.7208258527827648,0.03750561041292639
6927,,1150,19828,20978,97,997,27795,8109,19686,27795,2029,0.041374347904299336,0.7133657132577802,0.0034898363014930745,0.29174311926605506,0.708256880733945,0.03586976074833603
6928,27.0,243,7934,8177,13,347,10851,3138,7713,10851,964,0.022394249377937516,0.7311768500599023,0.0011980462630172333,0.2891899364113907,0.7108100635886093,0.031978619482075386
6929,17.0,288,5345,5633,17,260,7615,2160,5455,7615,590,0.03782009192383454,0.7019041365725541,0.002232435981615233,0.28365068942875904,0.716349310571241,0.034143138542350626
6930,23.0,43,1838,1881,3,50,2443,733,1710,2443,229,0.01760130986492018,0.7523536635284487,0.0012279983626688497,0.30004093327875564,0.6999590667212444,0.020466639377814164
6931,33.0,448,9159,9607,62,482,12853,3561,9292,12853,976,0.034855675717731266,0.7125962810238855,0.004823776550221738,0.27705594024741304,0.7229440597525869,0.037500972535594805
6932,17.0,292,2493,2785,7,187,3765,997,2768,3765,206,0.07755644090305445,0.6621513944223107,0.0018592297476759628,0.2648074369189907,0.7351925630810093,0.04966799468791501
6933,15.0,732,7057,7789,138,612,11076,2913,8163,11076,651,0.06608884073672806,0.637143373058866,0.012459371614301192,0.2630010834236186,0.7369989165763814,0.0552546045503792
6934,23.0,506,7605,8111,145,542,11224,3008,8216,11224,644,0.045081967213114756,0.6775659301496793,0.012918745545260157,0.26799714896650034,0.7320028510334996,0.04828937990021383
6935,27.0,342,6760,7102,31,349,9414,2672,6742,9414,631,0.036328871892925434,0.7180794561291693,0.003292967920118972,0.28383258975993203,0.716167410240068,0.03707244529424262
6936,,140,7664,7804,19,462,10624,2996,7628,10624,590,0.013177710843373495,0.7213855421686747,0.0017884036144578312,0.2820030120481928,0.7179969879518072,0.04348644578313253
6937,17.0,428,5701,6129,39,580,8994,2322,6672,8994,433,0.047587280409161666,0.6338670224594174,0.004336224149432955,0.2581721147431621,0.7418278852568378,0.0644874360684901
6938,16.0,39,2167,2206,46,189,3153,861,2292,3153,170,0.012369172216936251,0.6872819536948938,0.014589280050745322,0.2730732635585157,0.7269267364414843,0.05994291151284491
6939,,319,11679,11998,36,684,15739,4685,11054,15739,1118,0.02026812376898151,0.7420420611220535,0.0022873117733019886,0.29766821271999494,0.7023317872800051,0.04345892369273779
6940,15.0,416,9146,9562,71,500,13086,3676,9410,13086,1057,0.03178969891487086,0.6989148708543481,0.005425645728259208,0.2809108971419838,0.7190891028580162,0.03820877273421978
6941,25.0,1040,20703,21743,228,893,28799,8222,20577,28799,2307,0.03611236501267405,0.7188791277474912,0.00791694156047085,0.2854960241675058,0.7145039758324941,0.031008021111844163
6942,,503,14283,14786,94,733,19737,5575,14162,19737,1456,0.025485129452297715,0.7236662106703147,0.004762628565638142,0.28246440695141106,0.7175355930485889,0.03713836955971019
6943,14.0,226,9552,9778,91,697,13443,3615,9828,13443,1137,0.016811723573607083,0.7105556795358179,0.006769322323886037,0.268913189020308,0.7310868109796921,0.051848545711522726
6944,,4952,97411,102363,788,3951,133152,38786,94366,133152,9053,0.037190579187695263,0.7315774453256428,0.00591804854602259,0.2912911559721221,0.7087088440278779,0.02967285508291276
6945,26.0,128,3100,3228,2,281,4383,1177,3206,4383,330,0.02920374172940908,0.7072781200091262,0.0004563084645220169,0.26853753137120695,0.731462468628793,0.06411133926534338
6946,16.0,250,13953,14203,71,1263,19218,5117,14101,19218,1145,0.013008637735456343,0.7260380892912894,0.0036944531168696016,0.26626079716932044,0.7337392028306796,0.06571963783952545
6947,,208,5358,5566,39,272,7446,2119,5327,7446,591,0.027934461455815202,0.7195809830781628,0.005237711522965351,0.2845823260811174,0.7154176739188827,0.0365296803652968
6948,15.0,189,7511,7700,70,821,10947,2846,8101,10947,739,0.017265004110715264,0.6861240522517584,0.006394445966931579,0.2599799031698182,0.7400200968301818,0.07499771626929752
6949,,2386,36458,38844,652,2734,54303,14788,39515,54303,3303,0.043938640590759255,0.6713809550116936,0.012006703128740585,0.27232381268069905,0.727676187319301,0.050347126309780305
6950,,150,4007,4157,20,222,5442,1620,3822,5442,372,0.027563395810363836,0.7363101800808526,0.003675119441381845,0.29768467475192945,0.7023153252480706,0.040793825799338476
6951,16.0,292,5694,5986,35,324,8058,2286,5772,8058,607,0.03623727972201539,0.7066269545793,0.004343509555721023,0.28369322412509307,0.7163067758749069,0.040208488458674606
6952,,4100,85641,89741,259,5139,123461,34110,89351,123461,8329,0.033208867577615604,0.6936684459059946,0.002097828464049376,0.276281578798163,0.723718421201837,0.041624480605211366
6953,,2647,89317,91964,966,6426,129070,34827,94243,129070,9181,0.02050825133648408,0.6920043387309212,0.007484310839079569,0.2698303246300457,0.7301696753699543,0.049786937320833655
6954,17.0,60,32350,32410,611,1595,43952,12106,31846,43952,2804,0.001365125591554423,0.7360302147797597,0.01390152894066254,0.2754368401892974,0.7245631598107026,0.03628958864215508
6955,16.0,367,12041,12408,15,678,16326,4689,11637,16326,1149,0.022479480583118952,0.7375352198946465,0.0009187798603454612,0.28721058434399116,0.7127894156560088,0.04152884968761485
6956,17.0,2379,21334,23713,92,2286,32614,9130,23484,32614,1904,0.07294413442080089,0.6541362605016251,0.0028208744710860366,0.2799411295762556,0.7200588704237444,0.0700925982706813
6957,45.0,309,11023,11332,40,445,14554,4302,10252,14554,1152,0.021231276624982823,0.7573862855572351,0.002748385323622372,0.29558884155558607,0.7044111584444139,0.030575786725298888
6958,43.0,859,25570,26429,127,856,34273,10050,24223,34273,2731,0.02506346103346658,0.7460683336737374,0.0037055408047150817,0.2932337408455636,0.7067662591544365,0.024975928573512676
6959,15.0,1224,36794,38018,275,2023,50999,14395,36604,50999,4504,0.024000470597462697,0.7214651267671915,0.005392262593384184,0.28226043647914667,0.7177395635208533,0.039667444459695285
6960,15.0,149,7032,7181,63,337,9727,2724,7003,9727,876,0.015318186491210034,0.7229361570885166,0.006476817107021692,0.2800452349131284,0.7199547650868716,0.03464583119152873
6961,,43,8598,8641,21,384,11798,3175,8623,11798,967,0.0036446855399220207,0.7287675877267333,0.0017799627055433125,0.26911340905238174,0.7308865909476182,0.032547889472791997
6962,40.0,123,4025,4148,5,140,5361,1586,3775,5361,396,0.02294348069390039,0.7507927625443014,0.0009326618168252192,0.2958403282969595,0.7041596717030405,0.026114530871106136
6963,27.0,1057,30394,31451,304,1458,44077,11651,32426,44077,2876,0.02398076094108038,0.6895659867958346,0.0068970211221271865,0.2643328720194206,0.7356671279805794,0.03307847630283368
6964,23.0,112,2469,2581,5,125,3444,1000,2444,3444,237,0.032520325203252036,0.7168989547038328,0.0014518002322880372,0.29036004645760743,0.7096399535423926,0.03629500580720093
6965,17.0,149,3290,3439,3,229,4538,1326,3212,4538,279,0.03283384750991626,0.7249889819303658,0.0006610841780520053,0.29219920669898636,0.7078007933010136,0.050462758924636406
6966,27.0,6660,130850,137510,696,9435,184019,52367,131652,184019,13474,0.036191914965302496,0.7110678788603351,0.003782218140518099,0.2845738755237231,0.715426124476277,0.051271879534178534
6967,23.0,2501,46974,49475,548,2931,67757,18841,48916,67757,4480,0.03691131543604351,0.6932715438995233,0.008087725253479346,0.27806721076789115,0.7219327892321089,0.04325752320793424
6968,15.0,73,1917,1990,5,79,2564,726,1838,2564,181,0.02847113884555382,0.7476599063962559,0.0019500780031201249,0.2831513260530421,0.7168486739469578,0.03081123244929797
6969,16.0,3,7769,7772,14,455,10489,2895,7594,10489,1004,0.0002860139193440747,0.7406807131280388,0.001334731623605682,0.2760034321670321,0.7239965678329678,0.04337877776718467
6970,26.0,4215,98382,102597,443,4663,136346,38648,97698,136346,9718,0.030913998210435216,0.7215613219309698,0.0032490868819033927,0.2834553268889443,0.7165446731110557,0.03419975650184091
6971,33.0,7829,137811,145640,1365,8933,193600,55466,138134,193600,11798,0.04043904958677686,0.7118336776859504,0.007050619834710743,0.2864979338842975,0.7135020661157024,0.04614152892561983
6972,,77,3012,3089,3,59,3974,1159,2815,3974,333,0.019375943633618522,0.7579265223955712,0.000754906894816306,0.29164569703069954,0.7083543029693005,0.014846502264720684
6973,17.0,1426,32312,33738,67,2219,45484,12823,32661,45484,3307,0.03135168410869756,0.7104036584293378,0.0014730454665376836,0.2819233136927271,0.7180766863072728,0.048786386421598806
6974,,79,2967,3046,18,116,3920,1152,2768,3920,274,0.020153061224489795,0.7568877551020409,0.004591836734693878,0.2938775510204082,0.7061224489795919,0.02959183673469388
6975,,206,2540,2746,0,55,3685,1068,2617,3685,210,0.0559023066485753,0.689280868385346,0.0,0.2898236092265943,0.7101763907734057,0.014925373134328358
6976,17.0,3177,49359,52536,437,2916,71844,19804,52040,71844,4093,0.044220811758810756,0.687030232169701,0.006082623461945326,0.2756528032960303,0.7243471967039697,0.04058794053783197
6977,27.0,272,5258,5530,55,274,7384,2079,5305,7384,509,0.03683640303358613,0.712080173347779,0.007448537378114843,0.2815547128927411,0.718445287107259,0.037107258938244854
6978,,19,5999,6018,36,347,8080,2213,5867,8080,574,0.0023514851485148514,0.742450495049505,0.004455445544554455,0.2738861386138614,0.7261138613861386,0.04294554455445545
6979,,2978,79836,82814,332,3660,111211,32059,79152,111211,9324,0.02677792664394709,0.7178786271142243,0.002985316200735539,0.2882718436125923,0.7117281563874077,0.032910413538229134
6980,,602,8453,9055,34,1273,13163,3380,9783,13163,656,0.0457342551090177,0.6421788346121705,0.0025829977968548205,0.2567803692167439,0.7432196307832561,0.09671047633518196
6981,27.0,158,3562,3720,25,145,4888,1407,3481,4888,446,0.032324058919803604,0.7287234042553191,0.005114566284779051,0.287847790507365,0.712152209492635,0.029664484451718494
6982,27.0,322,8425,8747,31,526,11770,3227,8543,11770,894,0.02735768903993203,0.715802888700085,0.0026338147833474936,0.2741716227697536,0.7258283772302464,0.044689889549702634
6983,23.0,1970,45317,47287,205,2353,62732,17787,44945,62732,4200,0.0314034304661098,0.7223904865140598,0.003267869667793152,0.28353950137091116,0.7164604986290888,0.037508767455206274
6984,26.0,678,38000,38678,37,1955,51491,14882,36609,51491,4699,0.013167349633916607,0.7379930473286593,0.0007185721776621157,0.28902138237750286,0.7109786176224971,0.03796780019809287
6985,,139,4013,4152,13,107,5526,1530,3996,5526,490,0.025153818313427435,0.7262034020991676,0.002352515381831343,0.2768729641693811,0.7231270358306189,0.019363011219688746
6986,24.0,80,3579,6443,101,135,8170,1475,6708,8183,406,0.009776365636074789,0.43737015764389586,0.01234266161554442,0.18025174141512892,0.8197482585848711,0.016497617010876205
6987,15.0,580,10167,10747,39,658,14190,4079,10111,14190,904,0.0408738548273432,0.7164904862579281,0.0027484143763213532,0.28745595489781534,0.7125440451021846,0.0463706835799859
6988,26.0,352,5604,5956,8,493,8684,2181,6503,8684,558,0.04053431598341778,0.6453247351450945,0.0009212344541685859,0.25115154306771076,0.7488484569322893,0.056771073238139104
6989,25.0,0,1996,1996,16,98,2669,769,1900,2669,224,0.0,0.7478456350693143,0.005994754589733983,0.28812289246908956,0.7118771075309105,0.036717871862120645
6990,25.0,433,15808,16241,111,656,20760,6275,14485,20760,1676,0.020857418111753373,0.7614643545279384,0.005346820809248555,0.3022639691714836,0.6977360308285164,0.03159922928709056
6991,,91,1947,2038,28,104,3175,783,2392,3175,213,0.028661417322834646,0.6132283464566929,0.008818897637795276,0.24661417322834644,0.7533858267716536,0.032755905511811026
6992,,2352,15181,17533,138,835,22938,6213,16725,22938,477,0.10253727439183886,0.6618275350946028,0.006016217630133403,0.27086058069578867,0.7291394193042113,0.036402476240299936
6993,23.0,358,7894,8252,13,548,11126,3141,7985,11126,720,0.03217688297681107,0.709509257594823,0.0011684342980406255,0.2823117023188927,0.7176882976811073,0.04925399964048176
6994,,196,2955,3151,23,180,4278,1218,3060,4278,283,0.04581580177653109,0.6907433380084151,0.005376344086021506,0.2847124824684432,0.7152875175315568,0.04207573632538569
6995,23.0,13851,257956,271807,1935,24727,375095,103592,271503,375095,26533,0.036926645249870035,0.6877084471933776,0.005158693131073462,0.27617536890654365,0.7238246310934563,0.06592196643516976
6996,26.0,209,6330,6539,9,390,8697,2528,6169,8697,604,0.024031275152351386,0.7278371852362884,0.0010348395998620215,0.29067494538346555,0.7093250546165344,0.04484304932735426
6997,36.0,249,7000,7249,0,188,9203,2801,6402,9203,758,0.027056394653917203,0.7606215364555037,0.0,0.3043572748016951,0.695642725198305,0.020428121264804956
6998,17.0,1312,33545,34857,392,3601,47836,13267,34569,47836,2879,0.02742704239484907,0.7012501045237897,0.008194665105778076,0.2773434233631575,0.7226565766368426,0.0752780332803746
6999,17.0,62,2051,2113,15,96,2806,816,1990,2806,259,0.022095509622238062,0.7309337134711333,0.005345687811831789,0.2908054169636493,0.7091945830363506,0.03421240199572345
7000,43.0,5364,108408,113772,438,4106,149205,43447,105758,149205,11277,0.03595053785060822,0.7265708253744848,0.0029355584598371367,0.29118997352635634,0.7088100264736437,0.02751918501390704
7001,14.0,369,11706,12075,26,426,15654,4674,10980,15654,1199,0.023572249904177847,0.7477960904561135,0.0016609173374217453,0.29858183211958605,0.701418167880414,0.027213491759294748
7002,24.0,888,19083,19971,59,1090,26903,7564,19339,26903,1820,0.033007471285730214,0.7093260974612496,0.002193063970560904,0.28115823514106236,0.7188417648589377,0.0405159275917184
7003,15.0,36,8278,8314,4,538,11166,3076,8090,11166,957,0.0032240730789897904,0.7413576929965968,0.0003582303421099767,0.2754791330825721,0.7245208669174279,0.04818198101379187
7004,,204,8698,8902,0,758,12198,3426,8772,12198,1018,0.016724053123462864,0.7130677160190195,0.0,0.2808657156910969,0.7191342843089031,0.06214133464502378
7005,25.0,1166,23960,25126,80,1386,33051,9480,23571,33051,2230,0.035278811533690356,0.7249402438655411,0.002420501648966748,0.28682944540255967,0.7131705545974403,0.04193519106834891
7006,13.0,133,9906,10039,18,626,14048,3759,10289,14048,1263,0.00946753986332574,0.7051537585421412,0.0012813211845102506,0.2675825740318907,0.7324174259681093,0.04456150341685649
7007,24.0,750,14241,14991,12,907,20606,5706,14900,20606,1245,0.03639716587401728,0.69110938561584,0.0005823546539842764,0.27690963796952345,0.7230903620304766,0.04401630593031156
7008,38.0,452,10448,10900,144,402,14044,4206,9850,14056,830,0.0321570859419465,0.7433124644280023,0.010244735344336939,0.29923164484917475,0.7007683551508253,0.028599886169607285
7009,,74,1387,1461,4,65,1991,557,1434,1991,160,0.0371672526368659,0.6966348568558514,0.0020090406830738324,0.27975891511803114,0.7202410848819688,0.03264691109994977
7010,,1065,28398,29463,79,1389,38289,11268,27021,38289,3002,0.027814777090025857,0.7416751547441824,0.00206325576536342,0.2942881767609496,0.7057118232390504,0.03627673744417457
7011,,156,2953,3109,14,174,4205,1172,3033,4205,261,0.0370986920332937,0.7022592152199763,0.0033293697978596906,0.2787158145065398,0.7212841854934602,0.041379310344827586
7012,26.0,4472,81643,86115,531,3964,117008,32554,84454,117008,7439,0.0382196089156297,0.6977557090113496,0.0045381512375222205,0.27822029262956377,0.7217797073704362,0.03387802543415835
7013,15.0,866,12040,12906,32,1000,17672,5066,12606,17672,1215,0.049004074241738346,0.6813037573562698,0.0018107741059302852,0.2866681756450883,0.7133318243549117,0.05658669081032141
7014,17.0,4291,83668,87959,466,5930,126294,33475,92819,126294,8109,0.033976277574548276,0.662485945492264,0.003689803157711372,0.2650561388506184,0.7349438611493816,0.0469539328867563
7015,13.0,637,8892,9529,36,1770,14053,3565,10488,14053,634,0.045328399629972246,0.6327474560592045,0.0025617305913328116,0.25368248772504093,0.7463175122749591,0.12595175407386322
7016,17.0,1618,11870,13488,25,1454,18544,5253,13291,18544,1254,0.08725194132873167,0.6400992234685073,0.0013481449525452978,0.283272217428818,0.7167277825711821,0.07840811044003451
7017,,2827,83908,86735,277,3553,115498,32997,82501,115498,9025,0.02447661431366777,0.726488770368318,0.002398309927444631,0.2856932587577274,0.7143067412422726,0.03076243744480424
7018,,2761,73484,76245,298,4086,99138,29614,69524,99138,6660,0.027850067582561682,0.7412293974056365,0.0030059109524097722,0.2987149226330973,0.7012850773669027,0.04121527567632997
7019,14.0,87,1831,1918,2,70,2730,763,1967,2730,203,0.031868131868131866,0.6706959706959706,0.0007326007326007326,0.2794871794871795,0.7205128205128205,0.02564102564102564
7020,16.0,40,2106,2146,5,83,2937,843,2094,2937,223,0.013619339462036091,0.7170582226762002,0.0017024174327545114,0.2870275791624106,0.7129724208375894,0.02826012938372489
7021,,4171,66852,71023,1154,3875,96613,26804,69809,96613,6043,0.043172243900924306,0.6919565689917506,0.011944562325980975,0.2774367838696656,0.7225632161303345,0.04010847401488413
7022,,142,1984,2126,8,70,2783,810,1973,2783,173,0.05102407473948976,0.712899748472871,0.002874595759971254,0.2910528206970895,0.7089471793029105,0.025152712899748474
7023,25.0,45,2146,2191,0,112,2934,833,2101,2934,254,0.015337423312883436,0.7314246762099523,0.0,0.28391274710293113,0.7160872528970689,0.038173142467621
7024,14.0,126,4618,4744,16,974,7119,1842,5277,7119,401,0.017699115044247787,0.6486866132883832,0.0022475066722854333,0.2587442056468605,0.7412557943531395,0.13681696867537577
7025,16.0,536,12424,12960,45,763,17424,4939,12485,17424,1395,0.03076216712580349,0.7130394857667585,0.0025826446280991736,0.28345959595959597,0.7165404040404041,0.043790174471992654
7026,13.0,119,2420,2539,17,172,3487,950,2537,3487,259,0.03412675652423287,0.694006309148265,0.004875250932033267,0.27244049326068254,0.7275595067393175,0.04932606825351305
7027,25.0,1445,36125,37570,419,1160,48508,14412,34096,48508,2636,0.029788900799868064,0.7447225199967016,0.008637750474148593,0.297105632060691,0.7028943679393089,0.02391358126494599
7028,17.0,109,2384,2493,3,113,3352,981,2371,3352,249,0.03251789976133652,0.711217183770883,0.0008949880668257757,0.29266109785202865,0.7073389021479713,0.03371121718377088
7029,16.0,111,1598,1709,14,163,2464,617,1847,2464,162,0.045048701298701296,0.648538961038961,0.005681818181818182,0.25040584415584416,0.7495941558441559,0.06615259740259741
7030,,532,12072,12604,50,532,16747,4836,11911,16747,1284,0.03176688362094703,0.720845524571565,0.0029856093628709618,0.2887681375768794,0.7112318624231205,0.03176688362094703
7031,24.0,17384,327667,345051,3021,19798,461747,131161,330587,461748,30478,0.037648241031904846,0.7096229978256539,0.00654252969152005,0.2840532065109107,0.7159467934890893,0.04287620087147102
7032,17.0,369,2560,2929,12,254,4168,1113,3055,4168,323,0.088531669865643,0.6142034548944337,0.0028790786948176585,0.2670345489443378,0.7329654510556622,0.0609404990403071
7033,26.0,1092,7133,8507,159,286,12646,2453,10257,12710,346,0.08591660110149489,0.5612116443745082,0.012509834775767113,0.1929976396538159,0.8070023603461841,0.022501966955153423
7034,26.0,793,2889,3937,1114,713,7937,1287,6650,7937,115,0.09991180546806099,0.36399143253118305,0.14035529797152577,0.1621519465793121,0.8378480534206879,0.08983243038931586
7035,16.0,80,1555,1635,18,96,2248,598,1650,2248,165,0.03558718861209965,0.6917259786476868,0.00800711743772242,0.26601423487544484,0.7339857651245552,0.042704626334519574
7036,,2140,55966,58106,281,3903,77139,21204,55935,77139,5379,0.027742127847133098,0.7255214612582481,0.0036427747313291592,0.27488041068720104,0.725119589312799,0.050596974293159104
7037,,798,23422,24220,62,780,31320,9160,22160,31320,2413,0.025478927203065133,0.7478288633461048,0.001979565772669221,0.29246487867177523,0.7075351213282248,0.02490421455938697
7038,,3632,72290,75922,637,4449,102423,28301,74122,102423,7145,0.03546078517520479,0.7057985022895248,0.006219306210519122,0.27631489021020667,0.7236851097897933,0.04343750915321754
7039,27.0,15462,364936,380398,648,22044,492491,142030,350461,492491,31691,0.03139549758269694,0.741000343153479,0.0013157600849558672,0.28839105689241024,0.7116089431075898,0.04476020881599867
7040,,558,11487,12045,59,785,16056,4639,11417,16056,1078,0.034753363228699555,0.7154334828101644,0.003674638764324863,0.28892625809666167,0.7110737419033383,0.04889138016940708
7041,16.0,183,2428,2611,27,246,3569,964,2605,3569,223,0.05127486690949846,0.6803026057719249,0.007565144298122724,0.27010367049593725,0.7298963295040628,0.06892687027178482
7042,,105,3484,3589,32,643,5084,1319,3765,5084,282,0.02065302911093627,0.6852871754523997,0.006294256490952006,0.259441384736428,0.740558615263572,0.12647521636506687
7043,,1444,73390,74834,713,8543,106831,28008,78823,106831,6830,0.013516675871235877,0.6869728824030478,0.006674092725894169,0.26217109266037014,0.7378289073396299,0.07996742518557348
7044,23.0,635,15194,15829,68,566,20806,5998,14808,20806,1603,0.030520042295491684,0.7302701143900798,0.0032682879938479284,0.2882822262808805,0.7117177737191195,0.0272036912429107
7045,,259,3524,3783,12,441,5219,1470,3749,5219,294,0.04962636520406208,0.6752251389155011,0.0022992910519256562,0.2816631538608929,0.7183368461391071,0.08449894615826786
7046,,541,21671,22212,61,648,29250,8388,20862,29250,2398,0.018495726495726495,0.7408888888888889,0.0020854700854700853,0.2867692307692308,0.7132307692307692,0.022153846153846152
7047,17.0,289,6203,6492,30,425,8824,2322,6502,8824,533,0.03275158658204896,0.7029691749773346,0.003399818676337262,0.26314596554850406,0.7368540344514959,0.04816409791477788
7048,34.0,603,14709,15312,44,1049,20713,5859,14854,20713,1427,0.029112151788731715,0.7101337324385651,0.002124269782262347,0.28286583305170665,0.7171341669482934,0.05064452276348187
7049,16.0,222,3643,3865,16,205,5194,1468,3726,5194,445,0.04274162495186754,0.7013862148633038,0.0030804774740084712,0.28263380824027723,0.7173661917597227,0.03946861763573354
7050,23.0,1415,29880,31295,169,1889,42695,11985,30710,42695,3153,0.0331420541046961,0.6998477573486357,0.003958308935472538,0.28071202716945776,0.7192879728305422,0.0442440566811102
7051,16.0,202,8184,8386,13,422,11131,3078,8053,11131,908,0.018147515946455844,0.7352439133950229,0.0011679094420986435,0.27652502021381725,0.7234749797861827,0.03791213727427904
7052,17.0,1330,26942,28272,116,2068,39818,10600,29218,39818,2791,0.03340197900447034,0.676628660404842,0.00291325531166809,0.2662112612386358,0.7337887387613642,0.05193631021146215
7053,17.0,137,5102,5239,31,172,6788,2044,4744,6788,506,0.020182675309369475,0.7516205067766647,0.004566882734236889,0.30111962286387745,0.6988803771361226,0.025338833235120803
7054,17.0,206,3583,3789,0,236,5954,1480,4474,5954,332,0.03459858918374202,0.6017803157541148,0.0,0.2485723883103796,0.7514276116896205,0.03963721867651999
7055,26.0,834,10883,13407,219,1046,19737,4335,15402,19737,682,0.042255661954704364,0.5514009221259564,0.011095911232710138,0.21963824289405684,0.7803617571059431,0.05299690935805847
7056,16.0,96,1918,2014,9,106,2707,780,1927,2707,202,0.03546361285555966,0.708533431843369,0.0033247137052087182,0.28814185445142226,0.7118581455485777,0.039157739194680456
7057,17.0,893,26974,27867,186,1619,37282,10277,27005,37282,2181,0.02395257765141355,0.7235126870876026,0.004989002735904726,0.2756558124564133,0.7243441875435868,0.043425781878654576
7058,,279,2024,2303,15,144,3284,921,2363,3284,186,0.08495736906211937,0.6163215590742996,0.004567600487210719,0.2804506699147381,0.7195493300852619,0.0438489646772229
7059,14.0,707,12505,13212,81,747,17758,4985,12773,17758,1415,0.03981304200923527,0.7041896609978601,0.0045613244734767425,0.2807185493861921,0.7192814506138079,0.042065547922063296
7060,17.0,87,3133,3220,93,208,4477,1228,3249,4477,354,0.01943265579629216,0.6997989725262452,0.020772838954657136,0.2742908197453652,0.7257091802546348,0.046459682823319186
7061,14.0,57,3258,3315,24,226,4668,1240,3428,4668,328,0.012210796915167094,0.6979434447300771,0.005141388174807198,0.2656383890317052,0.7343616109682948,0.048414738646101116
7062,,359,13682,14041,43,530,18272,5532,12740,18272,773,0.01964754816112084,0.7487959719789843,0.002353327495621716,0.3027583187390543,0.6972416812609457,0.029006129597197897
7063,,659,49427,50086,765,4510,71168,18370,52798,71168,4148,0.009259779676258992,0.69451157823741,0.010749213129496404,0.25812162769784175,0.7418783723021583,0.06337117805755396
7064,46.0,252,9506,9758,37,411,12805,3681,9124,12805,1105,0.01967981257321359,0.7423662631784459,0.002889496290511519,0.2874658336587271,0.712534166341273,0.03209683717297931
7065,23.0,291,3113,3404,105,177,5598,1268,4330,5598,200,0.051982851018220796,0.5560914612361557,0.018756698821007504,0.22650946766702393,0.773490532332976,0.03161843515541265
7066,16.0,222,7513,7735,9,389,10307,3043,7264,10307,875,0.02153876006597458,0.7289220917822838,0.0008731929756476181,0.2952362472106336,0.7047637527893664,0.03774134083632483
7067,25.0,503,11391,11894,31,614,15918,4645,11327,15972,850,0.03149261207112447,0.7131855747558227,0.0019408965689957426,0.29082143751565237,0.7091785624843476,0.038442273979464064
7068,17.0,704,11787,12491,63,913,17859,4894,12965,17859,1076,0.039419900330365645,0.6600033596505963,0.00352763312615488,0.27403550030796797,0.725964499692032,0.05112268324094294
7069,17.0,301,8172,8473,25,328,11645,3237,8408,11645,1135,0.025848003434950622,0.7017604121940747,0.0021468441391155,0.27797337913267495,0.722026620867325,0.028166595105195362
7070,42.0,141,2656,2797,16,54,3587,1066,2521,3587,250,0.03930861444103708,0.7404516308893225,0.004460551993309172,0.2971842765542236,0.7028157234457764,0.015054362977418455
7071,,348,23445,23793,48,718,29660,9504,20156,29660,2198,0.011732973701955496,0.790458530006743,0.0016183412002697235,0.32043155765340525,0.6795684423465947,0.02420768712070128
7072,25.0,227,10257,10484,27,364,13976,3930,10046,13976,1260,0.01624212936462507,0.7339009730967373,0.0019318832283915283,0.2811963365769891,0.7188036634230108,0.026044647967945048
7073,,118,2840,2958,30,373,4828,1126,3702,4828,306,0.02444076222038111,0.5882352941176471,0.006213753106876553,0.2332228666114333,0.7667771333885667,0.07725766362883181
7074,25.0,158,3322,3480,23,167,4624,1339,3285,4624,378,0.034169550173010384,0.7184256055363322,0.004974048442906574,0.28957612456747406,0.7104238754325259,0.0361159169550173
7075,23.0,319,6376,6695,218,394,10452,2354,8098,10452,350,0.030520474550325298,0.6100267891312667,0.020857252200535782,0.22522005357826252,0.7747799464217374,0.037696134711060085
7076,15.0,508,2822,3330,29,319,4625,1224,3401,4625,154,0.10983783783783783,0.6101621621621621,0.00627027027027027,0.2646486486486486,0.7353513513513513,0.06897297297297297
7077,23.0,504,17151,17655,31,540,23143,6753,16390,23143,2132,0.021777643347880567,0.7410880179751976,0.0013394979043339238,0.29179449509570926,0.7082055049042907,0.02333318930130061
7078,23.0,158,9577,9735,40,391,13291,3662,9629,13291,1243,0.011887743585885185,0.7205627868482432,0.003009555338198781,0.2755247912120984,0.7244752087879016,0.029418403430893084
7079,15.0,247,7589,7836,12,323,10088,3010,7078,10088,731,0.024484536082474227,0.7522799365582871,0.0011895321173671688,0.29837430610626486,0.7016256938937351,0.032018239492466294
7080,26.0,43,1562,1605,3,114,2146,618,1528,2146,168,0.020037278657968314,0.727865796831314,0.0013979496738117428,0.287977632805219,0.712022367194781,0.05312208760484623
7081,,1236,71543,72779,331,9321,100976,26888,74088,100976,6134,0.012240532403739502,0.7085148946284265,0.003278006655046744,0.26628109649817777,0.7337189035018222,0.09230906353985105
7082,16.0,3073,44301,47374,165,2326,62758,17814,44944,62758,4746,0.048965868893208836,0.7059020363937666,0.002629146881672456,0.28385225787947355,0.7161477421205265,0.03706300391981899
7083,25.0,511,17733,18244,54,563,24114,6959,17155,24114,1989,0.021191009372148958,0.7353819358049266,0.002239363025628266,0.2885875425064278,0.7114124574935722,0.02334743302645766
7084,24.0,113,2159,2272,14,122,3077,864,2213,3077,216,0.03672408189795255,0.7016574585635359,0.004549886252843679,0.2807929801754956,0.7192070198245044,0.03964900877478063
7085,24.0,856,49003,49859,395,1971,65178,19402,45776,65178,4918,0.013133265825892172,0.7518334407315351,0.006060327104237626,0.29767713032004667,0.7023228696799534,0.03024026512013256
7086,13.0,69,1764,1833,14,113,2568,705,1863,2568,221,0.026869158878504672,0.6869158878504673,0.005451713395638629,0.27453271028037385,0.7254672897196262,0.044003115264797506
7087,27.0,1449,78350,79799,405,7074,111075,30160,80915,111075,8454,0.013045239702903444,0.7053792482556831,0.0036461850101282916,0.27152824668017106,0.7284717533198289,0.06368669817690749
7088,,289,6180,6469,181,267,8273,2414,5859,8273,431,0.034932914299528585,0.7470083403843829,0.021878399613199564,0.29179257826665056,0.7082074217333495,0.03227366130786897
7089,,177,5471,5648,28,139,7085,2153,4932,7085,414,0.024982357092448837,0.7721947776993648,0.003952011291460833,0.3038814396612562,0.6961185603387439,0.01961891319689485
7090,,538,16024,16562,52,993,22272,6322,15950,22272,1918,0.0241558908045977,0.7194683908045977,0.002334770114942529,0.2838541666666667,0.7161458333333334,0.04458512931034483
7091,17.0,75,7314,7389,73,304,9905,2746,7159,9905,721,0.00757193336698637,0.7384149419485109,0.007370015143866734,0.277233720343261,0.722766279656739,0.030691569914184754
7092,17.0,202,6934,7136,1,525,9304,2490,6814,9304,647,0.021711092003439382,0.7452708512467756,0.00010748065348237318,0.2676268271711092,0.7323731728288908,0.056427343078245915
7093,15.0,240,6946,7186,47,705,9913,2696,7217,9913,715,0.024210632502774134,0.7006960556844548,0.004741248865126601,0.2719661051144961,0.7280338948855039,0.07111873297689902
7094,13.0,489,5082,5571,34,574,7815,2062,5753,7815,431,0.06257197696737044,0.6502879078694818,0.004350607805502239,0.2638515674984005,0.7361484325015994,0.07344849648112604
7095,15.0,2299,36626,38925,137,3048,54069,14762,39307,54069,3295,0.042519743290980044,0.6773937006417725,0.0025337994044646655,0.2730215095526087,0.7269784904473913,0.056372413027797816
7096,,142,3377,3519,12,142,4514,1315,3199,4514,334,0.03145768719539211,0.7481169694284449,0.002658396101019052,0.2913159060700044,0.7086840939299955,0.03145768719539211
7097,16.0,156,12160,12316,65,831,16731,4637,12094,16731,1331,0.009324009324009324,0.7267945729484191,0.003885003885003885,0.2771502002271233,0.7228497997728767,0.04966828043751121
7098,25.0,2399,75905,78304,212,3872,102283,30131,72152,102283,7408,0.02345453301135086,0.7421076816284231,0.0020726806996275043,0.2945846328324355,0.7054153671675645,0.03785575315546083
7099,37.0,5054,60818,65872,632,3187,92535,24408,68127,92535,4832,0.05461717188090993,0.6572432052736802,0.0068298481655589775,0.2637704652293727,0.7362295347706274,0.034441022315880476
7100,17.0,886,28187,29073,49,1175,38727,11317,27410,38727,3415,0.022878095385648257,0.7278384589562837,0.0012652671262943166,0.29222506261781184,0.7077749373821881,0.03034058925297596
7101,23.0,5037,142189,147226,367,4648,189409,55794,133615,189409,15426,0.026593245305133337,0.7506982244771896,0.0019376059215771163,0.2945688958813995,0.7054311041186004,0.02453948861986495
7102,,888,16226,17114,377,975,23709,6457,17252,23709,1688,0.03745413134252815,0.6843814585178624,0.015901134590239993,0.27234383567421655,0.7276561643257835,0.04112362394027584
7103,17.0,55,2125,2180,4,204,3012,837,2175,3012,226,0.018260292164674636,0.7055112881806109,0.0013280212483399733,0.2778884462151394,0.7221115537848606,0.06772908366533864
7104,,205,7231,7436,9,275,9750,2781,6969,9750,828,0.021025641025641025,0.7416410256410256,0.0009230769230769231,0.28523076923076923,0.7147692307692308,0.028205128205128206
7105,23.0,2113,64851,66964,124,2893,86152,25245,60907,86152,6247,0.024526418423251928,0.7527509518061102,0.0014393165567833596,0.2930286006128703,0.7069713993871297,0.03358018386108274
7106,,206,2462,2668,6,141,3848,998,2850,3848,219,0.05353430353430354,0.6398128898128899,0.0015592515592515593,0.25935550935550933,0.7406444906444907,0.036642411642411644
7107,46.0,742,34534,35276,0,1325,45143,15119,30024,45143,2306,0.016436656846022638,0.7649912500276898,0.0,0.3349134971091864,0.6650865028908136,0.029351172939326143
7108,,15,4035,4050,3,229,5433,1522,3911,5433,486,0.0027609055770292656,0.7426836002208724,0.0005521811154058532,0.2801398858825695,0.7198601141174306,0.042149825142646785
7109,,79,1896,1975,18,85,2623,772,1851,2623,210,0.030118185284025923,0.7228364468166222,0.006862371330537552,0.2943194815097217,0.7056805184902784,0.03240564239420511
7110,,95,6345,6440,76,643,8844,2337,6507,8844,560,0.010741745816372682,0.7174355495251018,0.008593396653098146,0.26424694708276797,0.735753052917232,0.07270465852555405
7111,,359,7508,7867,97,314,10592,2979,7613,10592,746,0.03389350453172205,0.7088368580060423,0.00915785498489426,0.28125,0.71875,0.02964501510574018
7112,,1244,23602,24846,202,697,31993,9497,22496,31993,2265,0.038883505766886504,0.7377238770981153,0.006313881161504079,0.29684618510299127,0.7031538148970087,0.02178601569093239
7113,,79,2030,2109,13,123,3296,818,2478,3296,230,0.023968446601941747,0.6158980582524272,0.003944174757281553,0.24817961165048544,0.7518203883495146,0.03731796116504854
7114,,574,49697,50271,77,2174,66969,19184,47785,66969,5885,0.008571129925786559,0.7420896235571682,0.0011497857217518553,0.2864608998193194,0.7135391001806806,0.03246278128686407
7115,24.0,811,20880,21691,146,1243,28801,8001,20800,28801,2262,0.02815874448803861,0.7249748272629423,0.005069268428179577,0.2778028540675671,0.7221971459324329,0.04315822367278914
7116,42.0,240,5814,6054,78,328,8278,2310,5972,8282,589,0.028978507606858248,0.702004346776141,0.00941801497222893,0.27891813571601065,0.7210818642839893,0.039603960396039604
7117,36.0,573,14868,15441,18,929,20772,5696,15076,20772,1723,0.027585210860774118,0.7157712305025996,0.0008665511265164644,0.2742152898132101,0.7257847101867899,0.04472366647409975
7118,16.0,1010,16509,17519,75,972,24419,6673,17746,24419,1607,0.04136123510381261,0.6760719112166755,0.00307137884434252,0.27327081371063516,0.7267291862893649,0.03980506982267906
7119,,1139,32856,33995,57,1984,45451,12889,32562,45451,3490,0.025059954676464765,0.722888385294053,0.0012540978196299312,0.28358011924930143,0.7164198807506985,0.04365140480957515
7120,25.0,4270,106146,110416,450,5900,144847,41433,103414,144847,10051,0.02947938169240647,0.7328146250871609,0.0031067264078648506,0.2860466561268097,0.7139533438731903,0.04073263512533915
7121,25.0,351,8704,9055,183,638,12323,3516,8807,12323,555,0.028483323865941736,0.7063215126186805,0.01485027996429441,0.2853201330844762,0.7146798669155238,0.05177310719792259
7122,,170,3482,3652,8,165,4968,1378,3590,4968,356,0.03421900161030596,0.7008856682769726,0.001610305958132045,0.2773752012882448,0.7226247987117552,0.03321256038647343
7123,24.0,419,12864,13283,28,487,17295,4982,12313,17295,1245,0.024226655102630817,0.7437987857762359,0.0016189650187915584,0.28806013298641225,0.7119398670135877,0.028158427291124603
7124,26.0,532,11607,12139,59,618,16157,4606,11551,16157,1256,0.03292690474716841,0.7183883146623754,0.003651668007674692,0.2850776753110107,0.7149223246889893,0.03824967506343999
7125,,314,4522,4836,23,445,6739,1818,4921,6739,439,0.04659445021516546,0.6710194390859178,0.0034129692832764505,0.2697729633476777,0.7302270366523222,0.06603353613295741
7126,23.0,208,4886,5094,24,282,6815,1922,4893,6815,570,0.030520909757887012,0.7169479090242113,0.0035216434336023477,0.28202494497432135,0.7179750550256786,0.041379310344827586
7127,24.0,2744,65811,68555,386,2704,90857,26080,64777,90857,7059,0.030201305347964384,0.7243360445535292,0.0042484343528842025,0.2870444764850259,0.712955523514974,0.029761053083416797
7128,23.0,649,29554,30203,85,1427,39719,11775,27944,39719,3346,0.016339787003701,0.744077141922002,0.002140033737002442,0.2964576147435736,0.7035423852564264,0.03592738991414688
7129,17.0,5482,121872,127354,220,5436,165182,48668,116514,165182,11296,0.03318763545664782,0.7378043612500151,0.0013318642467096899,0.29463258708575996,0.7053674129142401,0.03290915475051761
7130,25.0,460,7075,7535,8,597,10193,2882,7311,10193,722,0.045129010104974,0.6941037967232414,0.0007848523496517218,0.2827430589620328,0.7172569410379672,0.05856960659275974
7131,16.0,961,27644,28605,42,1463,39397,10814,28583,39397,2828,0.024392720257887655,0.7016777927253344,0.001066071020636089,0.27448790517044447,0.7255120948295556,0.03713480721882377
7132,,1757,35125,36882,369,1850,48349,14187,34163,48350,2696,0.036339193381592555,0.7264736297828335,0.007631851085832472,0.2934229576008273,0.7065770423991727,0.038262668045501554
7133,27.0,809,25109,25918,71,1082,33519,9943,23576,33519,2325,0.024135564903487575,0.7490975267758585,0.002118201616993347,0.29663772785584297,0.703362272144157,0.03228019928995495
7134,24.0,122,1827,1949,16,98,3024,710,2314,3024,128,0.04034391534391534,0.6041666666666666,0.005291005291005291,0.2347883597883598,0.7652116402116402,0.032407407407407406
7135,25.0,308,5822,6130,28,500,8245,2299,5946,8245,601,0.037355973317161915,0.7061249241964828,0.003395997574287447,0.27883565797453,0.72116434202547,0.06064281382656155
7136,17.0,2294,52942,55236,88,4173,73776,20129,53647,73776,5293,0.03109412274994578,0.7176046410756886,0.0011927998265018433,0.2728394057688137,0.7271605942311863,0.056563109954456736
7137,13.0,147,8553,8700,27,1253,12505,3344,9161,12505,696,0.011755297880847662,0.6839664134346262,0.0021591363454618153,0.2674130347860856,0.7325869652139144,0.1001999200319872
7138,,801,22842,23643,182,882,31051,9053,21998,31051,2480,0.02579627065150881,0.7356284821744872,0.005861324917071914,0.2915526070013848,0.7084473929986151,0.02840488229042543
7139,24.0,268,7338,7606,38,427,10325,2850,7475,10325,636,0.025956416464891042,0.7107021791767555,0.0036803874092009685,0.27602905569007263,0.7239709443099274,0.04135593220338983
7140,24.0,1433,20629,22062,259,2450,30364,7605,22759,30364,1545,0.04719404558029245,0.6793900671848241,0.008529837966012383,0.25046107232248715,0.7495389276775128,0.08068765643525228
7141,26.0,617,20510,21127,63,1038,28026,8043,19983,28026,2233,0.022015271533575964,0.7318204524370228,0.00224791265253693,0.2869835153072147,0.7130164846927852,0.037037037037037035
7142,25.0,427,16198,16625,25,742,21753,6215,15538,21753,1884,0.01962947639406059,0.744632924194364,0.0011492667678021423,0.28570771847561255,0.7142922815243874,0.03411023766836758
7143,,822,23659,24481,80,824,30876,9478,21398,30876,1913,0.02662261951029926,0.7662585827179687,0.002591009198082653,0.30696981474284235,0.6930301852571576,0.02668739474025133
7144,25.0,20305,297006,317311,3187,16736,434077,121270,312807,434077,32228,0.04677741506691209,0.6842242274988078,0.0073420153567224245,0.27937439670841807,0.7206256032915819,0.03855537151242752
7145,,106,1848,1954,3,101,2920,726,2194,2920,154,0.036301369863013695,0.6328767123287671,0.0010273972602739725,0.24863013698630138,0.7513698630136987,0.03458904109589041
7146,14.0,449,8164,8613,26,425,11529,3292,8237,11529,835,0.03894526845346517,0.7081273310781507,0.0022551825830514354,0.28554081013097404,0.7144591898690259,0.03686356145372539
7147,16.0,30,3527,3557,8,314,4774,1325,3449,4774,341,0.006284038542103058,0.7387934645999162,0.0016757436112274822,0.27754503560955174,0.7224549643904482,0.06577293674067868
7148,,352,10061,10413,87,548,14013,3903,10110,14013,965,0.02511953186326982,0.7179761649896524,0.0062085206593877115,0.2785270819952901,0.7214729180047099,0.03910654392349961
7149,,151,3134,3285,15,170,4432,1273,3159,4432,372,0.034070397111913356,0.7071299638989169,0.003384476534296029,0.2872292418772563,0.7127707581227437,0.03835740072202166
7150,16.0,254,4135,4389,60,711,6344,1686,4658,6344,407,0.04003783102143758,0.651796973518285,0.009457755359394703,0.2657629255989912,0.7342370744010088,0.11207440100882723
7151,26.0,12662,256704,269446,1384,10194,349392,102117,247276,349393,22724,0.036239993359912764,0.7347142043486847,0.0039611554896635025,0.29226973637136405,0.707730263628636,0.029176314350888542
7152,14.0,787,9441,10228,59,876,14665,3841,10824,14665,798,0.05366518922604841,0.6437777020115922,0.004023184452778725,0.26191612683259463,0.7380838731674054,0.059734060688714626
7153,27.0,9642,135830,145472,1415,4779,183230,55122,128117,183239,10254,0.05261980255294997,0.7412723273975518,0.00772215521804856,0.30082024023270154,0.6991797597672984,0.026080692429013473
7154,26.0,130,2775,2905,51,168,3827,1075,2752,3827,209,0.0339691664489156,0.7251110530441599,0.013326365299189966,0.2808988764044944,0.7191011235955056,0.04389861510321401
7155,17.0,430,7719,8149,67,789,11684,2964,8720,11684,546,0.036802464909277646,0.6606470386853818,0.005734337555631633,0.25368024649092774,0.7463197535090722,0.06752824375213967
7156,26.0,520,12345,12865,26,676,17497,4885,12612,17497,1359,0.02971938046522261,0.7055495227753329,0.0014859690232611304,0.2791907184088701,0.7208092815911299,0.03863519460478939
7157,,8657,354398,363055,462,15804,473217,138975,334242,473217,38303,0.018293932804611838,0.7489122326543637,0.0009762962869043166,0.2936813343561199,0.7063186656438801,0.03339694051566195
7158,26.0,146,2975,3121,74,162,4173,1221,2952,4173,237,0.034986820033549006,0.7129163671219746,0.01773304577042895,0.29259525521207763,0.7074047447879224,0.038820992092020126
7159,,9232,171944,181176,1055,10819,244418,69368,175050,244418,18113,0.03777135890155389,0.7034833768380397,0.004316376044317521,0.2838088847793534,0.7161911152206466,0.04426433405068367
7160,14.0,1878,30762,32640,78,1694,43617,12454,31163,43617,3178,0.04305660636907628,0.7052754659880321,0.001788293555265149,0.28553087099066876,0.7144691290093312,0.038838067725886695
7161,23.0,646,143122,143772,589,19989,204488,54240,150248,204488,17159,0.003159109581002308,0.6999041508548179,0.002880364617972693,0.2652478385039709,0.7347521614960291,0.09775145729822778
7162,23.0,856,2205,3061,20,104,4014,1162,2852,4014,252,0.21325361235675136,0.5493273542600897,0.004982561036372696,0.2894867962132536,0.7105132037867464,0.025909317389138018
7163,17.0,438,9388,9826,50,504,12785,3733,9052,12785,804,0.03425889714509191,0.7342980054751662,0.003910833007430583,0.2919827923347673,0.7080172076652327,0.039421196714900276
7164,15.0,763,16814,17577,128,1037,23501,6594,16907,23501,1633,0.03246670354453002,0.715458916641845,0.005446576741415259,0.28058380494447044,0.7194161950555296,0.044125781881622056
7165,26.0,448,13899,14347,36,509,18914,5423,13491,18914,1497,0.023686158401184307,0.7348524902188854,0.001903352014380882,0.28671883261076453,0.7132811673892355,0.026911282647774135
7166,17.0,114,4710,4824,220,206,6709,1857,4852,6709,533,0.01699210016395886,0.7020420330898792,0.032791772246236396,0.2767923684602772,0.7232076315397228,0.030705023103294083
7167,17.0,55,2090,2145,1,157,2982,786,2196,2982,220,0.018443997317236754,0.7008718980549966,0.00033534540576794097,0.2635814889336016,0.7364185110663984,0.052649228705566736
7168,27.0,144,3845,3989,19,254,5444,1428,4016,5444,375,0.02645113886847906,0.7062821454812638,0.0034900808229243203,0.2623071271124173,0.7376928728875827,0.04665686994856723
7169,,77,6068,6145,39,1109,8833,2253,6580,8833,410,0.008717310087173101,0.6869693195969659,0.004415260953243519,0.25506622891429864,0.7449337710857014,0.12555190761915544
7170,24.0,164,13653,13817,24,817,18586,5378,13208,18586,1628,0.008823845905520284,0.7345851716345636,0.001291294522759066,0.28935758097492736,0.7106424190250726,0.043957817712256535
7171,,225,4614,4839,19,360,6484,1886,4598,6484,429,0.03470080197409007,0.7115977791486736,0.002930289944478717,0.2908698334361505,0.7091301665638495,0.055521283158544106
7172,23.0,219,6239,6458,7,375,8819,2451,6368,8819,634,0.024832747477038213,0.7074498242431114,0.0007937407869372944,0.2779226669690441,0.7220773330309559,0.04252182787164078
7173,,120,2749,2869,32,145,4211,1104,3107,4211,262,0.02849679411066255,0.6528140584184279,0.00759914509617668,0.2621705058180955,0.7378294941819046,0.03443362621705058
7174,,2424,47925,50349,267,2560,66857,19008,47849,66857,4661,0.03625648772753788,0.7168284547616555,0.0039935982769193955,0.2843082998040594,0.7156917001959406,0.03829068010829083
7175,15.0,849,22426,23275,86,1583,31766,8790,22976,31766,2264,0.026726688912673928,0.7059749417616319,0.002707297110117736,0.2767109488131965,0.7232890511868035,0.049833154945539256
7176,35.0,144,2743,2887,32,137,3809,1107,2702,3809,268,0.03780519821475453,0.7201365187713311,0.00840115515883434,0.2906274612759254,0.7093725387240746,0.035967445523759516
7177,,751,12127,12878,157,778,17771,4803,12968,17771,1109,0.04225986157222441,0.682403916493163,0.008834618198188059,0.27027179112036465,0.7297282088796354,0.04377919081649879
7178,,6821,144271,151092,659,7823,201943,57857,144086,201943,14765,0.03377685782621829,0.7144144634872216,0.0032632970689749088,0.2865016366004269,0.7134983633995732,0.03873865397661717
7179,14.0,372,3831,4203,19,370,5931,1641,4290,5931,439,0.06272129489124936,0.6459281740010117,0.0032035069971337042,0.2766818411734952,0.7233181588265049,0.06238408362839319
7180,,808,14288,15096,78,826,20136,5647,14489,20136,1325,0.04012713547874454,0.709574890742948,0.0038736591179976162,0.2804429876837505,0.7195570123162495,0.041021056813667064
7181,13.0,487,6110,6597,148,569,9425,2428,6997,9425,485,0.051671087533156496,0.6482758620689655,0.01570291777188329,0.25761273209549074,0.7423872679045093,0.06037135278514589
7182,25.0,11243,748047,759290,2704,39799,1019845,286958,732887,1019845,90574,0.011024224269374267,0.7334908736131471,0.0026513832984424103,0.28137413038255815,0.7186258696174419,0.039024557653368895
7183,16.0,257,4135,4392,30,427,6180,1609,4571,6180,378,0.04158576051779935,0.669093851132686,0.0048543689320388345,0.26035598705501617,0.7396440129449838,0.06909385113268608
7184,17.0,236,6052,6288,34,311,8288,2412,5876,8288,595,0.028474903474903474,0.7302123552123552,0.004102316602316602,0.291023166023166,0.708976833976834,0.037524131274131275
7185,,55,2250,2305,4,64,2958,922,2036,2958,275,0.01859364435429344,0.7606490872210954,0.001352265043948614,0.3116970926301555,0.6883029073698445,0.021636240703177823
7186,,240,7912,8152,10,288,10334,3099,7235,10334,708,0.023224308109154247,0.7656280239984518,0.0009676795045480937,0.29988387845945425,0.7001161215405458,0.027869169730985098
7187,23.0,191,1603,1794,4,104,2500,697,1803,2500,200,0.0764,0.6412,0.0016,0.2788,0.7212,0.0416
7188,,1828,50228,52056,158,2067,67622,19700,47922,67622,4782,0.027032622519298454,0.7427760196385792,0.0023365177013398007,0.2913253083316081,0.7086746916683919,0.030566975244742837
7189,25.0,1660,31084,32744,124,1691,42497,11951,30546,42497,2772,0.039061580817469466,0.7314398663435066,0.002917853024919406,0.28121985081299855,0.7187801491870014,0.03979104407369932
7190,16.0,110,2376,2486,35,148,3409,931,2478,3409,232,0.03226752713405691,0.6969785860956292,0.01026694045174538,0.2731006160164271,0.7268993839835729,0.04341449105309475
7191,48.0,149,3368,3517,12,176,4724,1287,3437,4724,299,0.03154106689246401,0.7129551227773073,0.002540220152413209,0.2724386113463167,0.7275613886536834,0.03725656223539373
7192,17.0,456,13800,14256,39,983,19317,5278,14039,19317,1456,0.023606150023295542,0.7143966454418388,0.0020189470414660664,0.2732308329450743,0.7267691670549257,0.050887819019516486
7193,15.0,1029,12394,13423,84,1023,17987,5087,12900,17987,1255,0.05720798354367043,0.6890532050925668,0.004670039472952688,0.28281536665369433,0.7171846333463057,0.05687440929560238
7194,,994,32142,33136,78,3650,45553,11446,34107,45553,2691,0.021820736285206244,0.7055956797576449,0.0017122911773099466,0.2512677540447391,0.7487322459552609,0.08012644611770904
7195,,2370,14884,17254,614,2423,24507,6117,18390,24507,846,0.09670706328804016,0.6073366793161138,0.025054066185171583,0.24960215448647324,0.7503978455135267,0.0988697106949035
7196,44.0,1951,32854,34805,195,2676,47181,12927,34254,47181,3053,0.04135139144994807,0.6963396282401815,0.004133019647739556,0.2739874101863038,0.7260125898136962,0.056717746550518214
7197,,5779,145081,150860,320,8010,200419,56397,144022,200419,14404,0.02883459153074309,0.7238884536895205,0.0015966550077587455,0.28139547647678115,0.7186045235232189,0.039966270662961094
7198,17.0,430,21698,22128,117,1826,29993,8300,21693,29993,2171,0.014336678558330276,0.7234354682759311,0.0039009102123828895,0.2767312372887007,0.7232687627112993,0.06088087220351415
7199,26.0,344,9532,9876,30,443,13324,3806,9518,13324,1032,0.0258180726508556,0.7154007805463825,0.002251576103272291,0.28564995496847795,0.7143500450315221,0.03324827379165416
7200,24.0,902,23347,24249,229,1415,32454,9138,23316,32454,2216,0.027793184199174217,0.7193874406852776,0.00705614099956862,0.2815677574413015,0.7184322425586984,0.04360017255191964
7201,,61,1474,1535,21,80,2108,586,1522,2108,163,0.028937381404174574,0.6992409867172675,0.009962049335863378,0.27798861480075904,0.722011385199241,0.03795066413662239
7202,24.0,524,10699,11223,39,460,14689,4395,10294,14689,1237,0.035672952549526855,0.7283681666553203,0.002655047995098373,0.2992034856014705,0.7007965143985295,0.031315950711416705
7203,35.0,315,7266,7581,40,497,10022,2679,7343,10022,735,0.03143085212532429,0.7250049890241469,0.003991219317501496,0.26731191378966274,0.7326880862103372,0.0495909000199561
7204,27.0,278,3858,4136,36,167,5650,1609,4043,5652,306,0.0491861288039632,0.6825902335456475,0.006369426751592357,0.28467799009200284,0.7153220099079972,0.02954706298655343
7205,17.0,535,10143,10678,55,680,14624,4016,10608,14624,934,0.036583698030634576,0.6935858862144421,0.003760940919037199,0.27461706783369805,0.725382932166302,0.04649890590809628
7206,35.0,1116,23132,24248,165,932,30771,9252,21519,30771,2031,0.03626791459491079,0.7517467745604628,0.005362191673978747,0.3006727113190992,0.6993272886809009,0.030288258425140553
7207,,274,6732,7006,4,368,9197,2689,6508,9197,714,0.029792323583777317,0.7319778188539742,0.0004349244318799609,0.2923779493313037,0.7076220506686963,0.0400130477329564
7208,,313,6299,6612,13,399,8933,2464,6469,8933,612,0.03503862084406135,0.705138251427292,0.0014552781820217173,0.2758311877308855,0.7241688122691146,0.0446658457405127
7209,25.0,91,5067,5158,3,340,6910,1985,4925,6910,536,0.01316931982633864,0.7332850940665702,0.0004341534008683068,0.28726483357452964,0.7127351664254703,0.049204052098408106
7210,33.0,11600,304360,315960,1231,17723,416871,119633,297238,416871,30840,0.027826353956019966,0.7301059560391584,0.002952951872401774,0.2869784657603911,0.7130215342396089,0.042514350962288096
7211,14.0,143,14241,14384,29,742,19271,5593,13678,19271,1860,0.007420476363447667,0.7389860412018058,0.0015048518499299465,0.29022884126407555,0.7097711587359244,0.03850345078096622
7212,43.0,630,18673,19303,32,1137,24989,7165,17824,24989,1836,0.02521109288086758,0.7472487894673656,0.0012805634479170836,0.2867261595101845,0.7132738404898156,0.045500020008803876
7213,24.0,201,5203,5404,6,303,7181,2042,5139,7181,552,0.02799053056677343,0.7245508982035929,0.0008355382258738338,0.2843615095390614,0.7156384904609386,0.042194680406628604
7214,13.0,158,3061,3219,29,335,4493,1151,3342,4493,287,0.035165813487647454,0.6812819942132206,0.006454484754061874,0.2561762742043178,0.7438237257956821,0.0745604273314044
7215,27.0,109,3104,3213,21,105,4279,1220,3059,4279,352,0.025473241411544754,0.7254031315727973,0.004907688712315962,0.28511334423930823,0.7148866557606918,0.024538443561579807
7216,27.0,561,8827,9388,29,607,12375,3567,8808,12375,860,0.04533333333333334,0.7132929292929293,0.0023434343434343436,0.28824242424242424,0.7117575757575758,0.04905050505050505
7217,,972,19847,20819,183,1290,30247,7729,22521,30250,1620,0.032132231404958675,0.656099173553719,0.006049586776859504,0.25550413223140495,0.744495867768595,0.042644628099173555
7218,13.0,762,13432,14194,46,1241,19481,5364,14117,19481,1333,0.03911503516246599,0.6894923258559622,0.0023612750885478157,0.27534520815153224,0.7246547918484677,0.06370309532364868
7219,14.0,801,16290,17091,139,1082,22927,6531,16396,22927,1589,0.034936973873598814,0.7105159855192568,0.006062720809525886,0.28486064465477384,0.7151393553452261,0.04719326558206481
7220,17.0,4625,107223,111848,854,9220,153437,41211,112226,153437,11396,0.03014266441601439,0.6988079798223376,0.005565802251086765,0.2685858039455933,0.7314141960544067,0.0600898088466276
7221,17.0,7,3033,3040,1,145,4085,1122,2963,4085,350,0.0017135862913096695,0.7424724602203182,0.0002447980416156671,0.27466340269277845,0.7253365973072216,0.03549571603427173
7222,26.0,521,11145,11666,91,351,15248,4437,10811,15248,1099,0.034168415529905564,0.7309155299055614,0.005967995802728227,0.29098898216159497,0.709011017838405,0.02301941238195173
7223,16.0,429,8030,8459,70,650,11767,3235,8532,11767,814,0.036457890711311294,0.6824169286989037,0.00594883997620464,0.27492139032888585,0.7250786096711141,0.05523922835047166
7224,27.0,254,7404,7658,35,248,10020,2917,7103,10020,812,0.02534930139720559,0.7389221556886227,0.003493013972055888,0.29111776447105786,0.7088822355289421,0.02475049900199601
7225,,2674,45173,47847,410,2618,65506,18012,47494,65506,3936,0.040820688181235305,0.689600952584496,0.006258968644093671,0.27496717857906144,0.7250328214209385,0.039965804659115194
7226,16.0,802,9851,10653,53,756,14296,4024,10272,14296,775,0.05609960828203693,0.6890738668158926,0.003707330721880246,0.28147733631785116,0.7185226636821489,0.05288192501398993
7227,23.0,144,3541,3685,4,145,4811,1394,3417,4811,350,0.029931407191852007,0.7360216171274163,0.0008314279775514446,0.28975265017667845,0.7102473498233216,0.030139264186239866
7228,24.0,261,3470,3731,29,175,5217,1451,3766,5217,415,0.050028752156411734,0.6651332183247077,0.0055587502396013035,0.27812919302281003,0.72187080697719,0.033544182480352694
7229,16.0,286,6203,6489,9,359,8480,2448,6032,8480,546,0.03372641509433962,0.7314858490566037,0.0010613207547169811,0.28867924528301886,0.7113207547169811,0.042334905660377356
7230,23.0,1773,41632,43405,336,1906,56117,16241,39876,56117,3737,0.031594703922162626,0.7418785751198389,0.0059874904217973165,0.28941319029883994,0.7105868097011601,0.03396475221412406
7231,15.0,3905,68743,72648,162,8344,102193,28128,74065,102193,7886,0.03821201060738015,0.6726781677805721,0.0015852357793586646,0.2752439012456822,0.7247560987543178,0.08164942804301664
7232,16.0,1948,33327,35275,288,1872,46673,13512,33161,46673,3147,0.041737192809547276,0.7140530927945493,0.006170591134060378,0.28950356737299937,0.7104964326270006,0.04010884237139246
7233,27.0,1894,70417,72311,175,3200,92540,27663,64877,92540,6505,0.020466825156689,0.7609358115409552,0.0018910741301059002,0.2989301923492544,0.7010698076507457,0.034579641236222175
7234,27.0,665,10600,11265,50,880,15582,4376,11206,15582,907,0.0426774483378257,0.6802721088435374,0.0032088307020921576,0.28083686304710564,0.7191631369528944,0.05647542035682197
7235,,193,8229,8422,24,334,10757,3221,7536,10757,888,0.01794180533606024,0.7649902389141954,0.0022311053267639676,0.29943292739611416,0.7005670726038858,0.03104954913079855
7236,16.0,2306,46168,48474,47,3235,67452,18910,48542,67452,4935,0.034187273913301314,0.6844570954159995,0.0006967917926822036,0.28034750637490363,0.7196524936250963,0.04796003083674317
7237,16.0,341,7491,7832,31,442,10581,3022,7559,10581,803,0.03222757773367357,0.707967110859087,0.0029297797939703244,0.2856062753993006,0.7143937246006994,0.041772989320480104
7238,38.0,270,9003,9273,8,413,12014,3574,8440,12014,734,0.02247378058931247,0.7493757283169635,0.000665889795238888,0.2974862660229732,0.7025137339770268,0.03437656067920759
7239,,481,15760,16241,29,690,20779,6074,14705,20779,1634,0.023148370951441358,0.7584580586168728,0.0013956398286731797,0.2923143558400308,0.7076856441599692,0.033206602820154967
7240,15.0,159,3343,3502,39,132,4779,1337,3442,4779,347,0.03327055869428751,0.6995187277673154,0.008160703075957313,0.27976564134756227,0.7202343586524378,0.027620841180163214
7241,,274,5955,6229,67,331,8484,2357,6127,8484,616,0.032296086751532296,0.7019094766619519,0.007897218293257896,0.2778170674210278,0.7221829325789721,0.03901461574728902
7242,25.0,119,3557,3676,1,194,4878,1383,3495,4878,376,0.024395243952439524,0.7291922919229192,0.0002050020500205002,0.2835178351783518,0.7164821648216482,0.03977039770397704
7243,24.0,7689,115872,123561,1315,7083,167906,46917,120989,167906,10989,0.04579347968506188,0.6901004133265041,0.007831763010255737,0.27942420163663,0.7205757983633699,0.04218431741569688
7244,,1324,33180,34504,142,1502,46991,13133,33858,46991,3669,0.02817560809516716,0.7060926560405184,0.0030218552488774446,0.2794790491796301,0.7205209508203698,0.03196356749164734
7245,17.0,615,11642,12257,71,756,16564,4694,11870,16564,1183,0.03712871287128713,0.7028495532480077,0.004286404250181116,0.2833856556387346,0.7166143443612654,0.04564114948080174
7246,24.0,178,3568,3746,58,251,5196,1414,3782,5196,300,0.034257120862201694,0.6866820631254812,0.011162432640492687,0.2721324095458045,0.7278675904541956,0.04830638953040801
7247,26.0,196,2955,3151,23,180,4278,1218,3060,4278,283,0.04581580177653109,0.6907433380084151,0.005376344086021506,0.2847124824684432,0.7152875175315568,0.04207573632538569
7248,,273,21583,21856,113,1050,29386,8194,21192,29386,2209,0.009290138161029061,0.7344653916831144,0.003845368542843531,0.2788402640713265,0.7211597359286736,0.03573130061934254
7249,33.0,61,2236,2297,6,229,3114,887,2227,3114,200,0.019588953114964676,0.7180475272960822,0.0019267822736030828,0.2848426461143224,0.7151573538856776,0.073538856775851
7250,14.0,176,3368,3544,28,180,4712,1314,3398,4712,312,0.03735144312393888,0.7147707979626485,0.005942275042444821,0.27886247877758913,0.7211375212224108,0.038200339558573854
7251,24.0,704,24015,24719,16,777,32145,9487,22658,32145,2497,0.021900762171410796,0.7470835277648157,0.0004977445948047908,0.2951314356820656,0.7048685643179343,0.024171721885207654
7252,40.0,11339,203178,214517,403,11273,289034,82214,206820,289034,23416,0.039230678743677215,0.7029553616529544,0.0013942996325691788,0.2844440446452666,0.7155559553547334,0.03900233190558896
7253,16.0,272,6379,6651,43,244,8631,2532,6099,8631,519,0.03151430888657166,0.7390800602479435,0.004982041478391843,0.2933611400764685,0.7066388599235315,0.02827018885413046
7254,14.0,30,1485,1515,5,89,2096,572,1524,2096,185,0.01431297709923664,0.7084923664122137,0.002385496183206107,0.2729007633587786,0.7270992366412213,0.042461832061068704
7255,17.0,3225,66978,70203,405,4648,95959,26732,69227,95959,6432,0.03360810346085307,0.6979855980158193,0.004220552527642014,0.2785773090590773,0.7214226909409227,0.048437353453037235
7256,25.0,410,11599,12009,59,575,16118,4554,11564,16118,1362,0.025437399181039832,0.7196302270753195,0.0036605037845886586,0.2825412582206229,0.7174587417793771,0.03567440129048269
7257,,440,12870,13310,80,2916,19754,4401,15353,19754,1094,0.022273969828895415,0.6515136174951909,0.004049812696162803,0.22279032094765616,0.7772096790523438,0.14761567277513415
7258,13.0,88,2117,2205,9,150,2982,844,2138,2982,156,0.029510395707578806,0.709926224010731,0.0030181086519114686,0.28303152246814217,0.7169684775318578,0.05030181086519115
7259,,7,1799,1806,39,349,2995,687,2308,2995,125,0.002337228714524207,0.6006677796327212,0.01302170283806344,0.22938230383973288,0.7706176961602671,0.11652754590984975
7260,,201,27587,27788,190,1849,37729,10527,27202,37729,3054,0.005327466935248748,0.7311882106602349,0.005035914018394339,0.27901614142966946,0.7209838585703305,0.049007394842163855
7261,16.0,185,3043,3228,24,176,4409,1250,3159,4409,276,0.0419596280335677,0.6901791789521433,0.005443411204354729,0.2835110002268088,0.7164889997731912,0.03991834883193468
7262,,792,24434,25226,157,1126,32821,9658,23163,32821,2619,0.02413089180707474,0.7444623868864446,0.00478352274458426,0.29426281953627254,0.7057371804637275,0.03430730325096737
7263,14.0,1786,41560,43346,314,2403,57614,16461,41153,57614,5126,0.030999409865657652,0.7213524490575207,0.005450064220501961,0.28571180615822545,0.7142881938417746,0.04170861249001979
7264,42.0,630,14117,14747,142,703,19577,5626,13951,19577,1364,0.03218062011544159,0.7211012923328396,0.007253409613321755,0.28737804566583236,0.7126219543341676,0.03590948562088165
7265,43.0,2246,60882,63128,376,2842,83009,24181,58828,83009,5869,0.02705730703899577,0.7334385428086111,0.004529629317302943,0.29130576202580444,0.7086942379741956,0.03423725138238022
7266,,3599,73694,77293,780,6790,108517,28309,80208,108517,6739,0.033165310504344944,0.6791009703548753,0.007187813890911101,0.26087156851000304,0.739128431489997,0.06257084143498254
7267,25.0,170,4517,4687,7,215,6244,1798,4446,6244,551,0.027226137091607944,0.7234144778987829,0.0011210762331838565,0.2879564381806534,0.7120435618193466,0.034433055733504164
7268,,118,3329,3447,14,367,4845,1361,3484,4845,369,0.02435500515995872,0.6871001031991744,0.002889576883384933,0.28090815273477815,0.7190918472652219,0.07574819401444788
7269,15.0,190,3938,4128,9,267,5658,1574,4084,5658,376,0.0335807705903146,0.696005655708731,0.0015906680805938495,0.27819017320607986,0.7218098267939201,0.047189819724284196
7270,25.0,119,3274,3393,26,195,4555,1287,3268,4555,346,0.026125137211855103,0.7187705817782657,0.00570801317233809,0.2825466520307355,0.7174533479692645,0.042810098792535674
7271,16.0,161,2404,2565,7,114,3299,1028,2271,3299,175,0.04880266747499242,0.7287056683843589,0.002121855107608366,0.31160957866020006,0.6883904213397999,0.034555926038193394
7272,13.0,239,3584,3823,41,629,5865,1452,4413,5865,237,0.04075021312872975,0.6110826939471441,0.006990622335890878,0.24757033248081842,0.7524296675191816,0.1072463768115942
7273,25.0,2248,65645,67893,322,3077,89410,25469,63941,89410,6382,0.02514260149871379,0.7342019908287664,0.003601386869477687,0.28485628005815905,0.715143719941841,0.034414495022928086
7274,14.0,51,4218,4269,43,145,5785,1662,4123,5785,520,0.00881590319792567,0.7291270527225583,0.007433016421780467,0.2872947277441659,0.712705272255834,0.025064822817631807
7275,,45,2173,2218,0,97,2843,850,1993,2843,216,0.015828350334154064,0.7643334505803728,0.0,0.2989799507562434,0.7010200492437566,0.03411888849806542
7276,,9149,228846,237995,1043,12960,320290,90989,229302,320291,23694,0.02856464902229535,0.7144940070123731,0.0032564136987926606,0.28408228766965044,0.7159177123303496,0.04046320377406796
7277,,331,9769,10100,85,408,14110,3836,10274,14110,1107,0.023458540042523034,0.6923458540042523,0.006024096385542169,0.27186392629340894,0.7281360737065911,0.02891566265060241
7278,17.0,99,2558,2657,7,101,3524,1003,2521,3524,289,0.028093076049943246,0.7258796821793416,0.0019863791146424517,0.28461975028376846,0.7153802497162316,0.02866061293984109
7279,16.0,550,14537,15087,75,654,19749,5795,13954,19749,1623,0.027849511367664184,0.7360879031849714,0.0037976606410451163,0.29343257886475266,0.7065674211352474,0.033115600789913414
7280,23.0,214,4307,4521,91,309,6267,1752,4515,6267,404,0.03414711983405138,0.6872506781554173,0.014520504228498484,0.2795595978937291,0.7204404021062709,0.04930588798468167
7281,,218,5628,5846,0,234,7580,2322,5258,7580,636,0.028759894459102903,0.7424802110817942,0.0,0.3063324538258575,0.6936675461741425,0.03087071240105541
7282,46.0,328,12262,12590,12,447,16064,4738,11326,16064,1113,0.02041832669322709,0.7633217131474104,0.000747011952191235,0.29494521912350596,0.705054780876494,0.027826195219123506
7283,,4465,43354,47819,762,5431,67338,17536,49802,67338,4418,0.06630728563366896,0.6438266654786302,0.01131604740265526,0.26041759482016097,0.739582405179839,0.08065282604175948
7284,23.0,4734,117102,121836,453,11507,165279,46403,118876,165279,10942,0.02864247726571434,0.708511063111466,0.0027408200678852124,0.2807555708831733,0.7192444291168267,0.06962167002462503
7285,23.0,769,24129,24898,19,1094,32538,9473,23065,32538,2410,0.023633904972647366,0.7415637101235478,0.0005839326326141742,0.2911365173028459,0.708863482697154,0.033622226319995084
7286,14.0,406,8037,8443,35,484,11314,3235,8079,11314,829,0.03588474456425667,0.7103588474456426,0.00309351246243592,0.28592893759943433,0.7140710624005657,0.04277885805197101
7287,,153,4260,4413,29,269,5959,1711,4248,5959,411,0.025675448900822285,0.7148850478268166,0.004866588353750629,0.2871287128712871,0.7128712871287128,0.045141802315824806
7288,16.0,11,1889,1900,1,181,2556,702,1854,2556,153,0.004303599374021909,0.7390453834115805,0.0003912363067292645,0.2746478873239437,0.7253521126760564,0.07081377151799687
7289,35.0,2693,29481,32174,107,1998,43640,12114,31526,43640,2840,0.06170944087992667,0.6755499541704858,0.002451879010082493,0.2775893675527039,0.7224106324472961,0.04578368469294226
7290,,756,18756,19512,25,758,26266,7495,18771,26266,2005,0.028782456407523034,0.7140790375390238,0.0009518008071270844,0.2853498819766999,0.7146501180233,0.0288586004720932
7291,17.0,2361,62340,64701,56,7191,92549,24591,67958,92549,5953,0.025510810489578494,0.673589125760408,0.0006050848739586598,0.2657078952770965,0.7342921047229035,0.0776993808685129
7292,,652,13811,14463,192,762,19815,5449,14366,19815,1470,0.03290436537976281,0.6969972243250063,0.009689629068887207,0.2749936916477416,0.7250063083522584,0.0384557153671461
7293,25.0,200,2706,2906,3,157,3919,1130,2789,3919,318,0.05103342689461597,0.6904822658841541,0.0007655014034192396,0.28833886195458025,0.7116611380454197,0.04006124011227354
7294,17.0,2473,33818,36291,270,2794,49288,13587,35701,49288,2743,0.05017448466158091,0.6861304982957313,0.00547800681707515,0.2756654763837039,0.724334523616296,0.05668722609965915
7295,15.0,2486,40711,43197,299,3007,58503,16552,41951,58503,4041,0.04249354733945268,0.695878843819975,0.005110849016289763,0.28292566193186675,0.7170743380681333,0.05139907355178367
7296,14.0,1499,31421,32920,323,2062,44192,12318,31874,44192,3082,0.03392016654598117,0.7110110427226647,0.007309015206372194,0.2787382331643736,0.7212617668356264,0.046660028964518464
7297,23.0,320,5684,6004,36,447,8130,2306,5824,8130,597,0.03936039360393604,0.6991389913899139,0.004428044280442804,0.28364083640836407,0.7163591635916359,0.05498154981549815
7298,,77,4497,4574,34,548,6438,1714,4724,6438,344,0.011960236098167133,0.6985088536812675,0.005281143212177695,0.26623174899036967,0.7337682510096303,0.08511960236098168
7299,16.0,212,23601,24293,130,1321,32145,8841,23304,32145,2422,0.006595115881163478,0.7342043863742417,0.004044174832788925,0.2750349976668222,0.7249650023331777,0.04109503810857054
7300,24.0,224,2833,3057,21,180,5029,1077,3952,5029,202,0.04454165838138795,0.563332670511036,0.0041757804732551205,0.2141578842712269,0.7858421157287732,0.03579240405647246
7301,25.0,2872,61587,64459,389,2313,84702,24947,59755,84702,6414,0.03390710963141366,0.7271020755117943,0.004592571603976294,0.29452669358456707,0.7054733064154329,0.02730750159382305
7302,16.0,181,5546,5727,16,916,8601,2257,6344,8601,474,0.02104406464364609,0.644808743169399,0.001860248808278107,0.2624113475177305,0.7375886524822695,0.10649924427392164
7303,,23,8181,8204,28,453,10830,3136,7694,10830,991,0.002123730378578024,0.7554016620498615,0.0025854108956602033,0.28956602031394274,0.7104339796860573,0.04182825484764543
7304,,5145,124449,129594,1373,9245,177224,49365,127859,177224,12349,0.029031056741750553,0.702213018552792,0.007747257707759672,0.27854579515189815,0.7214542048481019,0.052165620909131946
7305,,4451,100381,104832,429,3850,137179,40204,96977,137181,10135,0.03244618423834204,0.7317412761242447,0.0031272552321385616,0.2930726558342628,0.7069273441657372,0.028065111057653757
7306,,720,14510,15230,191,720,22690,5808,16882,22690,1541,0.031732040546496254,0.6394887615689732,0.008417805200528867,0.25597179374173645,0.7440282062582636,0.031732040546496254
7307,,423,5932,6355,425,617,9202,2496,6706,9202,534,0.04596826776787655,0.6446424690284721,0.046185611823516624,0.27124538143881766,0.7287546185611824,0.06705064116496413
7308,,159,3619,3778,22,204,5030,1411,3619,5030,397,0.031610337972166995,0.7194831013916501,0.00437375745526839,0.2805168986083499,0.7194831013916501,0.04055666003976143
7309,,219,2252,2471,13,146,3409,975,2434,3409,226,0.06424171311234966,0.6606042827808741,0.0038134350249339984,0.2860076268700499,0.7139923731299501,0.04282780874156644
7310,17.0,564,11589,12153,48,254,15991,4595,11396,15991,1397,0.035269839284597586,0.7247201550872365,0.003001688449752986,0.2873491338878119,0.7126508661121881,0.015883934713276218
7311,39.0,218,6290,6508,25,269,8598,2463,6135,8598,689,0.025354733658990464,0.7315654803442662,0.002907652942544778,0.2864619678995115,0.7135380321004885,0.03128634566178181
7312,,128,2662,2790,6,165,3796,1049,2747,3796,289,0.03371970495258166,0.7012644889357218,0.0015806111696522655,0.27634351949420444,0.7236564805057956,0.043466807165437306
7313,15.0,2226,34350,36576,186,1436,48118,13920,34198,48118,3466,0.04626127436718068,0.7138700694126938,0.003865497319090569,0.28928883162226193,0.7107111683777381,0.029843301882871275
7314,,2564,59215,61779,322,2295,80380,23415,56966,80381,5399,0.03189808536843284,0.7366790659484207,0.004005921797439693,0.2913001828790386,0.7086998171209614,0.02855152336995061
7315,,548,7899,8447,201,1055,12136,3307,8829,12136,486,0.04515491100856955,0.6508734344100198,0.01656229400131839,0.2724950560316414,0.7275049439683586,0.08693144363876071
7316,23.0,1675,47522,49197,234,1772,62269,18815,43471,62286,3810,0.026892078476704235,0.7629643900716052,0.003756863500626144,0.30207430241145683,0.6979256975885432,0.028449410782519346
7317,17.0,167,2292,2459,3,283,3351,873,2478,3351,203,0.049835869889585195,0.683974932855864,0.0008952551477170994,0.26051924798567594,0.7394807520143241,0.0844524022679797
7318,24.0,1212,25549,26761,145,1575,36007,10355,25652,36007,2318,0.03366012164301386,0.7095564751298359,0.0040269947510206345,0.2875829699780598,0.7124170300219401,0.04374149470936207
7319,25.0,180,5082,5262,14,163,6913,2033,4880,6913,502,0.026037899609431505,0.7351366989729495,0.0020251699696224503,0.2940836105887458,0.7059163894112541,0.023578764646318532
7320,,1072,18190,19262,64,829,25206,7418,17788,25206,1612,0.042529556454812344,0.7216535745457431,0.0025390779973022298,0.29429500912481155,0.7057049908751885,0.03288899468380544
7321,26.0,507,11768,12275,52,856,16884,4654,12230,16884,1193,0.030028429282160627,0.6969912343046671,0.003079838900734423,0.2756455816157309,0.7243544183842692,0.05069888651978204
7322,33.0,1910,39608,41518,160,1754,55003,16053,38950,55003,4367,0.03472537861571187,0.7201061760267622,0.002908932240059633,0.29185680781048307,0.7081431921895169,0.03188916968165373
7323,17.0,19,3483,3502,16,478,5047,1367,3680,5047,260,0.003764612641172974,0.6901129383792352,0.0031702001188825043,0.270853972657024,0.7291460273429761,0.09470972855161482
7324,14.0,97,5307,5404,0,203,7416,2073,5343,7416,590,0.01307982740021575,0.7156148867313916,0.0,0.2795307443365696,0.7204692556634305,0.027373247033441208
7325,24.0,561,16506,17067,37,628,22474,6488,15986,22474,1839,0.024962178517397883,0.7344486962712468,0.0016463468897392542,0.28868915190887245,0.7113108480911275,0.02794340126368248
7326,33.0,518,8954,9472,56,707,13061,3518,9543,13061,880,0.039660056657223795,0.6855524079320113,0.004287573692672843,0.2693515044789832,0.7306484955210167,0.05413061786999464
7327,,627,62791,63418,111,5039,89817,24050,65767,89817,7392,0.006980861084204549,0.6990992796463921,0.0012358462206486522,0.2677666811405413,0.7322333188594586,0.056102964917554586
7328,25.0,164,2312,2476,10,190,3507,936,2571,3507,222,0.046763615625891077,0.6592529227259766,0.00285143997718848,0.2668947818648417,0.7331052181351583,0.054177359566581124
7329,25.0,215,5369,5584,13,308,7839,2133,5706,7839,592,0.027426967725475187,0.6849087893864013,0.001658374792703151,0.27210103329506313,0.7278989667049368,0.039290725857890035
7330,23.0,488,16262,16750,62,625,23378,6565,16814,23379,2013,0.020873433423157534,0.6955815047692373,0.0026519526070405064,0.280807562342273,0.719192437657727,0.026733393216134136
7331,,113,2640,2753,16,129,3568,991,2577,3568,220,0.03167040358744395,0.7399103139013453,0.004484304932735426,0.27774663677130046,0.7222533632286996,0.03615470852017937
7332,,10,4666,4676,14,68,5891,1757,4134,5891,529,0.0016975046681378374,0.792055678153115,0.002376506535392972,0.298251570191818,0.701748429808182,0.011543031743337295
7333,15.0,508,12700,13208,28,947,17752,5050,12702,17752,1324,0.02861649391617846,0.7154123479044615,0.0015772870662460567,0.28447498873366384,0.7155250112663362,0.053346101847679135
7334,,131,1737,1868,38,125,2737,705,2032,2737,152,0.04786262331019364,0.6346364632809646,0.013883814395323347,0.25758129338692,0.74241870661308,0.04567044208987943
7335,26.0,464,6072,6536,21,273,8958,2445,6513,8958,462,0.05179727617771824,0.6778298727394507,0.002344273275284662,0.2729403884795713,0.7270596115204286,0.030475552578700604
7336,,151,3422,3573,6,183,4789,1310,3479,4789,366,0.03153059093756525,0.7145541866778033,0.001252871163082063,0.2735435372729171,0.7264564627270829,0.03821257047400292
7337,23.0,158,2732,2890,8,246,3933,1111,2822,3933,301,0.04017289600813628,0.6946351385710653,0.0020340706839562673,0.28248156623442666,0.7175184337655733,0.06254767353165523
7338,24.0,2194,36543,38737,9,141,50215,15237,34978,50215,2927,0.04369212386737031,0.7277307577417107,0.00017922931395001493,0.3034352285173753,0.6965647714826247,0.002807925918550234
7339,17.0,259,7485,7744,0,319,10127,2929,7198,10127,827,0.025575195023205294,0.7391132615779599,0.0,0.2892268193937,0.7107731806063,0.03149995062703664
7340,,452,4681,5133,97,417,7059,1878,5181,7059,391,0.06403173254001983,0.6631250885394532,0.013741323133588328,0.26604334891627707,0.7339566510837229,0.05907352316192095
7341,,892,3144,4036,9,308,5358,1506,3852,5358,284,0.16648002986188876,0.5867861142217246,0.0016797312430011197,0.2810750279955207,0.7189249720044792,0.05748413587159388
7342,15.0,25702,301676,327378,3433,24515,447719,124006,323713,447719,27943,0.05740654294323002,0.673806561704998,0.007667755891530179,0.276972833406668,0.723027166593332,0.0547553264435952
7343,23.0,309,7937,8246,13,363,11064,3157,7907,11064,924,0.027928416485900217,0.7173716558206796,0.0011749819233550253,0.2853398409255242,0.7146601590744758,0.032809110629067245
7344,23.0,1254,30556,31810,158,960,41104,12081,29023,41104,3259,0.030507979758660958,0.7433826391592059,0.003843908135461269,0.2939130011677696,0.7060869988322305,0.023355391202802646
7345,16.0,82,2938,3020,0,108,3946,1171,2775,3946,325,0.020780537252914344,0.7445514445007603,0.0,0.2967562088190573,0.7032437911809427,0.027369488089204256
7346,,908,24028,24936,228,1361,32861,9327,23534,32861,2354,0.027631538906302305,0.7312011198685372,0.006938315936824807,0.28383189799458325,0.7161681020054168,0.04141687714920422
7347,27.0,200,3516,3716,6,183,4957,1451,3506,4957,377,0.040346984062941293,0.7092999798265079,0.0012104095218882388,0.2927173693766391,0.7072826306233609,0.036917490417591285
7348,25.0,276,5038,5314,49,267,7125,2049,5076,7125,425,0.03873684210526316,0.7070877192982457,0.006877192982456141,0.28757894736842105,0.712421052631579,0.03747368421052632
7349,23.0,150,5077,5227,37,186,6698,1994,4704,6698,490,0.022394744699910422,0.757987458942968,0.005524037025977904,0.2977008062108092,0.7022991937891908,0.027769483427888923
7350,,66,1355,1421,0,51,2975,540,2435,2975,143,0.022184873949579832,0.45546218487394957,0.0,0.1815126050420168,0.8184873949579832,0.017142857142857144
7351,26.0,7068,176312,183380,520,10174,245456,70187,175269,245456,19048,0.028795384916237534,0.7183038915324946,0.0021185059644090996,0.28594534254611825,0.7140546574538817,0.04144938400365035
7352,23.0,326,9371,9697,0,311,12930,3716,9214,12930,991,0.025212683681361175,0.7247486465583913,0.0,0.2873936581593194,0.7126063418406806,0.02405259087393658
7353,,752,11673,12425,196,612,16713,4538,12175,16713,834,0.04499491413869443,0.6984383414108778,0.01172739783402142,0.27152516005504695,0.728474839944953,0.0366182014001077
7354,43.0,6732,49258,55990,372,2823,74572,21095,53477,74572,4855,0.09027517030520839,0.6605428310894169,0.004988467521321676,0.28288097409215257,0.7171190259078475,0.037856031754545945
7355,17.0,647,25719,26366,31,957,34234,9810,24424,34234,2820,0.01889933983758836,0.7512706665887714,0.0009055325115382368,0.28655722381258397,0.713442776187416,0.02795466495297073
7356,26.0,422,9924,10346,11,453,13723,3954,9769,13723,1038,0.03075129344895431,0.7231654885957881,0.0008015739998542593,0.28812941776579465,0.7118705822342053,0.03301027472127086
7357,15.0,148,3397,3545,19,279,5036,1320,3716,5036,319,0.02938840349483717,0.6745432883240667,0.003772835583796664,0.2621127879269261,0.7378872120730738,0.05540111199364575
7358,35.0,78,1767,1845,2,50,2348,710,1638,2348,197,0.03321976149914821,0.7525553662691652,0.0008517887563884157,0.3023850085178876,0.6976149914821125,0.02129471890971039
7359,15.0,4099,65432,69531,305,5299,94955,26323,68632,94955,6206,0.04316781633405297,0.6890843030909378,0.003212047812121531,0.2772155231425412,0.7227844768574588,0.055805381496498344
7360,,858,18440,19298,58,1479,25787,7208,18579,25787,1632,0.03327257920657696,0.7150889983324931,0.0022491953309807266,0.27952068871912206,0.7204793112808779,0.05735448094000853
7361,38.0,507,12037,12544,94,724,17094,4723,12371,17094,1196,0.02965952965952966,0.7041652041652041,0.005499005499005499,0.2762957762957763,0.7237042237042237,0.04235404235404235
7362,,575,21056,21631,63,1082,28745,8105,20640,28745,2394,0.02000347886588972,0.7325100017394329,0.0021916855105235692,0.28196208036180204,0.718037919638198,0.03764132892676987
7363,,1429,8139,9568,46,442,12469,3627,8842,12469,800,0.11460421846178523,0.6527387922046676,0.0036891490897425615,0.29088138583687545,0.7091186141631245,0.0354479108188307
7364,24.0,11,2957,2968,3,292,3980,1158,2822,3980,331,0.002763819095477387,0.742964824120603,0.0007537688442211055,0.29095477386934676,0.7090452261306532,0.07336683417085427
7365,25.0,50,1898,1948,8,68,2526,750,1776,2526,207,0.01979414093428345,0.7513855898653998,0.003167062549485352,0.29691211401425177,0.7030878859857482,0.026920031670625493
7366,33.0,115,4028,4143,4,104,5302,1626,3676,5302,511,0.02168992832893248,0.7597133157299132,0.0007544322897019992,0.3066767257638627,0.6933232742361373,0.01961523953225198
7367,23.0,1320,34615,35935,182,2155,47513,13122,34391,47513,3609,0.027781870224991054,0.7285374529076253,0.0038305305916275546,0.2761770462820702,0.7238229537179298,0.045356007829436155
7368,,863,38346,39449,151,2523,53698,14852,38846,53698,3994,0.016071362061901746,0.7141048083727514,0.0028120227941450335,0.27658385787180156,0.7234161421281985,0.04698499012998622
7369,,384,8621,9005,28,418,11707,3427,8280,11707,855,0.03280088835739301,0.7363970274194926,0.002391731442726574,0.29273084479371314,0.7072691552062869,0.035705133680703854
7370,,481,10794,11287,94,326,14111,4251,9860,14111,813,0.034086882573878534,0.7649351569697399,0.006661469775352562,0.30125434058535894,0.6987456594146411,0.023102544114520587
7371,,410,3315,3725,28,355,5336,1379,3957,5336,253,0.07683658170914542,0.6212518740629686,0.005247376311844078,0.25843328335832083,0.7415667166416792,0.06652923538230884
7372,,2048,33391,35439,153,3488,49175,13510,35665,49175,2993,0.04164717844433147,0.679023894255211,0.0031113370615149976,0.27473309608540925,0.7252669039145907,0.07093035078800203
7373,25.0,1343,27018,28361,145,1142,38403,10853,27550,38403,2892,0.03497122620628597,0.7035387860323412,0.003775746686456787,0.2826081295732104,0.7173918704267895,0.02973726010988725
7374,,294,2063,2357,28,129,3938,866,3072,3938,118,0.07465718638902996,0.5238699847638395,0.007110208227526663,0.21990858303707467,0.7800914169629254,0.03275774504824784
7375,,1626,32121,33747,69,2339,45827,12377,33450,45827,3138,0.03548126650228031,0.7009186723983678,0.0015056626006502718,0.27008095664128134,0.7299190433587187,0.05103978004233312
7376,,121,2354,2475,17,108,3373,946,2429,3375,178,0.03585185185185185,0.6974814814814815,0.005037037037037037,0.2802962962962963,0.7197037037037037,0.032
7377,37.0,433,11709,12142,31,482,15729,4650,11079,15729,1172,0.027528768516752497,0.744421132939157,0.0019708818106681926,0.29563227160022887,0.7043677283997711,0.030644033314260282
7378,,29,5524,5553,29,305,7458,2042,5416,7458,646,0.0038884419415392865,0.7406811477607937,0.0038884419415392865,0.27379994636631805,0.7262000536336819,0.04089568248860284
7379,,55,14617,14672,39,658,19218,5529,13689,19218,1465,0.0028619003018003956,0.7605890311166614,0.0020293474867311896,0.2876990321573525,0.7123009678426475,0.03423873451972109
7380,41.0,413,8390,8803,31,472,11774,3360,8414,11774,847,0.03507728894173603,0.7125870562255818,0.002632919993205368,0.2853745541022592,0.7146254458977408,0.04008833021912689
7381,15.0,65,4239,4304,47,639,6514,1599,4915,6514,264,0.009978507829290759,0.6507522259748234,0.0072152287381025484,0.24547129260055264,0.7545287073994473,0.09809640773718145
7382,26.0,909,36532,37441,114,1359,48149,14488,33661,48149,3202,0.018878896757980435,0.7587281148102765,0.002367650418492596,0.3008992917817608,0.6991007082182392,0.028224885252030155
7383,26.0,104,6856,6960,36,588,9467,2635,6832,9467,571,0.010985528678567657,0.7241998521178832,0.0038026830041195735,0.27833526988486323,0.7216647301151368,0.06211048906728636
7384,,186,4026,4212,3,212,5927,1612,4315,5927,407,0.03138181204656656,0.6792643833305213,0.0005061582588155897,0.2719757044035769,0.7280242955964231,0.03576851695630167
7385,,387,37249,37636,248,2531,51158,14059,37099,51158,3162,0.00756479924938426,0.7281168145744557,0.0048477266507682085,0.2748152781578639,0.7251847218421361,0.04947417803667071
7386,26.0,4637,127114,131751,531,6790,176776,49713,127066,176779,13415,0.02623049117825081,0.7190559964701689,0.0030037504454714643,0.28121552899382846,0.7187844710061716,0.03840953959463511
7387,37.0,76,2951,3027,4,134,4045,1170,2875,4045,321,0.018788627935723116,0.7295426452410383,0.000988875154511743,0.2892459826946848,0.7107540173053152,0.03312731767614339
7388,,320,3914,4234,25,304,5796,1559,4237,5796,328,0.05521048999309869,0.6752933057280883,0.004313319530710835,0.2689786059351277,0.7310213940648723,0.05244996549344375
7389,17.0,369,12214,12583,28,638,16435,4768,11667,16435,1306,0.02245208396714329,0.7431700638880439,0.0017036811682385154,0.29011256464861573,0.7098874353513842,0.038819592333434745
7390,26.0,2785,66787,69572,259,3970,93497,25559,67938,93497,6552,0.029787051990972972,0.7143223846754442,0.002770142357508797,0.2733670599056654,0.7266329400943345,0.042461255441351056
7391,16.0,415,4858,5273,17,441,7118,2032,5086,7118,443,0.058302894071368364,0.6824950828884518,0.002388311323405451,0.28547344759763976,0.7145265524023602,0.06195560550716493
7392,23.0,125,4788,4913,83,140,6275,1898,4377,6275,423,0.0199203187250996,0.7630278884462152,0.013227091633466135,0.30247011952191233,0.6975298804780876,0.022310756972111555
7393,27.0,359,9731,10090,26,299,12806,3855,8951,12806,881,0.0280337341870998,0.7598781821021396,0.002030298297672966,0.30103076682804936,0.6989692331719507,0.023348430423239107
7394,24.0,199,3996,4195,32,327,5585,1626,3959,5585,319,0.03563115487914056,0.7154879140555058,0.005729632945389436,0.2911369740376007,0.7088630259623993,0.0585496866606983
7395,,67,2239,2306,0,74,3105,879,2226,3105,233,0.021578099838969404,0.7210950080515298,0.0,0.28309178743961355,0.7169082125603865,0.02383252818035427
7396,14.0,100,1372,1472,8,71,2520,557,1963,2520,107,0.03968253968253968,0.5444444444444444,0.0031746031746031746,0.22103174603174602,0.778968253968254,0.028174603174603175
7397,,130,1240,1869,26,390,2938,520,2421,2941,108,0.044202652159129545,0.42162529751785105,0.00884053043182591,0.17681060863651818,0.8231893913634818,0.13260795647738866
7398,23.0,168,10036,10204,6,396,12942,3975,8967,12942,993,0.012980992118683357,0.77545974347087,0.0004636068613815484,0.30713954566527585,0.6928604543347242,0.030598052851182198
7399,,625,15970,16595,139,505,21293,6277,15016,21293,1382,0.029352369323251772,0.7500117409477293,0.0065279669374911945,0.29479171558728223,0.7052082844127178,0.023716714413187432
7400,,330,5015,5345,51,284,6984,2081,4903,6984,493,0.04725085910652921,0.718069873997709,0.007302405498281787,0.2979667812142039,0.702033218785796,0.04066437571592211
7401,,399,13307,13706,70,2115,19732,3944,15788,19732,1065,0.020220960875734845,0.6743867828907358,0.0035475369957429555,0.19987837016014595,0.800121629839854,0.10718629637137644
7402,25.0,492,14338,14830,54,1205,19940,5522,14418,19940,1349,0.024674022066198596,0.7190571715145436,0.002708124373119358,0.2769307923771314,0.7230692076228686,0.060431293881644935
7403,,97,2068,2165,1,86,2864,830,2034,2864,191,0.033868715083798885,0.7220670391061452,0.00034916201117318437,0.28980446927374304,0.710195530726257,0.030027932960893854
7404,,269,2865,3134,6,225,4384,1263,3121,4384,268,0.06135948905109489,0.6535127737226277,0.0013686131386861315,0.2880930656934307,0.7119069343065694,0.05132299270072993
7405,,4573,141439,146012,1196,9367,195476,55706,139770,195476,15744,0.02339417626716323,0.723561971802165,0.006118398166526837,0.28497616075630766,0.7150238392436923,0.04791892610857599
7406,15.0,1925,23096,25021,67,1676,34115,9468,24647,34115,2257,0.05642679173384142,0.677004250329767,0.0019639454785285067,0.27753187747325225,0.7224681225267477,0.04912794958229518
7407,14.0,359,8788,9147,39,534,12258,3507,8751,12258,881,0.029286996247348672,0.7169195627345407,0.0031815956926089083,0.28609887420460106,0.7139011257953989,0.04356338717572198
7408,,58,5655,5713,6,487,7575,2050,5525,7575,594,0.007656765676567656,0.7465346534653465,0.0007920792079207921,0.2706270627062706,0.7293729372937293,0.06429042904290429
7409,35.0,7806,177016,184822,1828,8845,249436,70580,178856,249436,16532,0.03129460061899646,0.7096650042495871,0.0073285331708334,0.2829583540467294,0.7170416459532706,0.035459997754935135
7410,,536,11674,12210,125,668,17726,4545,13181,17726,1145,0.03023806837413968,0.6585806160442288,0.007051788333521381,0.25640302380683744,0.7435969761931626,0.03768475685433826
7411,24.0,747,20299,21046,31,1052,27627,8049,19578,27627,1949,0.027038766424150287,0.7347522351322981,0.0011220907083650052,0.2913454229558041,0.7086545770441959,0.03807869113548341
7412,,296,30398,30694,253,7419,45836,11325,34511,45836,1573,0.006457806091281962,0.6631905052796928,0.005519678855048433,0.24707653372894667,0.7529234662710533,0.16185967361898945
7413,,274,5809,6083,15,377,8107,2289,5818,8107,579,0.0337979523868262,0.716541260638954,0.0018502528678919453,0.28234858764031084,0.7176514123596892,0.04650302207968422
7414,27.0,105,2796,2901,4,197,3954,1095,2859,3954,283,0.026555386949924126,0.7071320182094082,0.0010116337885685382,0.27693474962063735,0.7230652503793626,0.04982296408700051
7415,,310,8861,9171,9,557,12482,3460,9022,12482,861,0.02483576349943919,0.7099022592533248,0.0007210382951450088,0.2771991668001923,0.7228008331998077,0.04462425893286332
7416,,8145,155855,164000,865,9421,219281,63086,156195,219281,15557,0.037144121013676513,0.7107546937491165,0.0039447102120110725,0.28769478431783874,0.7123052156821612,0.04296313862122117
7417,,357,10691,11048,21,593,14214,4143,10071,14214,972,0.025116082735331363,0.752145771774307,0.0014774166314900801,0.2914731954411144,0.7085268045588856,0.04171943154636274
7418,,10242,212402,222644,978,13982,305493,84874,220619,305493,22641,0.03352613644175153,0.6952761601738828,0.0032013826830729346,0.27782633317293687,0.7221736668270632,0.04576864281669302
7419,14.0,322,20978,21300,52,2462,29894,8044,21850,29894,2408,0.010771392252625946,0.7017461697999599,0.0017394794942128856,0.26908409714323944,0.7309159028567606,0.08235766374523315
7420,15.0,244,6023,6267,12,259,8277,2367,5910,8277,691,0.029479279932342638,0.7276791107889332,0.0014498006524102935,0.28597317868793043,0.7140268213120696,0.031291530747855505
7421,25.0,2281,57828,60109,126,2981,78528,23025,55503,78528,5624,0.0290469641401793,0.7363997555012225,0.001604523227383863,0.2932075183374083,0.7067924816625917,0.03796098207008965
7422,36.0,1013,23484,24497,107,1626,32886,9737,23149,32886,2183,0.030803381378094023,0.7141032658274038,0.003253664173204403,0.2960834397616007,0.7039165602383993,0.04944353220215289
7423,15.0,263,4593,4856,25,736,7272,1854,5418,7272,339,0.036166116611661164,0.6316006600660066,0.003437843784378438,0.25495049504950495,0.745049504950495,0.10121012101210121
7424,,70,3560,3630,22,439,5062,1360,3702,5062,313,0.01382852627419992,0.7032793362307388,0.00434610825760569,0.2686685104701699,0.7313314895298301,0.08672461477676807
7425,25.0,82,1695,1777,6,45,2392,692,1700,2392,210,0.034280936454849496,0.7086120401337793,0.002508361204013378,0.28929765886287623,0.7107023411371237,0.018812709030100336
7426,23.0,218,17167,17385,51,614,22336,6655,15681,22336,1595,0.009760028653295129,0.7685798710601719,0.0022833094555873928,0.29794949856733527,0.7020505014326648,0.027489255014326648
7427,,101,4943,5044,9,384,7197,1941,5256,7197,546,0.014033625121578436,0.6868139502570515,0.0012505210504376823,0.2696957065443935,0.7303042934556065,0.05335556481867445
7428,,2,4416,4418,58,237,6113,1624,4489,6113,471,0.0003271716015049894,0.7223948961230165,0.00948797644364469,0.26566334042205136,0.7343366595779486,0.03876983477834124
7429,,371,6176,6547,31,426,8880,2384,6496,8880,506,0.041779279279279276,0.6954954954954955,0.003490990990990991,0.26846846846846845,0.7315315315315315,0.047972972972972976
7430,,85,1787,1872,2,184,2545,681,1864,2545,181,0.03339882121807466,0.7021611001964636,0.0007858546168958742,0.2675834970530452,0.7324165029469548,0.07229862475442043
7431,,190,13869,14059,93,1453,19006,5454,13552,19006,812,0.009996843102178259,0.7297169314953172,0.00489319162369778,0.28696201199621174,0.7130379880037883,0.07644954224981584
7432,24.0,135,3492,3627,11,328,4995,1268,3727,4995,324,0.02702702702702703,0.6990990990990991,0.0022022022022022024,0.25385385385385384,0.7461461461461462,0.06566566566566566
7433,,118,2982,3100,5,145,4207,1143,3064,4207,272,0.028048490610886618,0.7088186356073212,0.001188495364868077,0.2716900404088424,0.7283099595911576,0.03446636558117423
7434,16.0,681,14362,15043,59,753,20079,5711,14368,20079,1710,0.03391603167488421,0.7152746650729618,0.0029383933462821853,0.2844265152647044,0.7155734847352956,0.03750186762288959
7435,27.0,2427,63636,66063,202,4346,87107,24304,62803,87107,6629,0.02786228431698945,0.7305497835994811,0.002318986993008599,0.27901316771327217,0.7209868322867278,0.04989266075057114
7436,23.0,147,3616,3763,1,175,5054,1470,3584,5054,382,0.029085872576177285,0.7154728927582114,0.00019786307874950534,0.29085872576177285,0.7091412742382271,0.03462603878116344
7437,16.0,12417,261300,273717,1077,14294,367427,104306,263121,367427,25465,0.03379446801677612,0.7111616729309496,0.0029311944957773925,0.28388224055390593,0.716117759446094,0.03890296575918482
7438,23.0,116,1918,2034,30,112,2806,764,2042,2806,196,0.041339985744832504,0.6835352815395581,0.010691375623663579,0.2722736992159658,0.7277263007840342,0.03991446899501069
7439,14.0,165,1968,2133,4,141,2991,793,2198,2991,171,0.055165496489468405,0.6579739217652959,0.0013373453694416582,0.2651287194918088,0.7348712805081913,0.04714142427281846
7440,,382,9069,9451,181,798,13476,3602,9874,13476,1000,0.028346690412585338,0.6729741763134461,0.013431285247848026,0.26728999703176015,0.7327100029682398,0.059216384683882455
7441,23.0,2849,219105,221954,589,11657,290986,84449,206537,290986,23360,0.009790849044283918,0.7529743699009575,0.0020241523647185774,0.2902167114569086,0.7097832885430915,0.040060346545881934
7442,24.0,3339,83300,86639,339,4652,116439,33293,83146,116439,8896,0.02867595908587329,0.7153960442806964,0.002911395666400433,0.2859265366415033,0.7140734633584968,0.03995224967579591
7443,25.0,117,2494,2611,19,123,3629,1004,2625,3629,208,0.032240286580325156,0.68724166437035,0.005235602094240838,0.2766602369798843,0.7233397630201157,0.033893634610085425
7444,25.0,134,3537,3671,0,192,4875,1377,3498,4875,364,0.027487179487179488,0.7255384615384616,0.0,0.2824615384615385,0.7175384615384616,0.039384615384615386
7445,,83,2014,2097,4,83,2782,805,1977,2782,234,0.029834651329978434,0.723939611790079,0.0014378145219266715,0.28936017253774265,0.7106398274622574,0.029834651329978434
7446,25.0,2959,69350,72309,395,4242,97546,27403,70143,97546,6875,0.030334406331371865,0.7109466303077523,0.004049371578537305,0.2809238718143235,0.7190761281856765,0.04348717528140569
7447,34.0,97,3039,3136,20,88,4268,1198,3070,4268,403,0.022727272727272728,0.7120431115276477,0.004686035613870665,0.28069353327085284,0.7193064667291471,0.020618556701030927
7448,16.0,17,1897,1914,8,217,2719,690,2029,2719,121,0.00625229863920559,0.697682971680765,0.002942258183155572,0.2537697682971681,0.7462302317028319,0.07980875321809489
7449,,4110,98217,102327,401,4131,132092,38979,93115,132094,8924,0.031114206549881146,0.7435386921434736,0.0030357169894166276,0.29508531803109905,0.704914681968901,0.03127318424758127
7450,17.0,1021,12601,13622,55,1085,18709,5210,13499,18709,1243,0.05457266556202897,0.6735261104281361,0.0029397616120583675,0.2784755999786199,0.7215244000213801,0.05799347907424234
7451,17.0,123,9332,9455,55,621,13664,3712,9952,13664,1068,0.00900175644028103,0.6829625292740047,0.004025175644028103,0.2716627634660422,0.7283372365339579,0.045447892271662765
7452,,5692,107067,112759,203,7073,151948,42866,109082,151948,10409,0.037460183747071364,0.7046292152578514,0.0013359833627293548,0.28210966909732277,0.7178903309026772,0.04654881933292969
7453,,7940,216842,224782,1060,19182,305779,85780,219999,305779,22909,0.025966465977061867,0.7091461480350187,0.003466555911295413,0.2805294019536986,0.7194705980463014,0.06273158065138548
7454,23.0,5428,290942,296370,1533,18238,399542,112572,286970,399542,28536,0.013585555461002848,0.7281887761486903,0.0038368932427629635,0.28175260673471125,0.7182473932652887,0.04564726611970706
7455,25.0,268,11150,11418,35,938,16576,4333,12243,16576,1114,0.016167953667953667,0.6726592664092664,0.0021114864864864866,0.26140202702702703,0.738597972972973,0.056587837837837836
7456,,162,1896,2058,37,81,2900,788,2112,2900,228,0.05586206896551724,0.6537931034482759,0.012758620689655173,0.2717241379310345,0.7282758620689656,0.02793103448275862
7457,27.0,547,14821,15368,76,692,20006,5816,14190,20006,1284,0.02734179746076177,0.7408277516744977,0.0037988603418974308,0.29071278616415075,0.7092872138358493,0.03458962311306608
7458,24.0,1271,34339,35610,155,1832,47414,13632,33782,47414,3776,0.026806428481039354,0.7242375669633442,0.00326907664402919,0.2875100181381027,0.7124899818618974,0.0386383768507192
7459,38.0,141,4360,4501,0,221,5987,1734,4253,5987,447,0.023551027225655587,0.7282445298145983,0.0,0.2896275263069985,0.7103724736930015,0.03691331217638216
7460,15.0,546,9248,9794,27,729,13350,3743,9607,13350,892,0.04089887640449438,0.6927340823970037,0.0020224719101123597,0.280374531835206,0.719625468164794,0.05460674157303371
7461,,100,1699,1799,9,128,2383,635,1748,2383,169,0.0419639110365086,0.7129668485102811,0.0037767519932857744,0.2664708350818296,0.7335291649181703,0.05371380612673101
7462,,134,2957,3091,26,388,4372,1171,3201,4372,64,0.030649588289112534,0.6763494967978042,0.005946935041171089,0.26784080512351327,0.7321591948764867,0.08874656907593778
7463,17.0,2394,37409,39803,134,2857,53566,15482,38084,53566,3566,0.04469252884292275,0.6983721017063063,0.0025015868274651833,0.28902662136429824,0.7109733786357018,0.05333607138856737
7464,15.0,101,1571,1672,9,285,2508,637,1871,2508,138,0.040271132376395534,0.6263955342902712,0.0035885167464114833,0.2539872408293461,0.7460127591706539,0.11363636363636363
7465,,3372,71913,75285,322,3669,99382,28803,70579,99382,7768,0.03392968545611882,0.7236018594916585,0.0032400233442675735,0.28982109436316433,0.7101789056368356,0.036918154192912195
7466,14.0,6323,126236,132559,1166,8433,179527,49868,129659,179527,12573,0.03522032897558584,0.7031588563280176,0.006494844786578064,0.2777743737710762,0.7222256262289238,0.04697343575061133
7467,27.0,8566,251602,260168,637,12983,342803,98269,244534,342803,23289,0.02498811270613151,0.7339550704048681,0.0018582101090130483,0.2866631855613866,0.7133368144386134,0.03787306412137583
7468,35.0,1952,67003,68955,331,2435,87540,26322,61218,87540,6275,0.022298377884395704,0.7653986748914782,0.003781128626913411,0.30068540095956137,0.6993145990404387,0.02781585560886452
7469,17.0,702,3513,4215,14,598,6416,1550,4866,6416,345,0.1094139650872818,0.5475374064837906,0.0021820448877805485,0.24158354114713218,0.7584164588528678,0.09320448877805486
7470,,214,4579,4793,13,196,6414,1802,4612,6414,470,0.03336451512316807,0.7139070782662925,0.0020268163392578734,0.280947926410976,0.719052073589024,0.030558154038041782
7471,17.0,526,12159,12685,33,689,16956,4800,12156,16956,1202,0.031021467327199813,0.7170912951167728,0.00194621372965322,0.28308563340410475,0.7169143665958952,0.040634583628214205
7472,,378,8976,9354,10,550,12539,3555,8984,12539,844,0.030145944652683627,0.7158465587367414,0.0007975117632985087,0.28351543185261985,0.7164845681473802,0.04386314698141797
7473,37.0,165,3454,3619,0,158,4660,1390,3270,4660,315,0.03540772532188841,0.7412017167381975,0.0,0.2982832618025751,0.7017167381974249,0.03390557939914163
7474,15.0,596,10098,10694,47,823,14660,4012,10648,14660,901,0.040654843110504775,0.6888130968622102,0.0032060027285129604,0.27366984993178717,0.7263301500682128,0.056139154160982266
7475,23.0,1436,30256,31692,144,1403,40566,12225,28341,40566,2604,0.03539910269683972,0.7458462752058374,0.003549770743972785,0.30136074545185626,0.6986392545481438,0.034585613568012624
7476,,54,8008,8062,46,165,10484,3106,7378,10484,1006,0.005150705837466615,0.7638305990080122,0.00438763830599008,0.296260969095765,0.7037390309042351,0.015738267836703547
7477,16.0,375,3165,3540,16,114,4723,1378,3345,4723,359,0.07939868727503706,0.6701249206013127,0.0033876773237349143,0.29176370950666947,0.7082362904933305,0.024137200931611265
7478,14.0,459,11003,11462,17,592,15209,4309,10900,15209,1341,0.030179498980866592,0.7234532184890525,0.0011177592215135775,0.2833190873824709,0.7166809126175291,0.03892432112564929
7479,24.0,172,3553,3725,25,150,5036,1365,3671,5036,345,0.03415409054805401,0.7055202541699762,0.004964257347100874,0.2710484511517077,0.7289515488482923,0.029785544082605243
7480,24.0,6790,180902,187692,445,8543,248388,71252,177136,248388,19113,0.02733626423176643,0.7283041048681901,0.0017915519268241623,0.2868576581799443,0.7131423418200558,0.034393771035637795
7481,37.0,149,6150,6299,23,329,8124,2298,5826,8124,651,0.018340718857705565,0.7570162481536189,0.002831117676021664,0.28286558345642543,0.7171344165435746,0.040497291974396846
7482,23.0,1312,25490,26802,567,1202,35121,9997,25124,35121,2264,0.03735656729591982,0.7257766008940519,0.016144187238404373,0.2846445146778281,0.715355485322172,0.03422453802568264
7483,17.0,984,19574,20563,72,1242,27806,7916,19890,27806,2115,0.035388045745522546,0.7039487880313602,0.002589369200891894,0.28468675825361434,0.7153132417463857,0.044666618715385166
7484,23.0,7207,118463,125670,649,8569,170359,48368,121991,170359,12256,0.04230477990596329,0.6953727129180143,0.003809602075616786,0.2839180788804818,0.7160819211195182,0.050299661303482644
7485,,224,4786,5010,27,437,7241,1862,5379,7241,456,0.03093495373567187,0.6609584311559177,0.003728766744924734,0.2571468029277724,0.7428531970722276,0.060350780278966995
7486,24.0,146,3167,3313,2,265,4369,1281,3088,4369,303,0.03341725795376516,0.7248798352025635,0.00045777065690089265,0.29320210574502176,0.7067978942549783,0.060654612039368276
7487,16.0,331,8044,8375,11,344,11006,3240,7766,11006,954,0.030074504815555153,0.7308740686898055,0.000999454842813011,0.29438488097401416,0.7056151190259858,0.0312556787206978
7488,15.0,45,950,995,3,274,1981,246,1735,1981,52,0.02271580010095911,0.4795557799091368,0.001514386673397274,0.12417970721857648,0.8758202927814235,0.13831398283695104
7489,,682,9832,10514,47,1038,15341,3960,11381,15341,1077,0.04445603285313865,0.6408969428329314,0.003063685548530083,0.2581318036633857,0.7418681963366143,0.06766182126328141
7490,17.0,23,5657,5680,16,147,7600,2136,5464,7600,800,0.0030263157894736843,0.7443421052631579,0.002105263157894737,0.2810526315789474,0.7189473684210527,0.019342105263157893
7491,,791,16050,16841,40,783,23229,6432,16797,23229,1569,0.03405226225838392,0.6909466615007103,0.001721985449222954,0.276895260235051,0.7231047397649489,0.033707865168539325
7492,26.0,225,4076,4301,45,272,5953,1635,4318,5953,416,0.03779606920880228,0.6846967915336805,0.007559213841760457,0.27465143625062993,0.7253485637493701,0.045691248110196536
7493,25.0,930,19190,20120,91,1315,26843,7449,19394,26843,1903,0.034645903960064076,0.7148977387028276,0.003390083075662184,0.2775025146220616,0.7224974853779383,0.04898856312632716
7494,,155,3888,4043,32,222,5423,1588,3835,5423,408,0.02858196570164116,0.7169463396643924,0.005900792919048497,0.2928268486077817,0.7071731513922184,0.04093675087589895
7495,13.0,135,3739,3874,4,208,5231,1473,3758,5231,425,0.025807684955075513,0.7147772892372395,0.0007646721468170522,0.2815905180653795,0.7184094819346205,0.03976295163448671
7496,17.0,419,8167,8586,58,496,11864,3220,8644,11864,857,0.03531692515171949,0.6883850303438975,0.004888739042481456,0.27140930546190156,0.7285906945380984,0.041807147673634526
7497,13.0,64,3007,3071,2,161,4093,1145,2948,4093,377,0.015636452479843636,0.7346689469826533,0.0004886391399951136,0.27974590764720253,0.7202540923527975,0.03933545076960664
7498,46.0,743,14398,15141,297,776,20928,5951,14977,20928,1380,0.0355026758409786,0.6879778287461774,0.01419151376146789,0.2843558868501529,0.7156441131498471,0.03707951070336391
7499,23.0,180,3802,3982,31,174,5402,1476,3926,5402,361,0.03332099222510181,0.7038134024435394,0.0057386153276564236,0.27323213624583487,0.7267678637541651,0.03221029248426509
7500,15.0,325,6463,6788,19,367,9168,2659,6509,9168,680,0.03544938917975567,0.7049520069808028,0.0020724258289703318,0.2900305410122164,0.7099694589877836,0.040030541012216404
7501,27.0,88,1994,2082,13,176,3130,816,2314,3130,221,0.028115015974440896,0.6370607028753994,0.004153354632587859,0.26070287539936104,0.739297124600639,0.05623003194888179
7502,24.0,187,6473,6660,70,242,8837,2591,6246,8837,711,0.02116102749801969,0.7324884010410773,0.007921240239900419,0.2931990494511712,0.7068009505488287,0.027384859115084304
7503,46.0,520,13061,13581,21,620,17524,5153,12371,17524,1270,0.02967359050445104,0.7453207030358365,0.0011983565396028303,0.294053868979685,0.705946131020315,0.03538005021684547
7504,,3384,7831,11580,240,1159,15430,3887,11599,15486,366,0.21851995350639286,0.5056825519824357,0.015497869043006587,0.25100090404236086,0.7489990959576391,0.07484179258685264
7505,34.0,123,2987,3110,84,137,4537,1196,3341,4537,193,0.027110425391227683,0.6583645580780251,0.018514436852545734,0.2636103151862464,0.7363896848137536,0.030196164866651973
7506,15.0,144,1942,2086,7,133,2819,784,2035,2819,181,0.05108194395175594,0.6888967719049308,0.0024831500532103584,0.2781128059595601,0.7218871940404399,0.04717985101099681
7507,14.0,1002,15385,16387,102,1239,22160,6091,16069,22160,1367,0.04521660649819494,0.694268953068592,0.0046028880866426,0.2748646209386282,0.7251353790613718,0.055911552346570394
7508,24.0,421,10320,10741,46,274,14077,4055,10022,14077,895,0.029906940399232793,0.7331107480286992,0.0032677417063294734,0.2880585351992612,0.7119414648007388,0.01946437451161469
7509,42.0,205,3326,3531,18,321,4513,1245,3268,4513,214,0.0454243297141591,0.7369820518502105,0.0039884777309993355,0.275869709727454,0.7241302902725459,0.07112785286948814
7510,,393,6334,6727,42,462,9159,2627,6532,9159,609,0.04290861447756305,0.6915602139971613,0.004585653455617425,0.2868217054263566,0.7131782945736435,0.05044218801179168
7511,,611,6657,7268,62,490,9916,2713,7203,9916,602,0.06161758773699072,0.6713392496974586,0.006252521177894313,0.2735982250907624,0.7264017749092376,0.04941508672851956
7512,17.0,350,12552,12902,30,334,16868,4949,11919,16868,1480,0.02074934787763813,0.7441308987431824,0.0017785155323689827,0.2933957789898032,0.7066042210101968,0.019800806260374674
7513,33.0,83,1747,1830,11,85,2555,675,1880,2555,209,0.0324853228962818,0.683757338551859,0.004305283757338552,0.26418786692759294,0.735812133072407,0.033268101761252444
7514,25.0,436,12532,12968,15,555,17018,4900,12118,17018,1389,0.0256199318368786,0.7363967563756023,0.0008814196732871077,0.28793042660712187,0.7120695733928781,0.03261252791162299
7515,23.0,79,2466,2545,26,137,3414,971,2443,3414,279,0.023140011716461628,0.7223198594024605,0.007615700058582308,0.28441710603397774,0.7155828939660223,0.04012888107791447
7516,33.0,442,8056,8498,17,657,11609,3132,8510,11642,740,0.037965985225906204,0.6919773234839375,0.0014602302009963924,0.26902594056004125,0.7309740594399587,0.056433602473801754
7517,16.0,25,2011,2036,8,154,2745,726,2019,2745,199,0.009107468123861567,0.7326047358834245,0.0029143897996357013,0.2644808743169399,0.7355191256830601,0.05610200364298725
7518,25.0,186,3937,4123,10,220,5527,1547,3980,5527,395,0.033652976298172606,0.7123213316446535,0.0018092998009770218,0.2798986792111453,0.7201013207888547,0.03980459562149448
7519,,291,6394,6685,20,273,9092,2570,6522,9092,688,0.03200615926088869,0.7032556093268808,0.002199736031676199,0.28266608007039157,0.7173339199296085,0.030026396832380113
7520,17.0,145,7575,7720,16,602,10256,2880,7376,10256,666,0.014138065522620905,0.7385920436817472,0.0015600624024961,0.28081123244929795,0.719188767550702,0.05869734789391576
7521,,295,10823,11118,21,500,14362,4258,10104,14362,1035,0.020540314719398413,0.7535858515527085,0.0014621918952792091,0.296476813814232,0.703523186185768,0.03481409274474307
7522,,226,6209,6435,43,246,8766,2486,6280,8766,675,0.025781428245493954,0.7083048140543007,0.004905315993611681,0.2835957107004335,0.7164042892995665,0.02806297056810404
7523,,94,2043,2137,36,68,2836,844,1992,2836,182,0.03314527503526093,0.7203808180535967,0.012693935119887164,0.29760225669957685,0.7023977433004231,0.023977433004231313
7524,35.0,617,14476,15093,31,546,19775,5728,14047,19775,1566,0.03120101137800253,0.7320353982300885,0.0015676359039190897,0.28965865992414663,0.7103413400758534,0.02761061946902655
7525,17.0,1432,23982,25414,87,3033,35223,9491,25732,35223,2290,0.04065525366947733,0.6808619368026574,0.00246997700366238,0.26945461772137524,0.7305453822786248,0.08610850864491951
7526,17.0,183,5595,5778,30,412,8230,2142,6088,8230,577,0.02223572296476306,0.6798298906439855,0.0036452004860267314,0.2602673147023086,0.7397326852976914,0.05006075334143378
7527,14.0,455,3526,3981,438,454,6060,1585,4475,6060,227,0.07508250825082509,0.5818481848184819,0.07227722772277227,0.2615511551155115,0.7384488448844885,0.07491749174917492
7528,17.0,72,2902,2974,5,142,3975,1123,2852,3975,250,0.018113207547169812,0.730062893081761,0.0012578616352201257,0.2825157232704403,0.7174842767295597,0.03572327044025157
7529,25.0,204,3814,4018,27,218,5478,1477,4001,5478,363,0.03723986856516977,0.6962395034684191,0.004928806133625411,0.2696239503468419,0.730376049653158,0.0397955458196422
7530,14.0,977,13459,14436,122,1388,20806,5585,15221,20806,1434,0.046957608382197445,0.6468807074882246,0.005863693165433048,0.26843218302412764,0.7315678169758724,0.06671152552148418
7531,,663,16173,16836,36,1223,23059,6290,16769,23059,1780,0.02875233097705885,0.7013747343770328,0.001561212541740752,0.27277852465414804,0.7272214753458519,0.053037859404137216
7532,,1959,44118,46077,140,3394,61476,17388,44088,61476,3964,0.03186609408549678,0.7176459105992582,0.0022773114711432106,0.2828420847159867,0.7171579152840133,0.05520853666471469
7533,17.0,5195,101355,106550,578,5557,143929,40880,103049,143929,9631,0.03609418532748786,0.7042013770678599,0.00401586893537786,0.28402893093122306,0.7159710690687769,0.03860931431469683
7534,,115,2385,2500,4,140,3354,933,2421,3354,246,0.03428741800834824,0.7110912343470484,0.0011926058437686344,0.278175313059034,0.721824686940966,0.04174120453190221
7535,,2718,35341,38059,1021,2339,51774,14312,37462,51774,3234,0.052497392513616875,0.6826013056746629,0.01972032294201723,0.27643218603932473,0.7235678139606753,0.04517711592691312
7536,,132,21145,21277,139,2104,29242,8033,21209,29242,2330,0.0045140551261883596,0.7231037548731277,0.004753436837425621,0.27470761233841734,0.7252923876615827,0.07195130292045687
7537,15.0,120,3721,3841,22,155,5038,1476,3562,5038,383,0.023818975784041286,0.7385867407701469,0.004366812227074236,0.2929734021437078,0.7070265978562922,0.03076617705438666
7538,40.0,349,8644,8993,78,342,11791,3466,8325,11791,902,0.029598846577898397,0.7331015181070308,0.006615214994487321,0.29395301501144944,0.7060469849885506,0.029005173437367485
7539,,33,9273,9306,50,1277,13120,3521,9599,13120,786,0.0025152439024390245,0.7067835365853659,0.0038109756097560975,0.2683689024390244,0.7316310975609757,0.09733231707317073
7540,16.0,101,3058,3159,7,1213,5282,1207,4075,5282,298,0.019121544869367665,0.5789473684210527,0.0013252555850056798,0.22851192730026504,0.771488072699735,0.22964786065884135
7541,23.0,1339,26944,28283,102,2160,39118,10704,28414,39118,2980,0.0342297663479728,0.6887877703359068,0.002607495270719362,0.2736336213507848,0.7263663786492152,0.05521754690935119
7542,,310,8084,8394,82,440,11349,3145,8204,11349,897,0.027315181954357212,0.7123094545774958,0.00722530619437836,0.2771169266014627,0.7228830733985373,0.03876993567715217
7543,24.0,137,7861,7998,79,633,10857,3011,7846,10857,786,0.012618587086672193,0.7240490006447453,0.00727641153173068,0.27733259648153263,0.7226674035184674,0.058303398728930644
7544,24.0,161,4256,4417,17,215,5784,1656,4128,5784,412,0.027835408022130016,0.73582295988935,0.0029391424619640387,0.2863070539419087,0.7136929460580913,0.037171507607192254
7545,,265,5676,5941,10,247,7830,2218,5612,7830,633,0.03384418901660281,0.724904214559387,0.001277139208173691,0.28326947637292466,0.7167305236270753,0.03154533844189017
7546,,165,5695,5860,3,216,7817,2283,5534,7817,653,0.021107841883075348,0.7285403607522067,0.0003837789433286427,0.2920557758730971,0.7079442241269029,0.027632083919662275
7547,24.0,265,10567,10832,8,350,14083,4085,9998,14083,1244,0.018817013420435985,0.7503372860896116,0.0005680607825037279,0.29006603706596606,0.709933962934034,0.024852659234538096
7548,13.0,50,5081,5131,80,446,7162,2082,5080,7162,296,0.006981290142418319,0.7094387042725495,0.01117006422786931,0.2907009215302988,0.7092990784697012,0.062273108070371404
7549,16.0,78,1862,1940,15,191,2693,743,1950,2693,199,0.028963980690679538,0.6914222057185295,0.005569996286669142,0.2759004827330115,0.7240995172669885,0.07092461938358707
7550,17.0,2060,42627,44687,216,2527,60283,16975,43308,60283,4202,0.034172154670470946,0.7071147753097888,0.0035830997130202546,0.281588507539439,0.718411492460561,0.04191894895741751
7551,,1137,19262,20399,127,1225,27200,7627,19609,27236,1587,0.04174621824056396,0.7072257306506095,0.004662946100749008,0.28003377882214714,0.7199662211778528,0.0449772360111617
7552,,358,7848,8206,27,661,10944,2855,8089,10944,816,0.03271198830409357,0.7171052631578947,0.0024671052631578946,0.2608735380116959,0.7391264619883041,0.0603983918128655
7553,,153,2877,3030,12,98,4009,1158,2851,4009,356,0.0381641307059117,0.7176353205288102,0.002993265153404839,0.288850087303567,0.711149912696433,0.024444998752806184
7554,,374,8101,8475,74,331,11478,3292,8186,11478,923,0.03258407388046698,0.7057849799616658,0.0064471162223383865,0.2868095487018644,0.7131904512981355,0.028837776616135215
7555,34.0,185,2844,3029,55,186,4037,1179,2858,4037,265,0.045826108496408224,0.7044835273718107,0.013623978201634877,0.29204855090413673,0.7079514490958633,0.046073817190983406
7556,,36,3322,3358,2,226,4498,1290,3208,4498,394,0.008003557136505114,0.7385504668741663,0.00044464206313917296,0.28679413072476656,0.7132058692752334,0.05024455313472655
7557,14.0,5415,71257,76672,1016,5645,107830,29325,78505,107830,7051,0.05021793563943244,0.6608272280441435,0.009422238709079106,0.2719558564406937,0.7280441435593064,0.05235092274877121
7558,27.0,724,21023,21747,98,764,28648,8205,20443,28648,2548,0.025272270315554315,0.7338383133203016,0.0034208321697849764,0.2864074280927115,0.7135925719072884,0.02666852834403798
7559,25.0,337,17040,17377,32,595,22394,6632,15762,22394,1739,0.015048673751897829,0.7609181030633205,0.0014289541841564705,0.2961507546664285,0.7038492453335715,0.026569616861659373
7560,25.0,227,6268,6495,13,299,8450,2486,5964,8450,639,0.026863905325443787,0.7417751479289941,0.0015384615384615385,0.2942011834319527,0.7057988165680473,0.03538461538461538
7561,,4950,135615,140565,378,5159,185036,53446,131590,185036,14280,0.026751551049525497,0.7329114334507879,0.0020428457165092197,0.28884109038241207,0.7111589096175879,0.027881060982727687
7562,24.0,213,6912,7125,17,301,9289,2741,6548,9289,702,0.02293034772311336,0.7441059317472279,0.0018301216492625687,0.29508020238992355,0.7049197976100764,0.03240391861341371
7563,16.0,2764,66326,69090,1274,2680,92889,26108,66781,92889,7061,0.029755945268008052,0.7140350310585752,0.013715294598929905,0.28106664944180687,0.7189333505581931,0.02885164012961707
7564,23.0,4245,69359,73604,187,5138,99348,27926,71422,99348,7035,0.04272859040946974,0.698141885090792,0.0018822724161533196,0.2810927245641583,0.7189072754358417,0.05171719611869388
7565,15.0,729,16164,16893,82,1856,23369,6486,16883,23369,1367,0.031195173092558516,0.6916855663485815,0.0035089220762548677,0.2775471778852326,0.7224528221147675,0.07942145577474433
7566,45.0,2452,45840,48292,231,2377,64734,18513,46221,64734,4439,0.03787808570457565,0.7081286495504681,0.003568449346556678,0.28598572620261375,0.7140142737973862,0.03671949825439491
7567,26.0,2065,56120,58185,55,2473,79787,21554,58233,79787,6320,0.025881409252133808,0.703372729893341,0.0006893353553837091,0.27014425908982664,0.7298557409101734,0.030995024252071138
7568,17.0,348,8218,8566,9,332,11137,3268,7869,11137,810,0.031247194037891713,0.7379006913890634,0.0008081170871868546,0.29343629343629346,0.7065637065637066,0.029810541438448416
7569,,877,8748,9625,378,800,14007,3603,10404,14007,909,0.06261155136717356,0.6245448704219319,0.026986506746626688,0.25722852859284645,0.7427714714071536,0.05711429999286071
7570,14.0,145,2574,2719,16,213,3923,1017,2906,3923,302,0.036961509049197046,0.6561305123629875,0.004078511343359674,0.25924037726229926,0.7407596227377007,0.054295182258475655
7571,,2259,41118,43377,214,2657,57447,16581,40866,57447,3092,0.03932320225599248,0.7157553919264713,0.0037251727679426254,0.2886312601180218,0.7113687398819781,0.046251327310390444
7572,17.0,484,6000,6484,90,498,8814,2445,6369,8814,566,0.054912638983435444,0.6807351940095303,0.010211027910142955,0.2773995915588836,0.7226004084411164,0.05650102110279102
7573,17.0,767,18619,19386,64,1000,26296,7359,18937,26296,2033,0.02916793428658351,0.7080544569516276,0.002433830240340736,0.27985244904167933,0.7201475509583206,0.038028597505324
7574,39.0,128,4693,4821,32,195,6284,1837,4447,6284,500,0.020369191597708464,0.7468173138128581,0.005092297899427116,0.2923297262889879,0.7076702737110121,0.03103119032463399
7575,17.0,2061,63725,65786,375,2668,84333,25301,59032,84333,5906,0.024438831774038633,0.7556353977683706,0.004446657891928427,0.30001304352981634,0.6999869564701837,0.03163648868177345
7576,,304,1456,1760,7,69,2307,654,1653,2307,169,0.1317728651928912,0.6311226701343736,0.003034243606415258,0.2834850455136541,0.716514954486346,0.02990897269180754
7577,26.0,202,6719,6921,2,208,8734,2666,6068,8734,614,0.023128005495763684,0.7692924204259217,0.0002289901534234028,0.3052438745133959,0.694756125486604,0.02381497595603389
7578,26.0,56,1534,1590,2,114,2145,597,1548,2145,180,0.026107226107226107,0.7151515151515152,0.0009324009324009324,0.2783216783216783,0.7216783216783217,0.05314685314685315
7579,15.0,192,5893,6085,9,379,7996,2268,5728,7996,573,0.0240120060030015,0.7369934967483742,0.0011255627813906953,0.2836418209104552,0.7163581790895448,0.04739869934967484
7580,17.0,3536,65336,68872,622,3393,91530,26177,65353,91530,6509,0.03863214246695073,0.713820605266033,0.006795586146618595,0.28599366327979897,0.714006336720201,0.03706981317600787
7581,17.0,31,1638,1669,3,53,2244,631,1613,2244,214,0.013814616755793227,0.7299465240641712,0.001336898395721925,0.28119429590017825,0.7188057040998217,0.023618538324420676
7582,15.0,425,10688,11113,71,875,15033,4244,10789,15033,990,0.028271136832302268,0.7109692010909333,0.004722942859043438,0.28231224639127256,0.7176877536087275,0.05820528171356349
7583,35.0,93,1492,1585,0,17,2134,613,1521,2134,152,0.04358013120899719,0.6991565135895033,0.0,0.2872539831302718,0.7127460168697282,0.007966260543580132
7584,25.0,287,5973,6260,54,202,8273,2383,5890,8273,599,0.03469116402755953,0.7219871872355856,0.006527257343164511,0.28804544905113016,0.7119545509488698,0.02441677746887465
7585,,310,6068,6378,18,361,8476,2350,6126,8476,529,0.0365738555922605,0.7159037281736669,0.0021236432279377066,0.27725342142520054,0.7227465785747994,0.042590844738084
7586,36.0,161,5852,6013,11,271,7847,2301,5546,7847,585,0.020517395182872437,0.7457627118644068,0.0014018096087676818,0.2932330827067669,0.706766917293233,0.03453549127054925
7587,,1917,44206,46123,144,4380,62766,16878,45888,62766,4290,0.030542013191855462,0.7042985055603352,0.002294235732721537,0.2689035465060702,0.7310964534939298,0.06978300353694676
7588,,118,3809,3927,7,296,5303,1511,3792,5303,378,0.02225155572317556,0.718272675843862,0.0013200075429002452,0.2849330567603243,0.7150669432396757,0.05581746181406751
7589,,415,3765,4180,26,386,5806,1567,4239,5806,443,0.07147778160523596,0.6484671029968998,0.0044781260764726145,0.26989321391663795,0.730106786083362,0.06648294867378574
7590,17.0,640,9333,9973,47,1410,14394,3634,10760,14394,1089,0.04446297068222871,0.6483951646519384,0.0032652494094761704,0.2524663054050299,0.7475336945949701,0.09795748228428512
7591,,313,2326,2639,20,366,3825,966,2859,3825,168,0.08183006535947712,0.6081045751633987,0.00522875816993464,0.25254901960784315,0.7474509803921568,0.09568627450980392
7592,,485,5268,5753,27,524,8099,2205,5894,8099,525,0.059883936288430674,0.6504506729225831,0.0033337449067786145,0.2722558340535869,0.7277441659464131,0.064699345598222
7593,24.0,27,2966,2993,0,37,4003,1100,2903,4003,330,0.006744941294029478,0.7409442917811642,0.0,0.2747939045715713,0.7252060954284287,0.00924306769922558
7594,,1799,49843,51642,127,2502,69127,19551,49576,69127,5335,0.026024563484600808,0.7210351960883591,0.0018371982004137314,0.2828272599707784,0.7171727400292216,0.036194251160906736
7595,16.0,374,11430,11804,18,476,15659,4432,11227,15659,1468,0.02388402835430104,0.7299316686889329,0.0011494986908487132,0.2830321221023054,0.7169678778976946,0.030397854269110416
7596,16.0,17492,379486,396978,1025,21819,527744,150147,377597,527744,37638,0.0331448581130245,0.7190721258792142,0.0019422295658501091,0.2845072610962891,0.7154927389037109,0.04134390916808149
7597,43.0,579,9176,9755,202,414,12651,3671,8980,12651,872,0.04576713303296182,0.7253181566674571,0.015967117223934867,0.290174689747846,0.709825310252154,0.03272468579558928
7598,,239,4986,5225,12,228,6998,1999,5001,7000,537,0.03414285714285714,0.7122857142857143,0.0017142857142857142,0.2855714285714286,0.7144285714285714,0.03257142857142857
7599,,639,22552,23191,75,1094,30119,8762,21357,30119,1974,0.02121584381951592,0.7487632391513662,0.00249012251402769,0.29091271290547493,0.7090872870945251,0.036322587071283906
7600,23.0,1056,36491,37547,95,1980,49212,13891,35321,49212,3435,0.021458180931480126,0.7415061367146224,0.0019304234739494432,0.282268552385597,0.717731447614403,0.04023408924652524
7601,38.0,110,3129,3239,17,174,4326,1204,3122,4326,311,0.025427646786870088,0.7233009708737864,0.003929727230698105,0.2783171521035599,0.7216828478964401,0.04022191400832178
7602,,560,19513,20073,91,1225,25488,7853,17635,25488,1370,0.02197112366603892,0.7655759573132455,0.0035703075957313245,0.3081057752667922,0.6918942247332078,0.04806183301946014
7603,41.0,189,3606,3795,31,108,4937,1431,3506,4937,428,0.03828235770710958,0.7304030787927891,0.006279116872594693,0.28985213692525824,0.7101478630747418,0.02187563297549119
7604,23.0,1167,14710,15877,29,1375,21598,6149,15449,21598,1540,0.05403278081303824,0.6810815816279285,0.0013427169182331697,0.28470228724881935,0.7152977127511807,0.06366330215760718
7605,23.0,81,1271,1352,3,82,1900,534,1366,1900,136,0.04263157894736842,0.6689473684210526,0.0015789473684210526,0.2810526315789474,0.7189473684210527,0.0431578947368421
7606,33.0,1152,20443,21595,203,1221,29243,8301,20943,29244,2143,0.03939269593762823,0.6990493776501162,0.006941594857064697,0.28385309807139925,0.7161469019286008,0.04175215428805909
7607,25.0,2290,55776,58066,285,2677,77076,21888,55188,77076,5927,0.029710934661892157,0.7236493850225751,0.0036976490736416005,0.28397944885567494,0.7160205511443251,0.034731952877679176
7608,,402,13398,13800,7,461,18370,5266,13104,18370,1311,0.021883505715841044,0.7293413173652694,0.0003810560696788242,0.2866630375612412,0.7133369624387589,0.025095264017419707
7609,33.0,1318,44451,45769,101,3007,60900,17163,43737,60900,4817,0.021642036124794744,0.7299014778325124,0.0016584564860426928,0.2818226600985222,0.7181773399014778,0.049376026272578
7610,37.0,23629,212978,236607,1606,15162,303304,98832,204472,303304,16497,0.07790533590061456,0.7021931791206183,0.005295017540157729,0.32585129111386596,0.6741487088861341,0.04998944952918524
7611,15.0,3105,67488,70593,141,4010,92743,26435,66308,92743,6440,0.033479615712237044,0.7276883430555405,0.0015203303753383004,0.28503498916360265,0.7149650108363974,0.043237764575224005
7612,,519,10672,11191,46,786,14826,4196,10630,14826,1027,0.03500607041683529,0.7198165385134224,0.003102657493592338,0.28301632267637933,0.7169836773236207,0.05301497369486038
7613,37.0,4968,111036,116004,1162,4895,147919,43956,103963,147919,9136,0.03358594906671895,0.7506540741892522,0.007855650727763168,0.29716263630770895,0.7028373636922911,0.033092435724957577
7614,,78,2416,2494,8,103,3308,942,2366,3308,224,0.02357920193470375,0.7303506650544136,0.0024183796856106408,0.28476420798065294,0.7152357920193471,0.031136638452237003
7615,,140,6064,6204,18,342,8048,2531,5517,8048,616,0.01739562624254473,0.7534791252485089,0.0022365805168986083,0.31448807157057657,0.6855119284294234,0.04249502982107356
7616,17.0,365,9474,9839,25,261,12847,3753,9094,12847,945,0.028411302249552423,0.7374484315404375,0.0019459796061337277,0.29213045847279523,0.7078695415272048,0.020316027088036117
7617,26.0,215,4857,5072,21,248,6697,1940,4757,6697,544,0.03210392713155144,0.7252501119904435,0.0031357324175003733,0.28968194714051065,0.7103180528594893,0.037031506644766315
7618,35.0,312,6330,6642,44,339,8651,2434,6217,8651,503,0.0360651947751705,0.7317073170731707,0.005086117211883019,0.28135475667552884,0.7186452433244711,0.03918622124609872
7619,,1341,4691,6032,34,722,8837,2209,6628,8837,271,0.15174833088152087,0.5308362566481838,0.003847459545094489,0.24997170985628606,0.750028290143714,0.08170193504583004
7620,15.0,340,6227,6567,55,566,8862,2294,6568,8862,499,0.03836605732340329,0.7026630557436244,0.0062062739787858276,0.25885804558790343,0.7411419544120966,0.06386820130895961
7621,24.0,1114,30584,31698,148,917,40395,12173,28222,40395,3254,0.027577670503775218,0.7571234063621736,0.0036638197796757025,0.3013491768783265,0.6986508231216735,0.022700829310558238
7622,16.0,621,14255,14876,69,2524,21665,5533,16132,21665,1376,0.02866374336487422,0.657973690283868,0.0031848603738749135,0.2553888760673898,0.7446111239326102,0.11650126932840987
7623,,140,2601,2741,8,68,3698,1053,2645,3698,285,0.03785830178474851,0.7033531638723635,0.002163331530557058,0.28474851270957274,0.7152514872904273,0.01838831800973499
7624,23.0,83,1909,1992,10,75,2601,732,1869,2601,162,0.031910803537101115,0.7339484813533257,0.0038446751249519417,0.28143021914648214,0.7185697808535179,0.02883506343713956
7625,25.0,250,5152,5402,11,169,7289,2085,5204,7289,584,0.03429825764851146,0.7068184936205241,0.001509123336534504,0.28604746878858556,0.7139525312114144,0.023185622170393744
7626,27.0,1349,109565,110942,532,5415,146435,42598,103843,146441,13065,0.00921190103864355,0.7481852759814532,0.0036328623814368926,0.2908884806850541,0.709111519314946,0.036977349239625514
7627,26.0,281,9191,9472,30,351,12222,3586,8636,12222,934,0.022991327115038457,0.7520045819014891,0.002454590083456063,0.29340533464244806,0.706594665357552,0.028718703976435934
7628,,494,8059,8553,34,324,11476,3244,8232,11476,707,0.04304635761589404,0.7022481700941094,0.0029627047751829907,0.28267689090275355,0.7173231090972464,0.028232833739979087
7629,34.0,98,8080,8178,21,434,10820,3057,7763,10820,925,0.009057301293900186,0.7467652495378928,0.0019408502772643253,0.2825323475046211,0.7174676524953789,0.04011090573012939
7630,,233,80308,80541,236,3560,107839,30730,77109,107839,10039,0.0021606283441055647,0.7447027513237326,0.0021884475931713016,0.2849618412633648,0.7150381587366351,0.03301217555800777
7631,24.0,227,7158,7385,15,335,9568,2849,6719,9568,638,0.023724916387959868,0.74811872909699,0.0015677257525083612,0.2977633779264214,0.7022366220735786,0.035012541806020064
7632,24.0,203,5166,5369,25,227,7009,2078,4931,7009,439,0.02896276216293337,0.7370523612498217,0.0035668426309031246,0.29647595948066774,0.7035240405193323,0.03238693108860037
7633,45.0,5256,143025,148281,750,6101,193073,55951,137122,193073,14612,0.027222863890859934,0.7407819840164083,0.0038845410803167715,0.28979194397973823,0.7102080560202617,0.03159944684135016
7634,,97,2012,2109,10,114,2782,788,1994,2782,183,0.03486700215672178,0.7232207045291158,0.0035945363048166786,0.28324946081955427,0.7167505391804457,0.040977713874910136
7635,27.0,3679,68170,71849,356,3112,95330,26806,68524,95330,5928,0.038592258470575895,0.7150949333892793,0.0037343963075632015,0.2811916500576943,0.7188083499423057,0.0326444980593727
7636,,112,5268,5380,9,179,7312,2077,5235,7312,621,0.015317286652078774,0.7204595185995624,0.0012308533916849016,0.28405361050328226,0.7159463894967177,0.024480306345733043
7637,,393,15463,15856,30,420,20067,5938,14166,20104,1542,0.0195483485873458,0.7691504178272981,0.0014922403501790688,0.2953641066454437,0.7046358933545563,0.020891364902506964
7638,,294,8321,8615,30,403,11331,3274,8057,11331,810,0.025946518400847232,0.7343570735151355,0.0026476039184537992,0.28894184096725795,0.711058159032742,0.03556614597122937
7639,,180,3879,4059,23,207,5355,1555,3800,5355,409,0.03361344537815126,0.7243697478991596,0.004295051353874884,0.2903828197945845,0.7096171802054155,0.03865546218487395
7640,23.0,64,1865,1929,6,76,2714,759,1955,2714,214,0.023581429624170966,0.687177597641857,0.002210759027266028,0.2796610169491525,0.7203389830508474,0.02800294767870302
7641,17.0,339,10468,10807,17,465,14253,4148,10105,14253,1104,0.023784466428120397,0.7344418718866204,0.0011927313548024978,0.2910264505718094,0.7089735494281906,0.03262471058724479
7642,16.0,741,19210,19951,79,1176,26652,7687,18965,26652,2071,0.02780279153534444,0.7207714242833558,0.002964130271649407,0.2884211316223923,0.7115788683776076,0.04412426834759117
7643,,195,5987,6182,4,209,8396,2395,6001,8396,608,0.023225345402572654,0.7130776560266794,0.0004764173415912339,0.28525488327775134,0.7147451167222487,0.024892806098141974
7644,16.0,83,3120,3203,2,123,4390,1244,3146,4390,406,0.018906605922551254,0.7107061503416856,0.00045558086560364467,0.283371298405467,0.7166287015945331,0.028018223234624145
7645,34.0,99,1990,2089,3,203,2891,763,2128,2891,190,0.03424420615703909,0.6883431338637149,0.0010377032168799724,0.2639225181598063,0.7360774818401937,0.07021791767554479
7646,17.0,383,7617,8000,31,451,10720,3068,7652,10720,844,0.035727611940298505,0.7105410447761195,0.0028917910447761193,0.28619402985074627,0.7138059701492537,0.04207089552238806
7647,43.0,356,8853,9209,57,350,12254,3509,8745,12254,858,0.029051738207932103,0.7224579729068059,0.004651542353517219,0.2863554757630162,0.7136445242369839,0.028562102170719764
7648,,1135,34981,36116,46,1137,47237,13917,33320,47237,4423,0.024027774837521436,0.7405423714461121,0.0009738129009039524,0.29462074221478923,0.7053792577852107,0.024070114528865084
7649,14.0,105,3882,3987,18,242,5192,1549,3643,5192,357,0.02022342064714946,0.74768875192604,0.0034668721109399076,0.2983436055469954,0.7016563944530047,0.046610169491525424
7650,,2199,73653,75852,138,4274,98386,28882,69504,98386,7100,0.022350740959079542,0.7486126074848047,0.0014026385867908036,0.29355802654849267,0.7064419734515073,0.04344113999959344
7651,24.0,132,3489,3621,27,195,4847,1368,3479,4847,390,0.027233340210439445,0.7198266969259336,0.005570455952135341,0.2822364349081906,0.7177635650918094,0.04023107076542191
7652,16.0,1202,27221,28423,60,1667,38732,10812,27920,38732,2799,0.031033770525663536,0.7028038830940824,0.0015491066818134876,0.27914902406279046,0.7208509759372096,0.04303934730971806
7653,16.0,127,6747,6874,11,522,9698,2614,7084,9698,825,0.013095483604866983,0.6957104557640751,0.0011342544854609198,0.2695401113631677,0.7304598886368323,0.05382553103732728
7654,16.0,131,2334,2465,0,133,3203,964,2239,3203,197,0.04089915704027474,0.7286918513893225,0.0,0.30096784264751797,0.699032157352482,0.04152357165157665
7655,,82,4141,4223,34,258,5779,1563,4216,5779,445,0.01418930610832324,0.7165599584703236,0.005883370825402319,0.27046201765011246,0.7295379823498875,0.044644402145699945
7656,41.0,117,3374,3491,7,287,4783,1310,3473,4783,322,0.02446163495713987,0.7054150114990592,0.0014635166213673428,0.27388668199874555,0.7261133180012544,0.06000418147606105
7657,16.0,46,2262,2308,17,302,3345,859,2486,3345,114,0.013751868460388639,0.6762331838565022,0.005082212257100149,0.2568011958146487,0.7431988041853512,0.09028400597907324
7658,15.0,407,8975,9382,6,565,12549,3497,9052,12549,902,0.03243286317634871,0.7151964299944219,0.0004781257470714798,0.27866762291816083,0.7213323770818392,0.045023507849231016
7659,14.0,72,2245,2317,19,140,3191,852,2339,3191,271,0.022563459730492008,0.7035412096521466,0.005954246317768724,0.26700094014415543,0.7329990598558446,0.04387339392040113
7660,,1456,64945,66401,161,3570,88527,25470,63057,88527,7618,0.016446959684615993,0.7336179922509517,0.0018186541958950377,0.2877088345928361,0.7122911654071639,0.040326679995933444
7661,,367,10882,11249,8,499,14781,4311,10470,14781,1284,0.024829172586428524,0.7362154116771531,0.000541235369731412,0.29165820986401464,0.7083417901359854,0.03375955618699682
7662,23.0,113,3010,3123,16,242,4288,1181,3107,4288,251,0.026352611940298507,0.7019589552238806,0.0037313432835820895,0.275419776119403,0.7245802238805971,0.05643656716417911
7663,24.0,152,3449,3601,25,222,4770,1379,3391,4770,367,0.031865828092243184,0.7230607966457023,0.005241090146750524,0.2890985324947589,0.7109014675052411,0.04654088050314465
7664,35.0,688,22183,22871,29,1198,30016,8767,21249,30016,2216,0.022921108742004266,0.7390391791044776,0.0009661513859275053,0.2920775586353945,0.7079224413646056,0.03991204690831557
7665,26.0,63,3640,3703,7,196,4946,1432,3514,4946,464,0.012737565709664375,0.7359482410028305,0.0014152850788515972,0.2895268904164982,0.7104731095835018,0.03962798220784472
7666,,738,13212,13950,18,1016,18658,5262,13396,18658,1364,0.03955407867938686,0.7081144817236574,0.0009647336263265087,0.2820237967627827,0.7179762032372172,0.05445385357487405
7667,,213,4003,4216,8,405,5928,1584,4344,5928,431,0.035931174089068825,0.6752699055330634,0.001349527665317139,0.26720647773279355,0.7327935222672065,0.06831983805668017
7668,,57,2648,2705,2,90,3680,1032,2648,3680,297,0.01548913043478261,0.7195652173913043,0.0005434782608695652,0.28043478260869564,0.7195652173913043,0.024456521739130436
7669,27.0,1729,57366,59095,41,1458,76504,22491,54013,76504,6229,0.022600125483634843,0.7498431454564467,0.0005359196904737007,0.29398462825473176,0.7060153717452682,0.019057827041723308
7670,17.0,1516,23592,25108,45,1353,33427,9611,23816,33427,2298,0.04535255930834355,0.7057767672839321,0.0013462171298650792,0.2875220630029617,0.7124779369970383,0.04047626170461004
7671,,684,7384,8068,79,866,11672,2974,8698,11672,724,0.05860178204249486,0.63262508567512,0.006768334475668266,0.2547978067169294,0.7452021932830706,0.07419465387251542
7672,15.0,380,14375,14755,95,1159,20446,5558,14888,20446,1469,0.018585542404382274,0.7030715054289347,0.0046463856010955686,0.27183801232514915,0.7281619876748509,0.05668590433336594
7673,,983,17947,18930,61,1359,25808,7184,18624,25808,1846,0.03808896466212027,0.6954045257284563,0.0023636081835089894,0.27836329820210787,0.7216367017978921,0.05265809051456913
7674,26.0,446,9884,10330,59,432,13701,4006,9695,13701,974,0.032552368440259834,0.721407196554996,0.004306255017881906,0.292387416976863,0.707612583023137,0.03153054521567769
7675,34.0,86,3345,3431,6,103,4275,1341,2934,4275,267,0.020116959064327485,0.7824561403508772,0.0014035087719298245,0.3136842105263158,0.6863157894736842,0.02409356725146199
7676,24.0,106,2821,2927,8,182,3834,1136,2698,3834,257,0.02764736567553469,0.7357850808555034,0.0020865936358894104,0.2962962962962963,0.7037037037037037,0.04747000521648409
7677,25.0,1007,22798,23805,82,1003,31522,9061,22461,31522,2296,0.0319459425163378,0.7232409111097011,0.002601357781866633,0.2874500348962629,0.712549965103737,0.031819047014783323
7678,,175,7087,7262,29,284,9563,2792,6771,9563,733,0.018299696747882465,0.7410854334413887,0.00303252117536338,0.2919585904005019,0.708041409599498,0.029697793579420685
7679,40.0,88,2023,2111,17,114,2938,805,2133,2938,226,0.029952348536419333,0.6885636487406399,0.005786249149081007,0.27399591558883596,0.726004084411164,0.03880190605854323
7680,39.0,967,26837,27804,131,1101,36723,10566,26157,36723,3087,0.02633227132859516,0.7307954143180023,0.0035672466846390547,0.2877215913732538,0.7122784086267462,0.029981210685401518
7681,,599,9048,9647,64,321,12183,3808,8375,12183,664,0.049166871870639416,0.7426742181728638,0.005253221702372158,0.3125666912911434,0.6874333087088565,0.026348190100960355
7682,26.0,4056,120524,124580,435,4576,162844,47032,115812,162844,13521,0.024907273218540443,0.7401193780550711,0.0026712682076097368,0.2888162904374739,0.7111837095625261,0.02810051337476358
7683,17.0,2455,50942,53397,146,2500,70286,20120,50166,70286,5274,0.03492871980195202,0.7247816065788351,0.002077227328344194,0.2862589989471587,0.7137410010528412,0.03556896110178414
7684,23.0,265,6128,6393,41,367,8561,2408,6153,8561,443,0.030954327765447962,0.7158042284779815,0.004789160144842892,0.2812755519215045,0.7187244480784954,0.04286882373554491
7685,,16,8126,8142,22,356,10733,3121,7612,10733,1093,0.0014907295257616695,0.7571042578962079,0.002049753097922296,0.2907854281188857,0.7092145718811144,0.033168731948197146
7686,17.0,277,9562,9839,15,359,12867,3699,9168,12867,1175,0.021527939690681588,0.7431413693945753,0.0011657729074376311,0.28747959897411984,0.7125204010258802,0.027900831584673973
7687,25.0,4222,75788,80010,454,4567,108076,30031,78045,108076,7529,0.03906510233539361,0.7012472704393204,0.004200747622043747,0.27786927717532106,0.7221307228246789,0.04225730041822421
7688,17.0,5354,141242,146596,864,6567,194431,56022,138409,194431,14811,0.02753676111319697,0.7264376565465384,0.004443735824019832,0.28813306520050813,0.7118669347994918,0.03377547819020629
7689,,871,12292,13163,36,656,17490,4936,12554,17490,1498,0.049799885648942256,0.7028016009148085,0.002058319039451115,0.28221841052029734,0.7177815894797027,0.0375071469411092
7690,39.0,99,2844,2943,12,107,3743,1130,2613,3743,286,0.026449372161367887,0.7598183275447502,0.0032059845044082286,0.3018968741651082,0.6981031258348918,0.028586695164306706
7691,44.0,261,5493,5754,31,292,7847,2161,5686,7847,481,0.033261118898942274,0.700012743723716,0.003950554351981649,0.27539186950426914,0.7246081304957308,0.03721167325092392
7692,26.0,896,20088,20984,124,970,27478,8009,19469,27478,1938,0.032607904505422516,0.7310575733313924,0.004512701069946867,0.29146953926777786,0.7085304607322221,0.035300968047165
7693,17.0,1587,24683,26270,174,1843,35003,9624,25379,35003,2129,0.04533897094534754,0.7051681284461332,0.004971002485501243,0.27494786161186185,0.7250521383881382,0.05265262977459075
7694,,1009,17890,18899,223,1769,26184,7121,19063,26184,1493,0.038534983195844794,0.683241674304919,0.00851665139016193,0.27195997555759244,0.7280400244424076,0.06756034219370607
7695,,681,11706,12387,76,665,17059,4694,12365,17059,1225,0.0399202766867929,0.686206694413506,0.004455126326279383,0.27516267073099243,0.7248373292690076,0.038982355354944605
7696,25.0,45,1916,1961,6,192,2664,650,2014,2664,186,0.016891891891891893,0.7192192192192193,0.0022522522522522522,0.243993993993994,0.756006006006006,0.07207207207207207
7697,23.0,234,1730,1964,2,158,2738,737,2001,2738,178,0.08546384222059898,0.6318480642804967,0.0007304601899196494,0.2691745799853908,0.7308254200146092,0.0577063550036523
7698,40.0,100,2533,2633,12,207,3443,971,2472,3443,205,0.02904443799012489,0.7356956142898635,0.0034853325588149867,0.2820214928841127,0.7179785071158873,0.060121986639558526
7699,16.0,175,4726,4901,41,295,6468,1837,4631,6468,458,0.027056277056277056,0.730674087816945,0.0063388991960420535,0.28401360544217685,0.7159863945578231,0.04560915275200989
7700,23.0,153,4899,5052,25,357,6895,1953,4942,6895,554,0.022189992748368383,0.710514865844815,0.0036258158085569255,0.283248730964467,0.716751269035533,0.05177664974619289
7701,23.0,376,13064,13440,20,729,17637,5116,12521,17637,1412,0.021318818393150762,0.7407155411918127,0.0011339797017633384,0.29007200771106195,0.709927992288938,0.04133356012927369
7702,,398,6747,7145,15,510,9826,2725,7101,9826,715,0.04050478322817016,0.6866476694484022,0.001526562181966212,0.2773254630571952,0.7226745369428048,0.05190311418685121
7703,33.0,454,11264,11718,76,681,15636,4420,11216,15636,1122,0.029035558966487594,0.7203888462522384,0.004860578152980302,0.2826809925812228,0.7173190074187772,0.04355333844973139
7704,,428,11300,11728,29,399,15251,4526,10725,15251,1207,0.02806373352567045,0.7409350206543833,0.0019015146547767359,0.29676742508687953,0.7032325749131204,0.026162218870893712
7705,25.0,1902,35060,36962,149,3114,51300,13873,37427,51300,3985,0.037076023391812866,0.6834307992202729,0.0029044834307992203,0.27042884990253413,0.7295711500974659,0.06070175438596491
7706,,2584,44612,47196,184,2676,64421,17821,46600,64421,4295,0.040111143881653495,0.6925071017214883,0.0028562114838329117,0.27663339594231695,0.723366604057683,0.04153924962356995
7707,13.0,192,11645,11837,281,1850,17802,4289,13513,17802,722,0.010785305021907651,0.6541399842714302,0.015784743287271093,0.2409279856195933,0.7590720143804067,0.10392090776317267
7708,,7810,183943,191753,892,8408,257138,73307,183831,257138,20095,0.0303727959305898,0.7153474010064634,0.003468954413583368,0.28508816277640797,0.714911837223592,0.0326983954141356
7709,26.0,3410,60754,64164,235,3549,86473,24508,61965,86473,6306,0.039434274282145874,0.7025776832074752,0.0027176112775085864,0.2834179454858742,0.7165820545141258,0.04104171244203393
7710,,52,1937,1989,8,58,2577,785,1792,2577,240,0.02017850213426465,0.7516492045013582,0.0031043849437330227,0.30461777260380285,0.6953822273961972,0.022506790842064417
7711,15.0,417,9104,9521,3,1082,13302,3594,9708,13302,911,0.03134866937302661,0.6844083596451661,0.0002255299954894001,0.27018493459630133,0.7298150654036987,0.0813411517065103
7712,,755,28765,29520,102,1004,37861,11438,26423,37861,3116,0.01994136446475265,0.7597527799054435,0.0026940651329864502,0.3021050685401865,0.6978949314598135,0.026518052877631336
7713,16.0,1815,19853,21668,2271,6402,37684,7045,30639,37684,946,0.04816367689204968,0.526828362169621,0.060264303152531576,0.18694936843222587,0.8130506315677741,0.1698864239465025
7714,,142,4113,4255,2,162,5550,1679,3871,5550,459,0.025585585585585584,0.7410810810810811,0.00036036036036036037,0.30252252252252254,0.6974774774774775,0.02918918918918919
7715,,1450,38101,39551,200,2484,52839,14695,38144,52839,3711,0.027441851662597702,0.721077234618369,0.003785082987944511,0.2781089725392229,0.721891027460777,0.04701073071027082
7716,16.0,650,10263,10913,79,660,15438,4167,11271,15438,1236,0.04210389946884312,0.6647881849980567,0.00511724316621324,0.2699183832102604,0.7300816167897396,0.04275165176836378
7717,17.0,2585,38863,41448,426,2270,57118,15659,41459,57118,3585,0.04525718687629118,0.6803984733359011,0.007458244336286285,0.27415175601386604,0.725848243986134,0.03974228789523443
7718,16.0,67,2006,2073,5,174,2776,746,2030,2776,206,0.024135446685878963,0.7226224783861671,0.0018011527377521613,0.2687319884726225,0.7312680115273775,0.06268011527377522
7719,16.0,347,6357,6704,12,322,8993,2537,6456,8993,620,0.038585566551762485,0.7068831313243634,0.0013343711775825643,0.28210830646058044,0.7178916935394195,0.03580562659846547
7720,17.0,13750,355660,369410,3372,21422,495044,141173,353871,495044,43853,0.02777530886143454,0.7184411890660224,0.006811515744055074,0.28517263111965807,0.7148273688803419,0.043272921194883684
7721,,20,2541,2561,0,96,3295,978,2317,3295,300,0.006069802731411229,0.7711684370257966,0.0,0.29681335356600913,0.7031866464339909,0.0291350531107739
7722,15.0,642,12522,13164,28,539,17240,5013,12227,17240,1394,0.03723897911832947,0.7263341067285383,0.0016241299303944316,0.2907772621809745,0.7092227378190256,0.03126450116009281
7723,,89,2906,2995,11,149,3904,1123,2781,3904,301,0.022797131147540985,0.7443647540983607,0.0028176229508196722,0.28765368852459017,0.7123463114754098,0.038165983606557374
7724,17.0,268,5125,5393,25,467,7602,2058,5544,7602,571,0.03525388055774796,0.67416469350171,0.0032886082609839516,0.27071823204419887,0.7292817679558011,0.06143120231518021
7725,,3255,98999,102254,411,3973,132709,38487,94222,132709,10840,0.024527349313158867,0.7459855774664869,0.0030970017105094606,0.29001047404471436,0.7099895259552856,0.02993768320159145
7726,41.0,970,25297,26267,175,1280,36116,10025,26091,36116,2683,0.02685790231476354,0.7004374792335807,0.004845497840292391,0.27757780485103556,0.7224221951489644,0.03544135563185292
7727,14.0,394,16710,17104,79,308,21718,6517,15201,21718,1709,0.018141633667925223,0.7694078644442398,0.0036375356846855143,0.30007367160880377,0.6999263283911963,0.014181784694723271
7728,24.0,440,9505,9945,34,456,13123,3754,9369,13123,988,0.03352891869237217,0.7243008458431761,0.0025908709898651225,0.2860626381162844,0.7139373618837156,0.034748152099367526
7729,17.0,112,4820,4932,5,251,6767,1883,4884,6767,560,0.016550908822225506,0.7122801832422048,0.0007388798581350672,0.2782621545736663,0.7217378454263337,0.03709176887838037
7730,23.0,1646,48844,50490,64,1972,65227,19242,45985,65227,4371,0.025234948717555612,0.7488310055651801,0.000981188771520996,0.29500053658760944,0.7049994634123906,0.030232879022490687
7731,16.0,648,29500,30148,444,1749,40363,11298,29065,40363,2922,0.01605430716250031,0.7308673785397517,0.01100017342615762,0.2799098183980378,0.7200901816019621,0.043331764239526296
7732,26.0,163,3538,3701,50,142,4912,1407,3505,4912,389,0.033184039087947884,0.7202768729641694,0.01017915309446254,0.2864413680781759,0.7135586319218241,0.028908794788273615
7733,17.0,230,3428,3658,2,228,4915,1394,3521,4915,324,0.04679552390640895,0.6974567650050865,0.0004069175991861648,0.2836215666327569,0.7163784333672432,0.04638860630722279
7734,,190,9546,9736,38,1315,13702,3546,10156,13702,948,0.01386658881915049,0.6966866150926871,0.0027733177638300977,0.25879433659319806,0.7412056634068019,0.0959713910378047
7735,15.0,1784,35396,37180,173,2680,50136,14141,35995,50136,4070,0.03558321365884794,0.7059996808680389,0.003450614329025052,0.2820528163395564,0.7179471836604436,0.05345460347853838
7736,15.0,492,12171,12663,815,1324,18924,4411,14513,18924,899,0.02599873176918199,0.6431515535827521,0.04306700486155147,0.23309025575988163,0.7669097442401184,0.06996406679348975
7737,13.0,1871,21929,23800,68,4958,34474,8948,25526,34474,1241,0.054272785287463016,0.6361025700527934,0.0019725010152578755,0.2595579277136393,0.7404420722863607,0.14381852990659627
7738,26.0,11,2290,2301,5,102,3132,877,2255,3132,306,0.00351213282247765,0.731162196679438,0.0015964240102171138,0.28001277139208175,0.7199872286079183,0.032567049808429116
7739,23.0,226,5000,5226,47,191,7202,1974,5229,7203,521,0.031375815632375396,0.6941552131056504,0.006525059003193114,0.27405247813411077,0.7259475218658892,0.026516729140635846
7740,17.0,533,9028,9561,11,504,12860,3584,9276,12860,937,0.041446345256609646,0.7020217729393469,0.0008553654743390358,0.2786936236391913,0.7213063763608087,0.039191290824261274
7741,27.0,236,7990,8226,32,390,10877,3114,7763,10877,944,0.02169715914314609,0.7345775489565137,0.0029419876804265884,0.28629217615151237,0.7137078238484876,0.03585547485519904
7742,24.0,44,5211,5255,29,315,6958,1954,5004,6958,549,0.006323656223052601,0.7489221040528887,0.004167864328830124,0.28082782408738144,0.7191721759126186,0.04527162977867203
7743,46.0,1271,25001,26272,1521,3192,39432,9873,29559,39432,2102,0.03223270440251572,0.634028200446338,0.03857273280584297,0.2503804017041996,0.7496195982958004,0.08094948265368229
7744,,41,1880,1921,14,81,2559,707,1852,2559,223,0.016021883548261038,0.7346619773348965,0.005470887065259867,0.2762797967956233,0.7237202032043767,0.031652989449003514
7745,,912,16897,17809,181,1397,24180,6681,17499,24180,1525,0.03771712158808933,0.6988006617038875,0.0074855252274607115,0.27630272952853596,0.723697270471464,0.05777502067824648
7746,26.0,4122,98393,104509,494,6498,142709,39421,103288,142709,9546,0.028883952658907287,0.6894659762173374,0.00346158966848622,0.2762334540918933,0.7237665459081067,0.045533217947011054
7747,25.0,213,5387,5600,14,248,7550,2182,5368,7550,686,0.028211920529801326,0.7135099337748344,0.0018543046357615894,0.2890066225165563,0.7109933774834437,0.0328476821192053
7748,16.0,462,19910,20372,61,910,27668,7731,19937,27668,2415,0.016697990458291168,0.7196038745120718,0.002204713025878271,0.2794202689027035,0.7205797310972966,0.032889981205725026
7749,14.0,118,5141,5259,11,205,6901,1995,4906,6901,587,0.01709897116359948,0.7449644978988552,0.0015939718881321549,0.289088537893059,0.710911462106941,0.029705839733371976
7750,,309,4828,5137,37,155,6869,1924,4945,6869,567,0.04498471393215898,0.7028679574901733,0.005386519143980201,0.2800989954869704,0.7199010045130295,0.022565147765322462
7751,24.0,405,4751,5156,56,251,7185,1987,5198,7185,492,0.05636743215031315,0.6612386917188587,0.007794015309672929,0.2765483646485734,0.7234516353514265,0.0349338900487126
7752,25.0,3722,46004,49726,409,2792,66675,18986,47689,66675,4826,0.05582302212223472,0.6899737532808399,0.006134233220847394,0.2847544056992876,0.7152455943007124,0.04187476565429321
7753,,52,1568,1620,2,74,2232,621,1611,2232,170,0.023297491039426525,0.7025089605734767,0.0008960573476702509,0.2782258064516129,0.7217741935483871,0.033154121863799284
7754,14.0,94,2246,2340,34,118,3129,878,2251,3129,210,0.03004154682007031,0.7178012144455097,0.010866091403004154,0.2806008309364014,0.7193991690635986,0.03771172898689677
7755,27.0,102,2102,2204,31,130,2986,794,2192,2986,206,0.03415941058271936,0.7039517749497656,0.010381781647689216,0.26590756865371734,0.7340924313462827,0.043536503683858
7756,17.0,1086,30615,31701,170,3039,43468,12023,31445,43468,2971,0.024983896199503083,0.7043112174473176,0.003910922977822766,0.2765942762491948,0.7234057237508051,0.06991349958590228
7757,,3014,88028,91042,132,3416,117188,34936,82252,117188,8587,0.025719356930743762,0.7511690616786701,0.001126395194047172,0.2981192613578182,0.7018807386421818,0.029149742294432877
7758,,286,3302,3588,27,385,4942,1334,3608,4942,293,0.05787130716309186,0.6681505463375151,0.0054633751517604206,0.2699312019425334,0.7300687980574666,0.07790368271954674
7759,13.0,535,2309,2844,4,164,4076,1142,2934,4076,209,0.13125613346418058,0.56648675171737,0.0009813542688910696,0.2801766437684004,0.7198233562315997,0.040235525024533855
7760,,167,5430,5597,78,238,7570,2140,5430,7570,597,0.022060766182298547,0.7173051519154557,0.010303830911492734,0.28269484808454426,0.7173051519154557,0.03143989431968296
7761,23.0,663,17634,18297,127,715,23535,7004,16531,23535,1795,0.02817080943275972,0.7492670490758445,0.005396218398130444,0.2975993201614617,0.7024006798385384,0.03038028468238793
7762,15.0,59124,720126,779250,6708,65289,1045642,291708,753934,1045642,66506,0.056543252853271005,0.6886926883197118,0.006415197553273491,0.27897502204387353,0.7210249779561265,0.0624391522146203
7763,,69,1634,1703,37,95,2352,668,1684,2352,175,0.029336734693877552,0.6947278911564626,0.015731292517006803,0.28401360544217685,0.7159863945578231,0.04039115646258504
7764,,99,1834,1933,85,169,2683,650,2033,2683,136,0.03689899366380917,0.6835631755497578,0.03168095415579575,0.2422661200149087,0.7577338799850913,0.06298919120387626
7765,37.0,283,6400,6683,74,468,9291,2490,6801,9291,597,0.03045958454418254,0.6888386610698526,0.00796469701862017,0.26800129157248953,0.7319987084275105,0.05037132709073297
7766,25.0,1763,44100,45890,90,2256,60177,17701,42476,60177,4711,0.02929690745633714,0.7328381275238047,0.0014955880153547036,0.2941489273310401,0.7058510726689599,0.0374894062515579
7767,,1286,31714,33000,31,1872,43653,12630,31023,43653,3159,0.02945960186012416,0.7265021877076031,0.0007101459235333196,0.28932719400728474,0.7106728059927153,0.04288365060820562
7768,15.0,714,17041,17755,98,1092,24859,6626,18233,24859,1560,0.028721992035077838,0.6855062552797779,0.003942234200893037,0.2665433042358904,0.7334566957641095,0.043927752524236696
7769,25.0,770,18546,19316,85,471,24455,7552,16903,24455,1612,0.03148640359844612,0.7583725209568596,0.0034757718258024944,0.30881210386424046,0.6911878961357596,0.019259865058270292
7770,17.0,144,2019,2163,22,115,2861,816,2045,2861,171,0.05033205173016428,0.705697308633345,0.007689619014330654,0.28521495980426426,0.7147850401957357,0.04019573575672842
7771,,11235,183619,194854,775,13457,258649,73747,184902,258649,17162,0.04343724506957305,0.7099157545554013,0.0029963386674605355,0.2851238551086608,0.7148761448913392,0.052028037997440546
7772,33.0,269,8455,8724,12,348,11569,3334,8235,11569,998,0.023251793586308238,0.730832396922811,0.001037254732474717,0.2881839398392255,0.7118160601607745,0.03008038724176679
7773,,8,1463,1471,9,75,1998,547,1451,1998,216,0.004004004004004004,0.7322322322322322,0.0045045045045045045,0.27377377377377377,0.7262262262262262,0.03753753753753754
7774,,113,2637,2750,5,162,3718,988,2730,3718,254,0.030392684238838084,0.7092522861753631,0.0013448090371167294,0.26573426573426573,0.7342657342657343,0.04357181280258203
7775,17.0,653,9023,9676,33,743,13154,3630,9524,13154,816,0.049642694237494296,0.6859510415082865,0.0025087425878059905,0.27596168465865895,0.724038315341341,0.05648471947696518
7776,,142,4497,4639,20,289,6180,1741,4439,6180,430,0.022977346278317153,0.7276699029126213,0.003236245954692557,0.28171521035598707,0.718284789644013,0.04676375404530744
7777,,77,2303,2380,38,206,3245,892,2353,3245,194,0.023728813559322035,0.7097072419106317,0.011710323574730355,0.274884437596302,0.725115562403698,0.06348228043143297
7778,27.0,443,4879,5322,4,377,7220,2050,5170,7220,457,0.06135734072022161,0.6757617728531856,0.000554016620498615,0.2839335180055402,0.7160664819944599,0.05221606648199446
7779,25.0,119,2229,2348,35,100,3203,874,2329,3203,252,0.037152669372463316,0.6959100842959726,0.010927255697783328,0.27286918513893227,0.7271308148610678,0.031220730565095223
7780,,148,3499,3647,10,104,4914,1394,3520,4914,469,0.030118030118030117,0.712047212047212,0.002035002035002035,0.2836792836792837,0.7163207163207164,0.021164021164021163
7781,,406,12561,12967,52,1782,18947,4890,14057,18947,1237,0.021428194437114054,0.6629545574497282,0.0027444978096796326,0.2580883517179501,0.7419116482820499,0.09405182878555972
7782,24.0,1820,39516,41336,194,1981,53982,15715,38267,53982,3757,0.03371494201770961,0.7320217850394576,0.0035937905227668484,0.291115557037531,0.708884442962469,0.03669741765773776
7783,14.0,100,2432,2532,38,220,3522,929,2593,3522,290,0.028392958546280524,0.6905167518455423,0.010789324247586598,0.26377058489494604,0.7362294151050539,0.06246450880181715
7784,27.0,232,2279,2511,8,133,3523,948,2575,3523,190,0.06585296622196991,0.64689185353392,0.0022707919386886176,0.2690888447346012,0.7309111552653988,0.03775191598069827
7785,,768,26440,27208,186,1133,35852,10296,25556,35852,2932,0.021421399085127746,0.7374762914202834,0.005187995090929376,0.28718063148499384,0.7128193685150062,0.031602142139908515
7786,16.0,31786,403888,435674,7299,30637,591160,165499,425661,591160,36972,0.053768861222004194,0.6832126666215577,0.012346911157723798,0.2799563569930307,0.7200436430069693,0.05182522498139252
7787,23.0,582,12142,12724,50,1080,19117,4694,14423,19117,1031,0.030444107339017628,0.6351414970968248,0.0026154731390908613,0.2455406182978501,0.7544593817021499,0.05649421980436261
7788,17.0,36,2443,2479,0,35,3112,935,2177,3112,272,0.011568123393316195,0.785025706940874,0.0,0.3004498714652956,0.6995501285347043,0.011246786632390746
7789,13.0,650,11838,12488,130,728,16514,4743,11771,16514,1015,0.039360542569940656,0.7168463122199346,0.00787210851398813,0.28721085139881314,0.7127891486011869,0.04408380767833354
7790,17.0,139,2157,2296,24,156,3051,825,2226,3051,202,0.04555883316945264,0.7069813176007866,0.007866273352999017,0.2704031465093412,0.7295968534906588,0.051130776794493606
7791,16.0,66,2396,2462,35,143,3341,936,2405,3341,270,0.019754564501646213,0.7171505537264292,0.010475905417539658,0.2801556420233463,0.7198443579766537,0.042801556420233464
7792,,3010,41269,44279,294,2519,58020,16343,41679,58022,3512,0.05187687428906277,0.7112646927027679,0.005067043535210782,0.2816690220950674,0.7183309779049326,0.043414566888421637
7793,26.0,2479,47281,49760,405,3385,68458,18598,49860,68458,4425,0.036211983990183765,0.6906570451955943,0.005916036109731514,0.271670221157498,0.7283297788425019,0.049446375880101666
7794,17.0,1452,17424,18876,70,2270,26493,6990,19503,26493,1455,0.05480693013248783,0.657683161589854,0.00264220737553316,0.26384327935681123,0.7361567206431888,0.08568301060657532
7795,15.0,64,3034,3098,13,136,4150,1191,2959,4150,323,0.015421686746987951,0.7310843373493976,0.0031325301204819275,0.2869879518072289,0.7130120481927711,0.0327710843373494
7796,40.0,377,8636,9013,37,334,11712,3383,8329,11712,646,0.03218920765027322,0.737363387978142,0.003159153005464481,0.288849043715847,0.711150956284153,0.02851775956284153
7797,16.0,496,9168,9664,11,520,12860,3623,9237,12860,987,0.038569206842923795,0.7129082426127528,0.0008553654743390358,0.2817262830482115,0.7182737169517885,0.04043545878693624
7798,27.0,72,2109,2181,3,58,2836,838,1998,2836,234,0.02538787023977433,0.7436530324400564,0.0010578279266572638,0.2954866008462623,0.7045133991537377,0.020451339915373765
7799,13.0,429,9822,10251,95,862,14062,3646,10416,14062,872,0.03050775138671597,0.698478168112644,0.00675579576162708,0.2592803299672877,0.7407196700327123,0.06129995733181624
7800,23.0,113,2496,2609,52,85,3388,948,2440,3388,201,0.0333530106257379,0.7367178276269185,0.015348288075560802,0.2798110979929162,0.7201889020070839,0.025088547815820542
7801,16.0,635,10510,11145,73,1405,15473,4088,11385,15473,960,0.041039229625799784,0.6792477218380405,0.004717895689265172,0.2642021585988496,0.7357978414011503,0.09080333484133653
7802,23.0,8394,190829,199223,710,13447,272917,75419,197498,272917,18595,0.030756603656056602,0.699219909349729,0.0026015235401239205,0.27634408996141685,0.7236559100385832,0.049271390202882195
7803,,977,17334,18311,66,875,24014,6970,17044,24014,1496,0.04068460064962105,0.7218289331223453,0.002748396768551678,0.29024735570916965,0.7097526442908304,0.03643707837095028
7804,27.0,1388,81692,83080,1007,5236,111966,33022,78944,111966,6884,0.012396620402622224,0.7296143472125467,0.00899380168979869,0.29492881767679474,0.7050711823232052,0.04676419627386885
7805,,3231,65853,69084,234,3546,91287,26587,64700,91287,5889,0.03539386769200434,0.7213842058562555,0.0025633441782510107,0.2912462891758958,0.7087537108241042,0.038844523316573
7806,25.0,50,1232,1282,4,246,1854,370,1484,1854,84,0.02696871628910464,0.6645091693635383,0.002157497303128371,0.19956850053937433,0.8004314994606256,0.13268608414239483
7807,24.0,552,15996,16548,31,833,21636,6336,15302,21638,1456,0.02551067566318514,0.7392550143266475,0.0014326647564469914,0.29281819022090766,0.7071818097790923,0.03849708845549496
7808,,165,3316,3481,22,211,4864,1319,3545,4864,301,0.03392269736842105,0.6817434210526315,0.004523026315789474,0.27117598684210525,0.7288240131578947,0.043379934210526314
7809,17.0,217,4365,4582,32,204,6459,1737,4722,6459,502,0.03359653197089333,0.6758012076172782,0.004954327295246942,0.2689270784951231,0.7310729215048769,0.03158383650719926
7810,15.0,4192,79836,84028,4468,12190,127299,32901,94398,127299,7186,0.03293034509304865,0.6271533947635095,0.035098468958907766,0.2584545047486626,0.7415454952513374,0.09575880407544443
7811,17.0,6468,111269,117737,395,5554,158168,45001,113167,158168,12283,0.04089322745435233,0.7034861666076577,0.002497344595619847,0.2845139345506044,0.7154860654493955,0.03511456173182945
7812,23.0,69,4132,4201,5,188,5567,1637,3930,5567,489,0.012394467397161846,0.7422310041314891,0.0008981498113885396,0.2940542482486079,0.7059457517513922,0.03377043290820909
7813,15.0,172,2619,2791,4,193,4063,941,3122,4063,233,0.04233325129214866,0.6445975879891706,0.0009844942160964804,0.23160226433669703,0.7683977356633029,0.047501845926655184
7814,27.0,4269,93535,97804,480,3775,128368,37027,91341,128368,9393,0.033255951639037766,0.7286473264364951,0.003739249657235448,0.28844416053845195,0.7115558394615481,0.029407640533466284
7815,,1466,27951,29417,254,1454,39674,11153,28521,39674,3062,0.03695115188788627,0.7045168120179462,0.00640217774865151,0.28111609618389877,0.7188839038161012,0.0366486867973988
7816,36.0,255,5850,6105,15,358,8142,2455,5687,8142,682,0.03131908621960206,0.7184966838614592,0.0018422991893883567,0.30152296732989436,0.6984770326701056,0.04396954065340211
7817,15.0,82,2153,2235,3,123,2995,840,2155,2995,234,0.027378964941569283,0.7188647746243739,0.001001669449081803,0.28046744574290483,0.7195325542570952,0.04106844741235392
7818,15.0,137,7824,7961,16,577,10950,3032,7918,10950,954,0.012511415525114155,0.7145205479452055,0.0014611872146118722,0.2768949771689498,0.7231050228310503,0.05269406392694064
7819,,236,2447,2683,5,119,3633,1069,2564,3633,265,0.06496008808147537,0.6735480319295348,0.0013762730525736307,0.29424717864024225,0.7057528213597578,0.03275529865125241
7820,23.0,504,17479,17983,47,869,24119,6847,17272,24119,1941,0.02089638873916829,0.7246983705792114,0.0019486711721049795,0.28388407479580413,0.7161159252041959,0.03602968613955802
7821,,291,10843,11134,58,615,14691,4141,10550,14691,1164,0.019808045742291197,0.7380709277789123,0.003947995371315772,0.2818732557348036,0.7181267442651964,0.04186236471308965
7822,16.0,2107,33993,36100,379,2045,48026,13301,34725,48026,2994,0.04387206929579811,0.7078041061091909,0.007891558739016365,0.27695414983550576,0.7230458501644942,0.0425811019031358
7823,15.0,1195,38697,39892,283,3160,56987,15482,41505,56987,4030,0.02096969484268342,0.6790496078052889,0.004966044887430467,0.2716759962798533,0.7283240037201467,0.05545124326600804
7824,24.0,179,2076,2255,8,185,3062,838,2224,3062,231,0.05845852384062704,0.6779882429784455,0.002612671456564337,0.2736773350751143,0.7263226649248857,0.060418027433050296
7825,15.0,1269,44801,46070,436,2270,62139,17612,44527,62139,5065,0.020421957224931203,0.7209803826904199,0.007016527462624117,0.2834290864030641,0.7165709135969359,0.036531003073754
7826,,158,5259,5417,46,249,7113,2069,5044,7113,503,0.022212849711795303,0.7393504850274146,0.006467032194573317,0.29087586109939545,0.7091241389006046,0.03500632644453817
7827,14.0,1100,32856,33956,201,2507,47926,12481,35445,47926,2746,0.0229520510787464,0.6855569002211743,0.004193965697116388,0.2604223177398489,0.7395776822601511,0.05230981095856112
7828,42.0,66,3832,3898,1,182,5289,1472,3817,5289,433,0.012478729438457176,0.7245225940631499,0.00018907165815844205,0.2783134808092267,0.7216865191907733,0.034411041784836456
7829,24.0,1393,25668,27061,209,2998,36854,10193,26661,36854,2209,0.03779779671134748,0.6964779942475715,0.005671026211537418,0.2765778477234493,0.7234221522765507,0.08134802192435014
7830,,33,1708,1741,1,57,2279,682,1597,2279,215,0.014480035103115402,0.7494515138218517,0.00043878894251864854,0.29925405879771827,0.7007459412022817,0.025010969723562967
7831,15.0,344,7738,8082,48,368,10905,3040,7865,10905,894,0.031545162769371846,0.7095827602017423,0.004401650618982118,0.2787712058688675,0.7212287941311325,0.03374598807886291
7832,25.0,123,2343,2466,11,186,3338,894,2444,3338,230,0.036848412222887955,0.7019173157579389,0.0032953864589574597,0.2678250449370881,0.732174955062912,0.05572198921509886
7833,,488,12385,12873,96,633,17059,5058,12001,17059,1218,0.028606600621372883,0.7260097309338179,0.005627527991089747,0.29650038103054105,0.7034996189694589,0.03710651269124802
7834,39.0,1505,26860,28365,379,1279,37970,10598,27372,37970,2082,0.03963655517513827,0.7074005794047933,0.009981564392941795,0.2791150908612062,0.7208849091387938,0.033684487753489596
7835,,273,7301,7574,17,327,9741,2796,6945,9741,580,0.028025870033877427,0.7495123703931834,0.0017452006980802793,0.28703418540190945,0.7129658145980905,0.033569448721897134
7836,15.0,1844,31210,33054,179,1669,44659,12354,32305,44659,2991,0.0412906692939833,0.6988512953715936,0.004008150652723975,0.2766295707472178,0.7233704292527822,0.037372086253610694
7837,,240,5456,5696,14,264,7503,2169,5334,7503,594,0.03198720511795282,0.7271757963481275,0.0018659202985472478,0.2890843662534986,0.7109156337465014,0.0351859256297481
7838,,102,1962,2064,15,211,3024,769,2255,3024,193,0.03373015873015873,0.6488095238095238,0.00496031746031746,0.2542989417989418,0.7457010582010583,0.06977513227513228
7839,24.0,116,2731,2847,15,100,3728,1105,2623,3728,270,0.03111587982832618,0.7325643776824035,0.004023605150214592,0.29640557939914164,0.7035944206008584,0.02682403433476395
7840,25.0,601,24553,25154,65,716,32638,9643,22995,32638,2546,0.018414118512163735,0.7522826153563331,0.0019915435994852628,0.29545315276671363,0.7045468472332863,0.021937618726637662
7841,33.0,505,7934,8439,83,237,11061,3116,7945,11061,527,0.04565590814573728,0.7172950004520386,0.007503842328903354,0.28171051442003436,0.7182894855799656,0.02142663411988066
7842,25.0,107,2601,2708,17,175,3789,1028,2761,3789,290,0.02823964106624439,0.6864608076009501,0.0044866719451042494,0.2713116917392452,0.7286883082607548,0.046186328846661386
7843,15.0,812,18445,19257,105,1679,26997,7366,19631,26997,1795,0.030077416009186207,0.6832240619328074,0.00388932103567063,0.27284513094047486,0.7271548690595251,0.06219209541800941
7844,,84,1753,1837,3,161,2544,694,1850,2544,190,0.0330188679245283,0.6890723270440252,0.0011792452830188679,0.2727987421383648,0.7272012578616353,0.06328616352201258
7845,34.0,1842,2879,4721,29,208,6306,1753,4553,6306,318,0.2921027592768792,0.45654931810973676,0.0045987947986045035,0.2779892166190929,0.7220107833809071,0.032984459245163335
7846,16.0,159,6866,7025,13,374,9232,2700,6532,9232,609,0.017222703639514732,0.7437175043327556,0.0014081455805892548,0.29246100519930673,0.7075389948006933,0.04051126516464471
7847,23.0,1175,29847,31022,106,1343,40901,11864,29037,40901,3043,0.028727903963228284,0.7297376592259358,0.0025916236766827215,0.2900662575487152,0.7099337424512848,0.03283538299797071
7848,26.0,636,16337,16973,20,769,22025,6468,15557,22025,1642,0.02887627695800227,0.7417480136208854,0.0009080590238365494,0.2936662883087401,0.7063337116912599,0.03491486946651532
7849,,1164,38231,39395,174,918,49825,15141,34684,49825,3557,0.023361766181635726,0.7673055694932263,0.003492222779729052,0.30388359257400904,0.696116407425991,0.018424485699949825
7850,,331,7295,7626,51,383,10230,3005,7225,10230,685,0.03235581622678397,0.7130987292277615,0.00498533724340176,0.2937438905180841,0.706256109481916,0.03743890518084066
7851,26.0,1435,41248,42683,269,1914,54536,16112,38424,54536,3814,0.026312894235000734,0.7563444330350594,0.004932521637083761,0.2954378758984891,0.704562124101511,0.035096083321108994
7852,14.0,485,22276,22761,934,1667,32392,8467,23925,32392,2092,0.014972832798221784,0.6877006668313164,0.028834280069152878,0.2613917016547296,0.7386082983452704,0.05146332427759941
7853,40.0,123,3597,3720,6,227,4885,1361,3524,4885,297,0.02517911975435005,0.7363357215967247,0.0012282497441146367,0.2786079836233367,0.7213920163766633,0.04646878198567042
7854,17.0,791,88395,89186,492,3161,120760,33555,87205,120760,10815,0.006550182179529645,0.7319890692282213,0.004074196753892017,0.2778651871480623,0.7221348128519377,0.026175886054985095
7855,35.0,363,7880,8243,65,304,11206,3115,8091,11206,960,0.0323933606996252,0.7031947171158308,0.00580046403712297,0.2779760842405854,0.7220239157594146,0.027128324112082814
7856,35.0,6898,176354,183252,933,7289,236167,70432,165760,236192,17096,0.029205053515783768,0.7466552635144289,0.003950176127895949,0.2981980761414442,0.7018019238585558,0.030860486383958812
7857,48.0,89,5550,5639,0,218,7171,2190,4981,7171,468,0.012411100264956072,0.7739506345000697,0.0,0.30539673685678426,0.6946032631432157,0.03040022312090364
7858,24.0,10,7631,7641,26,301,9771,2955,6816,9771,731,0.0010234367004400779,0.7809845461058234,0.002660935421144202,0.302425544980043,0.697574455019957,0.030805444683246343
7859,25.0,461,9681,10142,35,376,13257,3785,9472,13257,976,0.034774081617258805,0.7302557139624349,0.002640114656407935,0.28550954212868673,0.7144904578713133,0.028362374594553822
7860,15.0,196,3542,3738,2,186,4983,1401,3582,4983,351,0.03933373469797311,0.7108167770419426,0.0004013646397752358,0.2811559301625527,0.7188440698374473,0.03732691149909693
7861,33.0,488,15196,15684,122,426,20432,5859,14573,20432,1624,0.023884103367267033,0.7437353171495693,0.005971025841816758,0.28675606891151134,0.7132439310884886,0.020849647611589663
7862,17.0,10490,142852,153342,1146,11315,211811,59201,152610,211811,12197,0.049525284333674834,0.6744314506800875,0.005410483874775153,0.2794991761523245,0.7205008238476756,0.05342026618069883
7863,,205,5567,5772,15,335,7816,2161,5655,7816,644,0.026228249744114637,0.7122569089048106,0.0019191402251791197,0.27648413510747183,0.7235158648925282,0.042860798362333676
7864,,31,4014,4045,12,151,5342,1483,3859,5342,426,0.005803070011231749,0.7514039685511045,0.0022463496817671283,0.27761138150505427,0.7223886184949457,0.028266566828903033
7865,,298,4834,5132,5,204,6688,1880,4808,6688,474,0.04455741626794258,0.7227870813397129,0.0007476076555023923,0.2811004784688995,0.7188995215311005,0.030502392344497607
7866,27.0,2713,77292,80005,152,3747,105469,29865,75604,105469,8415,0.025723198285752213,0.732840929562241,0.0014411817690506215,0.2831637732414264,0.7168362267585736,0.0355270268988992
7867,13.0,53,2044,2097,8,151,2965,797,2168,2965,208,0.0178752107925801,0.6893760539629005,0.0026981450252951096,0.2688026981450253,0.7311973018549747,0.05092748735244519
7868,26.0,1288,28047,29335,140,1605,39048,11193,27855,39048,2613,0.032985044048350745,0.7182698217578365,0.0035853308748207335,0.28664720344191763,0.7133527965580824,0.04110325752919484
7869,25.0,299,5030,5329,37,296,7626,2058,5568,7626,545,0.03920797272488854,0.6595856281143456,0.004851822711775505,0.26986624704956724,0.7301337529504327,0.03881458169420404
7870,,98,4939,5037,5,97,6342,1985,4357,6342,496,0.01545253863134658,0.7787764112267423,0.0007883948281299275,0.3129927467675812,0.6870072532324188,0.015294859665720592
7871,24.0,143,2735,2878,15,121,3841,1081,2760,3841,307,0.03722988804998698,0.7120541525644364,0.003905233012236397,0.281437125748503,0.718562874251497,0.0315022129653736
7872,16.0,0,15013,15468,19,1143,21152,5836,15318,21154,1771,0.0,0.7097002930887776,0.00089817528599792,0.27588162995178217,0.7241183700482179,0.05403233431029592
7873,14.0,123,1749,1872,21,107,3293,653,2640,3293,171,0.03735195870027331,0.5311266322502277,0.006377163680534467,0.19829942301852413,0.8017005769814759,0.032493167324628
7874,48.0,116,5216,5332,23,317,7408,2045,5363,7408,537,0.01565874730021598,0.7041036717062635,0.0031047516198704104,0.2760529157667387,0.7239470842332614,0.04279157667386609
7875,23.0,239,2297,2536,13,111,3372,950,2422,3372,212,0.07087781731909845,0.6811981020166074,0.003855278766310795,0.28173190984578883,0.7182680901542111,0.03291814946619217
7876,,948,10144,11092,101,377,14987,4149,10838,14987,1220,0.06325482084473211,0.6768532728364582,0.006739173950757323,0.27683992793754586,0.7231600720624541,0.025155134449856544
7877,17.0,24,11526,11550,31,1028,15997,4240,11757,15997,1107,0.0015002813027442646,0.720510095642933,0.0019378633493780085,0.2650496968181534,0.7349503031818466,0.06426204913421267
7878,17.0,239,3770,4009,10,320,5464,1542,3922,5464,347,0.043740849194729134,0.6899707174231332,0.0018301610541727673,0.2822108345534407,0.7177891654465594,0.05856515373352855
7879,,525,13440,13965,92,574,17548,5420,12128,17548,1125,0.02991793936630955,0.7658992477775245,0.005242762708000912,0.30886710736266243,0.6911328926373376,0.03271028037383177
7880,14.0,235,6270,6505,27,369,8654,2471,6183,8654,657,0.0271550727987058,0.724520452969725,0.00311994453431939,0.2855327016408597,0.7144672983591402,0.04263924196903166
7881,27.0,1648,32307,33955,165,1532,44327,12948,31379,44327,3291,0.03717824350847113,0.7288334423714666,0.003722336273602996,0.2921018792158278,0.7078981207841721,0.034561328310059335
7882,37.0,1495,32046,33541,108,1762,44968,12778,32190,44968,3058,0.03324586372531578,0.712640099626401,0.002401707881159936,0.28415762319871907,0.7158423768012809,0.03918341932040562
7883,17.0,116,2382,2498,9,98,3329,940,2389,3329,310,0.03484529888855512,0.7155301892460199,0.0027035145689396217,0.2823670772003605,0.7176329227996395,0.02943826975067588
7884,16.0,73,1679,1752,8,147,2428,661,1767,2428,183,0.030065897858319604,0.6915156507413509,0.0032948929159802307,0.27224052718286657,0.7277594728171335,0.06054365733113674
7885,,2803,55678,58481,84,1854,76798,22612,54186,76798,5540,0.036498346311101854,0.7249928383551655,0.0010937784838146827,0.2944347509049715,0.7055652490950285,0.02414125367848121
7886,,1290,21660,22950,150,1254,31799,8770,23029,31799,2401,0.04056731343752948,0.6811534953929369,0.004717129469480172,0.2757948363156074,0.7242051636843926,0.03943520236485424
7887,27.0,100,3558,3658,56,194,4937,1391,3546,4937,388,0.020255215718047396,0.7206805752481263,0.011342920802106542,0.2817500506380393,0.7182499493619607,0.03929511849301195
7888,24.0,37,1901,1938,0,117,2599,753,1846,2599,203,0.014236244709503656,0.7314351673720662,0.0,0.28972681800692573,0.7102731819930742,0.04501731435167372
7889,23.0,201,1950,2151,35,94,3632,763,2869,3632,96,0.055341409691629956,0.5368942731277533,0.009636563876651983,0.21007709251101322,0.7899229074889867,0.025881057268722467
7890,,477,4522,4999,3,263,6653,1938,4715,6653,270,0.07169697880655343,0.6796933714113934,0.00045092439500977,0.29129715917631144,0.7087028408236885,0.03953103862918984
7891,17.0,412,6876,7288,19,698,10098,2777,7321,10098,773,0.04080015844721727,0.6809269162210339,0.001881560705090117,0.2750049514755397,0.7249950485244603,0.06912259853436324
7892,,660,2087,2747,1,198,3812,1041,2771,3812,228,0.1731374606505771,0.5474816369359916,0.00026232948583420777,0.2730849947534103,0.7269150052465897,0.051941238195173135
7893,26.0,5619,190565,196184,1388,9618,261159,74578,186581,261159,17122,0.021515628410278795,0.7296895760820037,0.005314769929429964,0.2855654984128443,0.7144345015871557,0.036828139179580256
7894,,526,15284,15810,124,553,20589,6019,14570,20589,1529,0.025547622516877946,0.7423381417261644,0.006022633445043469,0.2923405702073923,0.7076594297926077,0.026859002379911602
7895,23.0,685,15929,16614,71,508,22596,6257,16339,22596,1731,0.030315100017702247,0.7049477783678527,0.003142149052929722,0.27690741724198975,0.7230925827580102,0.022481855195609843
7896,,454,10186,10640,47,583,14147,4043,10104,14147,950,0.03209160952852195,0.720011309818336,0.0033222591362126247,0.285784972078886,0.714215027921114,0.0412101505619566
7897,14.0,201,1677,1878,6,86,2960,710,2250,2960,178,0.0679054054054054,0.566554054054054,0.002027027027027027,0.23986486486486486,0.7601351351351351,0.029054054054054056
7898,,571,19935,20506,59,1361,28106,7782,20325,28107,2005,0.02031522396556018,0.7092539225104066,0.0020991212153556055,0.27687053047283594,0.7231294695271641,0.048422101255914896
7899,14.0,284,5654,5938,16,366,7901,2232,5669,7901,589,0.035944817111758,0.7156056195418301,0.002025060118972282,0.2824958865966333,0.7175041134033666,0.046323250221490954
7900,24.0,61,2551,2612,0,158,3994,969,3025,3994,275,0.015272909364046069,0.6387080620931397,0.0,0.24261392088132197,0.7573860791186781,0.039559339008512766
7901,,356,24083,24439,251,803,31081,9422,21659,31081,2132,0.011453942923329366,0.7748463691644413,0.008075673240886715,0.30314339950452046,0.6968566004954796,0.02583571957144236
7902,,133,3377,3510,8,118,4626,1392,3234,4626,424,0.028750540423692173,0.7300043233895374,0.0017293558149589277,0.3009079118028534,0.6990920881971465,0.025507998270644185
7903,,240,4826,5066,10,195,6429,1988,4462,6450,469,0.037209302325581395,0.7482170542635659,0.0015503875968992248,0.3082170542635659,0.6917829457364341,0.030232558139534883
7904,23.0,172,5015,5187,11,330,6865,1905,4960,6865,521,0.025054624908958486,0.7305171158048069,0.0016023306627822287,0.27749453750910413,0.7225054624908959,0.04806991988346686
7905,33.0,133,3408,3541,27,177,4736,1343,3393,4736,305,0.02808277027027027,0.7195945945945946,0.005701013513513513,0.28357263513513514,0.7164273648648649,0.037373310810810814
7906,,124,2765,2889,43,116,3694,1129,2565,3694,204,0.033567948023822416,0.7485110990795886,0.011640498105035191,0.30563075257173794,0.694369247428262,0.03140227395776936
7907,,94,1976,2070,5,92,2757,757,2000,2757,200,0.034095030830612987,0.7167210736307581,0.0018135654697134566,0.27457381211461734,0.7254261878853827,0.033369604642727604
7908,23.0,634,14979,15613,101,776,20485,6006,14479,20485,1539,0.03094947522577496,0.7312179643641689,0.004930436905052477,0.2931901391261899,0.7068098608738101,0.037881376617036853
7909,17.0,40,8398,8438,23,702,11262,3008,8254,11262,855,0.003551767004084532,0.7456934825075475,0.002042266027348606,0.2670928787071568,0.7329071212928432,0.06233351092168354
7910,,137,2386,2523,5,108,3831,990,2841,3831,317,0.03576089793787523,0.6228138867136518,0.0013051422605063951,0.25841816758026626,0.7415818324197337,0.028191072826938137
7911,23.0,124,3973,4097,24,215,5929,1710,4219,5929,346,0.020914150784280654,0.6700961376286052,0.004047900151796255,0.28841288581548324,0.7115871141845168,0.036262438859841456
7912,,4721,101441,106163,1071,5030,143002,40821,102181,143002,8673,0.033013524286373615,0.7093677011510329,0.007489405742577027,0.28545754604830703,0.714542453951693,0.035174333226108724
7913,13.0,36,2023,2059,6,252,2879,764,2115,2879,152,0.012504341785342132,0.7026745397707538,0.0020840569642236887,0.2653699201111497,0.7346300798888503,0.08753039249739493
7914,36.0,225,3622,3847,14,200,5166,1486,3680,5166,370,0.04355400696864112,0.7011227255129694,0.0027100271002710027,0.2876500193573364,0.7123499806426635,0.03871467286101433
7915,,260,3811,4071,14,173,5454,1553,3901,5454,392,0.047671433810047674,0.6987532086541988,0.002566923359002567,0.28474514118078476,0.7152548588192152,0.03171983865053172
7916,27.0,4079,55487,59566,274,3124,79943,22513,57430,79943,5307,0.05102385449632863,0.6940820334488323,0.0034274420524623797,0.28161314936892534,0.7183868506310747,0.03907784296311122
7917,17.0,2784,55968,58752,201,5040,82315,22508,59807,82315,5250,0.03382129624005345,0.6799246795845229,0.002441839275952135,0.27343740509020226,0.7265625949097977,0.061228208710441594
7918,23.0,1782,38530,40312,296,2057,54353,15064,39289,54353,3748,0.03278567880337792,0.7088845141942487,0.005445881552076242,0.2771512152043126,0.7228487847956875,0.037845197137232535
7919,16.0,252,2016,2268,6,187,3124,894,2230,3124,144,0.08066581306017925,0.645326504481434,0.0019206145966709346,0.2861715749039693,0.7138284250960307,0.05985915492957746
7920,14.0,72,6669,6741,39,434,9136,2513,6623,9136,825,0.00788091068301226,0.7299693520140105,0.004268826619964973,0.2750656742556918,0.7249343257443083,0.04750437828371278
7921,15.0,946,11930,12876,26,908,17816,4954,12862,17816,960,0.053098338572070046,0.6696228109564436,0.0014593623709025594,0.2780646609788954,0.7219353390211046,0.050965424337674
7922,27.0,1164,34311,35475,25,1382,45980,13433,32547,45980,3603,0.025315354501957373,0.7462157459765115,0.0005437146585471945,0.2921487603305785,0.7078512396694215,0.030056546324488908
7923,16.0,1130,43739,44869,188,9794,66225,16912,49313,66225,3509,0.017063042657606643,0.6604605511513779,0.0028388070970177424,0.2553718384295961,0.7446281615704039,0.1478897697244243
7924,17.0,566,14401,14967,34,1002,20383,5642,14741,20383,1515,0.027768238237747142,0.7065201393317961,0.0016680567139282735,0.2767992935289212,0.7232007064710788,0.049158612569297946
7925,,538,17446,17984,24,713,23840,6976,16864,23840,1857,0.02256711409395973,0.7317953020134228,0.0010067114093959733,0.29261744966442954,0.7073825503355705,0.02990771812080537
7926,24.0,61,1894,1955,5,95,2563,726,1837,2563,179,0.023800234100663287,0.7389777604369879,0.0019508388607101053,0.2832618025751073,0.7167381974248928,0.037065938353492
7927,15.0,52,1643,1695,0,105,2258,646,1612,2258,164,0.023029229406554472,0.7276350752878654,0.0,0.2860938883968113,0.7139061116031886,0.04650132860938884
7928,41.0,1031,19319,20350,119,1598,32620,7123,25497,32620,1639,0.031606376456161864,0.5922440220723483,0.003648068669527897,0.2183629675045984,0.7816370324954016,0.048988350705088904
7929,35.0,259,7894,8153,5,288,10671,3148,7523,10671,859,0.024271389747914908,0.7397619716989973,0.00046855964764314496,0.29500515415612405,0.704994845843876,0.02698903570424515
7930,,371,4210,4581,75,258,6106,1670,4436,6106,419,0.06075990828693089,0.68948575171962,0.012283000327546676,0.2735014739600393,0.7264985260399607,0.04225352112676056
7931,,713,16171,16884,254,993,22915,6354,16561,22915,1998,0.031114990181104082,0.7056949596334279,0.011084442504909447,0.2772856207724198,0.7227143792275802,0.043334060658957015
7932,15.0,121,2079,2200,36,133,3013,832,2181,3013,209,0.040159309658148026,0.6900099568536342,0.011948224361101892,0.2761367407899104,0.7238632592100896,0.04414205111184866
7933,35.0,486,9871,10357,48,301,13732,4023,9709,13732,1124,0.03539178561025342,0.7188319254296534,0.003495484998543548,0.2929653364404311,0.7070346635595689,0.021919603845033497
7934,,86,1686,1772,12,185,2481,656,1825,2481,120,0.03466344216041919,0.6795646916565901,0.0048367593712212815,0.26440951229343007,0.73559048770657,0.07456670697299476
7935,25.0,1811,46386,48197,202,1522,62686,18364,44322,62686,3889,0.028890023290686916,0.739973837858533,0.0032224101075200204,0.2929521743291963,0.7070478256708037,0.024279743483393422
7936,,407,16342,16749,134,693,21705,6295,15410,21705,1502,0.018751439760423864,0.7529140750979038,0.00617369269753513,0.29002533978346,0.70997466021654,0.031928127159640635
7937,,318,8096,8414,27,557,11545,3202,8343,11545,868,0.02754439151147683,0.7012559549588566,0.0023386747509744478,0.2773495019488956,0.7226504980511044,0.04824599393676916
7938,23.0,152,4125,4277,55,310,5819,1586,4233,5819,365,0.026121326688434438,0.7088846880907372,0.00945179584120983,0.27255542189379617,0.7274445781062038,0.05327375837772813
7939,15.0,1276,28650,29926,0,703,40788,11317,29471,40788,2820,0.03128371089536138,0.7024124742571345,0.0,0.2774590565852702,0.7225409434147299,0.017235461410218693
7940,,275,5645,5920,42,412,7946,2174,5772,7946,546,0.03460860810470677,0.7104203372766171,0.005285678328718852,0.27359677825320916,0.7264032217467908,0.0518499874150516
7941,17.0,52,7708,7760,38,217,10216,2990,7226,10216,1070,0.005090054815974941,0.754502740798747,0.0037196554424432263,0.2926781519185591,0.7073218480814408,0.02124119028974158
7942,14.0,604,6500,7104,47,340,9354,2728,6626,9354,697,0.06457130639298696,0.6948898866794954,0.005024588411374813,0.2916399401325636,0.7083600598674364,0.03634808638015822
7943,17.0,528,7459,7987,38,447,10897,3048,7849,10897,846,0.048453702853996514,0.6845003211893181,0.00348719831146187,0.279710011929889,0.720289988070111,0.04102046434798568
7944,17.0,519,12217,12736,30,906,17475,4785,12690,17475,1228,0.029699570815450643,0.6991130185979971,0.0017167381974248926,0.2738197424892704,0.7261802575107296,0.05184549356223176
7945,23.0,207,8762,8969,24,342,11575,3427,8148,11575,905,0.017883369330453563,0.7569762419006479,0.0020734341252699783,0.29606911447084233,0.7039308855291576,0.02954643628509719
7946,,1048,28570,29618,107,1538,39633,11298,28335,39633,3173,0.02644261095551687,0.7208639265258749,0.0026997703933590695,0.2850654757399137,0.7149345242600863,0.0388060454671612
7947,,150,4885,5035,12,304,6779,1906,4873,6779,509,0.02212715739784629,0.7206077592565275,0.0017701725918277031,0.2811624133353002,0.7188375866646998,0.04484437232630181
7948,,124,1945,2069,5,125,2764,798,1966,2764,193,0.04486251808972504,0.7036903039073806,0.001808972503617945,0.28871201157742404,0.711287988422576,0.04522431259044862
7949,24.0,68,2605,2673,10,86,3456,1033,2423,3456,290,0.019675925925925927,0.7537615740740741,0.0028935185185185184,0.29890046296296297,0.7010995370370371,0.02488425925925926
7950,,8154,238413,246567,903,9853,317718,94957,222761,317718,19826,0.025664268313410007,0.7503918569297301,0.0028421430325005193,0.2988719556336122,0.7011280443663878,0.031011777740008434
7951,,700,9644,10344,64,784,14529,3892,10656,14548,901,0.04811657959857025,0.6629089909265878,0.004399230134726423,0.2675281825680506,0.7324718174319494,0.05389056915039868
7952,16.0,13,3707,3720,1,462,5080,1340,3740,5080,306,0.002559055118110236,0.7297244094488189,0.0001968503937007874,0.2637795275590551,0.7362204724409449,0.09094488188976378
7953,,190,3263,3453,15,138,4592,1366,3226,4592,381,0.04137630662020906,0.7105836236933798,0.0032665505226480837,0.29747386759581884,0.7025261324041812,0.03005226480836237
7954,,186,3447,3633,650,303,6043,1371,4672,6043,286,0.030779414198245904,0.5704120469965249,0.10756246897236472,0.22687406917094158,0.7731259308290584,0.050140658613271556
7955,23.0,514,10176,10690,23,455,13734,4077,9657,13734,922,0.03742536770059706,0.7409349060725208,0.0016746759866025922,0.29685452162516385,0.7031454783748362,0.033129459734964326
7956,23.0,3029,33987,37016,226,1979,49697,14604,35093,49697,3297,0.06094935307966275,0.6838843390949152,0.004547558202708413,0.29386079642634366,0.7061392035736563,0.03982131718212367
7957,40.0,84,2300,2384,1,106,3127,900,2227,3127,225,0.026862807803006077,0.7355292612727854,0.0003197953309881676,0.2878157978893508,0.7121842021106491,0.03389830508474576
7958,27.0,553,10725,11278,148,605,15435,4300,11135,15435,983,0.03582766439909297,0.6948493683187561,0.009588597343699384,0.27858762552640104,0.721412374473599,0.03919663103336573
7959,,256,18451,18707,46,718,24472,7186,17286,24472,2029,0.010460934946060804,0.7539637136319058,0.0018796992481203006,0.29364171297809744,0.7063582870219026,0.029339653481529913
7960,27.0,1893,49953,51846,153,1864,68419,19796,48623,68419,5237,0.02766775310951636,0.7301042108186323,0.0022362209327818298,0.2893348338911706,0.7106651661088295,0.02724389423990412
7961,,636,40848,41484,254,4435,58657,15871,42786,58657,4924,0.010842695671445864,0.6963874729358814,0.004330258963124606,0.2705729921407505,0.7294270078592495,0.07560904921833711
7962,24.0,17905,421184,439089,2137,20578,579624,167063,412567,579630,40488,0.03089039559719131,0.7266428583751704,0.003686834704897952,0.2882235219019029,0.7117764780980971,0.03550195814571364
7963,14.0,71,7096,7167,70,367,9909,2712,7197,9909,862,0.007165203350489454,0.7161166616207488,0.007064284993440307,0.2736905843172873,0.7263094156827127,0.037037037037037035
7964,25.0,3052,62626,65678,317,2659,87795,24977,62818,87795,5733,0.034762799703855575,0.713320804146022,0.003610683979725497,0.28449228315963326,0.7155077168403667,0.0302864627826186
7965,16.0,440,11417,11857,103,637,16038,4569,11469,16038,1116,0.027434842249657063,0.711871804464397,0.006422247162987903,0.2848858959970071,0.7151141040029929,0.039718169347798975
7966,16.0,15203,233494,248697,943,17834,338153,95000,243153,338153,23149,0.04495893870526064,0.6904980881435326,0.002788678497603156,0.28093791863446427,0.7190620813655357,0.052739440430810906
7967,,122,2473,2595,4,143,3449,1016,2433,3449,270,0.035372571759930416,0.7170194259205567,0.0011597564511452595,0.29457813859089593,0.7054218614091041,0.04146129312844303
7968,42.0,66,2048,2114,3,71,2902,806,2096,2902,224,0.022742935906271536,0.7057201929703653,0.0010337698139214334,0.2777394900068918,0.7222605099931082,0.02446588559614059
7969,,937,21135,22072,27,1159,29402,8330,21072,29402,2148,0.031868580368682405,0.7188286511121692,0.0009183048772192368,0.283314060268009,0.716685939731991,0.03941908713692946
7970,14.0,138,2661,2799,18,160,3917,1071,2846,3917,302,0.035231044166453916,0.6793464386009701,0.004595353586928772,0.2734235384222619,0.726576461577738,0.04084758743936686
7971,,45,2086,2131,4,78,2754,800,1954,2754,221,0.016339869281045753,0.7574437182280319,0.0014524328249818446,0.29048656499636893,0.7095134350036311,0.02832244008714597
7972,16.0,311,6972,7283,37,1258,10487,2337,8150,10487,590,0.029655764279584246,0.6648231143320301,0.003528177743873367,0.22284733479546104,0.777152665204539,0.11995804329169447
7973,14.0,4935,25402,30502,238,2844,44744,11837,32907,44744,434,0.11029411764705882,0.5677185767924191,0.005319148936170213,0.264549436795995,0.735450563204005,0.06356159485070624
7974,,2138,16662,18800,121,1544,26873,7275,19598,26873,1682,0.07955940907230305,0.6200275369329811,0.0045026606631191155,0.2707178208610873,0.7292821791389127,0.05745543854426376
7975,25.0,5627,88367,93994,343,7388,128877,34229,94648,128877,8385,0.043661786044057516,0.6856692815630407,0.0026614523925913855,0.26559432637320857,0.7344056736267914,0.057325977482405706
7976,17.0,58,1462,1520,1,153,2115,587,1528,2115,152,0.027423167848699765,0.6912529550827423,0.00047281323877068556,0.27754137115839245,0.7224586288416076,0.07234042553191489
7977,23.0,305,4987,5292,42,218,7303,2041,5262,7303,477,0.04176365877036834,0.6828700534027112,0.005751061207722854,0.27947418868957963,0.7205258113104204,0.029850746268656716
7978,14.0,630,11832,12462,42,644,16939,4766,12173,16939,1278,0.0371922781746266,0.6985064053367968,0.0024794852116417736,0.28136253615915935,0.7186374638408407,0.03801877324517386
7979,17.0,332,6792,7124,72,724,9890,2675,7215,9890,749,0.03356926188068756,0.6867542972699696,0.007280080889787664,0.2704752275025278,0.7295247724974722,0.07320525783619818
7980,26.0,541,14243,14784,82,619,19500,5575,13925,19500,1673,0.027743589743589744,0.7304102564102564,0.004205128205128205,0.2858974358974359,0.7141025641025641,0.03174358974358974
7981,,133,4931,5064,23,194,6694,1975,4719,6694,559,0.019868538990140423,0.7366298177472363,0.0034359127576934568,0.2950403346280251,0.7049596653719749,0.028981177173588286
7982,,202,4280,4482,10,261,6143,1622,4521,6143,411,0.03288295621032069,0.6967279830701611,0.0016278691193228065,0.2640403711541592,0.7359596288458408,0.042487384014325245
7983,,1349,40089,41438,79,1812,53047,15743,37304,53047,3611,0.025430278809357738,0.7557260542537749,0.001489245386166984,0.2967745584104662,0.7032254415895338,0.034158387844741456
7984,14.0,5,3137,3142,18,215,4262,1178,3084,4262,386,0.0011731581417175035,0.7360394181135617,0.004223369310183012,0.2763960581886438,0.7236039418113561,0.050445800093852654
7985,,506,13858,14364,73,607,19049,5411,13638,19049,1305,0.02656307417712216,0.7274922568113812,0.0038322221638931175,0.2840569058743241,0.7159430941256759,0.031865189773741406
7986,,133,3700,3833,19,144,4997,1445,3552,4997,426,0.026615969581749048,0.740444266559936,0.0038022813688212928,0.28917350410246145,0.7108264958975385,0.028817290374224536
7987,24.0,3400,78488,81888,207,4587,107534,30982,76567,107549,7622,0.03161349710364578,0.7297882825502794,0.0019247040883690226,0.28807334331328044,0.7119266566867195,0.04265032682777153
7988,26.0,1009,28876,29885,123,1129,39001,11393,27608,39001,3118,0.025871131509448475,0.7403912720186662,0.0031537652880695368,0.2921207148534653,0.7078792851465348,0.02894797569293095
7989,,575,13511,14086,59,979,18840,5501,13339,18840,1280,0.030520169851380043,0.7171443736730361,0.003131634819532909,0.2919851380042463,0.7080148619957537,0.05196390658174098
7990,14.0,47,3747,3794,36,294,5411,1426,3985,5411,500,0.00868600997967104,0.6924782849750508,0.006653114026982074,0.2635372389576788,0.7364627610423212,0.054333764553686936
7991,48.0,185,2569,2754,4,117,3693,1070,2623,3693,200,0.050094773896561064,0.6956404007581912,0.001083130246412131,0.28973734091524506,0.7102626590847549,0.03168155970755483
7992,,611,11213,11824,7,950,16107,4404,11703,16107,1095,0.037933817594834544,0.6961569503942385,0.000434593654932638,0.2734214937604768,0.7265785062395231,0.058980567455143726
7993,34.0,1439,23144,24583,212,1425,35007,9134,25873,35007,2091,0.04110606450138544,0.6611249178735682,0.0060559316708086956,0.26091924472248407,0.7390807552775159,0.04070614448538864
7994,26.0,136,6077,6213,13,208,8005,2355,5650,8005,636,0.016989381636477202,0.7591505309181762,0.0016239850093691442,0.2941911305434104,0.7058088694565896,0.025983760149906308
7995,24.0,102,2734,2836,32,113,4070,1090,2980,4070,317,0.02506142506142506,0.6717444717444717,0.007862407862407862,0.2678132678132678,0.7321867321867321,0.027764127764127764
7996,,728,11428,12156,87,599,15823,4484,11339,15823,833,0.04600897427794982,0.7222397775390255,0.005498325222776971,0.2833849459647349,0.7166150540352652,0.0378562851545219
7997,,1518,37640,39158,88,1797,51729,15000,36729,51729,3652,0.029345241547294555,0.7276382686694117,0.0017011734230315684,0.2899727425621991,0.7100272574378008,0.03473873455895146
7998,23.0,125,4346,4471,16,182,5974,1754,4220,5974,512,0.020924004017408772,0.7274857716772681,0.002678272514228323,0.2936056243722799,0.7063943756277201,0.03046534984934717
7999,17.0,641,11666,12307,31,970,16568,4720,11848,16568,1085,0.03868903911154032,0.7041284403669725,0.00187107677450507,0.28488652824722355,0.7151134717527764,0.058546595847416706
8000,,52,2190,2242,3,56,2950,854,2096,2950,289,0.017627118644067796,0.7423728813559322,0.001016949152542373,0.2894915254237288,0.7105084745762712,0.018983050847457626
8001,15.0,2762,36243,39005,214,2891,53789,14774,39015,53789,3499,0.05134878878581123,0.6737994757292384,0.0039785086170034765,0.27466582386733346,0.7253341761326665,0.05374704865307033
8002,23.0,117,1699,1816,4,125,2657,656,2001,2657,140,0.04403462551750094,0.6394429808054196,0.0015054572826496049,0.24689499435453519,0.7531050056454648,0.04704554008280015
8003,,61,1858,1919,6,67,2541,736,1805,2541,216,0.024006296733569462,0.7312081857536403,0.0023612750885478157,0.28964974419519873,0.7103502558048013,0.026367571822117276
8004,16.0,7902,92284,100186,1100,7263,137412,37451,99961,137412,7914,0.05750589468168719,0.6715861787907897,0.008005123278898496,0.27254533810729775,0.7274546618927022,0.05285564579512706
8005,23.0,5,2675,2680,22,251,3693,994,2699,3693,287,0.0013539128080151638,0.7243433522881126,0.005957216355266721,0.2691578662334146,0.7308421337665855,0.06796642296236122
8006,,1191,27640,28831,200,2853,40316,10594,29722,40316,3042,0.029541621192578627,0.6855838872904058,0.004960809604127394,0.262774084730628,0.737225915269372,0.07076594900287728
8007,26.0,3366,80726,84092,251,5486,113696,32023,81673,113696,8789,0.029605263157894735,0.7100161835068955,0.0022076414297776525,0.28165458767238954,0.7183454123276105,0.04825147762454264
8008,14.0,284,4205,4489,2,428,6029,1689,4340,6029,374,0.04710565599601924,0.6974622657157075,0.0003317299718029524,0.2801459611875933,0.7198540388124067,0.07099021396583181
8009,36.0,245,4705,4950,17,255,6660,1902,4758,6660,509,0.03678678678678678,0.7064564564564565,0.0025525525525525524,0.2855855855855856,0.7144144144144144,0.038288288288288286
8010,15.0,193,2193,2386,18,198,3382,882,2500,3382,167,0.05706682436428149,0.6484328799526907,0.005322294500295683,0.26079243051448847,0.7392075694855116,0.058545239503252515
8011,15.0,3431,48082,51513,1174,4266,72050,19563,52487,72050,4666,0.04761970853573907,0.6673421235253296,0.016294240111034003,0.27151977793199167,0.7284802220680083,0.0592088827203331
8012,,3573,273804,277377,662,8143,364792,105892,258900,364792,35347,0.009794622689094059,0.7505756705190904,0.0018147327792276146,0.2902804886072063,0.7097195113927937,0.02232230969977412
8013,,147,2714,2861,20,90,3800,1110,2690,3800,284,0.038684210526315786,0.7142105263157895,0.005263157894736842,0.29210526315789476,0.7078947368421052,0.02368421052631579
8014,,404,10314,10718,33,472,14377,4067,10310,14377,927,0.02810043819990262,0.7173958405787021,0.0022953328232593728,0.282882381581693,0.717117618418307,0.0328302149266189
8015,,273,11590,11863,30,1439,16359,4608,11751,16359,1172,0.01668806161745828,0.7084785133565621,0.0018338529249954153,0.2816798092792958,0.7183201907207042,0.08796381196894676
8016,26.0,841,14927,15768,32,1026,21864,5958,15906,21864,1440,0.03846505671423344,0.6827204537138676,0.0014635931211123307,0.2725027442371021,0.7274972557628979,0.0469264544456641
8017,26.0,4025,85610,89635,221,5197,118487,34308,84179,118487,8430,0.033969971389266336,0.7225265218969169,0.0018651835222429464,0.2895507524032172,0.7104492475967827,0.04386135187826513
8018,16.0,1804,37671,39475,120,2818,52711,14549,38162,52711,3511,0.03422435544762953,0.7146705621217583,0.0022765646639221417,0.2760144941283603,0.7239855058716397,0.05346132685777162
8019,23.0,164,4118,4282,21,151,5793,1635,4158,5793,462,0.028310029345762128,0.7108579319868807,0.0036250647332988087,0.28223718280683585,0.7177628171931641,0.026065941653720007
8020,,3947,17207,21154,2445,2813,34521,7620,26901,34521,719,0.11433620115292141,0.49845021870745343,0.07082645346310941,0.22073520465803423,0.7792647953419658,0.08148663132585962
8021,17.0,938,19587,20525,36,1251,27669,7835,19834,27669,2121,0.03390075535798186,0.7079041526618237,0.0013010950883660414,0.28316888937077594,0.716831110629224,0.04521305432071994
8022,17.0,449,24942,25391,44,2406,35243,9685,25558,35243,3158,0.012740118605113072,0.7077150072354794,0.0012484748744431519,0.2748063445223165,0.7251936554776836,0.06826887608886871
8023,23.0,667,13282,13949,262,665,18508,5224,13284,18508,993,0.0360384698508753,0.7176356170304733,0.014156040631078453,0.2822563215906635,0.7177436784093365,0.0359304084720121
8024,15.0,92,6544,6636,20,842,9536,2485,7051,9536,896,0.00964765100671141,0.6862416107382551,0.0020973154362416107,0.2605914429530201,0.7394085570469798,0.08829697986577181
8025,41.0,82,2543,2625,1,80,3616,1019,2597,3616,276,0.02267699115044248,0.7032632743362832,0.0002765486725663717,0.28180309734513276,0.7181969026548672,0.022123893805309734
8026,,2501,53906,56407,189,2740,74527,21166,53361,74527,5155,0.03355830772740081,0.7233083312088237,0.002535993666724811,0.28400445476136166,0.7159955452386384,0.03676519918955546
8027,,291,6013,6304,10,337,8362,2413,5949,8362,591,0.034800287012676394,0.7190863429801483,0.001195886151638364,0.2885673283903372,0.7114326716096627,0.04030136331021287
8028,24.0,131,4871,5002,4,466,6918,1911,5007,6918,615,0.018936108701936977,0.7041052327262215,0.0005782017924255566,0.2762359063313096,0.7237640936686903,0.06736050881757734
8029,15.0,135,55209,55344,395,8178,78743,20797,57946,78743,4385,0.0017144381087842728,0.7011289892434883,0.005016318910887317,0.2641123655436039,0.7358876344563962,0.10385685076768729
8030,25.0,24,9848,9872,40,726,13582,3546,10036,13582,1044,0.0017670446178766014,0.7250773082020321,0.0029450743631276688,0.2610808422912679,0.7389191577087322,0.05345309969076719
8031,,7690,124671,132361,1035,9337,186871,50513,136358,186871,13184,0.041151382504508456,0.6671500660883711,0.0055385800900086156,0.270309464817976,0.729690535182024,0.049964949082522164
8032,17.0,170,2664,2834,19,216,3946,1116,2830,3946,234,0.04308160162189559,0.675114039533705,0.00481500253421186,0.282818043588444,0.717181956411556,0.05473897617840851
8033,,7818,190414,198232,764,9837,269956,75465,194491,269956,19279,0.028960275007779045,0.7053519832861651,0.0028300908296166783,0.27954555557201916,0.7204544444279809,0.03643927158499904
8034,,250,3781,4031,30,184,5559,1544,4015,5559,282,0.044972117287281885,0.6801583018528512,0.005396654074473826,0.2777477963662529,0.7222522036337471,0.033099478323439464
8035,,268,4426,4694,83,196,6384,1749,4635,6384,452,0.041979949874686714,0.693295739348371,0.01300125313283208,0.27396616541353386,0.7260338345864662,0.03070175438596491
8036,24.0,339,8937,9276,11,506,12641,3524,9117,12641,901,0.026817498615615852,0.7069852068665454,0.0008701843208606914,0.2787754133375524,0.7212245866624476,0.040028478759591805
8037,25.0,170,4279,4449,6,179,5809,1668,4141,5809,470,0.02926493372353245,0.736615596488208,0.0010328800137717334,0.28714064382854193,0.7128593561714581,0.03081425374419005
8038,,3112,35465,38577,299,1950,51206,15300,35906,51206,1865,0.060774128031871266,0.6925946178182244,0.005839159473499199,0.2987931101824005,0.7012068898175995,0.03808147482716869
8039,17.0,599,16015,16614,67,751,21834,6353,15481,21834,1730,0.027434276815975083,0.7334890537693506,0.003068608592104058,0.2909682147110012,0.7090317852889988,0.034395896308509664
8040,,4442,68220,72662,47,1433,96113,28092,68021,96113,6296,0.04621643274062822,0.709789518587496,0.0004890077304839095,0.2922809609522125,0.7077190390477875,0.014909533569860477
8041,15.0,422,1209,1631,1,87,2283,619,1664,2283,126,0.18484450284713097,0.5295663600525624,0.0004380201489268506,0.27113447218572057,0.7288655278142795,0.03810775295663601
8042,,69,2149,2218,2,127,2924,825,2099,2924,246,0.02359781121751026,0.7349521203830369,0.0006839945280437756,0.28214774281805743,0.7178522571819426,0.04343365253077976
8043,,3574,51617,55191,3755,5977,83996,21466,62530,83996,3949,0.04254964522120101,0.6145173579694271,0.04470450973855898,0.2555597885613601,0.7444402114386399,0.07115815038811373
8044,,742,13185,13927,160,438,18914,5439,13475,18914,1524,0.03923019985196151,0.697102675266998,0.008459342286137253,0.28756476683937826,0.7124352331606217,0.023157449508300728
8045,,594,31310,31904,585,6278,48253,11936,36317,48253,1981,0.012310115433237312,0.6488715727519533,0.012123598532733716,0.2473628582678797,0.7526371417321203,0.13010590015128592
8046,15.0,167,4058,4225,15,296,5702,1556,4146,5702,365,0.02928796913363732,0.7116801122413189,0.002630655910206945,0.2728867064188004,0.7271132935811996,0.05191160996141705
8047,,106,2856,2962,2,108,3940,1141,2799,3940,331,0.026903553299492386,0.7248730964467005,0.0005076142131979696,0.2895939086294416,0.7104060913705583,0.027411167512690356
8048,,631,11762,12393,43,1011,16614,4842,11772,16614,1039,0.03798001685325629,0.7079571445768629,0.0025881786445166727,0.2914409534127844,0.7085590465872156,0.060852293246659445
8049,16.0,3177,21271,24448,401,1781,33598,9097,24501,33598,1969,0.09455919995237812,0.6331031609024347,0.011935234240133341,0.27076016429549377,0.7292398357045062,0.05300910768498125
8050,34.0,179,4113,4292,22,165,5539,1691,3848,5539,321,0.03231630258169345,0.7425528073659505,0.00397183607149305,0.30528976349521575,0.6947102365047843,0.02978877053619787
8051,,67,1920,1987,0,76,2620,759,1861,2620,190,0.025572519083969465,0.732824427480916,0.0,0.28969465648854964,0.7103053435114504,0.02900763358778626
8052,,3183,58263,61446,250,4251,82957,23316,59641,82957,5806,0.038369275648830116,0.7023277119471534,0.003013609460322818,0.28106127270754727,0.7189387272924527,0.05124341526332919
8053,24.0,996,22190,23186,107,923,30406,8812,21594,30406,2443,0.032756692758008285,0.7297901729921726,0.003519042294284023,0.2898112214694468,0.7101887785305532,0.03035585081891732
8054,26.0,1027,25070,26097,66,1019,33827,9844,23990,33834,2757,0.030354081692971567,0.7409706212685464,0.0019507004788082993,0.2909499320210439,0.7090500679789561,0.030117633150085713
8055,44.0,136,5716,5852,20,306,7641,2158,5483,7641,528,0.017798717445360556,0.7480696243947127,0.0026174584478471405,0.28242376652270645,0.7175762334772936,0.04004711425206125
8056,25.0,274,5226,5500,37,332,7439,2082,5357,7439,507,0.03683290764887754,0.7025137787337008,0.004973786799300981,0.2798763274633687,0.7201236725366312,0.044629654523457456
8057,,386,8074,8460,38,742,12418,3121,9297,12418,730,0.031083910452568853,0.6501852150104687,0.0030600740860041876,0.2513287163794492,0.7486712836205508,0.05975197294250282
8058,17.0,77,2101,2178,18,116,2916,818,2098,2916,235,0.026406035665294925,0.7205075445816187,0.006172839506172839,0.28052126200274347,0.7194787379972565,0.039780521262002745
8059,,7209,100694,107903,769,10821,145263,39815,105448,145263,8788,0.04962722785568245,0.6931840867942972,0.005293846333890942,0.2740890660388399,0.7259109339611601,0.07449247227442639
8060,17.0,3257,54029,57286,87,3085,78326,22031,56295,78326,6327,0.041582616244925055,0.6897964915864464,0.0011107422822562113,0.28127314046421364,0.7187268595357863,0.039386665985751856
8061,17.0,103,3191,3294,26,184,4626,1230,3396,4626,316,0.022265456117596196,0.6897968006917423,0.005620406398616515,0.26588845654993515,0.7341115434500648,0.03977518374405534
8062,,5,3301,3306,22,223,4593,1248,3345,4593,410,0.001088613106901807,0.718702373176573,0.004789897670367951,0.2717178314826911,0.728282168517309,0.048552144567820595
8063,,224,4298,4522,8,234,6200,1723,4477,6200,390,0.03612903225806452,0.6932258064516129,0.0012903225806451613,0.2779032258064516,0.7220967741935483,0.03774193548387097
8064,,1265,32059,33324,203,2018,44539,12600,31939,44539,3491,0.02840207458631761,0.719796133725499,0.004557803273535553,0.28289813421944815,0.7171018657805519,0.04530860594086082
8065,26.0,3300,29388,48610,1024,1874,59815,11849,48020,59869,1480,0.055120346088960895,0.4908717366249645,0.01710401042275635,0.19791544872972658,0.8020845512702734,0.0313016753244584
8066,,3350,44530,47880,407,3749,67431,17773,49658,67431,4988,0.04968041405288369,0.6603787575447494,0.006035799558066764,0.26357313401847815,0.7364268659815218,0.055597573816197295
8067,26.0,67,4116,4183,0,114,5292,1609,3683,5292,440,0.012660619803476946,0.7777777777777778,0.0,0.3040438397581255,0.6959561602418746,0.021541950113378686
8068,,39,1774,1813,133,108,2587,649,1938,2587,169,0.01507537688442211,0.6857363741785852,0.05141090065713181,0.25086973328179357,0.7491302667182064,0.041747197526091996
8069,,229,6090,6319,9,375,8431,2364,6067,8431,624,0.027161665282884592,0.7223342426758391,0.001067489028584984,0.2803937848416558,0.7196062151583442,0.044478709524374334
8070,26.0,1633,32882,34515,143,1544,44681,13209,31472,44681,2814,0.0365479734115172,0.7359280230970658,0.003200465522257783,0.29562901456995144,0.7043709854300486,0.03455607528927285
8071,17.0,216,7673,7889,50,251,10329,3007,7322,10329,758,0.02091199535288992,0.7428599089940943,0.0048407396650208155,0.2911220834543518,0.7088779165456481,0.024300513118404494
8072,,260,6808,7068,3,290,9321,2639,6682,9321,778,0.02789400278940028,0.730393734577835,0.000321853878339234,0.28312412831241285,0.7168758716875872,0.03111254157279262
8073,,113,5628,5741,16,198,7618,2162,5456,7618,691,0.014833289577316881,0.7387765817799947,0.002100288789708585,0.28380152270937253,0.7161984772906275,0.025991073772643737
8074,25.0,207,4037,4244,56,184,5510,1612,3898,5510,359,0.03756805807622505,0.7326678765880218,0.010163339382940109,0.2925589836660617,0.7074410163339383,0.033393829401088926
8075,23.0,99,4809,4908,10,158,6548,1922,4626,6548,555,0.015119120342089188,0.7344227244960293,0.0015271838729383018,0.2935247403787416,0.7064752596212583,0.02412950519242517
8076,16.0,86,2589,2675,2,115,3619,1001,2618,3619,260,0.02376347057198121,0.7153909919867366,0.0005526388505111909,0.2765957446808511,0.723404255319149,0.03177673390439348
8077,15.0,70,3232,3302,37,200,4420,1276,3144,4420,233,0.01583710407239819,0.7312217194570135,0.0083710407239819,0.28868778280542984,0.7113122171945702,0.04524886877828054
8078,,216,2047,2263,4,155,3604,834,2770,3604,190,0.05993340732519423,0.5679800221975583,0.0011098779134295228,0.2314095449500555,0.7685904550499445,0.043007769145394004
8079,24.0,171,4644,4815,34,240,6446,1812,4634,6446,500,0.02652807942910332,0.7204467887061744,0.005274588892336333,0.2811045609680422,0.7188954390319579,0.03723239218119764
8080,,103,4245,4348,10,209,5558,1572,3986,5558,350,0.01853184598776538,0.7637639438646995,0.0017992083483267362,0.28283555235696295,0.7171644476430371,0.03760345448002879
8081,16.0,2081,47517,49598,157,3033,66418,19104,47314,66418,4706,0.031331867867144446,0.7154235297660273,0.002363817037550062,0.2876328706073655,0.7123671293926346,0.04566533168719323
8082,15.0,156,2146,2302,4,144,3177,906,2271,3177,191,0.049102927289896126,0.6754800125904942,0.0012590494176896443,0.28517469310670446,0.7148253068932956,0.0453257790368272
8083,26.0,729,20256,20985,62,1058,27722,7883,19839,27722,2078,0.026296803982396654,0.730683211889474,0.002236490873674338,0.2843589928576582,0.7156410071423418,0.03816463458624919
8084,,99,1667,1766,25,75,2379,661,1718,2379,205,0.0416141235813367,0.7007145859604876,0.010508617065994116,0.27784783522488443,0.7221521647751156,0.031525851197982346
8085,37.0,519,13367,13886,26,587,18004,5369,12635,18004,1452,0.028826927349477893,0.7424461230837591,0.0014441235281048657,0.29821150855365475,0.7017884914463453,0.03260386580759831
8086,26.0,7035,170532,177567,593,8447,236221,67929,168292,236221,18143,0.029781433488131878,0.7219171877182807,0.002510361060193632,0.28756545777047765,0.7124345422295224,0.0357588868051528
8087,33.0,210,6161,6371,36,314,8311,2399,5912,8311,556,0.02526771748285405,0.7413067019612561,0.004331608711346409,0.2886535916255565,0.7113464083744435,0.03778125376007701
8088,16.0,2912,55726,58641,632,7623,83235,22324,60912,83236,4314,0.03498486231918881,0.6694939689557403,0.0075928684703733965,0.26820125907059444,0.7317987409294056,0.09158296890768418
8089,15.0,188,3240,3428,8,158,4695,1337,3358,4695,353,0.04004259850905218,0.6900958466453674,0.0017039403620873268,0.2847710330138445,0.7152289669861555,0.033652822151224705
8090,15.0,1376,31123,32499,79,1876,44118,12095,32023,44118,3366,0.031189083820662766,0.7054490230744821,0.001790652341447935,0.2741511401242123,0.7258488598757876,0.04252232648805476
8091,,51,4112,4163,9,159,5480,1594,3886,5480,500,0.009306569343065693,0.7503649635036497,0.0016423357664233577,0.2908759124087591,0.7091240875912409,0.029014598540145986
8092,23.0,19,7160,7179,32,281,9465,2734,6731,9465,870,0.002007395668251453,0.7564712097200211,0.0033808769149498152,0.2888536714210248,0.7111463285789752,0.029688325409403065
8093,,185,5176,5361,31,203,7034,2094,4940,7034,574,0.026300824566391812,0.7358544213818595,0.004407165197611601,0.2976969007676997,0.7023030992323003,0.028859823713392095
8094,,81,2420,2501,1,101,3222,917,2305,3222,240,0.025139664804469275,0.7510862818125388,0.00031036623215394165,0.2846058348851645,0.7153941651148356,0.03134698944754811
8095,23.0,236,3407,3643,8,233,5022,1349,3673,5022,322,0.04699322978892871,0.6784149741138988,0.0015929908403026682,0.2686180804460374,0.7313819195539626,0.046395858223815215
8096,17.0,426,7176,7602,46,574,10493,2890,7603,10493,704,0.04059849423425141,0.6838844944248547,0.0043838749642618885,0.2754217097112361,0.724578290288764,0.05470313542361575
8097,13.0,80,4887,4967,33,679,7072,1837,5235,7072,523,0.011312217194570135,0.6910350678733032,0.004666289592760181,0.25975678733031676,0.7402432126696833,0.09601244343891403
8098,14.0,525,14404,14929,10,924,20590,5761,14829,20590,1667,0.025497814473045166,0.6995628946090335,0.00048567265662943174,0.2797960174842156,0.7202039825157843,0.044876153472559493
8099,23.0,517,10289,10806,25,373,14341,4142,10199,14341,1264,0.03605048462450317,0.7174534551286521,0.0017432536085349698,0.2888222578620738,0.7111777421379262,0.026009343839341746
8100,14.0,72,2538,2610,19,94,3563,989,2574,3563,291,0.020207690148751054,0.7123210777434746,0.005332584900364861,0.27757507718214985,0.7224249228178501,0.02638226213864721
8101,23.0,90,1783,1873,9,114,2518,690,1828,2518,174,0.035742652899126294,0.7081016679904686,0.003574265289912629,0.27402700555996823,0.7259729944400317,0.04527402700555997
8102,,76,3507,3583,14,263,4917,1385,3532,4917,206,0.015456579214968477,0.7132397803538744,0.002847264592231035,0.28167581858857027,0.7183241814114297,0.05348789912548302
8103,14.0,52,4682,4734,21,129,6312,1782,4530,6312,637,0.008238276299112801,0.7417617237008872,0.003326996197718631,0.282319391634981,0.717680608365019,0.02043726235741445
8104,13.0,218,1779,1997,13,261,2761,682,2079,2761,145,0.07895689967403115,0.6443317638536762,0.004708438971387179,0.24701195219123506,0.7529880478087649,0.0945309670409272
8105,24.0,82,2445,2527,2,105,3251,966,2285,3251,243,0.025223008305136883,0.75207628422024,0.0006151953245155337,0.29713934174100276,0.7028606582589972,0.032297754537065515
8106,,17,2208,2225,10,91,3052,792,2260,3052,191,0.005570117955439056,0.7234600262123198,0.00327653997378768,0.2595019659239843,0.7404980340760158,0.02981651376146789
8107,16.0,68,4589,4657,47,739,6814,1750,5064,6814,392,0.009979454065159965,0.6734663927208688,0.006897563839154681,0.2568241855004403,0.7431758144995597,0.10845318461990021
8108,24.0,370,9319,9689,137,519,13184,3620,9564,13184,1059,0.028064320388349516,0.7068416262135923,0.010391383495145632,0.2745752427184466,0.7254247572815534,0.03936589805825243
8109,27.0,2401,61599,64000,59,3171,85109,24465,60644,85109,6594,0.02821088251536265,0.7237659941956784,0.000693228683217991,0.2874549107614941,0.7125450892385059,0.037258104313292364
8110,23.0,63,1794,2156,2,154,2915,750,2165,2915,200,0.021612349914236707,0.6154373927958834,0.0006861063464837049,0.25728987993138935,0.7427101200686106,0.052830188679245285
8111,,1541,35984,37525,173,2221,50809,13858,36951,50809,3269,0.030329272373004784,0.7082209844712551,0.0034049085791887264,0.2727469542797536,0.7272530457202464,0.043712728059989374
8112,,418,8716,9134,1,374,11891,3640,8251,11891,933,0.03515263644773358,0.7329913379867127,8.409721638213776e-05,0.3061138676309814,0.6938861323690186,0.03145235892691952
8113,16.0,327,6090,6417,38,426,8632,2332,6300,8632,516,0.0378822984244671,0.7055143651529193,0.004402224281742354,0.2701575532900834,0.7298424467099166,0.049351251158480075
8114,25.0,135,3348,3483,7,165,4633,1319,3314,4633,345,0.02913878696309087,0.7226419166846536,0.00151090006475286,0.28469674077271745,0.7153032592272826,0.03561407295488884
8115,34.0,97,2661,2758,10,124,3553,1058,2495,3553,253,0.02730087250211089,0.7489445538981143,0.0028145229383619475,0.29777652687869405,0.702223473121306,0.03490008443568815
8116,25.0,2082,56140,58222,119,3428,77315,21766,55552,77318,6084,0.026927752916526552,0.7260922424273778,0.0015390982694844667,0.28151271372772185,0.7184872862722781,0.044336377040275224
8117,27.0,389,8814,9203,29,379,12165,3433,8732,12165,898,0.03197698314837649,0.724537607891492,0.002383888203863543,0.28220304151253595,0.717796958487464,0.03115495273325113
8118,,892,2539,3431,8,186,4592,1313,3279,4592,277,0.19425087108013936,0.552918118466899,0.0017421602787456446,0.28593205574912894,0.7140679442508711,0.04050522648083624
8119,,394,9978,10372,158,446,13894,3953,9941,13894,985,0.028357564416294802,0.7181517201669786,0.011371815172016698,0.2845112998416583,0.7154887001583418,0.03210018713113574
8120,,765,8161,8926,75,1025,12681,3342,9339,12681,709,0.060326472675656495,0.6435612333412192,0.005914360066240833,0.26354388455169153,0.7364561154483085,0.08082958757195804
8121,25.0,456,8624,9080,1,222,11725,3429,8296,11725,778,0.03889125799573561,0.7355223880597015,8.528784648187633e-05,0.29245202558635397,0.707547974413646,0.018933901918976547
8122,36.0,83,2743,2826,3,90,3563,1092,2471,3563,274,0.02329497614369913,0.7698568621947797,0.0008419870895312938,0.30648330058939094,0.693516699410609,0.025259612685938817
8123,,191,12845,13036,54,537,18608,4868,13740,18608,1191,0.010264402407566637,0.6902944969905417,0.002901977644024076,0.2616079105760963,0.7383920894239037,0.028858555460017195
8124,,893,24901,25794,98,1064,33542,9713,23829,33542,2462,0.026623337904716476,0.742382684395683,0.0029217100948065113,0.2895772464373025,0.7104227535626975,0.031721423886470694
8125,,2073,45726,47799,83,2021,63052,18183,44869,63052,5110,0.03287762481761086,0.7252109370043773,0.0013163737867157267,0.28838101884159106,0.7116189811584089,0.03205290871027089
8126,26.0,2194,71994,74188,562,2417,95168,28677,66491,95168,6190,0.023053967720242097,0.7564937794216543,0.005905346334902488,0.3013302790854069,0.6986697209145931,0.025397192333557497
8127,,1881,50177,52058,164,3249,69827,19895,49932,69827,5173,0.02693800392398356,0.7185902301402036,0.0023486616924685293,0.2849184412906182,0.7150815587093817,0.04652927950506251
8128,16.0,167,4877,5044,30,301,6832,1960,4872,6832,465,0.024443793911007025,0.7138466042154566,0.004391100702576112,0.28688524590163933,0.7131147540983607,0.04405737704918033
8129,,3464,86277,89741,305,3585,119043,34462,84581,119043,9519,0.02909872903068639,0.7247549204909151,0.002562099409457087,0.2894920322908529,0.7105079677091471,0.03011516846853658
8130,,88,2474,2562,7,125,3361,990,2371,3361,233,0.02618268372508182,0.7360904492710503,0.0020827134781315083,0.2945551919071705,0.7054448080928295,0.037191312109491226
8131,23.0,208,4105,4313,20,435,6005,1627,4378,6005,423,0.03463780183180683,0.6835970024979184,0.0033305578684429643,0.27094088259783516,0.7290591174021649,0.07243963363863447
8132,27.0,152,3038,3190,11,204,4465,1196,3269,4465,303,0.03404255319148936,0.6804031354983203,0.002463605823068309,0.2678611422172452,0.7321388577827548,0.04568868980963046
8133,27.0,115,2189,2304,13,56,2876,878,1998,2876,178,0.03998609179415855,0.7611265646731572,0.004520166898470098,0.30528511821974963,0.6947148817802503,0.019471488178025034
8134,17.0,270,6306,6576,43,299,8730,2435,6295,8730,670,0.030927835051546393,0.7223367697594502,0.004925544100801833,0.2789232531500573,0.7210767468499427,0.03424971363115693
8135,,1005,25407,26412,50,1204,34754,9933,24821,34754,2587,0.02891753467226794,0.7310525407147379,0.0014386833170282557,0.2858088277608333,0.7141911722391667,0.0346434942740404
8136,,335,4518,4853,49,301,6505,1850,4655,6505,427,0.05149884704073789,0.6945426594926979,0.007532667179093005,0.2843966179861645,0.7156033820138356,0.04627209838585703
8137,17.0,15,2026,2041,12,77,2733,712,2021,2733,213,0.005488474204171241,0.7413099158433956,0.0043907793633369925,0.2605195755579949,0.7394804244420051,0.028174167581412366
8138,26.0,205,5863,6068,83,316,7940,2321,5619,7940,515,0.025818639798488665,0.7384130982367758,0.010453400503778338,0.2923173803526448,0.7076826196473551,0.039798488664987405
8139,17.0,28,5145,5173,7,247,6950,1949,5001,6950,660,0.004028776978417266,0.7402877697841727,0.0010071942446043165,0.28043165467625897,0.719568345323741,0.03553956834532374
8140,16.0,60,9677,9737,175,1233,14866,3637,11229,14866,640,0.004036055428494552,0.6509484730256963,0.011771828333109108,0.24465222655724472,0.7553477734427553,0.08294093905556303
8141,,1649,32158,33807,11,1765,44585,12953,31632,44585,3354,0.03698553325109342,0.7212739710665022,0.0002467197487944376,0.29052371873948635,0.7094762812605137,0.03958730514747112
8142,26.0,4,1691,1695,2,80,2230,636,1594,2230,181,0.0017937219730941704,0.7582959641255606,0.0008968609865470852,0.2852017937219731,0.7147982062780269,0.03587443946188341
8143,26.0,430,12040,12470,54,460,16169,4731,11438,16169,1276,0.026594099820644444,0.7446347949780444,0.0033397241635227904,0.2925969447708578,0.7074030552291422,0.02844950213371266
8144,15.0,182,1748,1930,20,157,2721,686,2035,2721,158,0.06688717383314957,0.6424108783535465,0.00735023888276369,0.25211319367879453,0.7478868063212054,0.05769937522969496
8145,,158,4463,4621,33,220,6456,1800,4656,6456,465,0.024473358116480794,0.6912949194547707,0.005111524163568773,0.2788104089219331,0.7211895910780669,0.03407682775712516
8146,15.0,87,5588,5675,18,459,7793,2160,5633,7793,663,0.011163865007057615,0.7170537662004363,0.0023097651738739895,0.27717182086487874,0.7228281791351213,0.05889901193378673
8147,15.0,118,3975,4093,3,241,5623,1551,4072,5623,470,0.020985239196158634,0.7069180152943269,0.0005335230304108127,0.2758314067223902,0.7241685932776099,0.04285968344300196
8148,,1904,32018,33922,103,2770,46626,12754,33872,46626,3060,0.04083558529575773,0.6866984086132201,0.002209067902028911,0.27353836915025953,0.7264616308497405,0.05940891348174838
8149,25.0,101,3470,3571,50,191,4706,1355,3351,4706,321,0.021461963450913727,0.7373565660858479,0.010624734381640459,0.28793030174245643,0.7120696982575435,0.04058648533786655
8150,16.0,204,3652,3856,19,184,5592,1426,4166,5592,361,0.03648068669527897,0.6530758226037195,0.003397711015736767,0.2550071530758226,0.7449928469241774,0.032904148783977114
8151,34.0,87,1504,1591,17,109,2174,585,1589,2174,144,0.04001839926402944,0.6918123275068997,0.0078196872125115,0.2690892364305428,0.7309107635694572,0.05013799448022079
8152,,277,7667,7944,30,855,11246,3008,8238,11246,693,0.024630979903965854,0.6817535123599502,0.0026676151520540637,0.26747287924595414,0.7325271207540459,0.07602703183354081
8153,23.0,149,10457,10606,0,196,13292,4090,9202,13292,961,0.011209750225699668,0.7867138128197412,0.0,0.3077038820343064,0.6922961179656937,0.014745711706289497
8154,15.0,4,1561,1565,27,110,2227,541,1686,2227,158,0.001796138302649304,0.7009429726088909,0.012123933542882801,0.24292770543331837,0.7570722945666817,0.04939380332285586
8155,,102,1663,1765,5,193,2542,666,1876,2542,141,0.04012588512981904,0.6542092840283241,0.001966955153422502,0.2619984264358773,0.7380015735641228,0.07592446892210858
8156,23.0,470,18166,18636,60,670,24098,7005,17093,24098,2139,0.01950369325255208,0.753838492820981,0.002489833181176861,0.29068802390239856,0.7093119760976014,0.027803137189808282
8157,,45,1510,1555,1,112,2089,585,1504,2089,164,0.0215414073719483,0.7228338918142652,0.0004786979415988511,0.2800382958353279,0.7199617041646721,0.053614169459071326
8158,24.0,64,2180,2244,2,128,2952,852,2100,2952,208,0.02168021680216802,0.7384823848238482,0.0006775067750677507,0.2886178861788618,0.7113821138211383,0.04336043360433604
8159,14.0,156,1892,2048,3,210,2832,777,2055,2832,162,0.05508474576271186,0.6680790960451978,0.001059322033898305,0.274364406779661,0.725635593220339,0.07415254237288135
8160,25.0,354,5559,5913,74,299,7867,2274,5593,7867,463,0.04499809330113131,0.7066226007372569,0.009406381085547222,0.2890555484937079,0.7109444515062922,0.03800686411592729
8161,15.0,578,11673,12251,15,747,16295,4566,11729,16295,988,0.035471003375268484,0.7163547100337527,0.0009205277692543725,0.280208652961031,0.719791347038969,0.04584228290886775
8162,16.0,23,2315,2338,10,162,3360,875,2485,3360,252,0.006845238095238095,0.6889880952380952,0.002976190476190476,0.2604166666666667,0.7395833333333334,0.048214285714285716
8163,14.0,837,16847,17684,63,1227,24309,6694,17615,24309,1778,0.03443169196593854,0.6930355012546794,0.00259163272861903,0.27537126167263154,0.7246287383273685,0.05047513266691349
8164,,78,1867,1945,36,284,2754,733,2021,2754,178,0.02832244008714597,0.6779230210602759,0.013071895424836602,0.26615831517792304,0.733841684822077,0.10312273057371096
8165,,942,11031,11973,168,911,16672,4526,12146,16672,1059,0.056501919385796545,0.6616482725527831,0.010076775431861805,0.27147312859884837,0.7285268714011516,0.05464251439539347
8166,16.0,70,3717,3787,31,471,5952,1355,4597,5952,277,0.011760752688172043,0.6244959677419355,0.005208333333333333,0.22765456989247312,0.7723454301075269,0.07913306451612903
8167,,216,5498,5714,5,157,7068,2207,4861,7068,470,0.030560271646859084,0.7778720996038483,0.0007074136955291454,0.3122524052065648,0.6877475947934352,0.02221279003961517
8168,26.0,314,9580,9894,44,608,13499,3755,9744,13499,1100,0.023260982294984814,0.7096821986813838,0.003259500703755834,0.27816875324098084,0.7218312467590192,0.045040373360989705
8169,34.0,392,10717,11109,67,469,15030,4216,10814,15030,1079,0.02608117099135063,0.7130405854956753,0.0044577511643379905,0.28050565535595473,0.7194943446440453,0.031204258150365934
8170,,437,8990,9427,58,681,12638,3543,9095,12638,768,0.03457825605317297,0.7113467320778604,0.004589333755341035,0.28034499129609114,0.7196550087039089,0.05388510840322836
8171,,949,19554,20503,53,910,26785,7782,19003,26785,1879,0.03543027814075042,0.7300354676124696,0.0019787194325182004,0.29053574761993656,0.7094642523800635,0.03397423931304835
8172,15.0,74,1685,1759,8,45,2307,673,1634,2307,192,0.03207628955353273,0.7303857824013871,0.0034677069787602947,0.2917208495882098,0.7082791504117902,0.01950585175552666
8173,,2740,53138,55878,126,2915,74257,21059,53198,74257,5255,0.03689887822023513,0.7155958360827935,0.001696809728375776,0.28359615928464654,0.7164038407153535,0.03925555839853482
8174,45.0,222,6396,6618,32,276,8524,2534,5990,8524,591,0.026044110746128578,0.7503519474425152,0.003754106053496011,0.2972782731112154,0.7027217268887846,0.0323791647114031
8175,17.0,187,3113,3300,28,151,4449,1306,3143,4449,310,0.042031917284783095,0.6997077995055069,0.006293549112160036,0.293549112160036,0.706450887839964,0.03394021128343448
8176,23.0,444,15095,15539,55,561,20209,5937,14272,20209,1824,0.021970409223613242,0.7469444306991935,0.002721559701123262,0.2937799990103419,0.7062200009896581,0.02775990895145727
8177,,245,8781,9026,53,359,11860,3352,8508,11860,952,0.02065767284991568,0.7403878583473862,0.004468802698145025,0.28263069139966274,0.7173693086003373,0.03026981450252951
8178,,297,6044,6341,42,292,8430,2417,6013,8430,608,0.03523131672597865,0.7169632265717675,0.00498220640569395,0.2867141162514828,0.7132858837485172,0.034638196915776985
8179,,87,3744,3831,11,177,4962,1426,3536,4962,372,0.017533252720677146,0.75453446191052,0.0022168480451430876,0.28738411930673113,0.7126158806932689,0.035671100362756954
8180,,237,3144,3381,38,312,4645,1189,3456,4645,319,0.051022604951560815,0.6768568353067815,0.008180839612486545,0.25597416576964477,0.7440258342303552,0.06716899892357374
8181,16.0,4,1865,1869,1,95,2505,708,1797,2505,229,0.0015968063872255488,0.7445109780439122,0.0003992015968063872,0.28263473053892213,0.7173652694610778,0.03792415169660679
8182,,83,2629,2712,8,155,3614,1046,2568,3614,247,0.022966242390702822,0.7274488101826231,0.002213613724405091,0.2894299944659657,0.7105700055340343,0.042888765910348646
8183,,721,11424,12156,117,1559,17534,4519,13015,17534,1133,0.04112010950153987,0.6515341621991559,0.006672750085548078,0.25772784304779284,0.7422721569522072,0.08891296908862781
8184,14.0,132,2513,2645,14,176,3617,1019,2598,3617,260,0.03649433231960188,0.6947746751451479,0.003870611003594139,0.2817251866187448,0.7182748133812552,0.048659109759469174
8185,,1359,37317,38676,375,4818,54669,14336,40333,54669,3842,0.02485869505569884,0.6825989134610108,0.006859463315590188,0.26223270957946915,0.7377672904205308,0.08813038467870274
8186,15.0,2171,57899,60070,38,4632,80030,20711,59319,80030,4787,0.027127327252280394,0.7234662001749343,0.00047482194177183554,0.25879045357990754,0.7412095464200925,0.057878295639135324
8187,,287,10387,10674,46,555,14014,3997,10017,14014,1210,0.02047952047952048,0.7411873840445269,0.0032824318538604252,0.2852147852147852,0.7147852147852148,0.039603253888968175
8188,25.0,2929,81143,84072,198,4514,111698,31814,79884,111698,8365,0.02622249279306702,0.7264498916721875,0.00177263693172662,0.2848215724542964,0.7151784275457036,0.04041254095865638
8189,23.0,313,7604,7917,36,412,10457,3035,7422,10457,678,0.029932102897580568,0.7271684039399445,0.003442669981830353,0.2902362054126422,0.7097637945873577,0.03939944534761404
8190,24.0,136,3741,3877,43,154,5026,1466,3560,5026,366,0.027059291683247114,0.7443294866693195,0.008555511341026662,0.291683247115002,0.708316752884998,0.03064066852367688
8191,27.0,198,6181,6379,28,225,8286,2413,5873,8286,702,0.02389572773352643,0.7459570359642771,0.0033791938209027277,0.2912140960656529,0.708785903934347,0.02715423606082549
8192,,201,4783,4984,36,312,6611,1875,4736,6611,432,0.030403872333988807,0.7234911511117834,0.00544546967175919,0.28361821207079113,0.7163817879292089,0.04719407048857964
8193,15.0,269,12626,12895,44,1073,17298,4837,12461,17298,1189,0.015550930743438548,0.7299109723667476,0.0025436466643542605,0.27962770262458087,0.7203722973754191,0.0620302925193664
8194,34.0,61,1851,1912,14,91,2546,730,1816,2546,239,0.023959151610369208,0.7270227808326787,0.0054988216810683424,0.2867242733699921,0.7132757266300078,0.03574234092694423
8195,,785,14148,14933,78,701,20098,5694,14404,20098,1449,0.039058612797293266,0.703950641854911,0.0038809831824062097,0.2833117723156533,0.7166882276843467,0.03487909244700965
8196,15.0,37,4146,4183,11,425,5895,1540,4355,5895,374,0.006276505513146734,0.7033078880407124,0.0018659881255301102,0.26123833757421544,0.7387616624257846,0.0720949957591179
8197,17.0,509,20548,21057,0,404,26661,7809,18852,26661,1726,0.019091556955853118,0.7707137766775439,0.0,0.29289974119500395,0.707100258804996,0.015153220059262593
8198,24.0,278,5246,5524,25,403,7443,2152,5291,7443,539,0.03735053069998656,0.7048233239285234,0.0033588606744592233,0.28913072685744995,0.71086927314255,0.05414483407228268
8199,15.0,162,2711,2873,40,89,3876,1082,2794,3876,325,0.04179566563467492,0.6994324045407637,0.010319917440660475,0.27915376676986586,0.7208462332301342,0.022961816305469555
8200,26.0,1603,38868,40471,162,1510,52108,15567,36541,52108,3793,0.03076303062869425,0.7459123359177093,0.003108927611883012,0.2987449144085361,0.7012550855914639,0.028978275888539188
8201,13.0,481,5924,6405,145,742,9330,2390,6940,9330,422,0.05155412647374062,0.6349410503751339,0.015541264737406217,0.25616291532690244,0.7438370846730975,0.0795284030010718
8202,25.0,16,1786,1802,0,60,2331,702,1629,2331,216,0.006864006864006864,0.7661947661947662,0.0,0.30115830115830117,0.6988416988416989,0.02574002574002574
8203,,91,2768,2859,1,170,3893,1094,2799,3893,248,0.02337528898022091,0.7110197790906756,0.00025687130747495504,0.2810172103776008,0.7189827896223991,0.043668122270742356
8204,26.0,1617,60265,62129,225,3520,82800,23017,59783,82800,6035,0.019528985507246376,0.7278381642512077,0.002717391304347826,0.27798309178743963,0.7220169082125604,0.04251207729468599
8205,,1728,43569,45297,188,2374,60465,16889,43576,60465,4435,0.02857851649714711,0.7205656164723394,0.003109236748532209,0.27931861407425784,0.7206813859257422,0.039262383196890766
8206,13.0,155,2679,2834,29,410,3994,1084,2910,3994,265,0.03880821231847772,0.670756134201302,0.007260891337005508,0.271407110665999,0.728592889334001,0.10265398097145718
8207,33.0,153,4201,4354,13,280,5865,1643,4222,5865,465,0.02608695652173913,0.7162830349531116,0.002216538789428815,0.2801364023870418,0.7198635976129583,0.04774083546462063
8208,,3275,77396,80671,162,4206,108454,31407,77047,108454,8692,0.030197134268906634,0.7136297416416176,0.00149372084017187,0.28958821251406125,0.7104117874859387,0.03878141885038818
8209,13.0,5,2277,2282,8,153,3045,846,2199,3045,204,0.0016420361247947454,0.7477832512315271,0.002627257799671593,0.27783251231527095,0.722167487684729,0.05024630541871921
8210,23.0,143,6147,6290,35,301,8304,2382,5922,8304,665,0.017220616570327554,0.7402456647398844,0.004214836223506744,0.28684971098265893,0.713150289017341,0.03624759152215799
8211,23.0,1327,58743,60070,156,3453,79381,23002,56379,79381,6465,0.016716846600571926,0.7400133533213238,0.0019652057797205883,0.28976707272521135,0.7102329272747887,0.0434990740857384
8212,16.0,113,4771,4884,19,570,6875,1776,5099,6875,479,0.016436363636363638,0.6939636363636363,0.0027636363636363635,0.25832727272727274,0.7416727272727273,0.0829090909090909
8213,17.0,2126,41970,44096,174,3006,59885,16745,43140,59885,4530,0.03550137764047758,0.7008432829590048,0.0029055690072639223,0.2796192702680137,0.7203807297319863,0.050196209401352596
8214,16.0,658,35304,35962,91,1412,47403,13643,33760,47403,3845,0.013880977997173175,0.7447629896841972,0.0019197097230133115,0.2878087884733034,0.7121912115266966,0.029787144273569183
8215,,146,3805,3951,5,230,5344,1520,3824,5344,426,0.027320359281437126,0.7120134730538922,0.0009356287425149701,0.2844311377245509,0.7155688622754491,0.04303892215568862
8216,,134,2935,3069,23,118,4489,1166,3323,4489,327,0.029850746268656716,0.6538204499888617,0.0051236355535754065,0.2597460458899532,0.7402539541100468,0.026286478057473826
8217,23.0,39,2150,2189,6,84,2880,821,2059,2880,253,0.013541666666666667,0.7465277777777778,0.0020833333333333333,0.28506944444444443,0.7149305555555555,0.029166666666666667
8218,,792,10582,11374,124,812,15368,4326,11042,15368,845,0.05153565851119209,0.6885736595523165,0.008068714211348256,0.2814940135346174,0.7185059864653827,0.05283706402915148
8219,23.0,357,7866,8223,21,518,10924,3150,7774,10924,649,0.032680336872940315,0.720065909923105,0.0019223727572317832,0.2883559135847675,0.7116440864152325,0.04741852801171732
8220,23.0,1814,35711,37525,174,2129,51618,14235,37383,51618,3489,0.03514277965050951,0.6918323065597273,0.003370917121934209,0.2757758921306521,0.7242241078693479,0.04124530202642489
8221,,1715,17819,19534,116,1372,26267,7275,18992,26267,2106,0.06529104960596947,0.6783797159934518,0.004416187611832337,0.2769634903110367,0.7230365096889634,0.05223283968477557
8222,23.0,135,6436,6571,10,191,8471,2478,5993,8471,730,0.01593672529807579,0.7597686223586353,0.001180498170227836,0.2925274465824578,0.7074725534175422,0.02254751505135167
8223,23.0,2217,58960,61177,703,5140,93385,23377,70008,93385,6128,0.02374042940515072,0.6313647802109547,0.007527975584944049,0.2503292820046046,0.7496707179953954,0.05504095946886545
8224,24.0,2433,115932,118365,654,6893,159692,45300,114392,159692,12481,0.015235578488590537,0.7259724970568344,0.004095383613455903,0.28367106680359694,0.7163289331964031,0.04316434135711244
8225,,115,3037,3152,11,112,4121,1198,2923,4121,365,0.027905848095122542,0.7369570492598884,0.0026692550351856345,0.2907061392865809,0.709293860713419,0.027177869449162825
8226,17.0,534,7786,8320,40,629,11844,3073,8771,11844,757,0.04508611955420466,0.6573792637622425,0.003377237419790611,0.2594562647754137,0.7405437352245863,0.05310705842620736
8227,,1398,29602,31000,131,1121,43539,11795,31744,43539,3043,0.03210914352649349,0.6798961850295138,0.0030087967109947403,0.27090654355864857,0.7290934564413515,0.025747031397138197
8228,25.0,352,7839,8191,69,438,11112,3160,7952,11112,901,0.03167746580273578,0.7054535637149028,0.006209503239740821,0.2843772498200144,0.7156227501799856,0.03941684665226782
8229,23.0,598,10191,10789,100,772,14928,4036,10892,14928,926,0.04005894962486602,0.6826768488745981,0.00669882100750268,0.2703644158628081,0.7296355841371919,0.05171489817792069
8230,,1555,39403,40958,103,1735,53046,15511,37535,53046,4010,0.029314180145534066,0.742808128793877,0.0019417109678392338,0.292406590506353,0.707593409493647,0.03270746144855408
8231,27.0,470,7923,8393,78,542,11464,3098,8366,11464,711,0.040997906489881365,0.6911200279134683,0.00680390788555478,0.27023726448011165,0.7297627355198884,0.047278436845778087
8232,24.0,549,6818,7545,18,860,11081,2848,8233,11081,617,0.04954426495803628,0.6152874289324068,0.0016244021297716813,0.257016514754986,0.742983485245014,0.07761032397798033
8233,,377,11339,11716,14,769,15582,4367,11215,15582,1007,0.024194583493774867,0.7276986266204595,0.0008984725965858042,0.28025927352072905,0.719740726479271,0.049351816198177384
8234,24.0,1112,23054,24166,87,1273,32303,9178,23125,32303,2089,0.034424047302108164,0.7136798439773395,0.0026932483051109804,0.2841222177506733,0.7158777822493266,0.039408104510416986
8235,,180,1935,2115,106,224,3197,782,2415,3197,174,0.05630278385986863,0.6052549264935877,0.033156083828589304,0.2446043165467626,0.7553956834532374,0.07006568658116985
8236,,541,11562,12103,27,842,16525,4518,12007,16525,1123,0.03273827534039334,0.6996671709531014,0.0016338880484114977,0.2734039334341906,0.7265960665658093,0.050953101361573376
8237,14.0,181,3945,4126,27,177,5537,1531,4006,5537,413,0.03268918186743724,0.712479682138342,0.004876286797905003,0.2765035217626874,0.7234964782373127,0.03196676900848835
8238,,158,3689,3847,0,242,5108,1491,3617,5108,349,0.030931871574001565,0.7222004698512138,0.0,0.2918950665622553,0.7081049334377447,0.04737666405638215
8239,14.0,47,1610,1657,5,222,2419,632,1787,2419,187,0.019429516329061595,0.6655642827614717,0.002066969822240595,0.26126498553121125,0.7387350144687888,0.09177346010748243
8240,,63,9481,9544,49,443,12820,3586,9234,12820,1045,0.004914196567862714,0.7395475819032762,0.0038221528861154446,0.2797191887675507,0.7202808112324492,0.03455538221528861
8241,16.0,401,5371,5772,32,310,7979,2135,5844,7979,541,0.05025692442661988,0.6731419977440782,0.004010527635041985,0.26757739065045744,0.7324226093495425,0.03885198646446923
8242,,178,2342,2520,5,329,3701,849,2852,3701,134,0.04809510942988381,0.6328019454201567,0.0013509862199405566,0.2293974601459065,0.7706025398540934,0.08889489327208862
8243,33.0,616,5712,6328,282,542,8610,2209,6401,8610,296,0.07154471544715447,0.6634146341463415,0.032752613240418116,0.2565621370499419,0.7434378629500581,0.06295005807200929
8244,16.0,505,22116,22621,75,1502,29816,8617,21199,29816,2045,0.016937214918164745,0.7417493962972901,0.002515427958143279,0.2890059028709418,0.7109940971290583,0.0503756372417494
8245,26.0,939,20837,21776,49,973,29032,8298,20734,29032,1932,0.03234362083218518,0.7177252686690548,0.00168779278038027,0.2858225406448057,0.7141774593551943,0.03351474235326536
8246,,1826,40239,42065,192,2243,56230,15912,40318,56230,3949,0.0324737684510048,0.7156144406900231,0.0034145473946292017,0.28298061532989505,0.717019384670105,0.0398897385737151
8247,,240,5733,5973,31,333,7899,2224,5675,7899,578,0.030383592859855677,0.7257880744398025,0.003924547411064691,0.28155462716799595,0.718445372832004,0.04215723509304975
8248,34.0,87,2790,2877,7,120,3902,1098,2804,3902,345,0.02229625832906202,0.7150179395181958,0.0017939518195797027,0.2813941568426448,0.7186058431573552,0.030753459764223477
8249,17.0,143,3863,4006,4,332,5429,1328,4101,5429,442,0.026340025787437833,0.7115490882298766,0.0007367839381101492,0.24461226745256953,0.7553877325474304,0.06115306686314238
8250,44.0,142,4210,4352,32,135,5526,1691,3835,5526,399,0.025696706478465437,0.7618530582699964,0.00579080709373869,0.3060079623597539,0.6939920376402461,0.024429967426710098
8251,16.0,236,4595,4831,12,190,6312,1835,4477,6312,500,0.037389100126742715,0.72797845373891,0.0019011406844106464,0.2907160963244613,0.7092839036755386,0.030101394169835233
8252,,204,4343,4547,11,213,6013,1754,4259,6013,512,0.03392649259936804,0.722268418426742,0.0018293696989855313,0.29170131382005654,0.7082986861799434,0.03542324962581074
8253,34.0,93,3313,3406,9,171,4474,1274,3200,4474,356,0.020786767992847562,0.740500670540903,0.002011622708985248,0.28475637013857846,0.7152436298614215,0.03822083147071972
8254,,1399,43410,44809,86,3398,62134,16946,45188,62134,4434,0.022515852834197058,0.6986513020246564,0.001384105320758361,0.2727331251810603,0.7272668748189397,0.054688254417871056
8255,,1498,38378,39876,169,2424,53382,14807,38575,53382,3870,0.028061893522161027,0.718931475029036,0.0031658611516990746,0.2773781424450189,0.7226218575549811,0.04540856468472519
8256,,11,2537,2548,20,126,3462,953,2509,3462,249,0.0031773541305603697,0.7328134026574235,0.005777007510109763,0.27527440785673024,0.7247255921432698,0.036395147313691506
8257,26.0,1256,31265,32521,164,1472,43154,12390,30764,43154,3130,0.029105065579088846,0.7244983083839274,0.003800342957779117,0.2871112758956296,0.7128887241043704,0.0341103953283589
8258,,223,1910,2133,42,242,3170,858,2312,3170,139,0.07034700315457414,0.6025236593059937,0.013249211356466877,0.27066246056782334,0.7293375394321766,0.07634069400630915
8259,,13434,228753,242187,1509,11296,313271,91894,221377,313271,19333,0.04288299906470756,0.7302080307465422,0.004816915705571215,0.2933370787592851,0.706662921240715,0.03605823711738399
8260,,3871,116425,120296,663,6704,159515,45098,114417,159515,11672,0.024267310284299282,0.729868664388929,0.004156348932702254,0.2827194934645645,0.7172805065354355,0.042027395542738925
8261,,596,9195,9791,74,583,13445,3713,9732,13445,891,0.044328746746002234,0.6838973596132392,0.005503904797322425,0.2761621420602454,0.7238378579397545,0.04336184455187802
8262,,158,3581,3739,12,267,5178,1376,3802,5178,313,0.030513711857860178,0.6915797605252993,0.002317497103128621,0.2657396678254152,0.7342603321745848,0.051564310544611816
8263,,128,21581,21709,71,2192,30203,7966,22237,30203,2601,0.004237989603681753,0.7145316690394994,0.0023507598582922225,0.26374863424163164,0.7362513657583684,0.07257557196305003
8264,,86,2245,2331,1,123,3255,889,2366,3255,282,0.02642089093701997,0.6897081413210445,0.00030721966205837174,0.2731182795698925,0.7268817204301076,0.03778801843317972
8265,23.0,684,11052,11736,62,470,15407,4480,10927,15407,929,0.044395404686181604,0.7173362757188291,0.004024144869215292,0.2907769195820082,0.7092230804179919,0.03050561433114818
8266,26.0,373,11165,11538,44,493,15308,4474,10834,15308,1153,0.024366344395087537,0.7293571988502744,0.0028743140841390124,0.2922654821008623,0.7077345178991377,0.03220538280637575
8267,15.0,160,2774,2934,33,163,4043,1071,2972,4043,264,0.03957457333663122,0.6861241652238437,0.008162255750680188,0.2649023002720752,0.7350976997279248,0.04031659658669305
8268,,981,14408,15389,50,1317,22400,5769,16631,22400,1226,0.04379464285714286,0.6432142857142857,0.002232142857142857,0.25754464285714285,0.7424553571428572,0.05879464285714286
8269,,203,9549,9752,13,391,12840,3808,9032,12840,1175,0.015809968847352026,0.7436915887850467,0.0010124610591900312,0.29657320872274145,0.7034267912772586,0.030451713395638628
8270,14.0,54,2316,2370,6,192,3264,862,2402,3264,222,0.016544117647058824,0.7095588235294118,0.001838235294117647,0.26409313725490197,0.7359068627450981,0.058823529411764705
8271,,361,8651,9012,98,359,12068,3488,8580,12068,977,0.029913821677162746,0.7168544912164402,0.008120649651972157,0.2890288365926417,0.7109711634073583,0.029748094133244946
8272,25.0,914,37012,37926,100,2537,51654,14193,37463,51656,3807,0.017693975530432088,0.7165092148056373,0.0019358835372463993,0.27475995044138146,0.7252400495586185,0.04911336533994115
8273,24.0,1510,47764,49274,48,2350,64255,18738,45517,64255,5298,0.02350011672243405,0.7433507120068478,0.0007470235779316785,0.291619329235079,0.7083806707649211,0.036573029336238426
8274,24.0,117,3809,3926,43,180,5230,1515,3715,5230,399,0.02237093690248566,0.7282982791586998,0.008221797323135755,0.28967495219885275,0.7103250478011472,0.03441682600382409
8275,23.0,162,6273,6435,15,234,8367,2447,5920,8367,610,0.01936177841520258,0.7497310864108999,0.0017927572606669057,0.2924584677901279,0.7075415322098721,0.027967013266403728
8276,17.0,7193,106608,113801,753,7738,153401,42974,110427,153401,9998,0.046890176726357716,0.6949628750790412,0.004908703333094309,0.2801415896897673,0.7198584103102327,0.050442956695197556
8277,,676,14467,15143,84,1205,20819,5572,15247,20819,1354,0.03247033959364042,0.6948940871319468,0.004034775925836976,0.26764013641385276,0.7323598635861472,0.05787982131706614
8278,16.0,9533,142674,152207,937,12326,207454,58512,148942,207454,14078,0.04595235570295102,0.6877380045696877,0.004516663935137428,0.28204806848747194,0.7179519315125281,0.059415581285489794
8279,23.0,2390,45221,47611,155,2720,62976,17731,45245,62976,4276,0.03795096544715447,0.718067200203252,0.002461255081300813,0.28155170223577236,0.7184482977642277,0.043191056910569105
8280,,663,20488,21151,54,2007,28143,6926,21217,28143,1739,0.023558256049461677,0.7279963045872864,0.0019187719859290054,0.24610027360267206,0.7538997263973279,0.07131435881036137
8281,,699,13706,14405,181,1585,20776,5340,15436,20776,1339,0.03364458991143627,0.6597035040431267,0.008711975356180207,0.2570273392375818,0.7429726607624182,0.07628994994224104
8282,48.0,138,4044,4182,121,190,5724,1641,4083,5724,410,0.02410901467505241,0.7064989517819706,0.02113906359189378,0.28668763102725364,0.7133123689727463,0.033193570929419984
8283,13.0,150,4154,4304,17,348,5999,1648,4351,5999,472,0.025004167361226872,0.6924487414569095,0.0028338056342723785,0.2747124520753459,0.7252875479246541,0.05800966827804634
8284,16.0,167,4329,4496,10,235,6035,1740,4295,6035,462,0.027671913835956918,0.7173156586578293,0.0016570008285004142,0.2883181441590721,0.7116818558409279,0.03893951946975974
8285,33.0,632,9718,10350,83,327,13448,3865,9583,13448,702,0.046995835812016655,0.7226353361094586,0.006171921475312314,0.28740333135038665,0.7125966686496134,0.024315883402736466
8286,16.0,657,9426,10083,84,745,13814,3739,10075,13814,873,0.047560445924424495,0.6823512378746199,0.0060807876067757345,0.2706674388301723,0.7293325611698277,0.0539307948458086
8287,27.0,736,14088,14841,72,748,19831,5743,14088,19831,1507,0.03711361000453835,0.7104029045433916,0.0036306792395744037,0.28959709545660833,0.7104029045433916,0.037718723211134085
8288,,59,14769,14828,108,1766,21143,5539,15604,21143,1566,0.002790521685664286,0.6985290639928109,0.005108073594097338,0.26197795960838105,0.738022040391619,0.08352646265903609
8289,,141,4863,5004,5,147,6481,1908,4573,6481,538,0.021755901866995834,0.7503471686468137,0.0007714858818083629,0.29439901249807127,0.7056009875019287,0.022681684925165868
8290,16.0,1109,23519,24628,82,1762,33043,9401,23642,33043,2483,0.0335623278757982,0.7117695124534698,0.0024816148654783162,0.2845080652483128,0.7154919347516872,0.05332445601186333
8291,24.0,81,2460,2541,4,129,3288,962,2326,3288,214,0.024635036496350366,0.7481751824817519,0.0012165450121654502,0.29257907542579076,0.7074209245742092,0.03923357664233577
8292,33.0,173,9369,9542,10,253,12118,3671,8447,12118,984,0.014276283215051989,0.7731473840567751,0.000825218682950982,0.3029377785113055,0.6970622214886945,0.020878032678659845
8293,33.0,63,1769,1832,5,87,2450,673,1777,2450,190,0.025714285714285714,0.7220408163265306,0.0020408163265306124,0.2746938775510204,0.7253061224489796,0.035510204081632656
8294,24.0,155,3801,3956,8,194,5492,1480,4012,5492,446,0.02822286962855062,0.6920975965040058,0.0014566642388929353,0.269482884195193,0.7305171158048069,0.035324107793153675
8295,26.0,123,3327,3450,39,136,4683,1305,3378,4683,361,0.02626521460602178,0.7104420243433697,0.008327994875080076,0.2786675208199872,0.7213324791800129,0.02904121289771514
8296,,1655,29303,30958,180,1806,41870,11849,30021,41870,3219,0.03952710771435395,0.69985669930738,0.0042990207786004295,0.2829949844757583,0.7170050155242417,0.043133508478624315
8297,33.0,89,1541,1630,5,72,2197,658,1539,2197,176,0.04050978607191625,0.7014110150204825,0.002275830678197542,0.29949931725079654,0.7005006827492034,0.032771961766044605
8298,26.0,330,5539,5869,59,394,8295,2187,6108,8295,533,0.039783001808318265,0.6677516576250754,0.0071127185051235685,0.2636528028933092,0.7363471971066908,0.04749849306811332
8299,,253,5694,5947,57,188,7930,2265,5665,7930,613,0.031904161412358134,0.7180327868852459,0.007187894073139975,0.28562421185372006,0.71437578814628,0.023707440100882726
8300,13.0,2181,13716,15897,101,2328,26629,5767,20863,26630,958,0.08190011265490049,0.5150582050319189,0.003792714983101765,0.21656027037176118,0.7834397296282388,0.08742020277882089
8301,15.0,97,4283,4380,105,523,6285,1588,4697,6285,332,0.01543357199681782,0.6814638027048529,0.016706443914081145,0.2526650755767701,0.7473349244232299,0.0832140015910899
8302,,2164,19681,21845,542,1874,32742,8334,24408,32742,1876,0.06609248060594955,0.6010933968603017,0.016553661963227658,0.25453545904343045,0.7454645409565696,0.05723535520127054
8303,23.0,319,7165,7484,23,393,9956,2825,7131,9956,676,0.03204098031337887,0.7196665327440739,0.002310164724789072,0.28374849337083163,0.7162515066291684,0.039473684210526314
8304,27.0,385,14525,14910,6,760,19714,5656,14058,19714,1693,0.01952926854012377,0.7367860403773968,0.00030435223698894185,0.2869027087349092,0.7130972912650908,0.038551283351932635
8305,,45,2510,2555,14,205,3570,938,2632,3570,281,0.012605042016806723,0.7030812324929971,0.00392156862745098,0.2627450980392157,0.7372549019607844,0.05742296918767507
8306,16.0,111,2639,2750,4,282,3916,1114,2802,3916,321,0.028345250255362615,0.6739019407558733,0.0010214504596527069,0.2844739530132789,0.7155260469867212,0.07201225740551584
8307,,390,2382,2772,37,273,3848,1026,2822,3848,205,0.10135135135135136,0.6190228690228691,0.009615384615384616,0.26663201663201663,0.7333679833679834,0.07094594594594594
8308,,7495,174764,182259,883,8573,240730,69208,171522,240730,18062,0.031134465999252275,0.7259751588917044,0.0036680098035143105,0.2874922111909608,0.7125077888090392,0.03561251194284053
8309,,620,12204,12824,205,761,17620,4845,12775,17620,1179,0.03518728717366629,0.692622020431328,0.011634506242905789,0.2749716231555051,0.7250283768444948,0.04318955732122588
8310,,251,3893,4144,18,321,5755,1552,4203,5755,372,0.04361424847958297,0.6764552562988706,0.0031277150304083404,0.2696785403996525,0.7303214596003476,0.05577758470894874
8311,15.0,401,9201,9602,51,504,12806,3693,9113,12806,1024,0.03131344682180228,0.7184913321880368,0.003982508199281587,0.2883804466656255,0.7116195533343745,0.0393565516164298
8312,38.0,89,2400,2489,8,117,3267,947,2320,3267,265,0.027242118151209062,0.7346189164370982,0.002448729721456994,0.2898683807774717,0.7101316192225283,0.03581267217630854
8313,15.0,42,2251,2293,17,88,3020,878,2142,3020,241,0.01390728476821192,0.7453642384105961,0.005629139072847682,0.29072847682119207,0.7092715231788079,0.02913907284768212
8314,,781,14712,15493,72,876,20579,5807,14772,20579,1532,0.03795130958744351,0.714903542446183,0.0034987122795082366,0.28218086398756015,0.7178191360124399,0.04256766606735021
8315,,3068,60784,63852,129,3710,83980,24570,59410,83980,5975,0.03653250773993808,0.723791378899738,0.0015360800190521553,0.29256965944272445,0.7074303405572755,0.04417718504405811
8316,24.0,203,5055,5258,8,290,6995,2015,4980,6995,536,0.029020729092208722,0.7226590421729807,0.0011436740528949249,0.28806290207290924,0.7119370979270908,0.04145818441744103
8317,14.0,1015,22205,23220,22,1326,30412,8771,21641,30412,2291,0.0333749835591214,0.7301394186505327,0.0007233986584243062,0.28840589241089043,0.7115941075891096,0.043601210048665004
8318,14.0,396,5046,5442,13,312,7396,2057,5339,7396,571,0.053542455381287185,0.6822606814494321,0.0017577068685776095,0.27812330989724177,0.7218766901027582,0.04218496484586263
8319,,1894,43689,45776,209,3177,64140,17370,46770,64140,4331,0.029529154973495477,0.6811506080449018,0.003258497037729966,0.2708138447146866,0.7291861552853134,0.049532273152478955
8320,16.0,68,1385,1453,14,84,2169,563,1606,2169,147,0.03135085292761641,0.6385431074227754,0.006454587367450438,0.2595666205624712,0.7404333794375288,0.03872752420470263
8321,16.0,481,5593,6074,61,312,8873,2312,6561,8873,563,0.05420939930125099,0.6303392313760847,0.006874788684774033,0.26056576129832076,0.7394342387016792,0.03516285360081145
8322,,134,10573,10707,91,1049,14649,3952,10697,14649,1166,0.009147382073861697,0.7217557512458188,0.0062120281247866746,0.2697795071335927,0.7302204928664072,0.07160898354836508
8323,24.0,124,2774,2898,0,57,3878,1114,2764,3878,324,0.03197524497163486,0.7153171738009283,0.0,0.28726147498710675,0.7127385250128933,0.014698298091799896
8324,25.0,252,5231,5483,30,152,7032,2077,4955,7032,459,0.03583617747440273,0.7438850967007964,0.004266211604095563,0.2953640500568828,0.7046359499431172,0.02161547212741752
8325,16.0,180,2644,2824,20,186,3826,1046,2780,3826,216,0.04704652378463147,0.69106116048092,0.005227391531625719,0.2733925771040251,0.7266074228959749,0.048614741244119186
8326,23.0,769,19469,20238,69,971,26867,7678,19189,26867,2096,0.028622473666579818,0.7246436148434883,0.002568206349797149,0.2857780920832248,0.7142219079167752,0.03614099080656567
8327,,78,2890,2968,3,241,3893,1084,2809,3893,278,0.020035961983046493,0.74235807860262,0.0007706139224248652,0.27844849730285126,0.7215515026971487,0.06190598510146417
8328,35.0,1344,43666,45010,45,2037,58452,17061,41391,58452,4194,0.02299322521042907,0.7470403065763361,0.0007698624512420448,0.29188051734756726,0.7081194826524327,0.03484910695955656
8329,13.0,96,1420,1516,11,117,2120,564,1556,2120,125,0.045283018867924525,0.6698113207547169,0.005188679245283019,0.2660377358490566,0.7339622641509433,0.05518867924528302
8330,16.0,131,3194,3325,7,128,4296,1263,3033,4296,322,0.030493482309124766,0.7434823091247672,0.0016294227188081937,0.29399441340782123,0.7060055865921788,0.0297951582867784
8331,24.0,740,16876,17616,1,725,23247,6800,16447,23247,1465,0.031832064352389555,0.7259431324471974,4.30163031789048e-05,0.29251086161655265,0.7074891383834473,0.031186819804705983
8332,44.0,2551,45129,47680,389,1683,63023,18443,44580,63023,3607,0.04047728607016486,0.7160719102549863,0.006172349777065516,0.29263919521444554,0.7073608047855545,0.026704536439077796
8333,26.0,248,5655,5903,42,369,7829,2217,5612,7829,491,0.03167709796908928,0.7223144718354835,0.005364669817345766,0.2831779282156086,0.7168220717843914,0.04713245625239494
8334,,132,2488,2620,18,151,3594,964,2630,3594,244,0.03672787979966611,0.6922648859209795,0.005008347245409015,0.26822481914301616,0.7317751808569839,0.04201446855870896
8335,24.0,782,20781,21563,28,949,28427,8323,20104,28427,2439,0.027509058289654203,0.7310303584620256,0.0009849790691947797,0.29278502831814823,0.7072149716818518,0.033383754880923065
8336,40.0,405,5903,6308,4,347,8926,2273,6653,8926,537,0.045373067443423704,0.661326462021062,0.00044812906116961686,0.25464933900963477,0.7453506609903652,0.038875196056464265
8337,,48,25977,26025,30,1437,34755,9870,24886,34756,3041,0.001381056508228795,0.747410519047071,0.0008631603176429969,0.283979744504546,0.716020255495454,0.04134537921509955
8338,17.0,257,5913,6170,63,231,8151,2387,5764,8151,635,0.03152987363513679,0.7254324622745676,0.007729112992270887,0.29284750337381915,0.7071524966261808,0.02834008097165992
8339,15.0,71,1534,1605,21,45,2142,613,1529,2142,184,0.03314659197012138,0.7161531279178338,0.00980392156862745,0.2861811391223156,0.7138188608776844,0.02100840336134454
8340,,113,2519,2632,15,151,3613,986,2627,3613,244,0.03127594796567949,0.6972045391641295,0.004151674508718516,0.2729034043730971,0.7270965956269029,0.0417935233877664
8341,24.0,2297,46987,49284,80,1870,65545,19084,46464,65548,5566,0.03504302190760969,0.7168334655519619,0.0012204796485018612,0.291145420150119,0.708854579849881,0.028528711783731005
8342,14.0,107,2282,2389,11,212,3315,913,2402,3315,185,0.03227752639517346,0.6883861236802413,0.0033182503770739064,0.27541478129713426,0.7245852187028657,0.06395173453996983
8343,26.0,83,2176,2259,12,111,2994,840,2154,2994,217,0.027722110888443553,0.7267869071476286,0.004008016032064128,0.280561122244489,0.7194388777555111,0.03707414829659319
8344,16.0,3780,44555,48335,258,3112,65916,19009,46916,65925,2559,0.05733788395904437,0.6758437618505878,0.00391353811149033,0.28834281380356463,0.7116571861964354,0.04720515737580584
8345,,69,1840,1909,24,140,2652,707,1945,2652,208,0.026018099547511313,0.693815987933635,0.00904977375565611,0.26659125188536953,0.7334087481146304,0.05279034690799397
8346,17.0,137,2074,2211,9,157,3404,769,2635,3404,188,0.04024676850763807,0.6092831962397179,0.0026439482961222094,0.22591069330199764,0.7740893066980024,0.046122209165687426
8347,16.0,829,14391,15220,32,960,20854,5949,14905,20854,1506,0.03975256545506857,0.6900834372302675,0.00153447779802436,0.28526901313896613,0.7147309868610339,0.046034333940730796
8348,15.0,1215,18733,19948,51,1492,27241,7767,19474,27241,1762,0.044601886861715796,0.6876766638522814,0.001872177967034984,0.28512169156785727,0.7148783084321427,0.05477038287874895
8349,13.0,144,2917,3061,15,565,4689,1128,3561,4689,242,0.030710172744721688,0.6220942631691192,0.003198976327575176,0.24056301983365322,0.7594369801663468,0.12049477500533162
8350,27.0,1137,27055,28192,44,1586,38225,10725,27500,38225,3071,0.02974493132766514,0.707782864617397,0.0011510791366906475,0.2805755395683453,0.7194244604316546,0.04149117069980379
8351,,71,2365,2436,6,151,3259,943,2316,3259,283,0.021785823872353484,0.725682724762197,0.001841055538508745,0.28935256213562444,0.7106474378643756,0.04633323105247008
8352,23.0,132,3738,3870,40,264,5494,1523,3971,5494,360,0.024026210411357846,0.6803785948307244,0.0072806698216235895,0.2772115034583182,0.7227884965416819,0.04805242082271569
8353,,985,23104,24089,80,1332,32044,9156,22888,32044,2433,0.03073898389714143,0.7210086131569092,0.0024965672200724003,0.28573211833728623,0.7142678816627138,0.041567844214205465
8354,14.0,138,8940,10159,70,1083,14356,3640,10716,14356,442,0.009612705488994148,0.6227361382000557,0.004876010030649206,0.2535525215937587,0.7464474784062413,0.07543884090275843
8355,25.0,193,11889,12082,9,328,15219,4500,10719,15219,1149,0.012681516525395887,0.7811945594322885,0.0005913660555884093,0.29568302779420463,0.7043169722057954,0.021552007359222025
8356,41.0,677,13913,14590,114,561,19364,5521,13843,19364,1372,0.034961784755215865,0.7184982441644289,0.005887213385664119,0.28511671142325967,0.7148832885767403,0.028971286924189217
8357,,149,2780,2929,4,142,3933,1145,2788,3933,313,0.03788456648868548,0.706839562674803,0.0010170353419781336,0.2911263666412408,0.7088736333587592,0.036104754640223745
8358,16.0,16,3057,3073,11,227,4199,1151,3048,4199,340,0.0038104310550130982,0.7280304834484401,0.002619671350321505,0.2741128840200048,0.7258871159799952,0.054060490592998334
8359,,98,1753,1851,6,65,2475,712,1763,2475,194,0.039595959595959594,0.7082828282828283,0.0024242424242424242,0.2876767676767677,0.7123232323232324,0.026262626262626262
8360,,74,1993,2067,16,85,2677,795,1882,2677,174,0.027642883825177437,0.7444901008591707,0.005976839745984311,0.2969742248785954,0.7030257751214045,0.03175196115054165
8361,,4085,69534,73619,710,5251,100111,27695,72416,100111,6600,0.04080470677547922,0.6945690283784999,0.0070921277382105866,0.2766429263517496,0.7233570736482504,0.05245177852583632
8362,24.0,208,5960,6168,19,357,8197,2356,5841,8197,660,0.02537513724533366,0.7270952787605222,0.002317921190679517,0.2874222276442601,0.7125777723557399,0.04355251921434671
8363,27.0,272,6059,6331,46,212,8414,2378,6036,8414,600,0.0323270739244117,0.7201093415735679,0.005467078678393154,0.2826241977656287,0.7173758022343713,0.025196101735203234
8364,33.0,1735,38431,40166,406,2433,54129,15281,38848,54129,3773,0.03205305843448059,0.7099891001126938,0.007500600417521107,0.28230708123187204,0.717692918768128,0.04494817934933215
8365,17.0,215,2555,2770,26,297,4183,1072,3111,4183,246,0.05139851781018408,0.6108056418838155,0.006215634711929237,0.25627540043031316,0.7437245995696868,0.07100167344011475
8366,33.0,6990,137438,144428,1076,6235,195312,54696,140616,195312,14298,0.03578889161956254,0.7036843614319652,0.005509134103383304,0.2800442369132465,0.7199557630867535,0.03192328172360121
8367,27.0,713,4987,5700,156,187,8145,2222,5943,8165,219,0.08732394366197183,0.610777709736681,0.019105939987752604,0.2721371708511941,0.7278628291488058,0.02290263319044703
8368,,323,26704,27027,118,1019,35288,10312,24976,35288,3328,0.009153253230559964,0.7567445023804126,0.003343912944910451,0.2922239854908184,0.7077760145091816,0.028876671956472456
8369,25.0,526,12675,13201,147,678,17582,4992,12590,17582,1002,0.029916960527812536,0.7209077465589808,0.008360823569559778,0.28392674326015244,0.7160732567398476,0.03856216585143897
8370,17.0,824,24280,25104,201,2170,34363,9438,24925,34363,1713,0.02397928003957745,0.7065739312632774,0.005849314669848384,0.27465587987079126,0.7253441201292088,0.06314931757995518
8371,14.0,103,2168,2271,3,173,3030,887,2143,3030,208,0.03399339933993399,0.7155115511551156,0.0009900990099009901,0.29273927392739274,0.7072607260726073,0.057095709570957096
8372,17.0,767,16540,17307,118,1630,24367,6549,17818,24367,1789,0.031476997578692496,0.678786883900357,0.004842615012106538,0.2687651331719128,0.7312348668280871,0.06689374974350557
8373,16.0,94,6406,6500,90,575,9054,2390,6664,9054,505,0.010382151535233046,0.7075325822840733,0.009940357852882704,0.2639717252043296,0.7360282747956705,0.06350784183786172
8374,27.0,186,2382,2568,27,202,3690,965,2725,3690,236,0.05040650406504065,0.6455284552845528,0.007317073170731708,0.26151761517615174,0.7384823848238482,0.054742547425474256
8375,17.0,517,8031,8548,77,421,11199,3394,7805,11199,782,0.04616483614608447,0.7171175997856951,0.006875613894097687,0.30306277346191624,0.6969372265380838,0.037592642200196445
8376,,165,6326,6491,57,608,9189,2417,6772,9189,595,0.017956252040483185,0.6884318206551311,0.006203068886712374,0.2630318859505931,0.7369681140494069,0.06616606812493199
8377,14.0,239,4145,4384,59,291,5955,1669,4286,5955,456,0.0401343408900084,0.6960537363560033,0.009907640638119228,0.2802686817800168,0.7197313182199833,0.048866498740554154
8378,,102,3291,3393,12,337,5070,1326,3744,5070,366,0.020118343195266272,0.649112426035503,0.002366863905325444,0.26153846153846155,0.7384615384615385,0.06646942800788955
8379,35.0,3535,76075,79610,404,4417,107253,29944,77309,107253,6782,0.03295945101768715,0.7093041686479632,0.003766794402021389,0.2791903256785358,0.7208096743214643,0.041182997212199195
8380,25.0,247,9281,9528,33,604,12539,3399,9140,12539,1054,0.019698540553473164,0.7401706675173458,0.0026317888188850786,0.2710742483451631,0.7289257516548369,0.04816971050322992
8381,26.0,541,10120,10661,2,513,15552,3929,11623,15552,1065,0.034786522633744855,0.6507201646090535,0.0001286008230452675,0.252636316872428,0.7473636831275721,0.03298611111111111
8382,,307,10181,10488,27,477,13837,4067,9770,13837,1085,0.022186890221868903,0.7357808773578087,0.0019512900195129002,0.29392209293922095,0.7060779070607791,0.0344727903447279
8383,24.0,403,10544,10947,28,575,14721,4198,10523,14721,1189,0.02737585761836832,0.7162556891515522,0.0019020446980504042,0.2851708443719856,0.7148291556280144,0.0390598464778208
8384,23.0,10563,204594,215157,886,10353,287796,82802,204994,287796,21302,0.03670308134928908,0.7108993870658383,0.003078569542314695,0.28771073955162685,0.7122892604483732,0.035973397823458285
8385,24.0,714,21587,22301,27,817,29181,8765,20416,29181,2328,0.024467975737637503,0.73976217401734,0.0009252595867173846,0.3003666769473287,0.6996333230526712,0.027997669716596417
8386,,115,2956,3071,4,219,4133,1176,2957,4133,251,0.02782482458262763,0.7152189692717155,0.0009678199854827002,0.28453907573191384,0.7154609242680862,0.052988144205177834
8387,17.0,138,2188,2326,0,119,3150,908,2242,3150,229,0.04380952380952381,0.6946031746031746,0.0,0.28825396825396826,0.7117460317460318,0.03777777777777778
8388,,769,23267,24036,32,951,31235,9222,22013,31235,2509,0.024619817512405953,0.7449015527453178,0.0010244917560429006,0.2952457179446134,0.7047542820553866,0.03044661437489995
8389,14.0,560,10661,11221,90,1044,15851,3929,11922,15851,1060,0.03532900132483755,0.6725758627215949,0.005677875212920321,0.2478707967951549,0.7521292032048451,0.06586335246987572
8390,27.0,308,7540,7848,42,388,10815,2928,7887,10815,748,0.0284789644012945,0.6971798428109107,0.003883495145631068,0.27073509015256586,0.7292649098474341,0.035876098012020345
8391,48.0,3666,81097,84763,457,3059,112089,31901,80188,112089,8232,0.03270615314616064,0.7235054287218192,0.004077117290724335,0.2846041984494464,0.7153958015505536,0.02729081354994692
8392,24.0,3146,54166,57312,787,3026,80267,21626,58642,80268,5259,0.03919370110131061,0.6748143718542882,0.00980465440773409,0.26942243484327505,0.730577565156725,0.037698709323765386
8393,17.0,2640,93546,96186,317,6690,130974,36439,94535,130974,11188,0.020156672316642997,0.7142333592926841,0.0024203276986272085,0.2782155236917251,0.7217844763082749,0.05107884007512942
8394,23.0,1187,24643,25830,159,1393,34188,9790,24398,34188,2185,0.03471978471978472,0.7208084708084708,0.004650754650754651,0.28635778635778636,0.7136422136422137,0.04074529074529074
8395,17.0,109,2268,2377,7,87,3191,901,2290,3191,234,0.034158570980883735,0.7107489815104983,0.0021936696960200563,0.28235662801629585,0.7176433719837042,0.027264180507677843
8396,36.0,477,8831,9308,88,566,13170,3523,9647,13170,859,0.03621867881548975,0.6705391040242976,0.006681852695520122,0.2675018982536067,0.7324981017463933,0.042976461655277146
8397,23.0,94,3902,3996,14,175,5204,1540,3664,5204,365,0.0180630284396618,0.7498078401229823,0.002690238278247502,0.29592621060722524,0.7040737893927748,0.033627978478093776
8398,24.0,7500,135699,143199,1148,7210,186992,54140,132852,186992,11805,0.040108667750492,0.7256941473432018,0.006139300077008642,0.28953110293488493,0.7104688970651151,0.038557799264139644
8399,23.0,27,3036,3063,0,73,3988,1150,2838,3988,420,0.006770310932798395,0.7612838515546639,0.0,0.2883650952858576,0.7116349047141425,0.0183049147442327
8400,34.0,263,6285,6548,13,236,8962,2494,6468,8962,671,0.02934612809640705,0.701294353938853,0.001450569069404151,0.27828609685338096,0.7217139031466191,0.02633340772149074
8401,,108,3364,3472,9,156,4481,1347,3134,4481,353,0.024101762999330506,0.7507252845347021,0.002008480249944209,0.30060254407498327,0.6993974559250168,0.03481365766569962
8402,24.0,9,3616,3625,7,216,4891,1393,3498,4891,481,0.0018401144960130853,0.739317113064813,0.0014312001635657329,0.28480883254958084,0.7151911674504191,0.04416274790431405
8403,27.0,324,9290,9614,43,443,13050,3722,9328,13050,1059,0.02482758620689655,0.7118773946360153,0.0032950191570881226,0.28521072796934865,0.7147892720306513,0.03394636015325671
8404,,253,9449,9702,38,960,13778,3681,10097,13778,949,0.018362607054724926,0.6858034547829873,0.002758020031934969,0.26716504572506894,0.7328349542749311,0.06967629554362026
8405,,2396,21808,24204,40,1589,32529,9229,23300,32529,2241,0.07365735190138031,0.6704171662209105,0.0012296719849980019,0.28371606873866395,0.716283931261336,0.04884871960404562
8406,,84,2885,2969,26,103,3884,1112,2772,3884,289,0.021627188465499485,0.7427909371781668,0.006694129763130793,0.286302780638517,0.713697219361483,0.026519052523171986
8407,,126,2797,2923,16,172,3936,1101,2835,3936,282,0.03201219512195122,0.710619918699187,0.0040650406504065045,0.27972560975609756,0.7202743902439024,0.04369918699186992
8408,,237,22107,22344,96,865,30515,8321,22194,30515,2461,0.007766672128461412,0.7244633786662297,0.0031459937735539897,0.27268556447648695,0.727314435523513,0.02834671473046043
8409,,91,2075,2166,7,117,2783,819,1964,2783,175,0.03269852676967301,0.745598275242544,0.0025152712899748474,0.29428674092705714,0.7057132590729429,0.04204096298957959
8410,14.0,265,11862,12127,130,1734,16882,4552,12330,16882,827,0.015697192275796707,0.7026418670773605,0.007700509418315365,0.26963629901670416,0.7303637009832958,0.10271294870276033
8411,16.0,812,30401,31213,63,1904,42814,11841,30973,42814,3285,0.018965758863923016,0.7100714719484281,0.001471481291166441,0.2765684122016163,0.7234315877983837,0.044471434577474656
8412,,267,9935,10202,38,492,13654,3841,9813,13654,1019,0.01955470924271276,0.727625604218544,0.0027830672330452617,0.28130950637175917,0.7186904936282408,0.03603339680679654
8413,,430,8538,8968,17,409,11847,3360,8487,11847,850,0.036296108719507045,0.720688781970119,0.001434962437747953,0.28361610534312487,0.7163838946568751,0.03452350806111252
8414,26.0,77,2234,2311,0,75,3078,912,2166,3078,241,0.025016244314489927,0.7257959714100065,0.0,0.2962962962962963,0.7037037037037037,0.024366471734892786
8415,,2897,67731,70628,307,2672,94029,27025,67004,94029,7731,0.030809643833285476,0.7203203267077178,0.0032649501749460273,0.28741133054695894,0.7125886694530411,0.02841676504057259
8416,16.0,429,21833,22262,209,662,29257,8358,20899,29257,2647,0.0146631575349489,0.7462487609802783,0.007143589568308439,0.2856752230235499,0.71432477697645,0.022627063608709027
8417,25.0,140,2880,3020,1,126,3851,1125,2726,3851,265,0.03635419371591794,0.7478576992988835,0.00025967281225655674,0.29213191378862635,0.7078680862113736,0.03271877434432615
8418,24.0,247,20008,20255,26,2373,30637,7934,22703,30637,2134,0.00806214707706368,0.6530665535137252,0.0008486470607435454,0.2589679146130496,0.7410320853869504,0.07745536442863205
8419,33.0,184,6425,6609,11,276,8991,2469,6522,8991,818,0.020464909353798244,0.7146034923812702,0.0012234456678901122,0.2746079412746079,0.725392058725392,0.030697364030697363
8420,27.0,214,9489,9703,28,514,13090,3713,9377,13090,1058,0.016348357524828112,0.7249045072574485,0.0021390374331550803,0.2836516424751719,0.7163483575248281,0.03926661573720397
8421,16.0,309,4993,5302,23,465,7257,1912,5345,7257,471,0.04257957833815626,0.6880253548298195,0.0031693537274355794,0.2634697533416012,0.7365302466583988,0.06407606448945845
8422,25.0,8348,149574,157922,358,9146,215797,60589,155208,215797,15652,0.03868450441850443,0.693123630078268,0.0016589665287283883,0.2807685000254869,0.7192314999745131,0.04238242422276491
8423,24.0,647,9918,10565,55,1080,14890,3884,11006,14890,851,0.04345198119543318,0.6660846205507052,0.0036937541974479517,0.26084620550705173,0.7391537944929483,0.0725319006044325
8424,34.0,349,6831,7180,251,262,9804,2824,6980,9804,758,0.03559771521827825,0.6967564259485924,0.025601795185638515,0.28804569563443494,0.7119543043655651,0.02672378620971032
8425,23.0,1035,31175,32210,18,1375,42539,12213,30326,42539,3384,0.02433061425985566,0.7328569077787442,0.00042314111756270716,0.2871012482662968,0.7128987517337032,0.032323279813817905
8426,,479,13514,13993,58,687,18712,5321,13391,18712,1511,0.02559854638734502,0.7222103463018384,0.003099615220179564,0.28436297563061136,0.7156370243693886,0.036714407866609663
8427,34.0,68,1728,1796,1,67,2423,678,1745,2423,193,0.028064382996285598,0.7131654973173751,0.0004127115146512588,0.2798184069335534,0.7201815930664466,0.02765167148163434
8428,,125,4728,4853,23,235,6453,1894,4559,6453,551,0.019370835270416862,0.7326824732682473,0.0035642336897567023,0.29350689601735624,0.7064931039826438,0.0364171703083837
8429,,274,1346,1620,3,184,2461,646,1815,2461,109,0.11133685493701748,0.5469321414059325,0.001219016659894352,0.2624949207639171,0.7375050792360829,0.07476635514018691
8430,27.0,2681,80288,82969,115,3446,108974,32113,76861,108974,9223,0.024602198689595685,0.7367628975718978,0.001055297593921486,0.29468497072696237,0.7053150292730376,0.031622221814377745
8431,24.0,458,7898,8356,69,500,11953,3229,8724,11953,720,0.03831674056722162,0.6607546222705597,0.005772609386764829,0.27014138709947294,0.7298586129005271,0.041830502802643686
8432,13.0,802,9220,10022,105,793,14168,3806,10362,14168,908,0.05660643704121965,0.6507622811970638,0.007411067193675889,0.2686335403726708,0.7313664596273292,0.055971202710333144
8433,25.0,422,11938,12360,44,375,16395,4777,11618,16395,1282,0.02573955474229948,0.7281488258615432,0.002683745044220799,0.2913693199146081,0.7086306800853919,0.022872827081427266
8434,34.0,1921,40081,42002,61,2036,56337,15911,40426,56337,4410,0.03409837229529439,0.7114507339758951,0.00108276976054813,0.28242540426362783,0.7175745957363722,0.036139659548786764
8435,14.0,1453,26733,28186,191,1709,39278,10941,28337,39278,2566,0.036992718570191964,0.6806100106930089,0.004862773053617801,0.278552879474515,0.721447120525485,0.04351036203472682
8436,17.0,308,16557,16865,55,994,22736,6391,16345,22736,1887,0.013546798029556651,0.7282283603096411,0.002419071076706545,0.2810960591133005,0.7189039408866995,0.0437192118226601
8437,16.0,540,11077,11617,8,601,15265,4501,10764,15265,1216,0.03537504094333443,0.7256469046839175,0.0005240746806419915,0.29485751719620046,0.7051424828037995,0.03937111038322961
8438,25.0,809,15428,16237,89,633,21562,6125,15437,21562,1700,0.037519710601984974,0.7155180409980522,0.004127631945088582,0.28406455801873665,0.7159354419812634,0.029357202485854744
8439,,554,13820,15136,98,1920,21982,5009,16973,21982,1135,0.025202438358657084,0.6286962059867164,0.0044581930670548634,0.22786825584569192,0.7721317441543081,0.08734419070148303
8440,17.0,305,8067,8372,14,308,10890,3194,7696,10890,823,0.02800734618916437,0.7407713498622589,0.0012855831037649219,0.2932966023875115,0.7067033976124886,0.028282828282828285
8441,15.0,914,41837,42751,200,2672,57539,16319,41220,57539,4995,0.01588487808269174,0.7271068318879369,0.003475903300370184,0.28361632979370516,0.7163836702062949,0.04643806809294566
8442,,330,9825,10155,81,575,13672,3828,9844,13672,974,0.024136922176711526,0.718622001170275,0.0059245172615564655,0.2799882972498537,0.7200117027501463,0.04205675833820948
8443,16.0,116,2990,3106,33,207,4149,1133,3016,4149,287,0.027958544227524706,0.7206555796577488,0.007953723788864787,0.2730778500843577,0.7269221499156423,0.049891540130151846
8444,13.0,47,1717,1764,0,57,2411,672,1739,2411,208,0.019493985897967647,0.7121526337619245,0.0,0.278722521775197,0.721277478224803,0.02364164247200332
8445,24.0,535,15104,15639,255,509,20035,6058,13977,20035,1394,0.026703269278762168,0.7538807087596706,0.01272772647866234,0.30237085101073125,0.6976291489892688,0.02540554030446718
8446,,142,2890,3032,22,178,4130,1158,2972,4130,306,0.03438256658595642,0.6997578692493946,0.005326876513317191,0.2803874092009685,0.7196125907990315,0.043099273607748186
8447,25.0,1118,32646,33764,105,1622,44426,12875,31551,44426,3112,0.025165443659118533,0.7348399585828118,0.0023634808445504884,0.2898077702246432,0.7101922297753568,0.036510151712960875
8448,,532,17787,18319,83,835,24109,6871,17238,24109,2220,0.022066448214359782,0.7377742751669502,0.0034426977477290638,0.2849973039114024,0.7150026960885976,0.034634368907876724
8449,,837,13259,14096,53,1481,19977,5283,14694,19977,1292,0.0418981829103469,0.6637132702608,0.002653051008659959,0.2644541222405767,0.7355458777594234,0.07413525554387546
8450,38.0,502,12308,12810,82,396,16417,4964,11453,16417,978,0.030578059328744595,0.7497106657732838,0.004994822440153499,0.3023694950356338,0.6976305049643662,0.02412133763781446
8451,,141,5558,5699,11,300,7325,2164,5161,7325,446,0.01924914675767918,0.7587713310580205,0.0015017064846416382,0.2954266211604096,0.7045733788395905,0.040955631399317405
8452,26.0,1392,41206,42598,202,2783,57083,15836,41247,57083,3862,0.024385543857190408,0.721861149554158,0.003538706795368148,0.2774205980764851,0.7225794019235149,0.04875356936390869
8453,,160,2099,2259,65,119,3089,860,2229,3089,212,0.05179669796050502,0.6795079313693752,0.021042408546455164,0.27840725153771445,0.7215927484622855,0.038523794108125606
8454,,113071,1894790,2007861,9074,106641,2638768,752976,1885792,2638768,153826,0.04284992087216458,0.7180585788519491,0.003438725950898298,0.28535134577954563,0.7146486542204544,0.040413177664728385
8455,23.0,99,1682,1781,5,80,2436,668,1768,2436,167,0.04064039408866995,0.6904761904761905,0.002052545155993432,0.2742200328407225,0.7257799671592775,0.03284072249589491
8456,25.0,75,2977,3052,13,198,4013,1181,2832,4013,309,0.01868925990530775,0.7418390231746823,0.00323947171692001,0.2942935459755794,0.7057064540244207,0.04933964615001246
8457,17.0,194,3824,4018,19,224,5486,1518,3968,5486,400,0.035362741523878964,0.6970470288005833,0.0034633612832664965,0.27670433831571273,0.7232956616842873,0.04083120670798396
8458,26.0,1699,37843,39542,279,1833,53136,14935,38201,53136,3824,0.031974555856669674,0.7121913580246914,0.005250677506775068,0.28107121348991265,0.7189287865100873,0.03449638663053297
8459,17.0,638,3382,4020,12,281,5984,1494,4490,5984,291,0.10661764705882353,0.5651737967914439,0.002005347593582888,0.24966577540106952,0.7503342245989305,0.04695855614973262
8460,15.0,2635,24155,26790,116,1934,36893,10316,26577,36893,2381,0.07142276312579622,0.6547312498305912,0.0031442279023120917,0.27961944000216843,0.7203805599978316,0.05242186864716884
8461,,98,5993,6091,21,239,7986,2322,5664,7986,702,0.012271475081392437,0.7504382669671926,0.002629601803155522,0.2907588279489106,0.7092411720510894,0.029927372902579515
8462,,155,4013,4168,4,227,5560,1577,3983,5560,434,0.02787769784172662,0.7217625899280575,0.0007194244604316547,0.28363309352517985,0.7163669064748202,0.040827338129496404
8463,,104,6278,6382,22,340,8605,2483,6122,8605,756,0.012085996513654851,0.7295758280069727,0.002556653108657757,0.28855316676350956,0.7114468332364904,0.039511911679256245
8464,25.0,1903,35761,37664,123,2386,51504,14199,37305,51504,3435,0.036948586517552034,0.694334420627524,0.0023881640260950605,0.27568732525629075,0.7243126747437092,0.04632649891270581
8465,24.0,157,5516,5673,44,267,7509,2189,5320,7509,640,0.02090824344120389,0.7345851644693036,0.005859635104541217,0.29151684645092557,0.7084831535490744,0.035557331202556934
8466,15.0,403,6814,7217,14,400,9641,2787,6854,9641,691,0.04180064308681672,0.7067731563115859,0.0014521315216263872,0.28907789648376725,0.7109221035162328,0.04148947204646821
8467,40.0,264,7762,8026,59,295,10386,3052,7334,10386,760,0.025418833044482957,0.7473522048911997,0.005680724051607934,0.2938571153475833,0.7061428846524167,0.02840362025803967
8468,,841,13700,14541,97,573,19144,5520,13624,19144,1127,0.04393021312160468,0.7156289176765567,0.0050668616798997075,0.2883409945674885,0.7116590054325115,0.029931048892603427
8469,,9027,132261,141288,115,12558,200987,55151,145836,200987,13040,0.044913352604894846,0.6580574863050844,0.0005721763099105912,0.27440083189460013,0.7255991681053998,0.06248165304223656
8470,,108,3029,3137,18,132,4111,1193,2918,4111,349,0.02627098029676478,0.736803697397227,0.004378496716127463,0.2901970323522257,0.7098029676477743,0.032108975918268064
8471,16.0,368,17357,17725,10,783,23019,6797,16222,23019,1926,0.015986793518397845,0.7540292801598679,0.0004344237369129849,0.29527781397975583,0.7047221860202442,0.03401537860028672
8472,23.0,103,3518,3621,27,98,4703,1383,3320,4703,381,0.021900914310014886,0.748033170316819,0.005741016372528174,0.29406761641505424,0.7059323835849458,0.020837763129917076
8473,14.0,503,16154,16657,41,654,21293,6191,15102,21293,1363,0.023622786831353028,0.7586530784764947,0.0019255154276053162,0.29075282956840276,0.7092471704315972,0.030714319259850655
8474,26.0,794,22404,23198,79,1194,30765,8594,22171,30765,2206,0.025808548675442872,0.7282301316431009,0.0025678530797984722,0.27934340971883637,0.7206565902811637,0.038810336421257925
8475,,425,7767,8192,93,358,10979,3090,7889,10979,941,0.038710265051461884,0.7074414791875399,0.008470716823025776,0.2814463976682758,0.7185536023317242,0.032607705619819655
8476,23.0,106,6526,6632,10,246,8886,2544,6342,8886,818,0.011928876884987621,0.7344136844474454,0.0011253657438667567,0.2862930452397029,0.7137069547602971,0.027683997299122215
8477,,138,3176,3314,15,157,4428,1300,3128,4428,369,0.03116531165311653,0.7172538392050587,0.0033875338753387536,0.2935862691960253,0.7064137308039747,0.035456187895212286
8478,15.0,289,5900,6189,32,503,8543,2300,6243,8543,563,0.033828865738031136,0.6906239026103242,0.0037457567599204025,0.26922626711927894,0.730773732880721,0.05887861406999883
8479,,150,3888,4038,8,209,5375,1531,3844,5375,442,0.027906976744186046,0.7233488372093023,0.0014883720930232557,0.2848372093023256,0.7151627906976744,0.03888372093023256
8480,26.0,670,25401,26071,92,2473,34629,9830,24799,34629,2233,0.019347945363712496,0.7335181495278523,0.002656732796211268,0.28386612376909526,0.7161338762309047,0.07141413266337462
8481,16.0,646,12972,13618,61,851,18607,5163,13444,18607,1459,0.03471811683774923,0.6971569839307787,0.003278336110066104,0.2774762186273983,0.7225237813726018,0.04573547589616811
8482,,109,2308,2417,2,43,3657,903,2754,3657,208,0.02980585179108559,0.6311184030626197,0.0005468963631391851,0.2469237079573421,0.7530762920426579,0.01175827180749248
8483,37.0,70,2253,2323,7,103,3098,892,2206,3098,237,0.022595222724338282,0.7272433828276307,0.0022595222724338285,0.2879276952872821,0.7120723047127179,0.03324725629438347
8484,24.0,3338,48455,51793,1513,3446,73032,19528,53504,73032,4772,0.04570599189396429,0.663476284368496,0.020716945996275604,0.2673896374192135,0.7326103625807865,0.04718479570599189
8485,,103,4529,4632,4,152,5938,1791,4147,5938,388,0.01734590771303469,0.7627147187605254,0.0006736274840013472,0.3016167059616032,0.6983832940383967,0.025597844392051195
8486,,936,3434,4370,51,121,5740,1664,4076,5740,390,0.16306620209059233,0.5982578397212543,0.008885017421602788,0.2898954703832753,0.7101045296167248,0.0210801393728223
8487,17.0,837,32150,32987,73,1858,46017,12572,33445,46017,3401,0.018188930177977704,0.698654844948606,0.0015863702544711737,0.27320338135906297,0.726796618640937,0.04037638264119782
8488,,1903,41235,43138,285,3093,57948,16379,41569,57948,4355,0.03283978739559605,0.7115862497411473,0.004918202526402982,0.28264996203492787,0.7173500379650721,0.053375440049699734
8489,26.0,164,5238,5402,3,236,7092,2002,5090,7092,516,0.023124647490129723,0.7385786802030457,0.00042301184433164127,0.2822899041173153,0.7177100958826848,0.03327693175408911
8490,17.0,3094,122684,125778,205,5241,164552,48164,116388,164552,13682,0.018802566969711703,0.7455637123827118,0.001245806796635714,0.2926977490398172,0.7073022509601828,0.03185011424959891
8491,36.0,118,1698,1816,7,284,2793,690,2103,2793,213,0.042248478338703904,0.6079484425349087,0.002506265664160401,0.24704618689581095,0.7529538131041891,0.1016827783745077
8492,13.0,358,3025,3383,70,369,4828,1018,3810,4828,177,0.07415078707539353,0.6265534382767192,0.014498757249378625,0.2108533554266777,0.7891466445733223,0.07642916321458161
8493,24.0,2232,34987,37219,228,2374,49713,14142,35571,49713,3656,0.04489771287188462,0.7037796954518939,0.004586325508418321,0.28447287429847323,0.7155271257015268,0.04775410858326796
8494,,524,8604,9128,54,811,12229,3247,8982,12229,640,0.04284896557363644,0.7035734728923052,0.004415733093466351,0.26551639545343036,0.7344836045465696,0.06631776923705945
8495,16.0,172,3800,3972,2,184,5275,1495,3780,5275,415,0.032606635071090045,0.7203791469194313,0.0003791469194312796,0.2834123222748815,0.7165876777251184,0.03488151658767773
8496,,65,2042,2107,11,299,2945,778,2167,2945,136,0.022071307300509338,0.6933786078098472,0.003735144312393888,0.2641765704584041,0.735823429541596,0.10152801358234295
8497,24.0,2752,172701,175453,1832,11012,242903,66364,176641,243005,18896,0.011324869858644884,0.7106890804715952,0.007538939527993251,0.27309726137322277,0.7269027386267772,0.04531594000123454
8498,,858,11629,12487,45,1099,16976,4886,12090,16976,1055,0.05054194156456174,0.6850259189443921,0.0026508011310084826,0.287818096135721,0.7121819038642789,0.06473845428840716
8499,24.0,316,6967,7283,21,292,9686,2776,6910,9686,760,0.0326244063596944,0.7192855667974396,0.0021680776378277928,0.2865992153623787,0.7134007846376214,0.03014660334503407
8500,,366,9150,9516,15,496,12449,3603,8846,12449,926,0.0293999518033577,0.7349987950839425,0.0012049160575146598,0.2894208370150213,0.7105791629849787,0.03984255763515142
8501,17.0,466,10367,10833,29,659,14604,4099,10505,14604,1095,0.031909066009312516,0.7098740071213366,0.001985757326759792,0.2806765269789099,0.7193234730210901,0.04512462339085182
8502,26.0,1075,31390,32465,147,2047,42431,11921,30510,42431,3062,0.02533525017086564,0.7397893049892768,0.0034644481628997668,0.2809502486389668,0.7190497513610332,0.04824302986024369
8503,16.0,4412,136011,140423,314,8838,187065,53559,133506,187065,14531,0.023585384759308263,0.7270788228690562,0.0016785609280196723,0.2863122444070243,0.7136877555929757,0.047245609814770266
8504,45.0,10555,258300,268855,1420,9940,350259,103051,247208,350259,24978,0.03013484307326864,0.7374542838299658,0.004054142791477164,0.29421371042571354,0.7057862895742865,0.02837899954034015
8505,16.0,658,3546,4204,469,1034,7222,1556,5666,7222,108,0.09111049570756023,0.4909997230684021,0.0649404597064525,0.21545278316255884,0.7845472168374411,0.14317363611188036
8506,,227,36633,36860,327,3656,50619,13743,36876,50619,3133,0.004484482111460124,0.7237005867362057,0.006460024891839033,0.27149884430747345,0.7285011556925265,0.07222584405065292
8507,23.0,111,3399,3510,5,152,4675,1338,3337,4675,384,0.02374331550802139,0.7270588235294118,0.0010695187165775401,0.2862032085561497,0.7137967914438502,0.03251336898395722
8508,13.0,21843,37205,59048,116,5335,81689,22809,58880,81689,3800,0.2673921825459976,0.4554468777926037,0.0014200198313114372,0.27921752010674633,0.7207824798932537,0.06530867069005619
8509,,223,6185,6408,28,315,8692,2447,6245,8692,665,0.025655775425678786,0.7115738610216291,0.0032213529682466636,0.2815232397606995,0.7184767602393005,0.03624022089277497
8510,16.0,161,4863,5024,35,230,6746,1927,4819,6746,645,0.023865994663504298,0.7208716276311888,0.005188259709457456,0.28565075600355766,0.7143492439964423,0.03409427809072043
8511,34.0,89,1952,2041,10,72,2787,765,2022,2787,207,0.031933979189092215,0.700394689630427,0.003588087549336204,0.2744886975242196,0.7255113024757804,0.02583423035522067
8512,16.0,113,5499,5612,4,229,7237,2154,5084,7238,573,0.015612047526941144,0.7597402597402597,0.0005526388505111909,0.2975960210002763,0.7024039789997237,0.03163857419176568
8513,16.0,2023,38724,40963,805,5215,57370,15108,42262,57370,2721,0.03526233222938818,0.6749869269653129,0.014031723897507408,0.26334321073731914,0.7366567892626809,0.09090116785776538
8514,16.0,14,10468,10482,68,580,13889,3878,10011,13889,1206,0.0010079919360645115,0.7536899704802361,0.004895960832313341,0.27921376628986966,0.7207862337101303,0.04175966592267262
8515,25.0,399,7320,7719,15,332,10288,3122,7166,10288,776,0.038783048211508554,0.7115085536547434,0.00145800933125972,0.3034603421461897,0.6965396578538102,0.0322706065318818
8516,15.0,413,10471,10884,33,666,15091,4236,10855,15091,1372,0.02736730501623484,0.6938572659200848,0.002186733814856537,0.2806971042343118,0.7193028957656882,0.04413226426346829
8517,,227,4616,4843,12,154,6323,1860,4463,6323,495,0.035900680056935,0.7300332120828721,0.0018978333069745374,0.2941641625810533,0.7058358374189467,0.024355527439506565
8518,27.0,212,6839,7051,15,225,9209,2681,6528,9209,742,0.0230209577587143,0.7426430665653165,0.001628841350852427,0.29112824410902377,0.7088717558909762,0.024432620262786406
8519,,587,11615,12202,41,764,16571,4649,11922,16571,1224,0.035423329913704664,0.7009232997405105,0.002474201919015147,0.2805503590610102,0.7194496409389898,0.04610464063725786
8520,,159,3969,4128,38,243,5663,1585,4078,5663,468,0.0280769909941727,0.7008652657601978,0.006710224262758255,0.27988698569662723,0.7201130143033728,0.04291011831184884
8521,26.0,132,2575,2707,0,107,3600,1005,2595,3600,229,0.03666666666666667,0.7152777777777778,0.0,0.2791666666666667,0.7208333333333333,0.029722222222222223
8522,,1317,26514,27831,163,956,36705,10692,26013,36705,2604,0.03588067020841847,0.7223539027380466,0.0044408118784906685,0.2912954638332652,0.7087045361667348,0.02604549788857104
8523,,237,7962,8199,29,198,10665,3185,7480,10665,918,0.022222222222222223,0.7465541490857946,0.002719174871073605,0.2986404125644632,0.7013595874355368,0.018565400843881856
8524,,2474,42842,45316,247,2416,60420,17183,43237,60420,4000,0.040946706388613044,0.7090698444223767,0.004088050314465409,0.2843925852366766,0.7156074147633235,0.03998675935120821
8525,27.0,2638,76983,79621,399,2936,104605,30602,74003,104605,8481,0.02521867979542087,0.7359399646288418,0.0038143492184886,0.292548157353855,0.707451842646145,0.02806749199369055
8526,25.0,51,1691,1742,11,47,2279,664,1615,2279,183,0.022378236068451074,0.7419921017990346,0.004826678367705134,0.2913558578323826,0.7086441421676174,0.020623080298376482
8527,,8161,117865,126026,465,8722,171689,47218,124471,171689,12023,0.047533621839488845,0.6865029209792124,0.002708385511011189,0.275020531309519,0.724979468690481,0.05080115790761202
8528,,238,5028,5266,38,349,7014,2003,5011,7014,544,0.033932135728542916,0.716852010265184,0.005417735956658112,0.2855717137154263,0.7144282862845737,0.04975762760193898
8529,25.0,412,15118,15530,287,851,20700,5897,14803,20700,1344,0.019903381642512076,0.7303381642512077,0.013864734299516908,0.2848792270531401,0.7151207729468599,0.04111111111111111
8530,,104,2148,2252,3,131,3011,839,2172,3011,211,0.034540019926934576,0.7133842577216871,0.0009963467286615742,0.27864496844902026,0.7213550315509797,0.04350714048488874
8531,14.0,105,3496,3601,20,306,5577,1290,4287,5577,331,0.018827326519634213,0.6268603191680114,0.0035861574323112783,0.23130715438407745,0.7686928456159225,0.054868208714362564
8532,17.0,202,4806,5008,5,279,6546,1907,4639,6546,483,0.030858539566147265,0.7341888175985335,0.0007638252367858234,0.29132294531011305,0.708677054689887,0.042621448212648946
8533,15.0,322,4857,5179,37,300,6885,1997,4888,6885,503,0.046768336964415395,0.7054466230936819,0.005374001452432825,0.29005083514887436,0.7099491648511256,0.04357298474945534
8534,,882,20481,21363,131,1809,29166,8221,20945,29166,2064,0.03024069121579922,0.7022217650689159,0.004491531234999657,0.2818692998697113,0.7181307001302887,0.062024274840567786
8535,,199,17517,17716,270,2276,25051,6841,18210,25051,1375,0.007943794658895852,0.6992535228134605,0.010778012853778293,0.27308291086184183,0.7269170891381581,0.0908546565007385
8536,,87,1826,1913,1,80,2569,718,1851,2569,173,0.03386531724406384,0.7107824056052939,0.00038925652004671076,0.27948618139353837,0.7205138186064617,0.031140521603736863
8537,26.0,1363,22418,23781,235,1326,32213,9403,22810,32213,1711,0.04231211001769472,0.69593021450967,0.007295191382361159,0.2919007853971999,0.7080992146028001,0.04116350541706764
8538,17.0,34,4772,4806,13,172,6472,1842,4630,6472,647,0.005253399258343634,0.7373300370828183,0.0020086526576019777,0.284610630407911,0.715389369592089,0.02657601977750309
8539,,1312,29183,30495,174,2063,41001,11492,29509,41001,2885,0.031999219531230944,0.711763127728592,0.004243798931733373,0.2802858466866662,0.7197141533133338,0.05031584595497671
8540,,1309,29649,30958,127,1609,41186,11902,29284,41186,3174,0.031782644587966785,0.7198805419317243,0.0030835720876025833,0.2889816928082358,0.7110183071917642,0.03906667314135871
8541,17.0,172,7300,7472,20,292,9720,2902,6818,9720,781,0.017695473251028805,0.7510288065843621,0.00205761316872428,0.298559670781893,0.701440329218107,0.030041152263374487
8542,23.0,0,4888,4888,5,410,6555,1823,4732,6555,505,0.0,0.7456903127383676,0.0007627765064836003,0.2781083142639207,0.7218916857360793,0.06254767353165523
8543,,1345,36720,38065,121,1691,50157,14604,35553,50157,3948,0.026815798393045837,0.7321012022250134,0.0024124249855453873,0.29116573957772596,0.708834260422274,0.03371413760791116
8544,,156,3540,3696,62,708,5462,1397,4065,5462,224,0.02856096667887221,0.6481142438667155,0.011351153423654338,0.25576711827169535,0.7442328817283046,0.1296228487733431
8545,42.0,362,9666,10028,33,466,13196,3885,9311,13196,955,0.027432555319793876,0.732494695362231,0.0025007578053955746,0.2944073961806608,0.7055926038193392,0.03531373143376781
8546,,558,28636,29194,77,1006,39665,11182,28483,39665,4050,0.014067817975545191,0.721946300264717,0.001941258036051935,0.2819110046640615,0.7180889953359385,0.025362410185301904
8547,24.0,279,7571,7850,91,386,10613,3016,7597,10613,883,0.02628851408649769,0.7133703947988316,0.008574389899180251,0.2841797795156883,0.7158202204843117,0.03637048902289645
8548,,457,22979,23436,77,2094,33699,8757,24942,33699,2472,0.013561233271016944,0.6818896703166266,0.0022849342710466185,0.2598593430072109,0.7401406569927891,0.062138342384047
8549,,228,6006,6234,59,278,8076,2400,5676,8076,557,0.02823179791976226,0.7436849925705795,0.007305596830113918,0.2971768202080238,0.7028231797919762,0.03442298167409609
8550,13.0,113,2026,2139,10,81,2905,780,2125,2905,185,0.038898450946643716,0.6974182444061963,0.0034423407917383822,0.2685025817555938,0.7314974182444062,0.027882960413080894
8551,,116,2094,2210,20,127,3040,836,2204,3040,213,0.038157894736842106,0.6888157894736842,0.006578947368421052,0.275,0.725,0.04177631578947368
8552,13.0,304,7455,7759,53,322,10371,2929,7442,10371,907,0.029312506026419823,0.7188313566676309,0.005110404011185035,0.28242213865586735,0.7175778613441327,0.031048114935878893
8553,,40,2432,2472,8,139,3272,937,2335,3272,300,0.012224938875305624,0.7432762836185819,0.0024449877750611247,0.28636919315403425,0.7136308068459658,0.04248166259168704
8554,24.0,264,4988,5252,0,136,6909,2210,4699,6909,391,0.03821102909248806,0.7219568678535244,0.0,0.31987262990302506,0.680127370096975,0.019684469532493847
8555,15.0,1207,29502,30709,105,1389,40491,11562,28929,40491,2719,0.02980909337877553,0.7286063569682152,0.0025931688523375563,0.28554493591168406,0.7144550640883159,0.03430391938949396
8556,35.0,16778,279649,296427,3233,15819,404481,111984,292497,404481,29509,0.04148031675159031,0.6913773452893955,0.00799295887816733,0.27685849273513463,0.7231415072648654,0.039109377201895765
8557,,838,25973,26811,97,1922,36736,10136,26600,36736,3140,0.022811411149825784,0.7070176393728222,0.0026404616724738676,0.2759146341463415,0.7240853658536586,0.052319250871080136
8558,24.0,324,7444,7768,36,384,10248,2945,7303,10248,763,0.03161592505854801,0.7263856362217018,0.00351288056206089,0.28737314597970337,0.7126268540202967,0.03747072599531616
8559,24.0,1866,29724,31590,840,1872,44707,11995,32712,44707,2728,0.04173843022345494,0.6648623258102758,0.01878900395911155,0.2683025029637417,0.7316974970362583,0.041872637394591454
8560,17.0,6686,100146,106832,415,6742,148154,41210,106944,148154,11850,0.04512871741566208,0.6759587996274147,0.0028011393549954777,0.2781565128177437,0.7218434871822563,0.045506702485251835
8561,,1061,34304,35365,129,855,44859,13674,31185,44859,3222,0.02365188702378564,0.7647071936512183,0.00287567712164783,0.30482177489466994,0.69517822510533,0.01905972045743329
8562,17.0,7760,181054,188814,963,17357,262303,71624,190679,262303,17059,0.029584106929772057,0.690247538152442,0.0036713266718260943,0.27305825705386516,0.7269417429461348,0.0661715649458832
8563,25.0,190,2533,2723,48,159,3898,1012,2886,3898,223,0.04874294510005131,0.6498204207285787,0.012314007183170857,0.2596203181118522,0.7403796818881477,0.04079014879425346
8564,,138,2901,3039,19,212,4209,1175,3034,4209,311,0.03278688524590164,0.6892373485388453,0.004514136374435733,0.27916369684010456,0.7208363031598954,0.050368258493703966
8565,,220,24248,24468,68,713,32348,9410,22938,32348,3122,0.0068010387040929885,0.7495981204402127,0.00210213923581056,0.2908989736614319,0.7091010263385681,0.02204154816371955
8566,38.0,36,1449,1485,9,64,2015,557,1458,2015,187,0.017866004962779156,0.719106699751861,0.004466501240694789,0.27642679900744416,0.7235732009925558,0.03176178660049628
8567,14.0,293,35629,35922,184,4794,50294,13273,37021,50294,3509,0.005825744621624846,0.7084145226070704,0.0036584880900306198,0.2639082196683501,0.7360917803316499,0.0953195212152543
8568,33.0,56,2012,2068,2,142,2755,807,1948,2755,213,0.020326678765880218,0.7303085299455535,0.0007259528130671506,0.2929219600725953,0.7070780399274047,0.051542649727767696
8569,,303,12058,12361,26,511,16137,4607,11530,16137,1225,0.01877672429819669,0.7472268699262564,0.0016112040651917953,0.28549296647456157,0.7145070335254384,0.031666356819731054
8570,15.0,97,1486,1583,0,120,2308,636,1672,2308,144,0.042027729636048526,0.6438474870017331,0.0,0.2755632582322357,0.7244367417677643,0.05199306759098787
8571,26.0,115,3631,3746,1,138,4846,1436,3410,4846,359,0.02373091209244738,0.7492777548493603,0.0002063557573256294,0.2963268675196038,0.7036731324803962,0.028477094510936857
8572,26.0,1053,24757,25810,220,1282,34807,9632,25175,34807,2457,0.03025253540954406,0.7112649754359756,0.006320567701899043,0.2767259459304163,0.7232740540695837,0.03683167179015715
8573,14.0,116,2834,2950,4,136,3944,1100,2844,3944,272,0.029411764705882353,0.7185598377281948,0.0010141987829614604,0.2789046653144016,0.7210953346855984,0.034482758620689655
8574,15.0,347,10438,10785,15,1289,14979,4069,10910,14979,1069,0.023165765404900195,0.6968422458108018,0.001001401962747847,0.27164697242806596,0.728353027571934,0.08605380866546498
8575,,102,1624,1726,15,173,2640,662,1978,2640,137,0.038636363636363635,0.6151515151515151,0.005681818181818182,0.25075757575757573,0.7492424242424243,0.06553030303030304
8576,23.0,225,4744,4969,49,280,6633,1881,4752,6633,545,0.033921302578018994,0.7152118196894316,0.0073873058947685815,0.2835820895522388,0.7164179104477612,0.04221317654153475
8577,26.0,192,4597,4789,4,243,6325,1766,4559,6325,467,0.03035573122529644,0.726798418972332,0.0006324110671936759,0.2792094861660079,0.7207905138339921,0.03841897233201581
8578,23.0,631,17727,18358,78,519,23230,7085,16145,23230,1645,0.02716315109771847,0.7631080499354284,0.0033577270770555317,0.30499354283254415,0.6950064571674559,0.02234179939733104
8579,,1137,17784,18921,95,672,24097,7210,16887,24097,1732,0.04718429680043159,0.7380171805618957,0.003942399468813545,0.2992073702120596,0.7007926297879404,0.02788728887413371
8580,25.0,1360,16891,18251,531,1170,25692,6550,19142,25692,1228,0.0529347656858166,0.6574420052934765,0.020667912190565157,0.2549431729721314,0.7450568270278686,0.0455394675385334
8581,13.0,41831,222896,264727,1674,17139,376587,111379,265208,376587,21897,0.11107924596441195,0.5918844782214999,0.004445187964534092,0.29575901451722975,0.7042409854827703,0.04551139577308829
8582,,5974,98928,104902,572,6810,141787,40554,101233,141787,9622,0.04213362296966577,0.6977226402984759,0.004034220344601409,0.28602058016602366,0.7139794198339763,0.04802979116562167
8583,37.0,950,27535,28485,80,1074,37887,10802,27085,37887,3061,0.025074563834560668,0.7267664370364505,0.002111542217647214,0.2851109879378151,0.7148890120621849,0.02834745427191385
8584,,5400,150673,156073,586,8938,206415,58654,147761,206415,15948,0.026160889470241987,0.7299517961388465,0.0028389409684373714,0.28415570573843957,0.7158442942615605,0.04330111668241165
8585,27.0,60,1455,1515,6,73,2123,586,1537,2123,170,0.02826189354686764,0.6853509185115403,0.002826189354686764,0.27602449364107395,0.723975506358926,0.03438530381535563
8586,,815,7478,8293,111,1008,12433,3075,9358,12433,622,0.0655513552642162,0.6014638462157162,0.008927853293653986,0.24732566556744148,0.7526743344325585,0.08107455963966863
8587,36.0,153,7218,7371,28,280,9520,2826,6694,9520,721,0.01607142857142857,0.7581932773109243,0.0029411764705882353,0.2968487394957983,0.7031512605042017,0.029411764705882353
8588,,2262,87192,89454,133,2804,114979,34184,80795,114979,9829,0.01967315770705955,0.7583297819601841,0.001156732968629054,0.29730646465876376,0.7026935353412362,0.024387061985232085
8589,15.0,290,5288,5578,31,272,7425,2142,5283,7425,507,0.039057239057239054,0.7121885521885521,0.004175084175084175,0.2884848484848485,0.7115151515151515,0.036632996632996635
8590,,157,4341,4498,7,220,6082,1706,4376,6082,431,0.025813877014140084,0.7137454784610325,0.0011509371917132521,0.2804998355804012,0.7195001644195989,0.03617231173955936
8591,23.0,142,3337,3479,40,102,4529,1303,3226,4529,367,0.03135349966880106,0.7368072422168249,0.00883197173769044,0.2877014793552661,0.712298520644734,0.022521527931110622
8592,24.0,173,3481,3654,40,183,4899,1399,3500,4899,361,0.035313329250867526,0.7105531741171668,0.008164931618697694,0.28556848336395185,0.7144315166360482,0.03735456215554195
8593,,573,16827,17400,35,1395,24021,6596,17425,24021,1618,0.023854127638316472,0.7005120519545398,0.0014570584072270097,0.2745930644019816,0.7254069355980184,0.05807418508804796
8594,23.0,4778,94753,99531,848,7204,136824,37547,99277,136824,9612,0.03492077413319301,0.6925173946091329,0.006197743086008302,0.2744182307197568,0.7255817692802432,0.05265158159387242
8595,36.0,454,13483,13937,117,562,17796,5315,12481,17796,1212,0.025511350865363002,0.7576421667790515,0.006574511126095752,0.298662620813666,0.701337379186334,0.03158013036637446
8596,16.0,99,2838,2937,4,266,4070,1104,2966,4070,288,0.024324324324324326,0.6972972972972973,0.0009828009828009828,0.27125307125307124,0.7287469287469287,0.06535626535626536
8597,,5280,89568,94848,414,4704,124095,36208,87887,124095,8476,0.04254804786655385,0.7217696119908135,0.0033361537531729725,0.2917764615818526,0.7082235384181473,0.037906442644747976
8598,15.0,128,4811,4939,24,260,6914,1919,4995,6914,473,0.01851316170089673,0.6958345386172983,0.0034712178189181373,0.2775527914376627,0.7224472085623372,0.03760485970494649
8599,,986,20994,21980,38,1393,30018,8548,21471,30019,2023,0.03284586428595223,0.6993570738532263,0.001265864952196942,0.28475298977314367,0.7152470102268563,0.04640394416869316
8600,23.0,604,9028,9632,15,473,12865,3768,9097,12865,892,0.04694908666925768,0.7017489312087057,0.001165954139137194,0.2928876797512631,0.7071123202487369,0.03676642052079285
8601,,467,8174,8641,106,219,10742,3350,7392,10742,518,0.04347421336808788,0.7609383727425061,0.00986780860175014,0.31185998882889593,0.6881400111711041,0.020387264941351704
8602,16.0,1599,29749,31348,1480,2008,42666,11684,30982,42666,2784,0.037477148080438755,0.6972530820794075,0.03468804200065626,0.2738480288754512,0.7261519711245488,0.04706323536305255
8603,16.0,599,20685,21284,118,119,27908,8103,19805,27908,2086,0.021463379676078545,0.7411853232048158,0.004228178300128995,0.29034685394868853,0.7096531460513115,0.004264010319621614
8604,,1604,35504,37108,143,2099,50009,14082,35927,50009,3034,0.03207422663920494,0.7099522086024516,0.0028594852926473236,0.2815893139234938,0.7184106860765063,0.041972444959907214
8605,,323,3680,4003,10,300,5921,1510,4411,5921,311,0.05455159601418679,0.6215166357034285,0.0016889039013680122,0.25502448910656983,0.7449755108934302,0.05066711704104036
8606,38.0,437,15538,15975,30,476,20696,6065,14631,20696,1768,0.021115191341321993,0.7507730962504832,0.0014495554696559723,0.29305179744878235,0.7069482025512176,0.02299961345187476
8607,15.0,126,7063,7189,31,1320,10262,2636,7626,10262,448,0.01227830832196453,0.6882673942701227,0.0030208536347690507,0.25687000584681347,0.7431299941531865,0.12862989670629507
8608,16.0,218,8765,8983,15,625,12260,3516,8744,12260,880,0.017781402936378466,0.7149265905383361,0.0012234910277324632,0.2867862969004894,0.7132137030995106,0.050978792822185974
8609,,242,5367,5609,17,303,7614,2161,5453,7614,573,0.031783556606251644,0.7048857368006304,0.002232729183083793,0.283819280273181,0.7161807197268191,0.03979511426319937
8610,26.0,848,22964,23812,37,932,31237,9013,22224,31237,2487,0.027147293274001984,0.7351538239907802,0.001184492748983577,0.28853603098889136,0.7114639690111086,0.029836411947370106
8611,15.0,640,14981,15621,234,1583,21971,5823,16148,21971,1551,0.029129306813526924,0.6818533521460106,0.010650402803695782,0.26503117746119886,0.7349688225388011,0.072049519821583
8612,,54,1782,1836,7,106,2471,686,1785,2471,203,0.021853500607041682,0.7211655200323756,0.0028328611898017,0.2776203966005666,0.7223796033994334,0.042897612302711455
8613,16.0,153,5627,5780,0,341,7708,2128,5580,7708,665,0.019849507005708356,0.730020757654385,0.0,0.2760768033212247,0.7239231966787752,0.04423975090814738
8614,15.0,264,4632,4896,23,205,6616,1861,4755,6616,483,0.03990326481257558,0.7001209189842805,0.003476420798065296,0.2812877871825877,0.7187122128174124,0.030985489721886337
8615,,1794,53083,54877,212,2770,72792,20634,52158,72792,5549,0.02464556544675239,0.729242224420266,0.002912407956918343,0.28346521595779756,0.7165347840422024,0.03805363226728212
8616,,7,1973,1980,0,193,2782,698,2084,2782,174,0.0025161754133716753,0.7092020129403307,0.0,0.25089863407620416,0.7491013659237958,0.0693745506829619
8617,,1351,39634,40985,125,2394,55283,15614,39669,55283,4187,0.024437892299621945,0.7169292549246604,0.0022610929218747173,0.2824376390572147,0.7175623609427854,0.043304451639744584
8618,,488,38269,38757,73,3199,53334,14455,38879,53334,4459,0.00914988562642967,0.7175347808152398,0.0013687328908388646,0.2710278621517231,0.7289721378482769,0.05998050024374695
8619,34.0,158,2269,2427,25,144,3388,926,2462,3388,202,0.046635182998819365,0.6697166469893743,0.007378984651711925,0.2733175914994097,0.7266824085005903,0.04250295159386069
8620,37.0,368,10574,10942,24,603,14457,4089,10368,14457,1048,0.025454796984159922,0.7314103894307256,0.0016600954554886907,0.2828387632288857,0.7171612367711143,0.04170989831915335
8621,17.0,594,15060,15654,35,835,21299,6072,15237,21309,1590,0.02787554554413628,0.706743629452344,0.0016424984748228447,0.2849500211178375,0.7150499788821625,0.03918532075648787
8622,33.0,166,3614,3780,8,153,4992,1442,3550,4992,347,0.03325320512820513,0.7239583333333334,0.0016025641025641025,0.28886217948717946,0.7111378205128205,0.03064903846153846
8623,25.0,607,14479,15086,151,595,20106,5654,14452,20106,1693,0.030189993036904405,0.7201332935442156,0.007510195961404556,0.28120958917736,0.7187904108226401,0.029593156271759673
8624,16.0,164,6868,7032,12,167,9424,2706,6718,9424,890,0.01740237691001698,0.7287775891341256,0.0012733446519524619,0.2871392190152801,0.7128607809847198,0.017720713073005094
8625,15.0,215,7851,8066,72,480,10958,2945,8013,10958,914,0.019620368680416136,0.7164628581858004,0.006570542069720752,0.268753422157328,0.731246577842672,0.043803613798138345
8626,24.0,1060,344909,345969,1852,15777,455886,131920,323966,455886,37825,0.0023251426891810673,0.7565685280969365,0.004062419113550317,0.28937058826110035,0.7106294117388996,0.03460733604453745
8627,,4890,44713,58145,752,3291,78348,18114,60259,78373,2955,0.06239393668737958,0.570515356053743,0.009595141183826062,0.2311255151646613,0.7688744848353387,0.04199150217549411
8628,14.0,603,15582,16185,45,875,21775,6161,15614,21775,1576,0.027692307692307693,0.7155912743972446,0.0020665901262916187,0.282939150401837,0.7170608495981631,0.040183696900114814
8629,35.0,434,9159,9593,18,585,12882,3638,9244,12882,1065,0.03369042074212079,0.7109920819748486,0.0013972985561248254,0.2824095637323397,0.7175904362676603,0.04541220307405682
8630,27.0,1821,36088,37909,260,1426,50014,14388,35626,50014,3640,0.036409805254528735,0.7215579637701444,0.0051985444075658815,0.28767944975406884,0.7123205502459311,0.028512016635342103
8631,38.0,120,1970,2090,12,136,3006,767,2239,3006,184,0.03992015968063872,0.6553559547571524,0.003992015968063872,0.2551563539587492,0.7448436460412509,0.04524284763805722
8632,,800,16628,17428,79,1143,23177,6460,16717,23177,1693,0.034516978038572725,0.717435388531734,0.0034085515813090566,0.2787245976614747,0.7212754023385253,0.04931613237261078
8633,25.0,469,25556,26025,465,1396,34743,9920,24823,34743,2525,0.013499122125320208,0.7355726333362116,0.013383991019773767,0.2855251417551737,0.7144748582448263,0.04018075583570791
8634,36.0,665,14123,14788,57,678,20466,5545,14921,20466,1510,0.032492915078667056,0.6900713378285938,0.0027851070067428907,0.27093716407700574,0.7290628359229943,0.03312811492231017
8635,,1113,24559,25672,66,1960,36316,9599,26717,36316,2304,0.030647648419429453,0.6762583985020376,0.0018173807688071373,0.26431875757241985,0.7356812424275802,0.05397070161912105
8636,25.0,806,32309,33115,197,1575,43798,12848,30950,43798,4128,0.018402666788437827,0.7376820859399973,0.004497922279556144,0.29334672816110324,0.7066532718388967,0.035960546143659525
8637,17.0,1807,56516,58323,130,3066,76956,22267,54689,76956,5821,0.023480950153334373,0.7343936795051718,0.001689276989448516,0.28934715941577005,0.71065284058423,0.03984094807422423
8638,26.0,170,3895,4065,37,183,5490,1549,3941,5490,393,0.030965391621129327,0.7094717668488161,0.00673952641165756,0.2821493624772313,0.7178506375227687,0.03333333333333333
8639,24.0,903,11884,12787,291,986,17596,4802,12794,17596,840,0.05131848147306206,0.6753807683564447,0.016537849511252558,0.2729029324846556,0.7270970675153444,0.05603546260513753
8640,,129,4364,4493,7,295,5980,1767,4213,5980,489,0.02157190635451505,0.7297658862876254,0.0011705685618729096,0.2954849498327759,0.704515050167224,0.04933110367892977
8641,16.0,318,2508,2826,47,419,4135,1014,3121,4135,116,0.07690447400241839,0.6065296251511487,0.011366384522370012,0.24522370012091899,0.754776299879081,0.10133010882708585
8642,,590,11781,12371,87,732,16704,4637,12067,16704,1303,0.03532088122605364,0.7052801724137931,0.005208333333333333,0.27759818007662834,0.7224018199233716,0.04382183908045977
8643,,111,4150,4261,5,198,5588,1655,3933,5588,436,0.019863994273443094,0.7426628489620616,0.0008947745168217609,0.29617036506800287,0.7038296349319971,0.03543307086614173
8644,,5507,190390,195897,2048,14594,266233,74657,191576,266233,19284,0.02068488880041167,0.7151254728001413,0.0076925099442969125,0.28041978267156964,0.7195802173284304,0.054816645569857984
8645,,86,2322,2408,16,118,3161,916,2245,3161,222,0.027206580196140463,0.7345776652957925,0.00506168933881683,0.28978171464726354,0.7102182853527365,0.03732995887377412
8646,13.0,76,2841,2917,26,175,3947,1045,2902,3947,265,0.019255130478844692,0.7197871801368128,0.006587281479604763,0.2647580440841145,0.7352419559158855,0.04433747149733975
8647,23.0,470,6823,7293,49,581,9787,2798,6989,9787,597,0.048022887503831616,0.6971492796566875,0.005006641463165424,0.2858894451823848,0.7141105548176152,0.059364463063247164
8648,15.0,55,1441,1496,0,69,2004,584,1420,2004,172,0.027445109780439122,0.719061876247505,0.0,0.29141716566866266,0.7085828343313373,0.0344311377245509
8649,,162,3931,4093,27,148,5622,1531,4091,5622,385,0.0288153681963714,0.6992173603699751,0.0048025613660619,0.27232301672002845,0.7276769832799715,0.02632515119174671
8650,13.0,110,1367,1477,5,124,2044,555,1489,2044,134,0.053816046966731895,0.6687866927592955,0.002446183953033268,0.27152641878669276,0.7284735812133072,0.060665362035225046
8651,24.0,185,3379,3564,6,188,4847,1350,3497,4847,325,0.03816793893129771,0.6971322467505674,0.0012378791004745203,0.27852279760676707,0.7214772023932329,0.03878687848153497
8652,,86,3321,3407,7,139,4305,1306,2999,4305,271,0.019976771196283393,0.7714285714285715,0.0016260162601626016,0.30336817653890824,0.6966318234610918,0.03228803716608595
8653,23.0,1779,42183,43962,94,2357,58762,16852,41910,58762,4186,0.03027466730199789,0.7178618835301726,0.0015996732582281067,0.28678397603893674,0.7132160239610633,0.040110956060038803
8654,,83,1755,1838,13,108,2454,713,1741,2454,170,0.03382233088834556,0.715158924205379,0.005297473512632437,0.29054604726976363,0.7094539527302364,0.044009779951100246
8655,26.0,437,8487,8924,17,298,12011,3367,8644,12011,891,0.036383315294313545,0.7066022812421947,0.0014153692448588794,0.28032636749646156,0.7196736325035384,0.02481059029223212
8656,,631,14320,14951,42,574,19681,5794,13887,19681,1478,0.03206137899496977,0.7276053046085057,0.0021340379045780193,0.29439560997916775,0.7056043900208323,0.0291651846958996
8657,36.0,111,2575,2686,10,111,3541,1021,2520,3541,273,0.031347077096865295,0.7271957074272805,0.002824060999717594,0.28833662807116633,0.7116633719288337,0.031347077096865295
8658,40.0,284,2475,2759,30,199,3668,1046,2622,3668,191,0.07742639040348964,0.6747546346782988,0.008178844056706653,0.2851690294438386,0.7148309705561614,0.05425299890948746
8659,17.0,0,5637,5637,19,438,7619,2198,5421,7619,668,0.0,0.7398608741304633,0.0024937655860349127,0.28848930305814413,0.7115106969418559,0.05748785929912062
8660,15.0,136,5597,5733,22,611,8360,2029,6331,8360,654,0.016267942583732056,0.6694976076555024,0.002631578947368421,0.24270334928229664,0.7572966507177034,0.07308612440191388
8661,44.0,298,6271,6569,218,376,8887,2504,6383,8887,540,0.03353212557668504,0.705637447957691,0.024530212670192415,0.28175987397321933,0.7182401260267807,0.04230899066051536
8662,14.0,118,3012,3130,18,222,4371,1191,3180,4371,303,0.026996110729810112,0.6890871654083733,0.004118050789293068,0.272477693891558,0.727522306108442,0.05078929306794784
8663,25.0,93,2191,2284,4,89,3051,875,2176,3051,254,0.03048180924287119,0.7181252048508686,0.0013110455588331695,0.2867912159947558,0.7132087840052442,0.02917076368403802
8664,,232,8103,8335,10,545,11318,3202,8116,11318,976,0.020498321258172823,0.7159392118748895,0.0008835483300936561,0.28291217529598867,0.7170878247040113,0.048153383990104257
8665,13.0,95,3265,3360,7,109,4424,1269,3155,4424,389,0.02147377938517179,0.7380198915009042,0.0015822784810126582,0.28684448462929474,0.7131555153707052,0.024638336347197108
8666,44.0,208,4194,4402,48,193,5864,1653,4211,5864,450,0.03547066848567531,0.7152114597544338,0.008185538881309686,0.2818894952251023,0.7181105047748977,0.03291268758526603
8667,24.0,829,24565,25394,14,898,33295,9645,23650,33295,2800,0.02489863342844271,0.7377984682384743,0.00042048355608950293,0.28968313560594683,0.7103168643940532,0.026971016669169547
8668,26.0,7,7832,7839,35,269,10361,3058,7303,10361,825,0.0006756104623105878,0.7559115915452177,0.0033780523115529387,0.2951452562493968,0.7048547437506032,0.02596274490879259
8669,15.0,499,11039,11538,32,831,15739,4231,11508,15739,1097,0.031704682635491456,0.7013787407077959,0.0020331660207128788,0.26882266980113095,0.7311773301988691,0.05279878010038757
8670,,123,2991,3114,6,75,3912,1221,2691,3912,244,0.03144171779141104,0.7645705521472392,0.0015337423312883436,0.3121165644171779,0.6878834355828221,0.019171779141104295
8671,13.0,916,9846,10762,43,1068,15535,3919,11616,15535,759,0.05896363051174767,0.6337946572256196,0.0027679433537174123,0.2522690698422916,0.7477309301577084,0.06874798841326038
8672,23.0,152,28069,28221,105,1237,36962,10498,26464,36962,2722,0.004112331583788756,0.7594015475353065,0.002840755370380391,0.2840214274119366,0.7159785725880634,0.033466803744386125
8673,13.0,242,3989,4231,78,337,5944,1567,4377,5944,461,0.04071332436069987,0.6710969044414535,0.013122476446837146,0.2636271870794078,0.7363728129205922,0.056695827725437416
8674,16.0,287,5648,5935,20,751,8192,2294,5898,8192,388,0.0350341796875,0.689453125,0.00244140625,0.280029296875,0.719970703125,0.0916748046875
8675,23.0,60,2476,2536,9,178,3393,965,2428,3393,255,0.01768346595932803,0.7297376952549366,0.002652519893899204,0.2844090775125258,0.7155909224874742,0.052460949012673154
8676,25.0,555,24511,25066,35,451,31688,9538,22150,31688,2666,0.017514516536228226,0.7735104771522343,0.0011045190608432215,0.30099722292350417,0.6990027770764958,0.014232517041151225
8677,43.0,288,5181,5469,61,157,7102,2157,4953,7110,500,0.04050632911392405,0.7286919831223628,0.008579465541490859,0.30337552742616036,0.6966244725738396,0.022081575246132207
8678,16.0,14380,289525,303905,2232,18885,410892,115643,295249,410892,32261,0.03499703084995571,0.7046255463722827,0.005432084343331095,0.2814437857149811,0.7185562142850189,0.04596098244794253
8679,34.0,42,2554,2596,12,95,3639,970,2669,3639,285,0.011541632316570486,0.7018411651552624,0.0032976092333058533,0.2665567463588898,0.7334432536411102,0.026106073097004672
8680,25.0,245,6177,6422,102,140,7965,2453,5512,7965,478,0.030759573132454487,0.7755178907721281,0.012806026365348399,0.30797237915881986,0.6920276208411802,0.017576898932831136
8681,23.0,636,14757,15393,151,890,20626,5698,14930,20628,1353,0.030831878999418267,0.7153868528214078,0.0073201473725033935,0.2762264882683731,0.723773511731627,0.043145239480318016
8682,14.0,306,3622,3928,55,250,5406,1435,3971,5406,315,0.05660377358490566,0.6699963004069552,0.010173880873103959,0.2654458009618942,0.7345541990381058,0.04624491305956345
8683,17.0,55,1787,1842,4,84,2414,712,1702,2414,179,0.022783761391880698,0.7402651201325601,0.0016570008285004142,0.29494614747307374,0.7050538525269263,0.0347970173985087
8684,16.0,426,9052,9478,41,437,12752,3567,9185,12752,1181,0.03340652446675031,0.7098494353826851,0.003215181932245922,0.2797208281053952,0.7202791718946048,0.03426913425345044
8685,,305,7026,7331,41,291,9750,2797,6953,9750,808,0.03128205128205128,0.7206153846153847,0.004205128205128205,0.28687179487179487,0.7131282051282052,0.029846153846153845
8686,14.0,73,1569,1642,10,108,2359,640,1719,2359,182,0.030945315811784654,0.6651123357354811,0.00423908435777872,0.27130139889783805,0.7286986011021619,0.04578211106401017
8687,23.0,114,3097,3211,4,163,4187,1201,2986,4187,272,0.027227131597802722,0.739670408406974,0.0009553379508000956,0.28684021972772866,0.7131597802722713,0.03893002149510389
8688,25.0,1019,33056,34075,33,1377,44299,12819,31480,44299,3347,0.023002776586378924,0.7462019458678526,0.0007449378089798866,0.28937447797918686,0.7106255220208131,0.031084223120160726
8689,15.0,60,3199,3259,9,370,4494,1227,3267,4494,277,0.01335113484646195,0.7118380062305296,0.0020026702269692926,0.27303070761014686,0.7269692923898531,0.08233199821984868
8690,13.0,709,1519,2405,37,290,3977,860,3117,3977,69,0.17827508171988937,0.3819461905959266,0.009303495096806638,0.21624339954739755,0.7837566004526024,0.07291928589388987
8691,15.0,293,8466,8759,27,1696,13037,2487,10550,13037,493,0.02247449566618087,0.6493825266549053,0.0020710286108767354,0.1907647464907571,0.809235253509243,0.1300912786684053
8692,46.0,56,1752,1808,4,96,2395,673,1722,2395,170,0.02338204592901879,0.7315240083507307,0.0016701461377870565,0.2810020876826722,0.7189979123173278,0.04008350730688935
8693,17.0,97,1888,1985,12,74,2721,738,1983,2721,185,0.0356486585814039,0.6938625505328924,0.004410143329658214,0.27122381477398017,0.7287761852260198,0.02719588386622565
8694,24.0,1777,29282,31059,42,1956,41258,11752,29506,41258,2460,0.04307043482476126,0.7097290222502303,0.0010179843909060061,0.2848417276649377,0.7151582723350622,0.047408987347908285
8695,44.0,251,2657,2908,39,136,3845,1114,2731,3845,148,0.06527958387516256,0.6910273081924577,0.010143042912873863,0.2897269180754226,0.7102730819245774,0.03537061118335501
8696,23.0,158,6136,6294,14,480,8552,2281,6271,8552,382,0.018475210477081384,0.7174929840972872,0.001637043966323667,0.26672123479887744,0.7332787652011226,0.05612722170252572
8697,25.0,832,31468,32300,137,1173,42631,12313,30318,42631,3025,0.019516314419084704,0.7381482958410547,0.0032136238887194766,0.28882737913724754,0.7111726208627525,0.027515188477868217
8698,,252,3568,3820,41,288,5228,1471,3757,5228,360,0.04820198928844682,0.6824789594491201,0.00784238714613619,0.28136954858454477,0.7186304514154552,0.05508798775822494
8699,,964,15226,16190,66,853,21695,6164,15531,21695,1754,0.04443420142890067,0.7018206960129062,0.003042175616501498,0.2841207651532611,0.7158792348467389,0.03931781516478451
8700,27.0,486,17484,17970,82,922,23589,6779,16810,23589,1594,0.02060282334986646,0.7411929289075416,0.003476196532281996,0.28737971088219083,0.7126202891178092,0.039086014667853664
8701,34.0,95,1778,1873,50,88,2530,725,1805,2530,172,0.037549407114624504,0.7027667984189724,0.019762845849802372,0.2865612648221344,0.7134387351778656,0.034782608695652174
8702,17.0,110,4597,4707,17,225,6350,1739,4611,6350,567,0.01732283464566929,0.7239370078740157,0.0026771653543307085,0.27385826771653543,0.7261417322834646,0.03543307086614173
8703,23.0,31,2717,2748,6,173,3759,1026,2733,3759,326,0.008246874168661877,0.7227986166533653,0.0015961691939345571,0.27294493216280924,0.7270550678371908,0.04602287842511306
8704,25.0,1841,37694,39535,409,2236,53242,15212,38030,53242,3568,0.03457796476465948,0.7079749070282859,0.00768190526276248,0.2857142857142857,0.7142857142857143,0.041996919725029114
8705,25.0,2601,45723,48324,719,3505,67148,17972,49176,67148,4060,0.03873533091082385,0.6809286948233753,0.010707690474772146,0.26764758444034076,0.7323524155596592,0.052198129504974086
8706,,1610,30410,32020,81,2129,44155,12247,31908,44155,3274,0.036462461782357604,0.6887102253425433,0.0018344468350130223,0.27736383195561093,0.7226361680443891,0.04821651002151512
8707,,402,5774,6176,47,734,8844,2310,6534,8844,571,0.045454545454545456,0.6528720036182722,0.005314337403889643,0.26119402985074625,0.7388059701492538,0.08299412030755314
8708,25.0,7827,170486,178313,605,11109,242504,67913,174612,242525,17278,0.03227296155035563,0.7029625811771982,0.0024945881867848674,0.28002473971755487,0.7199752602824451,0.045805587052881146
8709,39.0,70,1980,2050,37,111,2748,744,2004,2748,201,0.025473071324599708,0.7205240174672489,0.013464337700145561,0.27074235807860264,0.7292576419213974,0.04039301310043668
8710,,262,5182,5444,5,295,7435,2078,5357,7435,553,0.03523873570948218,0.6969737726967048,0.0006724949562878278,0.2794889038332212,0.7205110961667788,0.03967720242098184
8711,25.0,301,8516,8817,28,409,12348,3273,9075,12348,957,0.024376417233560092,0.6896663427275672,0.0022675736961451248,0.2650631681243926,0.7349368318756074,0.033122772918691284
8712,15.0,317,1995,2312,32,191,3185,853,2332,3185,160,0.09952904238618525,0.6263736263736264,0.010047095761381476,0.26781789638932496,0.732182103610675,0.05996860282574568
8713,34.0,181,8472,8653,52,292,11015,3205,7810,11015,803,0.01643213799364503,0.7691330004539265,0.004720835224693599,0.2909668633681344,0.7090331366318656,0.026509305492510214
8714,,65,1749,1814,0,166,2420,623,1797,2420,170,0.026859504132231406,0.7227272727272728,0.0,0.2574380165289256,0.7425619834710744,0.06859504132231405
8715,23.0,4430,48829,53272,209,2570,70954,20159,50795,70954,5272,0.06243481692364067,0.6881782563350903,0.0029455703695351917,0.28411365109789444,0.7158863489021056,0.036220649998590634
8716,17.0,81,2248,2329,25,71,3139,895,2244,3139,266,0.02580439630455559,0.7161516406498885,0.00796431984708506,0.2851226505256451,0.7148773494743549,0.02261866836572157
8717,15.0,21,2796,2817,0,386,3880,1042,2838,3880,252,0.005412371134020618,0.7206185567010309,0.0,0.2685567010309278,0.7314432989690721,0.09948453608247422
8718,,126,2742,2868,28,189,4016,950,3066,4016,228,0.03137450199203187,0.6827689243027888,0.0069721115537848604,0.23655378486055778,0.7634462151394422,0.04706175298804781
8719,,61,3999,4060,10,455,5570,1536,4034,5570,398,0.010951526032315978,0.7179533213644524,0.0017953321364452424,0.2757630161579892,0.7242369838420107,0.08168761220825853
8720,27.0,94,1910,2004,22,162,2858,739,2119,2858,158,0.032890132960111965,0.6682995101469559,0.007697690692792162,0.25857242827151855,0.7414275717284815,0.05668299510146956
8721,23.0,929,23452,24381,72,1403,32386,9025,23361,32386,2221,0.028685234360526154,0.7241400605199778,0.0022231828567899708,0.27866979559068733,0.7213302044093126,0.043321188167726794
8722,,275,8854,9129,36,446,12075,3445,8630,12075,963,0.022774327122153208,0.7332505175983437,0.0029813664596273293,0.28530020703933745,0.7146997929606625,0.03693581780538302
8723,,210,2544,2754,23,585,4178,1012,3166,4178,126,0.05026328386787937,0.6089037817137386,0.005505026328386788,0.24222115844901868,0.7577788415509813,0.14001914791766396
8724,24.0,3338,48455,51793,1513,3446,73032,19528,53504,73032,4772,0.04570599189396429,0.663476284368496,0.020716945996275604,0.2673896374192135,0.7326103625807865,0.04718479570599189
8725,,54,2476,2530,10,191,3360,981,2379,3360,247,0.01607142857142857,0.736904761904762,0.002976190476190476,0.29196428571428573,0.7080357142857143,0.056845238095238095
8726,14.0,83,8100,8183,11,322,11077,3113,7964,11077,1063,0.007493003520808884,0.7312449219102645,0.0009930486593843098,0.2810327706057597,0.7189672293942403,0.029069242574704342
8727,17.0,283,23657,24098,211,1848,33071,8896,24175,33071,2680,0.00855734631550301,0.7153397236249281,0.006380212270569381,0.2689970064406882,0.7310029935593118,0.05587977381996311
8728,25.0,431,8224,8655,93,360,11603,3324,8279,11603,941,0.03714556580194777,0.7087822114970266,0.008015168490907524,0.28647763509437213,0.7135223649056278,0.03102645867448074
8729,,115,3045,3160,5,230,4289,1221,3068,4289,327,0.026812776871065515,0.7099557006295174,0.0011657729074376311,0.28468174399626955,0.7153182560037304,0.05362555374213103
8730,14.0,1299,13967,15266,388,1394,21533,5710,15823,21533,1224,0.06032601123856406,0.6486323317698416,0.018018854781033763,0.2651743835043886,0.7348256164956114,0.0647378442390749
8731,16.0,95,1844,1939,1,50,2598,780,1818,2598,190,0.0365665896843726,0.7097767513471901,0.00038491147036181676,0.3002309468822171,0.6997690531177829,0.01924557351809084
8732,14.0,87,3343,3430,35,348,4920,1297,3623,4920,414,0.01768292682926829,0.6794715447154471,0.007113821138211382,0.2636178861788618,0.7363821138211382,0.07073170731707316
8733,13.0,4,2158,2162,15,78,2931,808,2123,2931,290,0.001364721937905152,0.7362674854998295,0.00511770726714432,0.27567383145684066,0.7243261685431593,0.02661207778915046
8734,25.0,3715,24508,28223,218,1768,37046,11122,25924,37046,1405,0.1002807320628408,0.66155590347136,0.005884575932624305,0.30022134643416293,0.699778653565837,0.04772445068293473
8735,27.0,2500,48825,51325,156,2847,69451,19129,50322,69451,4981,0.03599660192077868,0.7030136355128076,0.0022461879598565894,0.27543159925703015,0.7245684007429699,0.04099293026738276
8736,,41,1517,1558,13,60,2166,602,1564,2166,153,0.018928901200369344,0.7003693444136657,0.006001846722068329,0.27793167128347185,0.7220683287165282,0.027700831024930747
8737,27.0,918,7797,8715,76,540,12036,3333,8703,12036,784,0.07627118644067797,0.6478065802592223,0.006314390162844799,0.27691924227318043,0.7230807577268196,0.0448654037886341
8738,,195,5497,5692,20,286,7556,2117,5439,7556,612,0.025807305452620433,0.7275013234515617,0.0026469031233456856,0.28017469560614083,0.7198253043938592,0.0378507146638433
8739,17.0,6154,78400,84554,325,4393,113346,32221,81125,113346,7608,0.054293931854675063,0.6916873996435693,0.0028673265929102043,0.28427116969279903,0.7157288303072009,0.03875743299278316
8740,,188,5781,5969,19,209,7719,2284,5435,7719,598,0.02435548646197694,0.7489312087057909,0.0024614587381785206,0.295893250421039,0.704106749578961,0.027076046119963726
8741,,2456,54752,57208,972,3954,80402,21621,58781,80402,5083,0.030546503818312976,0.6809780851222607,0.012089251511156439,0.26891122111390264,0.7310887788860974,0.04917788114723514
8742,,10256,210061,220317,825,13192,295060,84368,210692,295060,20171,0.034759032061275674,0.711926387853318,0.0027960414830881853,0.28593506405476854,0.7140649359452315,0.04470955059987799
8743,25.0,157,2949,3106,18,162,4238,1171,3067,4238,322,0.03704577630957999,0.6958470976875885,0.004247286455875413,0.2763095799905616,0.7236904200094384,0.038225578102878716
8744,15.0,2917,36868,39785,112,1748,53605,15002,38603,53605,4486,0.05441656561887884,0.6877716630911296,0.0020893573360693967,0.2798619531760097,0.7201380468239903,0.03260889842365451
8745,17.0,1253,53626,54879,225,9070,79797,21047,58750,79797,6575,0.015702344699675425,0.6720302768274496,0.0028196548742433925,0.2637567828364475,0.7362432171635526,0.11366342093061142
8746,,741,16354,17095,64,855,23197,6580,16617,23197,1638,0.031943785834375134,0.7050049575376126,0.0027589774539811185,0.2836573694874337,0.7163426305125663,0.036858214424279
8747,,538,5760,6298,198,432,8973,2391,6583,8974,626,0.059950969467350124,0.6418542455983953,0.02206373969244484,0.26643637174058393,0.7335636282594161,0.04813906841987965
8748,33.0,4737,111086,115823,1107,5008,152302,43783,108519,152302,11586,0.031102677574818452,0.7293797849010518,0.007268453467452824,0.2874748854250108,0.7125251145749891,0.032882037005423435
8749,,1178,23135,24313,55,1238,32280,9327,22953,32280,2432,0.036493184634448575,0.7166976456009914,0.0017038413878562577,0.28894052044609664,0.7110594795539034,0.03835192069392813
8750,17.0,656,3905,4561,38,261,6313,1746,4567,6313,402,0.10391256138127673,0.6185648661492159,0.006019325201964201,0.2765721527007762,0.7234278472992238,0.04134325993980675
8751,,230,19064,19294,114,2021,26220,7148,19072,26220,1657,0.008771929824561403,0.7270785659801678,0.004347826086956522,0.27261632341723874,0.7273836765827613,0.07707856598016781
8752,16.0,1235,13319,14554,89,917,20225,5585,14640,20225,1419,0.06106304079110012,0.6585414091470951,0.004400494437577256,0.2761433868974042,0.7238566131025957,0.045339925834363415
8753,27.0,1724,37647,39371,123,2011,52337,14659,37678,52337,3691,0.03294036723541663,0.7193190286030915,0.0023501538108794927,0.28008865620880063,0.7199113437911994,0.03842405946080211
8754,27.0,180,5941,6121,2,188,7961,2350,5621,7971,607,0.02258185923974407,0.7453268096851086,0.0002509095471082675,0.29481871785221425,0.7051812821477857,0.023585497428177143
8755,,58,1610,1668,0,81,2234,658,1576,2234,178,0.025962399283795883,0.720680393912265,0.0,0.2945389435989257,0.7054610564010743,0.03625783348254252
8756,15.0,226,5307,5533,12,353,7745,2077,5668,7745,578,0.02918011620400258,0.6852162685603616,0.0015493867010974822,0.2681730148482892,0.7318269851517107,0.04557779212395094
8757,16.0,209,5705,5914,44,715,8347,2247,6100,8347,487,0.025038936144722655,0.683479094285372,0.005271354977836348,0.2691985144363244,0.7308014855636755,0.08565951838984066
8758,,187,4592,4779,14,305,6435,1765,4670,6435,465,0.02905982905982906,0.7135975135975136,0.0021756021756021756,0.2742812742812743,0.7257187257187258,0.0473970473970474
8759,15.0,365,8272,8637,37,491,11824,3330,8494,11824,891,0.030869418132611636,0.699594046008119,0.003129228687415426,0.2816305818673884,0.7183694181326117,0.041525710419485794
8760,23.0,2785,51255,54040,482,2862,72929,20433,52496,72929,5297,0.03818782651620069,0.7028068395288568,0.006609167820757175,0.28017661012765843,0.7198233898723416,0.039243647931549865
8761,,1329,20021,21366,95,2083,31581,8086,23495,31581,2020,0.04208226465279757,0.6339571261201356,0.003008137804376049,0.25604002406510246,0.7439599759348976,0.06595737943700326
8762,37.0,157,6229,6386,12,338,8491,2380,6111,8491,623,0.01849016605817925,0.73360028265222,0.0014132610999882229,0.2802967848309975,0.7197032151690025,0.03980685431633494
8763,23.0,836,17288,18124,76,626,24281,6976,17305,24281,1814,0.034430212923685186,0.7119970347185042,0.003130019356698653,0.2873028293727606,0.7126971706272394,0.02578147522754417
8764,15.0,1400,32583,33983,151,3341,48244,12565,35679,48244,3333,0.02901915264074289,0.6753793217809468,0.0031299228919658404,0.2604468949506674,0.7395531050493326,0.06925213498051572
8765,,1171,26991,28162,180,1110,37272,10768,26504,37272,2728,0.031417686198755096,0.7241629104958146,0.004829362524146813,0.28890319811118265,0.7110968018888173,0.029781068898905343
8766,,108,1767,1875,0,32,2438,692,1746,2438,163,0.044298605414273995,0.7247744052502051,0.0,0.2838392124692371,0.716160787530763,0.013125512715340444
8767,16.0,863,17892,18755,295,898,24870,7072,17798,24870,1440,0.03470044229995979,0.7194209891435465,0.011861680739847206,0.28435866505830315,0.7156413349416968,0.03610776035383997
8768,15.0,48,2452,2500,0,86,3181,940,2241,3181,255,0.015089594467148696,0.7708267840301792,0.0,0.2955045583149953,0.7044954416850047,0.02703552342030808
8769,17.0,86,1354,1440,4,100,2009,564,1445,2009,167,0.0428073668491787,0.6739671478347437,0.001991040318566451,0.28073668491786957,0.7192633150821304,0.049776007964161276
8770,15.0,238,6197,6435,34,267,8621,2460,6161,8621,730,0.02760700614777868,0.7188261222595986,0.00394385802111124,0.28534972740981324,0.7146502725901868,0.030970885048138268
8771,26.0,771,10913,11684,51,664,15512,4488,11024,15512,1130,0.04970345538937597,0.7035198555956679,0.0032877772047447138,0.2893243940175348,0.7106756059824652,0.042805569881382156
8772,,2891,55585,58476,596,4718,78615,22232,56383,78615,5051,0.036774152515423264,0.7070533613178147,0.007581250397506837,0.28279590408955035,0.7172040959104496,0.06001399224066654
8773,,234,9924,10158,37,955,14249,3829,10420,14249,1063,0.016422205067022248,0.6964699277142256,0.002596673450768475,0.26872061197277003,0.73127938802723,0.06702224717524037
8774,25.0,940,24918,25858,121,1303,34289,9916,24373,34289,2541,0.027414039487882413,0.7267053574032488,0.00352882848726997,0.2891889527253638,0.7108110472746362,0.03800052494969232
8775,24.0,5975,145880,151855,376,8463,199406,58289,141117,199406,15264,0.02996399305938638,0.7315727711302569,0.0018856002326910926,0.29231317011524227,0.7076868298847577,0.04244104991825722
8776,,450,11118,11568,21,794,15692,4338,11354,15692,1200,0.028677032882997704,0.7085138924292633,0.001338261534539893,0.2764465969920979,0.7235534030079022,0.05059903135355595
8777,26.0,3154,27740,30894,318,1376,41002,11856,29146,41002,2686,0.07692307692307693,0.6765523632993512,0.007755719233208136,0.2891566265060241,0.7108433734939759,0.0335593385688503
8778,,150,2149,2299,41,312,3690,830,2860,3690,187,0.04065040650406504,0.5823848238482385,0.011111111111111112,0.22493224932249323,0.7750677506775068,0.08455284552845528
8779,14.0,35,7639,7674,79,743,11290,2762,8528,11290,751,0.003100088573959256,0.6766164747564216,0.0069973427812223205,0.2446412754650133,0.7553587245349868,0.0658104517271922
8780,,197,3155,3352,9,133,4559,1295,3264,4559,273,0.043211230533011624,0.6920377275718359,0.0019741171309497698,0.28405352050888355,0.7159464794911164,0.02917306426847993
8781,,88,2181,2269,3,139,2976,852,2124,2976,179,0.02956989247311828,0.7328629032258065,0.0010080645161290322,0.2862903225806452,0.7137096774193549,0.04670698924731183
8782,14.0,283,10270,10553,68,331,14054,3984,10070,14054,1142,0.020136615910061193,0.730752810587733,0.004838480148000569,0.28347801337697454,0.7165219866230255,0.023552013661591008
8783,,146,8623,8769,46,639,12262,3339,8923,12262,1077,0.011906703637253303,0.7032294894796933,0.003751427173381178,0.2723046811286903,0.7276953188713098,0.05211221660414288
8784,,1026,19503,20529,48,1794,27811,7834,19977,27811,1797,0.03689187731473158,0.7012692819388012,0.001725935780806156,0.281687102225738,0.718312897774262,0.06450684980763008
8785,17.0,571,13529,14100,81,642,19122,5359,13763,19122,1330,0.029860893212007113,0.7075096747202175,0.004235958581738312,0.28025311159920513,0.7197468884007949,0.0335738939441481
8786,24.0,223,5414,5637,34,394,7582,2130,5452,7582,588,0.029411764705882353,0.714059614877341,0.004484304932735426,0.28092851490371934,0.7190714850962807,0.05196518069111052
8787,23.0,1730,46896,48626,203,3063,65122,17969,47153,65122,4407,0.026565523171892754,0.7201253032769264,0.0031172261294186297,0.27592825773164215,0.7240717422683578,0.04703479622861706
8788,39.0,1907,41939,43846,198,1262,55330,16865,38465,55330,3611,0.034465931682631484,0.7579793963491777,0.0035785288270377734,0.3048075185252124,0.6951924814747876,0.022808602927887223
8789,13.0,156,3457,3613,35,220,4914,1311,3603,4914,320,0.031746031746031744,0.7035002035002035,0.007122507122507123,0.2667887667887668,0.7332112332112332,0.04477004477004477
8790,,2761,77246,80007,71,3992,106139,30570,75569,106139,8033,0.026013058348015337,0.7277814940785197,0.0006689341335418649,0.2880185417235889,0.7119814582764111,0.03761105719857922
8791,27.0,516,28434,28950,75,1286,38160,11081,27079,38160,3161,0.013522012578616353,0.745125786163522,0.0019654088050314465,0.2903825995807128,0.7096174004192872,0.03370020964360587
8792,,2221,9540,11761,1011,2201,18459,4408,14051,18459,1070,0.12032071076439677,0.5168210628961483,0.054770030879245896,0.2387995015981364,0.7612004984018635,0.11923722845224552
8793,,900,21856,22756,52,1331,30275,8628,21647,30275,2300,0.02972749793559042,0.7219157720891825,0.001717588769611891,0.28498761354252683,0.7150123864574731,0.043963666391412054
8794,23.0,353,8826,9179,13,985,12863,3504,9359,12863,838,0.02744305371997201,0.6861540853611132,0.0010106507035683744,0.27240923579258336,0.7275907642074166,0.0765762263857576
8795,24.0,175,3881,4056,21,137,5404,1566,3838,5404,449,0.03238341968911917,0.7181717246484086,0.0038860103626943004,0.28978534418948926,0.7102146558105107,0.02535159141376758
8796,17.0,9287,131171,140458,1840,9140,192202,53461,138741,192202,13766,0.04831895609827161,0.6824642823695903,0.00957326146450089,0.278150071279175,0.721849928720825,0.04755413575300985
8797,14.0,942,11031,11973,168,911,16672,4526,12146,16672,1059,0.056501919385796545,0.6616482725527831,0.010076775431861805,0.27147312859884837,0.7285268714011516,0.05464251439539347
8798,16.0,206,2862,3068,10,301,4211,1201,3010,4211,229,0.048919496556637375,0.6796485395393018,0.0023747328425552127,0.28520541439088104,0.714794585609119,0.0714794585609119
8799,23.0,196,4403,4599,15,268,6335,1756,4579,6335,516,0.030939226519337018,0.6950276243093922,0.0023677979479084454,0.2771902131018153,0.7228097868981846,0.04230465666929755
8800,27.0,66,1864,1930,12,70,2577,729,1848,2577,199,0.025611175785797437,0.7233216918897943,0.004656577415599534,0.2828870779976717,0.7171129220023282,0.02716336825766395
8801,26.0,344,10027,10371,28,398,13432,3974,9458,13432,1120,0.02561048243001787,0.746500893388922,0.002084574151280524,0.29586063132817153,0.7041393686718285,0.029630732578916023
8802,35.0,6464,153016,159480,1451,8080,215271,61256,154015,215271,16431,0.03002726795527498,0.7108063789363175,0.006740341244292078,0.28455295882863924,0.7154470411713607,0.03753408494409372
8803,,784,21302,22086,298,1696,30686,8143,22543,30686,2066,0.02554911034347911,0.6941927915010102,0.009711268982597927,0.26536531317213063,0.7346346868278694,0.05526950400834257
8804,,1972,52934,54906,34,2332,71554,20859,50695,71554,4719,0.02755960533303519,0.7397769516728625,0.0004751656091902619,0.2915141012382257,0.7084858987617744,0.03259077060681444
8805,15.0,1442,26518,27960,84,1509,38704,10777,27927,38704,2660,0.03725713104588673,0.6851488218272013,0.002170318313352625,0.2784466721785862,0.7215533278214138,0.03898821827201323
8806,,240,22250,22490,123,1495,30325,8472,21853,30325,2394,0.007914262159934049,0.7337180544105524,0.0040560593569661995,0.2793734542456719,0.7206265457543282,0.049299258037922504
8807,15.0,112,2752,2864,12,149,3942,1111,2831,3942,317,0.028411973617453068,0.6981227803145611,0.0030441400304414,0.28183663115169966,0.7181633688483003,0.037798072044647385
8808,17.0,211,7091,7302,33,559,10066,2726,7340,10066,712,0.020961653089608585,0.7044506258692629,0.0032783628054838068,0.27081263659845023,0.7291873634015498,0.05553347903834691
8809,26.0,2659,53472,56131,453,2659,74752,21228,53524,74752,5084,0.03557095462328767,0.7153253424657534,0.006060038527397261,0.2839790239726027,0.7160209760273972,0.03557095462328767
8810,,93,2154,2247,6,97,2981,820,2161,2981,169,0.031197584703119757,0.7225763166722576,0.0020127474002012745,0.27507547802750754,0.7249245219724925,0.032539416303253944
8811,38.0,333,6422,6755,18,216,9594,2539,7057,9596,477,0.03470195914964568,0.669237182159233,0.0018757815756565235,0.2645894122551063,0.7354105877448937,0.022509378907878283
8812,42.0,318,6685,7003,196,349,9425,2670,6768,9438,526,0.033693579148124604,0.708306844670481,0.020767111676202585,0.2828989192625556,0.7171010807374444,0.03697817334180971
8813,13.0,2040,24185,26225,267,1618,35479,9945,25534,35479,2240,0.057498802108289414,0.6816708475436174,0.007525578511231997,0.2803066602779109,0.7196933397220892,0.04560444206431974
8814,26.0,139,2992,3131,2,123,4101,1186,2915,4101,261,0.03389417215313338,0.7295781516703244,0.000487685930260912,0.2891977566447208,0.7108022433552792,0.029992684711046085
8815,,310,8414,8724,9,534,11556,3243,8313,11556,885,0.02682589131187262,0.7281066112841814,0.000778816199376947,0.28063343717549327,0.7193665628245067,0.046209761163032194
8816,,207,3792,3999,12,143,5182,1518,3664,5182,378,0.039945966808182166,0.731763797761482,0.0023157082207641835,0.2929370899266692,0.7070629100733308,0.02759552296410652
8817,27.0,1592,41977,43569,207,2080,57443,16500,40943,57443,4464,0.027714429956652683,0.7307591873683478,0.003603572236826071,0.28724126525425203,0.7127587347457479,0.036209807983566315
8818,,414,6916,7330,48,487,10219,2712,7507,10219,662,0.04051277032977786,0.6767785497602505,0.0046971327918583035,0.26538800273999413,0.7346119972600059,0.047656326450729036
8819,,76,2467,2543,2,178,3488,992,2496,3488,268,0.021788990825688075,0.7072821100917431,0.0005733944954128441,0.28440366972477066,0.7155963302752294,0.05103211009174312
8820,14.0,25038,51815,76853,221,7144,106559,29552,77007,106559,5129,0.23496842125019943,0.4862564400942201,0.002073968411865727,0.27732992989799077,0.7226700701020092,0.0670426711962387
8821,17.0,1637,44427,46064,162,3645,62801,16527,46274,62801,4236,0.026066463909810354,0.7074250410025318,0.0025795767583318735,0.2631645992898202,0.7368354007101797,0.058040477062467156
8822,,170,4061,4231,2,181,5626,1613,4013,5626,384,0.03021685033771774,0.7218272307145397,0.00035549235691432633,0.2867045858514042,0.7132954141485958,0.032172058300746535
8823,,530,7094,7624,22,508,10297,2931,7366,10297,773,0.05147130232106439,0.688938525784209,0.0021365446246479555,0.2846460134019617,0.7153539865980383,0.04933475769641643
8824,15.0,67,5029,5101,35,610,7175,1930,5245,7175,402,0.009337979094076656,0.7009059233449477,0.004878048780487805,0.2689895470383275,0.7310104529616724,0.08501742160278745
8825,25.0,2605,56740,59345,219,3274,78524,22240,56284,78524,5587,0.03317457083184759,0.7225816310936783,0.002788956242677398,0.2832255106718965,0.7167744893281035,0.04169425908002649
8826,23.0,74,1722,1796,10,94,2379,674,1705,2379,174,0.031105506515342583,0.7238335435056746,0.004203446826397646,0.2833123160992013,0.7166876839007986,0.039512400168137875
8827,,291,3444,3735,2,413,5230,1376,3854,5230,239,0.05564053537284895,0.6585086042065009,0.0003824091778202677,0.2630975143403442,0.7369024856596559,0.07896749521988528
8828,26.0,101,3118,3219,5,139,4257,1224,3033,4257,359,0.023725628376791166,0.732440685929058,0.0011745360582569885,0.28752642706131076,0.7124735729386892,0.03265210241954428
8829,27.0,1800,49831,51631,103,1669,68196,19760,48436,68196,5169,0.026394509941932078,0.7307026805091208,0.0015103525133438912,0.2897530646958766,0.7102469353041234,0.0244735761628248
8830,,982,21583,22565,122,1060,30241,8650,21591,30241,2374,0.03247247114844086,0.7136999437849277,0.00403425812638471,0.286035514698588,0.713964485301412,0.03505175093416223
8831,16.0,132,12520,12652,16,365,16473,4790,11683,16473,1413,0.00801311236568931,0.760031566806289,0.0009712863473562799,0.29077885023978634,0.7092211497602137,0.022157469799065136
8832,24.0,383,7717,8100,34,550,11002,2927,8075,11002,674,0.03481185239047446,0.7014179240138156,0.003090347209598255,0.2660425377204145,0.7339574622795856,0.049990910743501184
8833,17.0,3785,80718,84503,382,6847,115424,30599,84825,115424,8872,0.032792140282783475,0.6993172996950374,0.003309537011366787,0.2651008455780427,0.7348991544219573,0.05932041863044081
8834,15.0,85,2291,2376,2,112,3216,926,2290,3216,223,0.02643034825870647,0.7123756218905473,0.0006218905472636816,0.2879353233830846,0.7120646766169154,0.03482587064676617
8835,16.0,18601,452742,471343,2789,21232,604685,178329,426356,604685,38026,0.03076147084845829,0.7487237156536047,0.004612318810620406,0.2949122270272952,0.7050877729727048,0.03511249658913319
8836,27.0,191,3265,3456,12,156,4952,1295,3657,4952,326,0.0385702746365105,0.659329563812601,0.0024232633279483036,0.26151050080775445,0.7384894991922456,0.03150242326332795
8837,15.0,291,1472,1763,2,95,2312,674,1638,2312,162,0.1258650519031142,0.6366782006920415,0.0008650519031141869,0.291522491349481,0.7084775086505191,0.041089965397923874
8838,25.0,2580,69963,72543,231,3713,97941,27957,69984,97941,7809,0.026342389806107758,0.7143382240328361,0.002358562808221276,0.2854473611664165,0.7145526388335834,0.03791057881785973
8839,13.0,548,6557,7105,41,695,9894,2634,7260,9894,528,0.055387103294926215,0.6627248837679401,0.004143925611481706,0.2662219526986052,0.7337780473013947,0.0702445926824338
8840,,7621,164836,172457,237,8091,225377,65904,159473,225377,17352,0.033814453116333965,0.7313789783340803,0.0010515713670871474,0.2924167062300057,0.7075832937699943,0.03589984781055742
8841,24.0,637,15194,15831,61,582,21410,6044,15366,21410,1734,0.02975245212517515,0.7096683792620271,0.0028491359177954226,0.2822979915927137,0.7177020084072863,0.027183559084539934
8842,17.0,5,1425,1430,0,108,1968,553,1415,1968,179,0.002540650406504065,0.7240853658536586,0.0,0.2809959349593496,0.7190040650406504,0.054878048780487805
8843,37.0,536,8528,9064,27,344,11618,3438,8180,11618,654,0.046135307281804094,0.7340333964537786,0.0023239800309864003,0.29592012394560163,0.7040798760543984,0.02960922706145636
8844,14.0,1027,12366,13393,70,932,18454,5049,13405,18454,1252,0.05565189118890213,0.6700986236046386,0.0037932155630215673,0.2735992196813699,0.7264007803186301,0.0505039557819443
8845,24.0,1903,34686,36589,189,1820,48754,14103,34651,48754,3154,0.03903269475325102,0.7114493169791196,0.0038766049965131065,0.2892685728350494,0.7107314271649505,0.03733027033679288
8846,26.0,70,2595,2665,14,175,3532,968,2564,3532,240,0.019818799546998868,0.7347112117780294,0.003963759909399773,0.2740656851642129,0.7259343148357871,0.049546998867497166
8847,25.0,362,5590,5952,228,457,8252,2117,6139,8256,542,0.0438468992248062,0.6770833333333334,0.027616279069767442,0.25641957364341084,0.7435804263565892,0.05535368217054264
8848,,645,15113,15758,26,922,20620,6153,14467,20620,1127,0.03128031037827352,0.732929194956353,0.0012609117361784676,0.2983996120271581,0.7016003879728419,0.04471387002909796
8849,16.0,444,12252,12696,37,462,16306,4849,11459,16308,1201,0.027225901398086828,0.7512877115526122,0.0022688251165072356,0.29733872945793477,0.7026612705420653,0.02832965415746873
8850,27.0,2567,25291,27858,4,733,35680,10791,24889,35680,2806,0.07194506726457399,0.7088284753363229,0.00011210762331838565,0.3024383408071749,0.6975616591928251,0.020543721973094172
8851,,11,1611,1622,7,129,2194,601,1593,2194,198,0.005013673655423883,0.7342752962625342,0.0031905195989061076,0.2739288969917958,0.7260711030082042,0.05879671832269827
8852,15.0,6896,209698,216594,1421,15597,300449,82387,218062,300449,24113,0.02295231470232885,0.6979487367240363,0.004729588049885338,0.27421292798444996,0.72578707201555,0.05191230458413907
8853,,312,5284,5596,11,405,7508,2167,5343,7510,455,0.04154460719041278,0.703595206391478,0.0014647137150466045,0.2885486018641811,0.7114513981358189,0.05392809587217044
8854,17.0,10,2906,2916,17,100,3845,1106,2739,3845,363,0.002600780234070221,0.7557867360208063,0.004421326397919376,0.2876462938881664,0.7123537061118336,0.02600780234070221
8855,,893,11355,12248,130,557,16273,4706,11567,16273,1150,0.05487617525963252,0.6977816014256745,0.007988692926934186,0.2891906839550175,0.7108093160449824,0.03422847661771032
8856,25.0,86,2861,2947,14,171,3902,1091,2811,3902,296,0.022039979497693492,0.7332137365453614,0.0035879036391594054,0.2796002050230651,0.720399794976935,0.043823680164018455
8857,,272,4294,4566,25,168,6381,1713,4668,6381,394,0.04262654756307789,0.6729352766024134,0.003917881209841718,0.2684532204983545,0.7315467795016455,0.026328161730136343
8858,,125,2224,2349,6,109,3175,861,2314,3175,195,0.03937007874015748,0.7004724409448819,0.001889763779527559,0.2711811023622047,0.7288188976377953,0.034330708661417325
8859,,165,3185,3350,24,158,4483,1253,3230,4483,306,0.03680571046174437,0.710461744367611,0.005353557885344635,0.27950033459736784,0.7204996654026322,0.035244256078518846
8860,,114,3078,3192,8,154,4238,1236,3002,4238,275,0.026899480887210947,0.7262859839546956,0.0018876828692779614,0.291647003303445,0.7083529966965549,0.03633789523360075
8861,16.0,68,2811,2889,8,149,3866,1107,2759,3866,298,0.01758923952405587,0.7271081220900155,0.0020693222969477496,0.28634247284014486,0.7136575271598552,0.038541127780651836
8862,33.0,454,8066,8520,33,438,11491,3228,8263,11491,800,0.03950918109825081,0.7019406492037247,0.002871812723000609,0.2809154990862414,0.7190845009137586,0.03811678705073536
8863,34.0,1126,23477,24603,114,1194,32811,9264,23547,32811,2651,0.03431775928804364,0.7155222333973362,0.0034744445460363903,0.28234433574106244,0.7176556642589376,0.036390234982170616
8864,26.0,7278,164285,171563,1462,10565,254760,63119,191641,254760,12840,0.02856806406029204,0.6448618307426598,0.005738734495211179,0.2477586748312137,0.7522413251687863,0.04147040351703564
8865,35.0,1836,26604,28440,138,1820,39494,10630,28864,39494,2460,0.04648807413784372,0.6736213095660101,0.0034942016508836787,0.26915480832531524,0.7308451916746848,0.04608294930875576
8866,,278,6354,6632,10,236,8670,2545,6125,8670,707,0.032064590542099196,0.7328719723183391,0.0011534025374855825,0.2935409457900807,0.7064590542099193,0.027220299884659745
8867,17.0,50,2845,2895,12,108,3797,1121,2676,3797,354,0.01316829075585989,0.7492757440084277,0.0031603897814063736,0.2952330787463787,0.7047669212536213,0.028443508032657362
8868,17.0,7451,141411,148862,793,9620,200247,56528,143720,200248,13081,0.03720886101234469,0.7061793376213495,0.003960089489033598,0.2822899604490432,0.7177100395509568,0.04804042986696496
8869,,541,18062,18603,55,779,24725,7162,17563,24725,2085,0.021880687563195146,0.73051567239636,0.002224469160768453,0.28966632962588473,0.7103336703741153,0.031506572295247726
8870,23.0,910,13783,14693,39,676,23856,5492,18364,23856,1170,0.03814553990610329,0.5777582159624414,0.0016348088531187124,0.23021462105969148,0.7697853789403085,0.028336686787391013
8871,,1382,19519,20901,119,1039,28240,7986,20254,28240,1912,0.04893767705382436,0.6911827195467423,0.004213881019830028,0.2827903682719547,0.7172096317280453,0.036791784702549575
8872,14.0,625,5776,6401,99,678,9131,2533,6598,9131,344,0.06844814368634322,0.6325703646917096,0.010842185959916767,0.2774066367320118,0.7225933632679882,0.07425254627094513
8873,13.0,253,4661,4914,57,282,6623,1865,4758,6623,467,0.03820021138456892,0.7037596255473351,0.008606371734863356,0.2815944436056168,0.7184055563943832,0.042578891740902916
8874,26.0,897,20122,21019,144,1087,27556,7960,19596,27556,1708,0.03255189432428509,0.7302220931920453,0.00522572216577152,0.28886630860792567,0.7111336913920743,0.03944694440412251
8875,,952,21684,22636,116,1049,30091,8675,21416,30091,2170,0.03163736665448141,0.7206141371174105,0.003854973247814961,0.288292180386162,0.711707819613838,0.034860921870326675
8876,,102,2657,2759,2,163,3645,1079,2566,3645,279,0.027983539094650206,0.7289437585733882,0.0005486968449931413,0.2960219478737997,0.7039780521262002,0.04471879286694101
8877,45.0,212,2756,2968,44,186,4462,1151,3311,4462,281,0.047512326311071267,0.6176602420439264,0.009861048857014791,0.25795607350963695,0.7420439264903631,0.04168534289556253
8878,24.0,3351,95465,98816,144,4484,130007,37141,92866,130007,9578,0.025775535163491195,0.7343066142592322,0.0011076326659333728,0.2856846169821625,0.7143153830178375,0.03449045051420308
8879,,182,4299,4481,34,194,5970,1710,4260,5970,477,0.030485762144053602,0.7201005025125629,0.005695142378559464,0.2864321608040201,0.7135678391959799,0.03249581239530988
8880,,7275,180865,188140,1010,7626,247269,72374,174896,247270,16256,0.029421280381768916,0.7314474056699155,0.004084603874307437,0.2926921988110163,0.7073078011889837,0.030840781332147047
8881,15.0,251,3968,4219,34,424,6289,1586,4703,6289,303,0.03991095563682621,0.6309429162028939,0.005406264906980442,0.25218635713149945,0.7478136428685006,0.06741930354587375
8882,24.0,440,11880,12320,52,504,16026,4694,11332,16026,1201,0.027455384999376015,0.7412953949831523,0.0032447273181080744,0.29289903906152503,0.707100960938475,0.0314488955447398
8883,23.0,517,9538,10055,206,694,13828,3772,10056,13828,849,0.037387908591264105,0.6897599074341915,0.014897309806190338,0.2727798669366503,0.7272201330633498,0.05018802429852473
8884,,369,5221,5590,31,257,7537,2115,5422,7537,541,0.04895847154040069,0.692715934722038,0.004113042324532307,0.28061562956083325,0.7193843704391668,0.03409844765821945
8885,17.0,263,12375,12638,9,450,16186,5314,10872,16186,761,0.01624860990979859,0.7645496107747436,0.0005560360805634499,0.3283084146793525,0.6716915853206474,0.027801804028172495
8886,15.0,78,6837,6915,57,831,9809,2592,7217,9809,790,0.007951880925680497,0.6970129472933021,0.005810989907228056,0.26424711999184425,0.7357528800081558,0.08471811601590376
8887,25.0,232,5180,5412,7,234,7413,2116,5297,7413,599,0.031296371239714016,0.6987724268177526,0.0009442870632672333,0.28544448941049505,0.714555510589505,0.03156616754350466
8888,15.0,362,11505,11867,45,1762,17042,4574,12468,17042,1311,0.02124163830536322,0.6750968196221101,0.002640535148456754,0.2683957282009154,0.7316042717990846,0.10339162070179557
8889,27.0,79,2072,2151,2,104,2941,812,2129,2941,277,0.0268616116967018,0.7045222713362802,0.0006800408024481469,0.27609656579394765,0.7239034342060524,0.03536212172730364
8890,,108,4787,4895,45,205,6696,1840,4856,6696,578,0.016129032258064516,0.7149044205495818,0.006720430107526882,0.2747909199522103,0.7252090800477897,0.030615292712066904
8891,23.0,198,5913,6111,8,200,7979,2336,5643,7979,647,0.024815139741822284,0.7410703095626018,0.0010026319087604962,0.2927685173580649,0.707231482641935,0.025065797719012406
8892,,114,2761,3041,20,276,4536,1082,3454,4536,290,0.02513227513227513,0.6086860670194003,0.004409171075837742,0.23853615520282187,0.7614638447971781,0.06084656084656084
8893,,2818,57733,60551,337,4756,84857,22848,62009,84857,5628,0.033208810115841945,0.6803563642363034,0.003971387157217437,0.2692529785403679,0.7307470214596321,0.05604723240274815
8894,46.0,138,3361,3499,18,163,4682,1372,3310,4682,347,0.02947458351131995,0.7178556172575822,0.003844510892780863,0.29303716360529686,0.7069628363947031,0.034814181973515594
8895,,75,2555,2630,0,86,3469,1015,2454,3469,253,0.021620063418852694,0.7365234938022485,0.0,0.2925915249351398,0.7074084750648602,0.024791006053617757
8896,14.0,196,2119,2315,0,138,3564,890,2674,3564,183,0.05499438832772166,0.5945566778900112,0.0,0.24971941638608305,0.7502805836139169,0.03872053872053872
8897,,837,26075,26912,180,1411,36051,10081,25970,36051,3019,0.023217109095448114,0.7232809076031178,0.004992926687193143,0.2796316329644115,0.7203683670355885,0.03913899753127514
8898,,39,2882,2921,36,337,4224,1120,3104,4224,298,0.009232954545454546,0.6822916666666666,0.008522727272727272,0.26515151515151514,0.7348484848484849,0.07978219696969698
8899,23.0,78,1623,1701,39,106,2429,640,1789,2429,193,0.03211198023878139,0.6681762041992589,0.016055990119390694,0.2634829147797447,0.7365170852202553,0.04363935776039522
8900,,308,5742,6050,2,344,8048,2299,5749,8048,493,0.03827037773359841,0.713469184890656,0.00024850894632206757,0.2856610337972167,0.7143389662027833,0.042743538767395624
8901,,86,2357,2443,12,111,3363,933,2430,3363,299,0.025572405590246802,0.7008623253047874,0.003568242640499554,0.2774308652988403,0.7225691347011597,0.03300624442462088
8902,24.0,71,2664,2735,17,82,3597,981,2616,3597,357,0.019738671114817904,0.7406171809841534,0.004726160689463442,0.2727272727272727,0.7272727272727273,0.02279677509035307
8903,,383,8380,8763,93,806,12211,3251,8960,12211,839,0.03136516255834903,0.6862664810416838,0.0076160838588158215,0.2662353615592499,0.7337646384407501,0.06600606010973713
8904,,10,2484,2494,24,125,3355,955,2400,3355,318,0.0029806259314456036,0.7403874813710879,0.007153502235469449,0.2846497764530551,0.7153502235469449,0.037257824143070044
8905,27.0,39,2112,2151,24,212,2992,811,2181,2992,166,0.01303475935828877,0.7058823529411765,0.008021390374331552,0.2710561497326203,0.7289438502673797,0.07085561497326204
8906,,196,2998,3194,15,342,4352,1218,3134,4352,267,0.04503676470588235,0.6888786764705882,0.003446691176470588,0.27987132352941174,0.7201286764705882,0.07858455882352941
8907,,3818,62193,66011,312,4423,89265,25157,64108,89265,6855,0.042771522993334456,0.6967232397916316,0.0034952108889262307,0.2818237831176833,0.7181762168823167,0.04954909539013051
8908,37.0,189,4003,4192,7,138,5464,1596,3868,5464,467,0.0345900439238653,0.7326134699853587,0.001281112737920937,0.29209370424597364,0.7079062957540263,0.025256222547584188
8909,,307,3457,3764,40,304,5117,1406,3711,5117,274,0.05999609145983975,0.6755911666992378,0.007817080320500294,0.2747703732655853,0.7252296267344147,0.05940981043580223
8910,25.0,31,2532,2563,5,286,3560,1013,2547,3560,287,0.008707865168539325,0.7112359550561798,0.0014044943820224719,0.2845505617977528,0.7154494382022472,0.08033707865168539
8911,27.0,2178,47356,49535,175,2286,65836,18803,47033,65836,4653,0.03308220426514369,0.7193025092654475,0.0026581201774105354,0.28560362111914456,0.7143963788808555,0.034722644146059904
8912,,705,21496,22201,81,789,28678,8500,20178,28678,2092,0.02458330427505405,0.749564125810726,0.0028244647464955716,0.2963944487063254,0.7036055512936746,0.02751237882697538
8913,,357,6517,6874,18,498,9567,2629,6938,9567,718,0.03731577296958294,0.681195777150622,0.0018814675446848542,0.2747987874986934,0.7252012125013065,0.05205393540294763
8914,,152,3744,3946,16,178,5205,1512,3694,5206,432,0.029197080291970802,0.7191701882443334,0.003073376872839032,0.2904341144832885,0.7095658855167115,0.03419131771033423
8915,26.0,1010,25862,26872,21,1240,34809,10344,24465,34809,2388,0.029015484501134763,0.7429687724439081,0.0006032922520037921,0.29716452641558216,0.7028354735844178,0.03562297107070011
8916,17.0,3409,37117,40526,169,3596,56000,15281,40719,56000,3332,0.060875,0.6628035714285714,0.003017857142857143,0.272875,0.727125,0.06421428571428571
8917,17.0,245,7778,8023,8,243,10535,3063,7472,10535,801,0.023255813953488372,0.7383009017560512,0.0007593735168485999,0.2907451352634077,0.7092548647365923,0.023065970574276222
8918,17.0,587,10238,10825,59,527,14640,4075,10565,14640,1066,0.040095628415300545,0.6993169398907104,0.004030054644808743,0.27834699453551914,0.7216530054644809,0.03599726775956284
8919,25.0,43,2349,2392,15,187,3425,866,2559,3425,290,0.012554744525547445,0.6858394160583942,0.004379562043795621,0.25284671532846714,0.7471532846715329,0.0545985401459854
8920,47.0,514,11570,12084,30,592,15657,4698,10959,15657,1098,0.032828766685827425,0.7389665964105512,0.0019160758766047135,0.30005748227629814,0.6999425177237019,0.03781056396499968
8921,35.0,569,9192,9761,48,637,12733,3688,9045,12733,701,0.044687033691981466,0.7219037147569308,0.0037697321919421974,0.28964109008089217,0.7103589099191079,0.05002748763056625
8922,33.0,360,3189,3549,17,193,5374,1287,4087,5374,275,0.06698920729438035,0.5934127279493859,0.0031633792333457386,0.23948641607740975,0.7605135839225903,0.0359136583550428
8923,39.0,64,1828,1892,13,215,2524,614,1910,2524,146,0.025356576862123614,0.7242472266244057,0.005150554675118859,0.2432646592709984,0.7567353407290016,0.08518225039619651
8924,,2,2682,2684,47,251,3736,1037,2699,3736,291,0.0005353319057815846,0.7178800856531049,0.012580299785867237,0.2775695931477516,0.7224304068522484,0.06718415417558886
8925,15.0,30,12027,12057,28,1064,16562,4432,12130,16562,1226,0.001811375437749064,0.7261804129935998,0.0016906170752324597,0.26760053133679507,0.7323994686632049,0.06424344885883347
8926,35.0,3387,84202,87589,632,4738,115751,33306,82445,115751,8550,0.029261086297310605,0.7274407996475193,0.005459996025952259,0.28773833487399675,0.7122616651260032,0.04093269172620539
8927,24.0,252,10488,10740,101,415,13842,4145,9697,13842,983,0.018205461638491547,0.7576939748591244,0.007296633434474787,0.2994509463950296,0.7005490536049703,0.02998121658719838
8928,25.0,131,6129,6260,23,399,8417,2381,6036,8417,474,0.015563740049899013,0.7281691814185577,0.0027325650469288347,0.2828798859451111,0.717120114054889,0.04740406320541761
8929,23.0,156,3012,3168,11,163,4530,1224,3306,4530,287,0.03443708609271523,0.6649006622516557,0.0024282560706401766,0.27019867549668874,0.7298013245033113,0.03598233995584989
8930,17.0,1664,11417,13081,4,1459,17899,5065,12834,17899,990,0.09296608749092128,0.637856863511928,0.00022347617185317615,0.2829767026090843,0.7170232973909157,0.081512933683446
8931,23.0,139,3562,3701,16,179,5209,1428,3781,5209,349,0.026684584373200232,0.683816471491649,0.0030716068343252063,0.2741409099635247,0.7258590900364753,0.034363601459013245
8932,33.0,2709,61634,64343,108,2836,84485,24378,60107,84485,6080,0.03206486358525182,0.729525951352311,0.0012783334319701723,0.2885482630052672,0.7114517369947327,0.03356808900988341
8933,24.0,2330,37613,39943,156,1888,54737,15199,39538,54737,3858,0.04256718490235124,0.6871585947348229,0.002849991778869869,0.2776732374810457,0.7223267625189542,0.034492208195553285
8934,15.0,143,6557,6700,46,312,8998,2559,6439,8998,751,0.01589242053789731,0.7287174927761725,0.005112247166036897,0.28439653256279174,0.7156034674372083,0.03467437208268504
8935,26.0,1556,31293,32849,1559,2327,45562,12228,33334,45562,2628,0.034151266406215706,0.6868223519599667,0.03421711075018656,0.2683815460251964,0.7316184539748035,0.0510732628067249
8936,26.0,1536,25011,26547,203,1655,37441,10022,27419,37441,2404,0.041024545284581077,0.6680110039795946,0.005421863732272108,0.26767447450655696,0.732325525493443,0.04420287919660266
8937,,231,4109,4340,27,326,6033,1637,4396,6033,422,0.0382894082545997,0.681087352892425,0.0044753853804077575,0.27134095806398145,0.7286590419360186,0.05403613459307144
8938,,89,1709,1798,14,102,2457,681,1776,2457,202,0.03622303622303622,0.6955636955636956,0.005698005698005698,0.2771672771672772,0.7228327228327228,0.04151404151404151
8939,,1344,43666,45010,45,2037,58452,17061,41391,58452,4194,0.02299322521042907,0.7470403065763361,0.0007698624512420448,0.29188051734756726,0.7081194826524327,0.03484910695955656
8940,23.0,773,2221,2994,12,91,3844,1149,2695,3844,213,0.20109261186264307,0.5777835587929241,0.003121748178980229,0.2989073881373569,0.701092611862643,0.023673257023933404
8941,23.0,5149,89723,94872,392,6301,128296,36095,92201,128296,8466,0.04013375319573486,0.6993437051817671,0.0030554343081623746,0.2813415850844921,0.7186584149155079,0.0491129887135998
8942,16.0,3085,44810,47895,789,3598,66262,18353,47909,66262,4561,0.046557604660287945,0.6762548670429507,0.01190727717243669,0.2769762458120793,0.7230237541879206,0.0542995985632791
8943,27.0,1382,43554,44936,90,1783,58402,17072,41330,58402,4628,0.023663573165302557,0.7457621314338551,0.0015410431149618163,0.2923187562069792,0.7076812437930208,0.030529776377521318
8944,23.0,1139,30356,31495,87,1373,41191,12192,28999,41191,3011,0.02765167148163434,0.7369571022796242,0.0021121118690976184,0.29598698744871454,0.7040130125512855,0.03333252409506931
8945,,139,3955,4094,28,164,5351,1589,3762,5351,412,0.025976452999439358,0.7391141842646234,0.005232666791253972,0.29695384040366285,0.7030461595963371,0.030648476920201832
8946,26.0,79,2360,2439,2,117,3157,920,2237,3157,242,0.025023756731073803,0.7475451377890402,0.0006335128286347799,0.2914159011719987,0.7085840988280012,0.03706050047513462
8947,,137,2655,2792,14,137,3669,1054,2615,3669,209,0.03733987462523849,0.723630417007359,0.0038157536113382394,0.28727173616789314,0.7127282638321069,0.03733987462523849
8948,25.0,5095,89892,94987,819,8136,130955,35361,95594,130955,8231,0.03890649459738078,0.6864342713145737,0.006254056737047077,0.27002405406437324,0.7299759459356268,0.062128211981214924
8949,26.0,5988,174523,180511,824,6560,238225,68987,169238,238225,19504,0.025135900933990974,0.7325973344527232,0.0034589148913841956,0.2895875747717494,0.7104124252282507,0.02753699233917515
8950,33.0,19288,431901,451189,3081,26792,605336,171445,433895,605340,40905,0.031863085208312686,0.7134849836455546,0.0050897016552681135,0.283220999768725,0.7167790002312749,0.0442594244556778
8951,,63,3656,3719,2,69,4633,1462,3171,4633,294,0.01359810058277574,0.7891215195337794,0.0004316857327865314,0.31556227066695447,0.6844377293330456,0.014893157781135334
8952,23.0,25700,674578,700278,3988,34227,952630,268377,684253,952630,64831,0.0269779452673126,0.7081217261686069,0.004186305281168974,0.2817221796500215,0.7182778203499784,0.035928954578377754
8953,39.0,72,2014,2086,1,94,2693,798,1895,2693,227,0.026735982176011884,0.7478648347567768,0.0003713330857779428,0.29632380245079837,0.7036761975492016,0.034905310063126624
8954,38.0,157,4681,4838,2,297,6291,1877,4414,6291,444,0.024956286758861867,0.7440788427912891,0.00031791448100460976,0.29836274042282623,0.7016372595771737,0.04721030042918455
8955,25.0,468,11955,12423,21,738,16537,4697,11840,16537,1109,0.02830017536433452,0.7229243514543146,0.0012698796637842413,0.2840297514664087,0.7159702485335914,0.044627199612989055
8956,,2001,41973,43974,92,3478,62245,16928,45317,62245,3768,0.03214716041449112,0.6743192224275042,0.0014780303638846494,0.2719575869547755,0.7280424130452245,0.05587597397381316
8957,,607,12796,13403,44,903,18790,5081,13709,18790,1343,0.03230441724321448,0.6810005321979776,0.0023416711016498136,0.27040979244278873,0.7295902075572113,0.04805747738158595
8958,42.0,3007,61820,64827,708,3254,86472,24379,62093,86472,5422,0.034774262188916646,0.7149134980109169,0.008187621426588954,0.2819294106762883,0.7180705893237117,0.03763067813858821
8959,14.0,2866,53244,56110,297,2941,74161,21361,52800,74161,4626,0.038645649330510644,0.7179514839336039,0.004004800366769596,0.2880354903520718,0.7119645096479281,0.039656962554442364
8960,27.0,2486,134503,136989,97,4021,175676,51621,124071,175692,14525,0.014149762083646381,0.7655613232247342,0.0005521025430867655,0.2938153131616693,0.7061846868383307,0.022886642533524577
8961,23.0,1498,59103,60601,69,2457,78189,23178,55011,78189,5429,0.01915870518870941,0.7558991674020642,0.0008824770747803399,0.2964355599892568,0.7035644400107433,0.03142385757587384
8962,,1298,23478,24776,410,2365,35653,9481,26172,35653,2312,0.036406473508540656,0.6585140100412308,0.011499733542759375,0.2659243261436625,0.7340756738563374,0.06633382885030713
8963,,174,4542,4716,25,200,6229,1760,4469,6229,514,0.027933857762080593,0.7291700112377588,0.004013485310643763,0.28254936586932095,0.7174506341306791,0.032107882485150105
8964,,337,6946,7283,50,399,9985,2792,7193,9985,738,0.03375062593890836,0.6956434651977967,0.005007511266900351,0.27961942914371557,0.7203805708562844,0.039959939909864794
8965,,2906,63981,66887,173,3300,88553,25423,63130,88553,7083,0.03281650536966563,0.7225164590697096,0.0019536322880083115,0.2870936049597416,0.7129063950402583,0.03726581821056316
8966,15.0,827,23855,24682,105,1534,33407,9230,24177,33407,2902,0.02475529080731583,0.7140719010985721,0.0031430538509893136,0.2762894004250606,0.7237105995749394,0.04591852007064388
8967,,95,4640,4735,5,210,6142,1751,4392,6143,491,0.01546475663356666,0.7553312713657822,0.0008139345596614033,0.2850398827934234,0.7149601172065766,0.03418525150577893
8968,14.0,250,5229,5479,24,487,7500,2010,5490,7500,395,0.03333333333333333,0.6972,0.0032,0.268,0.732,0.06493333333333333
8969,,775,18746,19521,107,1315,26318,7330,18988,26318,1907,0.029447526407781748,0.7122881677939054,0.004065658484687287,0.27851660460521316,0.7214833953947868,0.0499658028725587
8970,,179,5261,5440,5,315,7176,1969,5207,7176,391,0.024944258639910812,0.7331382385730212,0.0006967670011148272,0.27438684503901895,0.725613154960981,0.04389632107023411
8971,15.0,962,3975,4937,26,230,6686,1879,4807,6686,391,0.14388274005384386,0.5945258749626084,0.003888722704157942,0.28103499850433744,0.7189650014956626,0.03440023930601256
8972,35.0,656,2963,3619,178,408,5449,1285,4164,5449,168,0.12038906221325013,0.5437694989906405,0.03266654432005873,0.23582308680491834,0.7641769131950816,0.07487612405946045
8973,,776,24720,25496,82,672,32788,9712,23076,32788,2719,0.02366719531535928,0.7539343662315481,0.0025009149688910576,0.2962059289984141,0.703794071001586,0.02049530315969257
8974,,178,4425,4603,7,211,6447,1764,4683,6447,553,0.027609740964789825,0.6863657515123314,0.0010857763300760044,0.2736156351791531,0.7263843648208469,0.0327284008065767
8975,,97,3643,3740,13,305,5068,1397,3671,5068,388,0.019139700078926597,0.7188239936858721,0.002565114443567482,0.27565114443567484,0.7243488555643252,0.06018153117600632
8976,26.0,159,3038,3197,40,301,4729,1177,3552,4729,291,0.03362233030238951,0.642419116092197,0.008458447874814971,0.24888982871643053,0.7511101712835695,0.06364982025798266
8977,24.0,221,6446,6667,21,281,9227,2488,6739,9227,713,0.023951446840793325,0.6986019291210578,0.0022759293378129403,0.269643437737076,0.730356562262924,0.03045410209168744
8978,16.0,1139,14954,16093,37,2115,23222,6111,17111,23222,1623,0.04904831625183016,0.6439583153905779,0.0015933166824562914,0.26315562828352423,0.7368443717164758,0.09107742657824477
8979,,131,4643,4774,21,197,7039,1831,5208,7039,502,0.0186105980963205,0.6596107401619549,0.0029833783207842022,0.2601221764455178,0.7398778235544822,0.02798692996164228
8980,23.0,109,9337,9446,43,357,12769,3631,9138,12769,1268,0.008536298848774375,0.7312240582661133,0.0033675307385073222,0.2843605607330253,0.7156394392669747,0.027958336596444516
8981,,171,3890,4061,19,577,5924,1558,4366,5924,308,0.028865631330182308,0.6566509115462525,0.0032072923700202567,0.26299797434166106,0.7370020256583389,0.0974004051316678
8982,17.0,1400,30591,31991,60,1989,42906,12225,30681,42906,3372,0.032629469071924676,0.7129772059851769,0.0013984058173682002,0.2849251852887708,0.7150748147112292,0.04635715284575584
8983,13.0,202,2223,2425,29,176,3303,929,2374,3303,232,0.061156524371783226,0.6730245231607629,0.00877989706327581,0.2812594610959734,0.7187405389040267,0.05328489252194974
8984,16.0,723,8362,9085,97,1112,12795,3452,9343,12795,709,0.05650644783118405,0.6535365377100429,0.007581086361860102,0.26979288784681515,0.7302071121531848,0.08690894880812818
8985,,135,5883,6018,7,339,8038,2242,5796,8038,746,0.016795222692211995,0.7318984822095048,0.0008708633988554367,0.2789251057476984,0.7210748942523015,0.042174670315999
8986,24.0,554,14235,14789,46,617,19588,5723,13867,19590,1542,0.028279734558448188,0.7266462480857581,0.0023481368044920878,0.29213884635017867,0.7078611536498214,0.03149566105155692
8987,34.0,592,15177,15769,64,671,20852,6060,14792,20852,1636,0.028390562056397468,0.7278438519086898,0.0030692499520429697,0.2906196048340687,0.7093803951659313,0.03217916746595051
8988,40.0,89,2678,2767,3,124,3723,1050,2673,3723,331,0.023905452591995703,0.7193123824872415,0.0008058017727639,0.28203062046736505,0.717969379532635,0.0333064732742412
8989,24.0,2049,74796,76845,220,2909,99999,29331,70668,99999,8900,0.02049020490204902,0.7479674796747967,0.0022000220002200022,0.29331293312933127,0.7066870668706687,0.02909029090290903
8990,23.0,4009,92354,96363,339,5475,127929,35992,91937,127929,9661,0.031337695127766185,0.7219160628160933,0.002649907370494571,0.28134355775469205,0.7186564422453079,0.042797176558872496
8991,23.0,136,7711,7847,68,682,11104,2897,8207,11104,596,0.012247838616714697,0.6944344380403458,0.006123919308357349,0.26089697406340057,0.7391030259365994,0.061419308357348705
8992,25.0,264,8093,8357,23,546,11221,3195,8026,11221,904,0.023527314856073435,0.7212369664022814,0.0020497281882185187,0.284733980928616,0.715266019071384,0.048658764815970056
8993,36.0,333,2939,3272,115,172,4574,1259,3315,4574,218,0.07280279842588544,0.6425448185395715,0.025142107564494972,0.27525142107564493,0.7247485789243551,0.03760384783559248
8994,,331,9819,10150,16,445,13614,3801,9813,13614,1197,0.02431320699280153,0.7212428382547378,0.0011752607609813426,0.2791978845306302,0.7208021154693698,0.03268693991479359
8995,,116,1978,2094,2,162,2860,813,2047,2860,198,0.04055944055944056,0.6916083916083916,0.0006993006993006993,0.28426573426573426,0.7157342657342657,0.056643356643356645
8996,,284,4732,5016,14,395,6882,1912,4970,6882,460,0.04126707352513804,0.6875908166230746,0.002034292356873002,0.2778262133100843,0.7221737866899157,0.057396105783202554
8997,,1715,41292,43007,308,3118,60418,15987,44431,60418,3851,0.02838558045615545,0.6834387103181171,0.005097818530901387,0.2646065741997418,0.7353934258002582,0.05160713694594326
8998,16.0,348,3974,4322,21,534,6211,1698,4513,6211,320,0.05602962485912091,0.6398325551440992,0.0033810980518435034,0.2733859281919176,0.7266140718080825,0.08597649331830623
8999,23.0,50,1689,1739,1,104,2346,659,1687,2346,188,0.021312872975277068,0.7199488491048593,0.00042625745950554135,0.28090366581415177,0.7190963341858483,0.0443307757885763
9000,25.0,125,3319,3444,11,141,4537,1335,3202,4537,370,0.027551245316288296,0.7315406656380868,0.00242450958783337,0.294247299977959,0.705752700022041,0.031077804716773197
9001,27.0,917,19058,19975,310,881,26716,7453,19263,26716,1946,0.03432400059889205,0.7133552927084893,0.011603533463093278,0.27897140290462646,0.7210285970953736,0.03297649348704896
9002,40.0,606,15499,16105,69,482,20776,6146,14630,20776,1501,0.02916827108201771,0.7460050057758952,0.0033211397766653833,0.29582210242587603,0.704177897574124,0.023199845976126298
9003,24.0,333,8940,9273,33,533,12366,3457,8909,12366,977,0.026928675400291122,0.7229500242600679,0.002668607472100922,0.2795568494258451,0.720443150574155,0.04310205401908459
9004,,72,2525,2597,32,213,3501,926,2575,3501,261,0.02056555269922879,0.7212225078548986,0.009140245644101685,0.2644958583261925,0.7355041416738075,0.060839760068551844
9005,16.0,947,20164,21111,93,1083,27801,8011,19790,27801,1953,0.0340635228948599,0.7252976511636272,0.0033452034099492826,0.2881551023344484,0.7118448976655516,0.03895543325779648
9006,17.0,2039,27082,29121,266,3349,39433,10874,28559,39433,2041,0.05170796033778815,0.6867851799254432,0.006745619151472117,0.2757588821545406,0.7242411178454594,0.08492886668526362
9007,25.0,73,1604,1677,2,55,2302,630,1672,2302,177,0.0317115551694179,0.6967854039965248,0.0008688097306689834,0.2736750651607298,0.7263249348392702,0.023892267593397045
9008,17.0,407,10050,10457,13,729,14422,3947,10475,14422,913,0.028220773817778395,0.6968520316183608,0.0009014006379142976,0.2736791013729025,0.7263208986270975,0.050547774233809455
9009,17.0,495,13817,14312,65,1014,19574,5460,14114,19574,1097,0.025288648206804945,0.7058853581281291,0.0033207315827117603,0.2789414529477879,0.7210585470522122,0.05180341269030347
9010,23.0,35728,604883,640611,2761,46090,867716,245128,622588,867716,66980,0.041174762249399574,0.6970978983907177,0.003181916663977615,0.2824979601620807,0.7175020398379193,0.0531164574584311
9011,17.0,288,6055,6343,9,602,9661,2294,7367,9661,574,0.029810578615050203,0.6267467135907256,0.0009315805817203188,0.2374495393851568,0.7625504606148432,0.06231239002173688
9012,25.0,68,1874,1942,0,98,2566,704,1862,2566,188,0.026500389711613406,0.730319563522993,0.0,0.27435697583788,0.72564302416212,0.03819173811379579
9013,,598,10191,10789,100,772,14928,4036,10892,14928,926,0.04005894962486602,0.6826768488745981,0.00669882100750268,0.2703644158628081,0.7296355841371919,0.05171489817792069
9014,,178,4140,4318,22,225,5761,1614,4147,5761,420,0.030897413643464676,0.7186252386738413,0.003818781461551814,0.28015969449748307,0.7198403055025169,0.03905571949314355
9015,16.0,157,4749,4906,8,177,6417,1843,4574,6417,610,0.02446626149290946,0.740065451145395,0.0012466884837151317,0.28720585943587346,0.7127941405641265,0.02758298270219729
9016,,132,11025,11157,45,1122,15284,4223,11061,15284,1262,0.008636482596179012,0.721342580476315,0.0029442554305155718,0.27630201517927244,0.7236979848207276,0.07341010206752159
9017,,497,11168,11665,14,824,15679,4427,11252,15679,1263,0.031698450156259966,0.7122903246380509,0.0008929140889087315,0.2823521908284967,0.7176478091715033,0.05255437209005676
9018,27.0,305,6621,6926,41,434,9440,2622,6818,9440,718,0.0323093220338983,0.7013771186440678,0.004343220338983051,0.2777542372881356,0.7222457627118644,0.04597457627118644
9019,24.0,120,1577,1697,0,63,2923,617,2306,2923,112,0.041053711939787886,0.5395141977420459,0.0,0.21108450222374273,0.7889154977762572,0.021553198768388643
9020,25.0,1505,27196,28701,157,1458,36896,10763,26133,36896,2425,0.04079032957502168,0.7370988725065047,0.00425520381613183,0.2917118386816999,0.7082881613183001,0.039516478751084126
9021,17.0,337,5517,5854,2,245,7662,2217,5445,7662,557,0.04398329417906552,0.7200469851213782,0.00026102845210127906,0.2893500391542678,0.7106499608457322,0.03197598538240668
9022,16.0,66,1937,2003,1,87,2796,763,2033,2796,187,0.023605150214592276,0.6927753934191703,0.000357653791130186,0.2728898426323319,0.727110157367668,0.03111587982832618
9023,23.0,1360,30923,32283,184,1590,43343,12431,30912,43343,3101,0.03137761576263757,0.7134485384029716,0.004245206838474494,0.28680525113628497,0.713194748863715,0.03668412431073068
9024,,848,11628,12476,90,700,16676,4748,11928,16676,957,0.050851523147037656,0.6972895178699928,0.005396977692492204,0.2847205564883665,0.7152794435116335,0.04197649316382825
9025,24.0,68,2274,2342,0,129,3046,888,2158,3046,223,0.02232435981615233,0.7465528562048588,0.0,0.29152987524622453,0.7084701247537755,0.042350623768877216
9026,,387,3557,3944,35,316,5307,1472,3835,5307,270,0.07292255511588468,0.6702468437912191,0.006595063124175617,0.27736951196532883,0.7226304880346712,0.059543998492557
9027,,1449,26841,28290,164,1972,37955,10727,27228,37955,2707,0.03817678830193651,0.7071795547358715,0.004320906336451061,0.2826241601896983,0.7173758398103016,0.051956263996838364
9028,47.0,431,9315,9746,20,352,13086,3671,9415,13086,861,0.03293596209689745,0.7118294360385145,0.0015283509093687911,0.2805288094146416,0.7194711905853584,0.02689897600489072
9029,41.0,5866,146452,152318,2244,6102,200000,57970,142052,200022,13328,0.029326774054853965,0.7321794602593714,0.011218765935747067,0.28981812000679924,0.7101818799932007,0.030506644269130394
9030,,54,2940,2994,2,99,3840,1140,2700,3840,300,0.0140625,0.765625,0.0005208333333333333,0.296875,0.703125,0.02578125
9031,24.0,27,9662,9689,14,367,12906,3916,8990,12906,1314,0.0020920502092050207,0.7486440415310708,0.0010847667751433443,0.3034247636758097,0.6965752363241903,0.028436386176971952
9032,33.0,172,4057,4229,24,245,5735,1558,4177,5735,455,0.02999128160418483,0.7074106364428945,0.004184829991281604,0.27166521360069745,0.7283347863993025,0.042720139494333044
9033,27.0,616,10858,11474,82,486,15156,4440,10716,15156,575,0.04064396938506202,0.7164159408814991,0.005410398522037477,0.2929532858273951,0.7070467141726049,0.032066508313539195
9034,39.0,193,5538,5731,20,605,7867,2132,5735,7867,497,0.024532858777170458,0.703953222321088,0.002542265158256006,0.2710054658700902,0.7289945341299098,0.07690352103724418
9035,23.0,1255,17773,19028,66,1146,29601,7095,22506,29601,1683,0.04239721631025979,0.6004189047667309,0.002229654403567447,0.23968784838350055,0.7603121516164995,0.03871490828012567
9036,15.0,130,2158,2288,33,121,3340,839,2501,3340,210,0.038922155688622756,0.6461077844311377,0.009880239520958085,0.25119760479041914,0.7488023952095808,0.03622754491017964
9037,33.0,3122,70375,73497,517,3223,95461,28022,67457,95479,6315,0.03269828967626389,0.7370730736601766,0.005414803255166058,0.2934886205343583,0.7065113794656417,0.03375611390986499
9038,,2714,46541,49255,1213,4142,70243,18897,51346,70243,4588,0.03863730193755961,0.6625713594237148,0.017268624631635893,0.269023247868115,0.7309767521318851,0.058966729780903435
9039,,2276,120648,122924,616,6108,163354,46781,116573,163354,15071,0.013932930935269415,0.7385677730572866,0.003770951430635307,0.28637805012427,0.71362194987573,0.03739118723753321
9040,16.0,2282,62053,64335,278,4491,86804,23227,63577,86804,6245,0.026289111100870927,0.7148633703515967,0.003202617390903645,0.26757983503064375,0.7324201649693562,0.05173724713146859
9041,43.0,41,1856,1897,2,62,2488,723,1765,2488,194,0.01647909967845659,0.7459807073954984,0.0008038585209003215,0.29059485530546625,0.7094051446945338,0.02491961414790997
9042,23.0,147,4085,4232,0,163,5733,1676,4057,5733,456,0.02564102564102564,0.7125414268271412,0.0,0.29234257805686376,0.7076574219431362,0.02843188557474272
9043,16.0,2057,38446,40503,433,2530,55752,15343,40409,55752,3988,0.03689553737982494,0.6895896111350266,0.0077665375233175495,0.2752008896541828,0.7247991103458172,0.04537953795379538
9044,,190,7520,7710,132,753,11362,2974,8388,11362,569,0.016722408026755852,0.6618553071642317,0.011617672944904065,0.26174969195564163,0.7382503080443584,0.0662735433902482
9045,26.0,1427,34255,35682,226,1487,47176,13837,33339,47176,3518,0.03024843140579956,0.7261107342716635,0.004790571477022215,0.2933059182635238,0.7066940817364762,0.031520264541292184
9046,16.0,59,6448,6507,3,292,9279,2499,6780,9279,760,0.006358443797823041,0.6949024679383554,0.00032331070158422246,0.2693178144196573,0.7306821855803427,0.03146890828753098
9047,,792,14785,15577,130,1063,20837,5823,15014,20837,1359,0.0380093103613764,0.7095551182991794,0.006238901953256227,0.27945481595239235,0.7205451840476076,0.0510150213562413
9048,,202,7358,7560,43,387,9862,2840,7022,9862,728,0.02048266071790712,0.7460961265463395,0.0043601703508416145,0.2879740417765159,0.7120259582234841,0.03924153315757453
9049,,363,9485,9848,45,346,12756,3852,8904,12756,913,0.02845719661335842,0.74357165255566,0.0035277516462841017,0.3019755409219191,0.6980244590780809,0.027124490435873314
9050,17.0,56,2454,2510,13,240,3520,965,2555,3520,226,0.015909090909090907,0.6971590909090909,0.003693181818181818,0.2741477272727273,0.7258522727272727,0.06818181818181818
9051,15.0,7308,118023,125331,1638,10906,172500,47477,125023,172500,10653,0.04236521739130435,0.684191304347826,0.009495652173913044,0.2752289855072464,0.7247710144927536,0.0632231884057971
9052,,183,3312,3495,4,275,4942,1277,3665,4942,331,0.03702954269526507,0.6701740186159449,0.0008093889113719142,0.2583974099554836,0.7416025900445163,0.0556454876568191
9053,24.0,459,13051,13510,39,692,17756,5182,12574,17756,1459,0.025850416760531653,0.7350191484568597,0.002196440639783735,0.2918450101374183,0.7081549898625816,0.038972741608470376
9054,15.0,130,3272,3402,6,238,4496,1231,3265,4496,271,0.02891459074733096,0.7277580071174378,0.0013345195729537367,0.27379893238434166,0.7262010676156584,0.052935943060498224
9055,17.0,10175,124528,134703,1821,9486,194729,52165,142564,194729,10868,0.052252104206358584,0.6394938606987146,0.009351457666808744,0.26788511213019117,0.7321148878698088,0.04871385361194275
9056,,161,1694,1855,10,146,2640,708,1932,2640,216,0.06098484848484848,0.6416666666666667,0.003787878787878788,0.2681818181818182,0.7318181818181818,0.055303030303030305
9057,17.0,139,3897,4036,13,180,5417,1557,3860,5417,365,0.02565995938711464,0.7194018829610486,0.002399852316780506,0.2874284659405575,0.7125715340594425,0.03322872438619162
9058,23.0,230,6816,7046,45,248,9331,2701,6630,9331,769,0.02464901939770657,0.7304683313685564,0.004822634229986068,0.28946522344871933,0.7105347765512807,0.026578073089700997
9059,27.0,344,9509,9853,21,505,12946,3726,9220,12946,1078,0.02657191410474278,0.7345125907616252,0.0016221226633709254,0.2878109068438128,0.7121890931561873,0.039008187857253206
9060,17.0,169,4320,4505,11,282,6244,1700,4545,6245,431,0.027061649319455563,0.6917534027221778,0.0017614091273018414,0.2722177742193755,0.7277822257806245,0.045156124899919936
9061,,324,7371,7695,6,356,10104,2908,7196,10104,644,0.032066508313539195,0.7295130641330166,0.0005938242280285036,0.28780680918448137,0.7121931908155186,0.035233570863024546
9062,,167,3351,3518,23,199,4871,1329,3542,4871,328,0.03428454116197906,0.6879490864298912,0.004721823034284541,0.27283925272018067,0.7271607472798194,0.04085403407924451
9063,41.0,730,11810,12540,183,623,17497,4761,12736,17497,1105,0.04172143796079328,0.6749728524889981,0.010458935817568725,0.2721037892210093,0.7278962107789907,0.035606103903526316
9064,,273,5419,5692,57,157,7389,2236,5153,7389,536,0.036946812829882256,0.7333874678576262,0.007714169711733658,0.30261199079713086,0.6973880092028691,0.021247800784950602
9065,,5510,31466,36976,5405,7403,59382,13856,45526,59382,2622,0.09278906065811189,0.5298912128254353,0.09102084806843824,0.23333670135731366,0.7666632986426863,0.12466740763194234
9066,17.0,7587,136691,144278,458,8852,192541,54683,137858,192541,13937,0.039404594346139264,0.7099319106060528,0.0023787141440004987,0.2840070426558499,0.71599295734415,0.04597462358666466
9067,33.0,3118,47953,51071,424,3270,69739,19153,50586,69739,3929,0.04470955993059837,0.687606647643356,0.006079811869972325,0.27463829421127345,0.7253617057887265,0.046889115129267696
9068,,99,2684,2783,3,154,3786,1081,2705,3786,313,0.026148969889064975,0.7089276281035394,0.000792393026941363,0.28552562070787113,0.7144743792921289,0.04067617538298996
9069,24.0,51,1414,1465,6,149,2014,525,1489,2014,141,0.0253227408142999,0.702085402184707,0.0029791459781529296,0.26067527308838134,0.7393247269116187,0.07398212512413108
9070,,1666,36799,38465,107,1914,52406,14845,37561,52406,4854,0.031790253024462846,0.7021905888638705,0.0020417509445483342,0.2832690913254208,0.7167309086745792,0.036522535587528146
9071,,963,18468,19431,230,1283,27195,7380,19815,27195,1616,0.03541092112520684,0.6790954219525648,0.0084574370288656,0.2713734142305571,0.728626585769443,0.047177790034932894
9072,17.0,1798,26332,28130,55,2805,40558,11428,29130,40558,3003,0.044331574535233495,0.6492430593224517,0.001356082647073327,0.28176931801370875,0.7182306819862913,0.06916021500073968
9073,16.0,778,7509,8287,123,588,11787,3080,8707,11787,431,0.06600492067532027,0.6370577755153983,0.010435225248154746,0.26130482735216765,0.7386951726478324,0.049885467039959275
9074,14.0,118,2006,2124,3,157,2880,794,2086,2880,200,0.04097222222222222,0.6965277777777777,0.0010416666666666667,0.27569444444444446,0.7243055555555555,0.05451388888888889
9075,15.0,5888,124309,130197,1267,7022,175483,49062,126421,175483,12081,0.033553107708438994,0.7083820085136452,0.007220072599625035,0.2795826376344147,0.7204173623655853,0.04001527213462273
9076,27.0,141,2818,2959,27,160,4097,1105,2992,4097,267,0.03441542592140591,0.687820356358311,0.006590187942396876,0.2697095435684647,0.7302904564315352,0.03905296558457408
9077,34.0,175,4274,4449,11,212,6071,1671,4400,6071,454,0.028825564157469938,0.7040026354801515,0.0018118926041838248,0.2752429583264701,0.72475704167353,0.03492011200790644
9078,,0,1692,1692,0,143,2311,587,1724,2311,184,0.0,0.7321505841627002,0.0,0.2540025962786672,0.7459974037213327,0.06187797490263955
9079,25.0,2796,57875,60671,333,3671,81571,23215,58359,81574,5759,0.03427562703802682,0.7094785103096575,0.004082183048520362,0.28458822664084144,0.7154117733591585,0.045002083997352095
9080,,114,2060,2174,18,191,2937,818,2119,2937,151,0.03881511746680286,0.7013959822948587,0.006128702757916241,0.27851549199863807,0.7214845080013619,0.06503234593122234
9081,,456,6595,7051,222,609,9861,2661,7200,9861,565,0.046242774566473986,0.6687962681269648,0.02251292972315181,0.26985092789777915,0.7301490721022209,0.061758442348646185
9082,27.0,290,9988,10278,7,423,13663,3984,9679,13663,1168,0.021225206762790015,0.7310253970577472,0.0005123325770328625,0.2915904266998463,0.7084095733001537,0.030959525726414402
9083,,71,2005,2076,6,144,2925,771,2154,2925,204,0.024273504273504273,0.6854700854700855,0.0020512820512820513,0.2635897435897436,0.7364102564102564,0.04923076923076923
9084,,2306,55945,58251,119,2870,77736,21844,55892,77736,5666,0.02966450550581455,0.7196794278069363,0.0015308222702480189,0.2810023669856952,0.7189976330143049,0.03691983122362869
9085,46.0,571,10731,11302,35,1069,15578,3989,11589,15578,1045,0.03665425600205418,0.6888560790858903,0.002246758248812428,0.25606624727179356,0.7439337527282065,0.06862241622801386
9086,27.0,7540,178820,186360,893,8688,246284,70764,175520,246284,18616,0.030615062285816376,0.7260723392506212,0.0036258953078559713,0.2873268259407838,0.7126731740592162,0.03527634763119001
9087,13.0,3103,43669,46772,429,3024,66141,17984,48157,66141,4533,0.046914924177136726,0.6602410002872651,0.006486143239443008,0.2719039627462542,0.7280960372537458,0.045720506191318545
9088,27.0,920,26245,27165,89,1308,36053,10344,25709,36053,2634,0.025517987407427955,0.7279560646825507,0.0024685879122403128,0.28691093667655954,0.7130890633234405,0.03627992122708235
9089,16.0,619,11018,11637,35,705,15659,4357,11302,15659,1114,0.039529982757519636,0.7036209208761735,0.002235136343316942,0.2782425442237691,0.721757455776231,0.04502203205824127
9090,,27,1957,1984,19,88,2873,737,2136,2873,174,0.009397841977027498,0.6811695092238078,0.006613296206056387,0.2565262791507135,0.7434737208492864,0.030630003480682212
9091,26.0,492,10105,10597,31,711,14342,4069,10273,14342,1014,0.03430483893459769,0.704573978524613,0.0021614837540092037,0.2837121740343048,0.7162878259656952,0.0495746757774369
9092,,539,16051,16590,6,883,21991,6354,15637,21991,1588,0.024510026829157382,0.7298895002501024,0.0002728388886362603,0.28893638306579966,0.7110636169342004,0.040152789777636304
9093,,176,4814,4990,7,276,6616,1834,4782,6616,515,0.026602176541717048,0.7276299879081015,0.0010580411124546554,0.2772067714631197,0.7227932285368803,0.04171704957678356
9094,33.0,171,8291,8462,100,191,11480,3194,8286,11480,925,0.014895470383275261,0.722212543554007,0.008710801393728223,0.27822299651567944,0.7217770034843206,0.016637630662020907
9095,23.0,71,2389,2460,12,135,3336,941,2395,3336,283,0.021282973621103117,0.7161270983213429,0.0035971223021582736,0.28207434052757796,0.717925659472422,0.040467625899280574
9096,17.0,258,4700,4958,22,344,6779,1833,4946,6779,496,0.03805871072429562,0.6933175984658504,0.003245316418350789,0.27039386340168164,0.7296061365983183,0.050744947632394156
9097,27.0,5,1922,1927,0,111,2515,721,1794,2515,224,0.0019880715705765406,0.7642147117296223,0.0,0.2866799204771372,0.7133200795228628,0.04413518886679921
9098,23.0,148,1827,1975,12,98,3137,673,2464,3137,133,0.047178833280204016,0.582403570290086,0.003825310806503028,0.2145361810647115,0.7854638189352885,0.031240038253108064
9099,15.0,1198,28832,30030,52,1626,40468,11569,28899,40468,2749,0.029603637441929426,0.7124641692201246,0.0012849658989819116,0.28588020164080263,0.7141197983591974,0.040179895225857465
9100,16.0,248,3828,4076,45,269,5646,1563,4083,5646,414,0.043924902585901524,0.6780021253985122,0.007970244420828906,0.27683315621679067,0.7231668437832094,0.04764434998228834
9101,13.0,223,2960,3183,11,349,4573,1133,3440,4573,261,0.04876448720752241,0.6472774983599388,0.0024054231357970696,0.24775858298709819,0.7522414170129018,0.07631751585392521
9102,17.0,2058,35100,37158,577,1970,50303,14064,36239,50303,3521,0.040912072838598094,0.6977715046816293,0.011470488837643879,0.27958571059380155,0.7204142894061984,0.03916267419438205
9103,,1244,37372,38616,200,1781,50365,14759,35606,50365,3919,0.024699692246599823,0.7420232304179489,0.003971011615208975,0.29304080214434625,0.7069591978556538,0.035361858433435915
9104,23.0,39,2091,2130,6,93,2829,825,2004,2829,254,0.013785790031813362,0.7391304347826086,0.0021208907741251328,0.2916224814422057,0.7083775185577943,0.032873806998939555
9105,,352,7996,8348,92,355,10960,3131,7829,10960,763,0.032116788321167884,0.7295620437956204,0.008394160583941606,0.28567518248175183,0.7143248175182482,0.03239051094890511
9106,,348,7288,7636,16,593,10457,2915,7542,10457,792,0.03327914315769341,0.6969494118772115,0.0015300755474801568,0.27876063880654106,0.7212393611934589,0.056708424978483316
9107,17.0,229,7109,7338,13,963,10018,2838,7180,10018,399,0.022858854062687162,0.7096226791774806,0.0012976642044320223,0.2832900778598523,0.7167099221401477,0.0961269714513875
9108,,13,1360,1373,3,193,1953,477,1476,1953,149,0.006656426011264721,0.6963645673323092,0.0015360983102918587,0.24423963133640553,0.7557603686635944,0.09882232462877624
9109,,1936,48219,50155,70,2940,66676,18383,48293,66676,4551,0.029035934969104324,0.7231837542744016,0.0010498530205771191,0.2757064011038455,0.7242935988961545,0.04409382686423901
9110,15.0,231,7411,7642,11,567,10356,2853,7503,10356,785,0.022305909617612977,0.7156237929702588,0.0010621861722672848,0.27549246813441486,0.7245075318655851,0.05475086906141367
9111,14.0,203,2847,3050,5,366,4314,1188,3126,4314,234,0.047056096430227165,0.6599443671766342,0.0011590171534538712,0.2753824756606398,0.7246175243393602,0.08484005563282336
9112,17.0,152,4522,4674,3,194,6200,1816,4384,6200,462,0.024516129032258065,0.7293548387096774,0.0004838709677419355,0.2929032258064516,0.7070967741935484,0.03129032258064516
9113,13.0,78,1829,1907,11,107,2591,708,1883,2591,251,0.03010420686993439,0.7059050559629486,0.0042454650714010035,0.2732535700501737,0.7267464299498263,0.04129679660362794
9114,16.0,3080,43926,47006,175,3950,63981,17834,46147,63981,4341,0.04813929135212016,0.6865475688094903,0.002735187008643191,0.27873900064081525,0.7212609993591848,0.06173707819508917
9115,16.0,110,1651,1761,7,83,2345,662,1683,2345,182,0.046908315565031986,0.7040511727078891,0.0029850746268656717,0.2823027718550107,0.7176972281449894,0.03539445628997868
9116,23.0,490,10640,11130,79,645,14867,4198,10669,14867,1034,0.032958902266765316,0.7156790206497612,0.005313782202192776,0.28237035044057307,0.7176296495594269,0.04338467747359925
9117,,733,14840,15573,22,873,21295,5742,15553,21295,1674,0.03442122563982156,0.6968772012209439,0.0010331063629960085,0.2696407607419582,0.7303592392580418,0.040995538858887064
9118,,145,4403,4548,3,322,6580,1826,4754,6580,444,0.022036474164133738,0.6691489361702128,0.0004559270516717325,0.2775075987841945,0.7224924012158055,0.04893617021276596
9119,,116,2831,2947,16,138,4024,1101,2923,4024,263,0.02882703777335984,0.7035288270377733,0.003976143141153081,0.2736083499005964,0.7263916500994035,0.03429423459244533
9120,17.0,419,7744,8163,12,367,10699,3134,7565,10699,767,0.03916253855500514,0.7238059631741284,0.0011216001495466866,0.29292457238994296,0.707075427610057,0.034302271240302835
9121,23.0,6696,70182,76878,264,3114,101068,28133,72935,101068,7163,0.06625242411049986,0.6944037677603198,0.00261210274270788,0.27835714568409387,0.7216428543159061,0.030810939169667945
9122,38.0,400,5697,6097,37,265,7826,2254,5572,7826,503,0.051111679018655765,0.7279580884232048,0.004727830309225658,0.2880143112701252,0.7119856887298748,0.03386148734985944
9123,37.0,968,30266,31234,94,1788,40726,12047,28679,40726,3003,0.02376859991160438,0.7431616166576634,0.0023081078426557974,0.2958061189412169,0.7041938810587831,0.04390315768796346
9124,,80,3142,3222,9,144,4235,1233,3002,4235,321,0.018890200708382526,0.7419126328217237,0.0021251475796930344,0.2911452184179457,0.7088547815820543,0.03400236127508855
9125,24.0,96,1154,2049,29,203,2920,469,2451,2920,90,0.03287671232876712,0.3952054794520548,0.00993150684931507,0.16061643835616438,0.8393835616438357,0.06952054794520549
9126,33.0,186,6524,6710,44,161,8636,2513,6123,8636,692,0.021537748957850857,0.7554423344140806,0.005094951366373321,0.2909911996294581,0.7090088003705419,0.018642890226956924
9127,15.0,253,9598,9851,24,861,13652,3741,9911,13652,1116,0.018532083211251098,0.7030471725754468,0.0017579841781423966,0.27402578376794606,0.7259742162320539,0.06306768239085848
9128,16.0,9331,172457,181788,1297,11117,245415,69880,175535,245415,16298,0.03802131084082065,0.7027158079172015,0.0052849255342990445,0.2847421714239146,0.7152578285760854,0.04529877961819775
9129,17.0,114,6350,6464,27,545,9090,2382,6708,9090,697,0.012541254125412541,0.6985698569856986,0.0029702970297029703,0.262046204620462,0.737953795379538,0.059955995599559955
9130,16.0,280,24059,24339,72,2653,35476,9043,26433,35476,2567,0.007892659826361484,0.6781767955801105,0.0020295410982072385,0.2549047243206675,0.7450952756793325,0.07478295185477506
9131,,63,3056,3119,10,350,4380,1170,3210,4380,291,0.014383561643835616,0.6977168949771689,0.00228310502283105,0.2671232876712329,0.7328767123287672,0.07990867579908675
9132,27.0,673,6511,7184,50,570,9618,2759,6859,9618,638,0.06997296735288001,0.6769598669161988,0.0051985859846121855,0.2868579746309004,0.7131420253690997,0.059263880224578916
9133,,5890,83571,89461,716,4263,119292,33966,85326,119292,7483,0.04937464373134829,0.7005582939342119,0.0060020789323676355,0.28472990644804347,0.7152700935519566,0.035735841464641385
9134,,133,2398,2531,1,126,3337,958,2379,3337,254,0.039856158225951455,0.7186095295175308,0.00029967036260113877,0.28708420737189094,0.7129157926281091,0.037758465687743485
9135,14.0,152,1868,2020,25,120,3059,783,2276,3059,184,0.049689440993788817,0.6106570774762995,0.008172605426610004,0.2559660019614253,0.7440339980385747,0.03922850604772801
9136,23.0,238,4067,4305,5,290,6013,1713,4300,6013,233,0.03958090803259604,0.6763678696158324,0.0008315316813570597,0.2848827540329287,0.7151172459670714,0.04822883751870946
9137,27.0,18502,248048,266550,1872,12120,372498,101931,270579,372510,22118,0.04966846527609997,0.6658827950927492,0.005025368446484658,0.27363292260610456,0.7263670773938955,0.032536039300958365
9138,17.0,213,4027,4240,1,183,5526,1622,3904,5526,394,0.03854505971769816,0.7287368802026782,0.00018096272167933406,0.29352153456387986,0.7064784654361201,0.03311617806731813
9139,17.0,49,2917,2966,13,170,4147,1202,2945,4147,341,0.011815770436460092,0.7034000482276345,0.003134796238244514,0.28984808295153125,0.7101519170484688,0.04099348926935134
9140,15.0,102,2076,2178,19,106,2955,857,2098,2955,266,0.03451776649746193,0.7025380710659899,0.006429780033840948,0.29001692047377325,0.7099830795262267,0.03587140439932318
9141,,732,17067,17799,279,756,23506,6560,16946,23506,1539,0.03114098528035395,0.726069939589892,0.011869309963413597,0.2790776822938824,0.7209223177061176,0.03216200119118523
9142,24.0,166,5304,5470,9,287,7217,2120,5097,7217,548,0.023001247055563254,0.734931411944021,0.0012470555632534293,0.2937508660108078,0.7062491339891922,0.03976721629485936
9143,23.0,72,1968,2040,9,112,2822,779,2043,2822,209,0.025513819985825654,0.6973777462792345,0.0031892274982282067,0.27604535790219703,0.723954642097803,0.039688164422395464
9144,23.0,75,2301,2376,0,107,3136,918,2218,3136,278,0.02391581632653061,0.7337372448979592,0.0,0.2927295918367347,0.7072704081632653,0.03411989795918367
9145,25.0,80,2565,2645,31,116,3614,1063,2551,3614,277,0.02213613724405091,0.7097399003873824,0.00857775318206973,0.29413392363032653,0.7058660763696735,0.032097399003873824
9146,,23,1937,1960,25,111,2819,729,2090,2819,210,0.008158921603405462,0.6871230932954948,0.00886839304717985,0.2586023412557645,0.7413976587442356,0.039375665129478536
9147,,194,4127,4321,29,248,5757,1664,4093,5757,402,0.03369810665277054,0.7168664234844537,0.005037345839847143,0.28903943025881534,0.7109605697411846,0.04307799200972729
9148,,223,12874,13097,142,1064,17894,5034,12864,17898,1186,0.012459492680746451,0.7192982456140351,0.00793384735724662,0.2812604760308414,0.7187395239691585,0.059447983014861996
9149,13.0,4098,59316,63414,290,5324,86219,24043,62179,86222,5261,0.04752847301152838,0.6879450720233815,0.003363410730440027,0.2788499454895502,0.7211500545104498,0.061747581823664494
9150,23.0,76,22312,22388,37,1011,29150,8639,20511,29150,2504,0.002607204116638079,0.7654202401372213,0.0012692967409948543,0.2963636363636364,0.7036363636363636,0.03468267581475128
9151,,9,1722,1731,4,179,2366,672,1694,2366,161,0.0038038884192730348,0.727810650887574,0.0016906170752324597,0.28402366863905326,0.7159763313609467,0.07565511411665257
9152,17.0,96,4753,4849,19,220,6445,1757,4688,6445,532,0.014895267649340575,0.7374709076803724,0.002948021722265322,0.2726144297905353,0.7273855702094647,0.03413498836307215
9153,,484,10357,10841,39,524,15498,4135,11363,15498,1235,0.03122983610788489,0.6682797780358756,0.002516453735965931,0.26680862046715703,0.733191379532843,0.03381081429861918
9154,27.0,15,1524,1539,7,64,2079,577,1502,2079,226,0.007215007215007215,0.733044733044733,0.003367003367003367,0.2775372775372775,0.7224627224627225,0.030784030784030785
9155,16.0,266,7390,7656,38,472,10480,2898,7582,10480,650,0.02538167938931298,0.7051526717557252,0.0036259541984732823,0.2765267175572519,0.7234732824427481,0.0450381679389313
9156,14.0,10,1435,1445,9,93,2092,535,1557,2092,158,0.004780114722753346,0.6859464627151052,0.004302103250478011,0.255736137667304,0.744263862332696,0.04445506692160612
9157,13.0,214,2284,2498,34,164,3492,972,2520,3492,274,0.06128293241695303,0.6540664375715922,0.009736540664375716,0.27835051546391754,0.7216494845360825,0.046964490263459335
9158,23.0,4718,129384,134102,399,4638,174582,51289,123295,174584,14555,0.027024240480227283,0.7410988406726848,0.00228543280025661,0.2937783531136874,0.7062216468863126,0.026566008339824955
9159,16.0,40,2620,2660,0,109,3463,1013,2450,3463,269,0.01155067860236789,0.7565694484550968,0.0,0.2925209356049668,0.7074790643950332,0.0314755991914525
9160,15.0,6791,284017,290808,1532,24345,396487,110378,286109,396487,31217,0.017127926010184445,0.7163337007266316,0.0038639350092184613,0.27838995982213793,0.7216100401778621,0.0614017609656811
9161,36.0,206,3528,3734,6,295,5221,1427,3794,5221,314,0.039456042903658305,0.6757326182723616,0.0011492051331162612,0.2733192874928175,0.7266807125071826,0.056502585711549515
9162,14.0,49,7990,8039,50,291,10909,2994,7915,10909,769,0.004491704097534146,0.7324227701897515,0.004583371528096068,0.2744522871023925,0.7255477128976074,0.026675222293519114
9163,,92,3786,3878,10,153,5217,1460,3757,5217,462,0.017634655932528272,0.7257044278320874,0.0019168104274487254,0.2798543224075139,0.7201456775924862,0.029327199539965498
9164,16.0,236,15945,16181,133,1790,22639,6002,16637,22639,1743,0.01042448871416582,0.7043155616414153,0.005874817792305313,0.26511771721365784,0.7348822827863422,0.07906709660320685
9165,15.0,17493,276724,294217,711,20188,395665,108941,286725,395666,27988,0.04421153194866377,0.6993878675448484,0.0017969701718115784,0.2753357629920185,0.7246642370079814,0.051022832388934104
9166,27.0,11531,303741,315272,785,17801,421340,119272,302068,421340,33535,0.027367446717615228,0.7208928656192148,0.001863103431907723,0.2830777994019082,0.7169222005980918,0.04224854037119666
9167,24.0,46,1618,1664,3,84,2224,613,1611,2224,162,0.02068345323741007,0.7275179856115108,0.0013489208633093526,0.2756294964028777,0.7243705035971223,0.03776978417266187
9168,,103,3628,3731,16,117,4844,1402,3442,4844,414,0.02126341866226259,0.7489677952105698,0.0033030553261767133,0.2894302229562345,0.7105697770437654,0.024153592072667217
9169,25.0,268,11557,11825,44,348,15305,4487,10818,15305,1249,0.01751061744527932,0.7551127082652728,0.002874877491016008,0.293172165958837,0.706827834041163,0.02273766742894479
9170,17.0,472,16024,16496,43,736,21948,6360,15588,21948,1810,0.021505376344086023,0.7300893019865136,0.0019591762347366502,0.2897758337889557,0.7102241662110443,0.033533807180608714
9171,17.0,27,1581,1608,10,97,2178,611,1567,2178,188,0.012396694214876033,0.7258953168044077,0.004591368227731864,0.2805325987144169,0.7194674012855831,0.04453627180899908
9172,17.0,457,3516,3973,43,488,5676,1468,4208,5676,210,0.08051444679351656,0.6194503171247357,0.007575757575757576,0.25863284002818887,0.7413671599718111,0.08597603946441155
9173,34.0,70,2474,2544,7,86,3344,935,2409,3344,289,0.020933014354066987,0.7398325358851675,0.0020933014354066986,0.27960526315789475,0.7203947368421053,0.025717703349282296
9174,24.0,253,4441,4694,51,246,6385,1789,4596,6385,472,0.039624119028974156,0.6955364134690681,0.00798747063429914,0.28018794048551293,0.7198120595144871,0.03852779953014879
9175,17.0,121,3320,3441,13,231,4591,1284,3307,4591,309,0.02635591374428229,0.7231539969505555,0.0028316270964931388,0.2796776301459377,0.7203223698540623,0.050315835329993466
9176,37.0,100,4624,4724,0,191,6162,1803,4359,6162,542,0.01622849724115547,0.7504057124310289,0.0,0.2925998052580331,0.7074001947419669,0.030996429730606945
9177,16.0,147,6329,6476,120,361,8751,2454,6297,8751,688,0.016798080219403495,0.7232316306707804,0.013712718546451834,0.28042509427494,0.71957490572506,0.041252428293909266
9178,23.0,579,13274,13853,47,649,18206,5319,12887,18206,1447,0.031802702405800284,0.7291002966055147,0.0025815665165330112,0.2921564319455125,0.7078435680544876,0.035647588707019666
9179,,20365,473646,494014,3134,22410,651145,187792,463353,651145,46633,0.03127567592471723,0.7274048023097774,0.004813060071105514,0.28840273671762817,0.7115972632823718,0.034416297445269486
9180,14.0,77,1629,1706,11,206,2361,610,1751,2361,148,0.03261329944938585,0.6899618805590851,0.004659042778483694,0.2583650995340957,0.7416349004659043,0.08725116476069462
9181,,136,5595,5731,264,248,7923,2146,5777,7923,611,0.01716521519626404,0.7061719045815978,0.03332071185157137,0.270856998611637,0.729143001388363,0.03130127476965796
9182,35.0,345,9231,9576,9,426,12609,3649,8960,12609,975,0.027361408517725436,0.7320961218177492,0.0007137758743754461,0.28939646284400034,0.7106035371559997,0.03378539138710445
9183,25.0,1,2105,2106,1,84,2763,803,1960,2763,238,0.0003619254433586681,0.7618530582699964,0.0003619254433586681,0.2906261310170105,0.7093738689829895,0.03040173724212812
9184,16.0,798,19156,19954,415,762,25504,7580,17924,25504,1750,0.031289209535759095,0.7510978670012547,0.016271957340025095,0.2972082810539523,0.7027917189460476,0.02987766624843162
9185,26.0,650,24146,24796,52,1079,32512,9514,22998,32512,2638,0.01999261811023622,0.742679625984252,0.0015994094488188976,0.2926304133858268,0.7073695866141733,0.03318774606299212
9186,,140,7145,7285,50,227,9206,2824,6382,9206,633,0.015207473386921572,0.7761242667825331,0.005431240495329133,0.30675646317618943,0.6932435368238106,0.024657831848794266
9187,15.0,1177,17113,18290,123,1058,24418,6808,17610,24418,1807,0.04820214595789991,0.7008354492587435,0.005037267589483168,0.2788107134081415,0.7211892865918584,0.04332869194856254
9188,16.0,691,7587,8278,13,703,11147,3230,7917,11147,816,0.061989773033103074,0.680631560061003,0.0011662330671929667,0.28976406207948324,0.7102359379205168,0.06306629586435812
9189,25.0,374,16466,16840,107,527,22054,6425,15629,22054,1784,0.01695837489797769,0.7466219279949216,0.004851727577763671,0.2913303709077718,0.7086696290922282,0.02389589190169584
9190,13.0,104,1553,1657,12,217,2704,587,2117,2704,111,0.038461538461538464,0.5743343195266272,0.004437869822485207,0.21708579881656806,0.7829142011834319,0.08025147928994082
9191,,1003,25892,26895,81,1233,35706,10068,25638,35706,3082,0.028090516999943988,0.7251442334621632,0.0022685262981011595,0.2819694169047219,0.7180305830952781,0.03453201142665098
9192,,1398,17228,18626,96,2631,26337,6958,19379,26337,1219,0.053081216539469185,0.6541367657667919,0.0036450620799635494,0.26419106200402476,0.7358089379959752,0.09989748262900103
9193,23.0,188,4342,4530,32,212,5892,1756,4136,5892,444,0.031907671418873046,0.7369314324507807,0.005431093007467753,0.29803122878479293,0.7019687712152071,0.03598099117447386
9194,16.0,52,2706,2758,5,281,3802,1047,2755,3802,284,0.013677012098895318,0.7117306680694372,0.0013150973172014729,0.27538137822198844,0.7246186217780116,0.07390846922672278
9195,23.0,11170,258546,269716,820,17270,363128,103782,259346,363128,27446,0.030760503183450465,0.7119968716265339,0.0022581569033508844,0.2858000484677579,0.714199951532242,0.04755898746447534
9196,33.0,458,12509,12967,63,600,17216,4872,12344,17216,1333,0.026603159851301114,0.7265915427509294,0.003659386617100372,0.2829925650557621,0.7170074349442379,0.03485130111524164
9197,,224,3334,3558,11,258,4806,1345,3461,4806,307,0.046608406158967955,0.6937161880982106,0.0022888056595921765,0.2798585101955888,0.7201414898044112,0.05368289637952559
9198,,47,1772,1819,75,74,2614,680,1934,2614,203,0.017980107115531753,0.6778882938026014,0.028691660290742157,0.26013771996939555,0.7398622800306044,0.028309104820198928
9199,,604,12916,13520,27,654,18269,5237,13032,18269,1456,0.03306147025015053,0.7069899830313646,0.0014779134052219608,0.28666046307953363,0.7133395369204664,0.03579834692648749
9200,,1576,40339,41915,178,2213,55518,16005,39513,55518,4296,0.02838718974026442,0.7265931769876437,0.0032061673691415396,0.2882848805792716,0.7117151194207284,0.03986094599949566
9201,36.0,156,6033,6189,15,290,8332,2300,6032,8332,687,0.01872299567930869,0.7240758521363418,0.001800288046087374,0.2760441670667307,0.7239558329332694,0.03480556889102256
9202,26.0,207,3417,3624,20,277,4957,1367,3590,4957,270,0.04175912850514424,0.689328222715352,0.004034698406294129,0.2757716360702038,0.7242283639297963,0.055880572927173695
9203,15.0,649,14960,15609,142,1916,21972,5782,16190,21972,1326,0.029537593300564356,0.6808665574367376,0.006462770799198981,0.2631531039504824,0.7368468960495176,0.08720189331876935
9204,24.0,8965,194600,203565,705,10042,267997,77377,190620,267997,18773,0.03345186699851118,0.7261275312783352,0.002630626462236518,0.28872338123187946,0.7112766187681205,0.0374705687003959
9205,,3183,109908,113091,723,11392,156902,42262,114640,156902,12475,0.020286548291290105,0.7004882028272424,0.0046079718550432755,0.2693528444506762,0.7306471555493238,0.07260583039094466
9206,26.0,249,7707,7956,11,226,10273,3063,7210,10273,761,0.024238294558551542,0.7502190207339628,0.0010707680327070963,0.29816022583471236,0.7018397741652876,0.021999415944709434
9207,,214,3262,3476,62,178,4749,1411,3338,4749,327,0.045062118340703304,0.6868814487260476,0.013055380080016846,0.29711518214360916,0.7028848178563908,0.03748157506843546
9208,,86,1703,1789,0,84,2383,678,1705,2383,198,0.0360889634913974,0.7146454049517414,0.0,0.28451531682752834,0.7154846831724717,0.03524968527066723
9209,17.0,465,11745,12210,21,768,16659,4668,11991,16659,1242,0.027912839906356925,0.7050243111831442,0.0012605798667386999,0.2802088960922024,0.7197911039077975,0.04610120655501531
9210,34.0,2277,62591,64868,256,2961,84352,24694,59658,84352,6528,0.026994025037936267,0.742021528831563,0.0030349013657056147,0.29274943095599393,0.7072505690440061,0.03510290212443096
9211,,98,2405,2503,10,162,3367,755,2612,3367,197,0.029106029106029108,0.7142857142857143,0.00297000297000297,0.22423522423522424,0.7757647757647758,0.04811404811404811
9212,38.0,56,1853,1909,9,55,2549,712,1837,2549,195,0.021969399764613574,0.7269517457826599,0.003530796390741467,0.2793252255786583,0.7206747744213418,0.02157708905453119
9213,26.0,4087,91299,95386,378,3757,129482,36355,93127,129482,9706,0.031564232866344355,0.7051095905222348,0.0029193246937798305,0.2807726170432956,0.7192273829567044,0.02901561607018736
9214,24.0,1631,44234,45865,134,1970,59894,17258,42636,59894,4168,0.02723144221457909,0.7385380839483087,0.002237285871706682,0.2881423848799546,0.7118576151200454,0.03289144154673256
9215,15.0,78,1641,1719,14,67,2408,659,1749,2408,177,0.03239202657807309,0.6814784053156147,0.005813953488372093,0.27367109634551495,0.7263289036544851,0.02782392026578073
9216,38.0,687,25305,25992,9,963,33317,9833,23484,33317,2448,0.020620103850886935,0.759522165861272,0.0002701323648587808,0.2951346159618213,0.7048653840381787,0.028904163039889547
9217,15.0,242,3728,3970,22,325,5593,1528,4065,5593,369,0.04326837117825854,0.6665474700518506,0.003933488288932595,0.2731986411585911,0.726801358841409,0.05810834972286787
9218,26.0,2414,65687,68112,86,3438,91495,26233,65262,91495,7037,0.026383955407399313,0.7179299415268594,0.0009399420733373408,0.28671512104486585,0.7132848789551341,0.037575823815509043
9219,16.0,135,8257,8392,18,392,11071,3155,7916,11071,1020,0.012194020413693434,0.7458224189323458,0.0016258693884924579,0.28497877337187244,0.7150212266281275,0.03540782223828019
9220,,491,24416,24907,15,905,32425,9397,23028,32425,2441,0.015142636854279105,0.7529992289899768,0.0004626060138781804,0.28980724749421743,0.7101927525057826,0.027910562837316886
9221,13.0,487,14283,14770,225,1045,20901,5799,15102,20901,1538,0.023300320558824937,0.6833644323238123,0.010765035165781542,0.2774508396727429,0.722549160327257,0.04999760776996316
9222,16.0,291,4826,5117,25,337,7043,1954,5089,7043,550,0.04131762033224478,0.6852193667471248,0.0035496237398835724,0.2774385915093,0.7225614084906999,0.047848928013630554
9223,25.0,2130,47028,49158,217,2476,65653,18665,46988,65653,4242,0.03244330038231307,0.7163115166100559,0.0033052564239257915,0.28429774724688894,0.7157022527531111,0.03771343274488599
9224,23.0,2263,38208,40471,205,1748,53820,15344,38476,53820,3170,0.04204756596060944,0.7099219620958751,0.003808992939427722,0.2850984764028242,0.7149015235971757,0.03247863247863248
9225,15.0,1400,18594,19994,70,1208,27655,7671,19984,27655,2297,0.05062375700596637,0.6723558126920991,0.0025311878502983186,0.2773820285662629,0.7226179714337371,0.04368107033086241
9226,24.0,282,8169,8451,28,379,11079,3228,7851,11079,904,0.02545356079068508,0.7373409152450582,0.0025273039082949725,0.29136203628486324,0.7086379637151368,0.03420886361584981
9227,24.0,498,12315,12813,33,462,16773,4876,11897,16773,1408,0.029690574137005904,0.7342157038096941,0.0019674476837774997,0.2907053001848208,0.7092946998151791,0.027544267572884994
9228,,730,21821,22551,180,702,29582,8675,20907,29582,2481,0.02467716854844162,0.7376445135555405,0.006084781285917112,0.29325265364072745,0.7067473463592725,0.023730647015076736
9229,23.0,266,9645,9911,6,210,12701,3704,8997,12701,1010,0.020943232816313676,0.7593890244862609,0.0004724037477363987,0.29163058026927013,0.7083694197307299,0.016534131170773955
9230,26.0,47,2003,2050,6,96,2691,773,1918,2691,212,0.017465626161278336,0.7443329617242661,0.002229654403567447,0.28725380899293945,0.7127461910070606,0.03567447045707915
9231,26.0,129,22746,22875,126,1087,31481,8909,22572,31481,2814,0.004097709729678219,0.7225310504748896,0.0040024141545694225,0.2829960928814205,0.7170039071185794,0.034528763381087006
9232,15.0,2433,24383,26816,187,2048,36223,9822,26401,36223,2047,0.06716726941446043,0.6731358529111338,0.00516246583662314,0.27115368688402397,0.728846313115976,0.056538663280236316
9233,,2216,32279,36687,486,5279,48963,10004,38959,48963,1051,0.04525866470600249,0.6592529052549885,0.009925862385883218,0.20431754590200762,0.7956824540979923,0.10781610603925414
9234,,200,5628,5828,6,215,7778,2216,5562,7778,683,0.025713551041398816,0.7235793263049627,0.0007714065312419646,0.2849061455386989,0.7150938544613011,0.02764206736950373
9235,,308,4904,5212,20,337,7058,2026,5032,7058,442,0.04363842448285633,0.6948143950127514,0.0028336639274582033,0.287050155851516,0.712949844148484,0.04774723717767073
9236,25.0,104,2167,2271,5,104,3018,853,2165,3018,239,0.03445990722332671,0.718025182239894,0.0016567263088137839,0.28263750828363154,0.7173624917163685,0.03445990722332671
9237,45.0,1937,39329,41266,136,1040,52732,15771,36961,52732,3637,0.03673291360084958,0.7458279602518395,0.002579079117044679,0.29907835849199726,0.7009216415080027,0.019722369718576955
9238,,85,7401,7486,12,1853,10465,1604,8861,10465,487,0.008122312470138558,0.707214524605829,0.0011466794075489727,0.15327281414237937,0.8467271858576206,0.17706641184902056
9239,,765,12955,13720,8,536,18525,5489,13036,18525,1401,0.04129554655870445,0.6993252361673414,0.0004318488529014845,0.296302294197031,0.703697705802969,0.02893387314439946
9240,,2359,63255,65614,223,6155,88137,22386,65758,88144,5891,0.026763024142312578,0.717632510437466,0.002529950989290252,0.2539707750952986,0.7460292249047014,0.06982891631875114
9241,,1349,35692,37041,338,2582,49984,13874,36110,49984,3510,0.026988636363636364,0.7140685019206146,0.006762163892445583,0.2775688220230474,0.7224311779769527,0.05165653008962868
9242,24.0,1001,30420,31421,16,1701,41194,12069,29125,41194,3092,0.02429965528960528,0.7384570568529397,0.0003884060785551294,0.29297956013011606,0.7070204398698839,0.04129242122639219
9243,,211,5292,5503,30,279,7658,2043,5615,7658,527,0.027552885870984593,0.6910420475319927,0.003917471924784539,0.2667798380778271,0.7332201619221729,0.03643248890049621
9244,,108,2005,2113,15,175,2905,752,2153,2905,199,0.03717728055077452,0.6901893287435457,0.0051635111876075735,0.25886402753872634,0.7411359724612737,0.060240963855421686
9245,,703,13613,14316,79,733,19694,5441,14253,19694,1276,0.03569615111201381,0.6912257540367625,0.004011374022544937,0.2762770386919874,0.7237229613080126,0.03721945770285366
9246,17.0,821,19406,20227,94,1421,27583,7625,19958,27583,1912,0.029764710147554652,0.703549287604684,0.003407896167929522,0.27643838596236814,0.7235616140376319,0.05151723887901968
9247,17.0,207,3256,3463,17,391,4861,1296,3565,4861,281,0.042583830487554,0.6698210244805596,0.003497222793663855,0.2666118082699033,0.7333881917300967,0.08043612425426867
9248,27.0,645,17504,18149,46,1021,23913,6872,17041,23913,1610,0.026972776314138754,0.731986785430519,0.0019236398611633839,0.287375067954669,0.712624932045331,0.042696441266256845
9249,14.0,55,1801,1856,7,86,2467,688,1779,2467,199,0.02229428455614106,0.7300364815565464,0.002837454398054317,0.27888123226591,0.72111876773409,0.03486015403323875
9250,16.0,1278,21490,22768,171,1627,31252,8716,22536,31252,2002,0.040893382823499295,0.6876359912965571,0.005471649814411878,0.2788941507743504,0.7211058492256496,0.0520606681172405
9251,34.0,479,9715,10194,110,773,14591,3795,10796,14591,984,0.03282845589747104,0.6658213967514222,0.007538893838667672,0.2600918374340347,0.7399081625659654,0.05297786306627373
9252,23.0,721,10968,11689,62,874,15840,4455,11385,15840,1043,0.04551767676767677,0.6924242424242424,0.003914141414141414,0.28125,0.71875,0.05517676767676768
9253,,154,3517,3671,17,193,4941,1440,3501,4941,342,0.031167779801659582,0.711799230924914,0.0034405990690143697,0.29143897996357016,0.7085610200364298,0.03906091884233961
9254,23.0,193,5643,5836,8,276,7748,2193,5555,7748,603,0.024909654104284976,0.7283169850283944,0.0010325245224574084,0.2830407847186371,0.716959215281363,0.035622096024780586
9255,,421,6680,7101,37,679,9843,2601,7242,9843,628,0.04277151275017779,0.6786548816417759,0.0037590165599918723,0.26424870466321243,0.7357512953367875,0.06898303362795896
9256,17.0,4201,92281,96482,345,5686,130518,36532,93986,130518,9275,0.032187131276911994,0.7070365773303299,0.002643313565944927,0.2799000904089857,0.7200999095910142,0.043564872278153206
9257,27.0,1150,16348,17498,46,1232,23655,6564,17091,23655,1654,0.04861551469034031,0.6911012470936377,0.0019446205876136123,0.2774889029803424,0.7225110970196575,0.052082012259564575
9258,24.0,0,1508,1508,1,72,2039,606,1433,2039,223,0.0,0.7395782246199117,0.0004904364884747426,0.297204512015694,0.702795487984306,0.03531142717018146
9259,27.0,116,3203,3319,7,147,4306,1309,2997,4306,334,0.02693915466790525,0.7438457965629355,0.001625638643752903,0.30399442638179286,0.6960055736182071,0.03413841151881096
9260,24.0,48,4306,4354,68,173,5566,1652,3914,5566,379,0.008623787279913761,0.7736255839022638,0.01221703197987783,0.296802012217032,0.703197987782968,0.031081566654689183
9261,23.0,858,15316,16174,56,867,21915,6188,15727,21915,1609,0.039151266255989046,0.698882044261921,0.0025553274013232945,0.28236367784622407,0.7176363221537759,0.03956194387405886
9262,24.0,2717,75955,78672,306,2695,102507,30031,72476,102507,7355,0.026505506940989396,0.7409737871559992,0.002985161988937341,0.29296535846332444,0.7070346415366755,0.02629088745158867
9263,,1721,19808,21529,135,502,29164,8327,20837,29164,2310,0.059011109587162255,0.6791935262652585,0.004628994650939514,0.2855232478398025,0.7144767521601975,0.01721300233164175
9264,,954,61157,62111,139,3712,84679,23351,61328,84679,7642,0.011266075414211315,0.7222215661498128,0.001641493168318001,0.27575904297405496,0.724240957025945,0.043836134106449064
9265,,36,1680,1716,2,49,2226,679,1547,2226,158,0.016172506738544475,0.7547169811320755,0.0008984725965858042,0.3050314465408805,0.6949685534591195,0.0220125786163522
9266,17.0,102,2972,3074,13,110,4021,1164,2857,4021,310,0.02536682417309127,0.7391196219845809,0.003233026610295946,0.28948022879880625,0.7105197712011937,0.02735637901019647
9267,23.0,153,6158,6311,15,503,8328,2173,6155,8328,580,0.018371757925072046,0.739433237271854,0.0018011527377521613,0.26092699327569646,0.7390730067243035,0.060398655139289145
9268,48.0,139,4718,4857,54,222,6219,1878,4341,6219,452,0.02235086026692394,0.7586428686283968,0.008683068017366137,0.30197780993728895,0.698022190062711,0.03569705740472745
9269,26.0,1110,72307,73417,61,2253,91786,28472,63314,91786,6904,0.012093347569346088,0.7877780925195563,0.0006645893709280282,0.3101998126075872,0.6898001873924128,0.024546227093456517
9270,,4368,111951,116319,484,5720,153844,44410,109434,153844,11023,0.02839239749356491,0.7276916876836276,0.003146044044616625,0.2886690413665791,0.7113309586334209,0.03718052052728738
9271,,1463,53321,54784,236,1772,71480,21123,50357,71480,5782,0.020467263570229436,0.7459569110240627,0.0033016228315612757,0.2955092333519866,0.7044907666480135,0.024790151091214324
9272,25.0,103,2264,2367,9,114,3150,933,2217,3150,221,0.0326984126984127,0.7187301587301588,0.002857142857142857,0.29619047619047617,0.7038095238095238,0.03619047619047619
9273,26.0,628,12960,13588,72,691,17690,5180,12511,17691,1088,0.035498275959527446,0.732575886043751,0.004069866033576394,0.2928042507489684,0.7071957492510316,0.03905940873890679
9274,26.0,722,16626,17348,89,1129,24888,6719,18169,24888,1803,0.029009964641594343,0.6680327868852459,0.0035760205721632916,0.2699694631951141,0.7300305368048859,0.04536322725811636
9275,23.0,224,6783,7007,4,281,8808,2686,6122,8808,552,0.025431425976385105,0.7700953678474114,0.00045413260672116256,0.30495004541326065,0.6950499545867393,0.03190281562216167
9276,23.0,272,8309,8581,47,295,11050,3292,7758,11050,778,0.024615384615384615,0.7519457013574661,0.004253393665158371,0.2979185520361991,0.7020814479638009,0.02669683257918552
9277,,3726,63533,67259,528,4015,92284,25510,66774,92284,6444,0.04037536300983919,0.6884508690563912,0.005721468510250964,0.27642928351610246,0.7235707164838975,0.04350700013003338
9278,24.0,1057,15385,16442,182,885,24045,6050,17995,24045,1601,0.04395924308588064,0.6398419629860678,0.007569141193595342,0.2516115616552298,0.7483884383447702,0.036805988771054274
9279,16.0,90,3135,3225,10,87,4256,1218,3038,4256,347,0.021146616541353382,0.7366071428571429,0.002349624060150376,0.28618421052631576,0.7138157894736842,0.02044172932330827
9280,,68,1764,1832,0,72,2448,700,1748,2448,207,0.027777777777777776,0.7205882352941176,0.0,0.28594771241830064,0.7140522875816994,0.029411764705882353
9281,26.0,109,3134,3243,13,133,4247,1247,3000,4247,332,0.025665175417942075,0.7379326583470686,0.0030609842241582294,0.29361902519425476,0.7063809748057452,0.03131622321638804
9282,14.0,346,1917,2263,56,167,3441,837,2604,3441,157,0.1005521650682941,0.5571054925893636,0.016274338854984017,0.24324324324324326,0.7567567567567568,0.04853240337111305
9283,17.0,282,19028,19310,51,1646,27374,7433,19941,27374,2055,0.01030174618250895,0.695112150215533,0.0018630817564111932,0.2715350332432235,0.7284649667567765,0.060130050412800465
9284,16.0,13206,292748,305954,1227,20519,422948,117949,304999,422948,29032,0.03122369653006989,0.6921607384359306,0.002901065852066921,0.2788735258235055,0.7211264741764946,0.04851423815693655
9285,27.0,478,10841,11319,18,369,14848,4333,10515,14848,1101,0.03219288793103448,0.7301320043103449,0.0012122844827586207,0.29182381465517243,0.7081761853448276,0.024851831896551723
9286,,152,3705,3857,4,186,5201,1447,3754,5201,395,0.029225149009805808,0.7123630071140166,0.0007690828686791001,0.27821572774466446,0.7217842722553355,0.03576235339357816
9287,25.0,419,13813,14232,19,778,18590,5440,13150,18590,1519,0.022538999462076385,0.7430338891877354,0.0010220548682087144,0.2926304464766003,0.7073695535233997,0.04185045723507262
9288,15.0,839,29408,30247,80,1437,40481,11403,29078,40481,3480,0.02072577258466935,0.7264642671870755,0.001976235764926756,0.28168770534324744,0.7183122946567525,0.03549813492749685
9289,42.0,4839,111061,115900,990,4624,146439,43949,102491,146440,7737,0.03304425020486206,0.7584061731767276,0.006760447965036875,0.3001160885004097,0.6998839114995903,0.03157607211144496
9290,24.0,308,9129,9437,7,461,12335,3513,8822,12335,937,0.02496959870287799,0.7400891771382245,0.0005674908796108633,0.2847993514389947,0.7152006485610053,0.03737332792865829
9291,13.0,351,14582,14933,51,1136,20999,5585,15414,20999,1606,0.01671508167055574,0.6944140197152245,0.002428687080337159,0.26596504595456927,0.7340349540454307,0.0540978141816277
9292,23.0,257,3416,3673,21,173,4793,1383,3412,4795,281,0.05359749739311783,0.7124087591240876,0.004379562043795621,0.2884254431699687,0.7115745568300312,0.03607924921793535
9293,16.0,2192,96316,98508,257,6937,132277,37053,95224,132277,10159,0.01657128601344149,0.728138678681857,0.001942892566356963,0.2801167247518465,0.7198832752481535,0.05244297950512939
9294,17.0,2396,47726,50122,220,3025,67081,19042,48039,67081,5104,0.035718012551989385,0.7114682249817385,0.003279617179231079,0.2838657742132646,0.7161342257867355,0.04509473621442733
9295,,207,4750,4957,20,272,6535,1894,4641,6535,432,0.03167559296097934,0.7268553940321346,0.00306044376434583,0.2898240244835501,0.7101759755164498,0.04162203519510329
9296,27.0,8399,213017,221416,1008,11019,299452,83752,215700,299452,21311,0.028047900832186796,0.7113560771008375,0.003366148831866209,0.27968422318101066,0.7203157768189894,0.03679721624834698
9297,,94,1882,1976,5,114,2666,733,1933,2666,151,0.035258814703675916,0.705926481620405,0.0018754688672168042,0.27494373593398347,0.7250562640660165,0.04276069017254314
9298,,147,2291,2438,15,303,3333,833,2500,3333,185,0.04410441044104411,0.6873687368736874,0.004500450045004501,0.24992499249924993,0.7500750075007501,0.09090909090909091
9299,43.0,980,28303,29283,78,1078,37517,11351,26166,37517,2805,0.026121491590478982,0.7544046698829864,0.002079057493936082,0.30255617453421113,0.6974438254657889,0.028733640749526883
9300,15.0,71,1835,1906,26,215,2928,704,2224,2928,139,0.02424863387978142,0.6267076502732241,0.008879781420765027,0.24043715846994534,0.7595628415300546,0.07342896174863388
9301,26.0,734,14948,15682,124,888,20963,5974,14989,20963,1583,0.035014072413299624,0.7130658779754806,0.005915183895434814,0.2849782950913514,0.7150217049086486,0.04236034918666221
9302,45.0,473,5980,6453,5,333,9383,2389,6994,9383,505,0.05041031652989449,0.637322817862091,0.0005328786102525844,0.25460939997868487,0.7453906000213152,0.035489715442822124
9303,24.0,78,3516,3594,32,97,4726,1445,3281,4726,228,0.016504443504020312,0.7439695302581464,0.006771053745239103,0.3057553956834532,0.6942446043165468,0.02052475666525603
9304,16.0,805,11775,12580,111,790,17249,4765,12484,17249,1229,0.046669372137515215,0.6826482694648965,0.006435155661197751,0.2762478984288944,0.7237521015711056,0.04579975650762363
9305,43.0,120,4479,4599,17,146,5969,1737,4232,5969,428,0.020103869994974034,0.7503769475624058,0.002848048249287988,0.2910035181772491,0.7089964818227509,0.024459708493885072
9306,24.0,1944,39645,41589,221,2167,54961,15830,39131,54961,3726,0.03537053547060643,0.7213296701297284,0.004021033096195484,0.2880224158949073,0.7119775841050927,0.03942795800658649
9307,23.0,1860,43048,44908,536,2205,60026,17108,42918,60026,4891,0.030986572485256388,0.7171558991103855,0.00892946389897711,0.2850098290740679,0.7149901709259321,0.036734081897844266
9308,33.0,342,7889,8231,50,263,10842,3147,7695,10842,859,0.03154399557277255,0.7276332779929903,0.004611695259177273,0.2902600996126176,0.7097399003873824,0.02425751706327246
9309,25.0,105,3613,3718,3,152,4771,1401,3370,4771,359,0.02200796478725634,0.7572835883462586,0.0006287989939216097,0.29364913016139177,0.7063508698386083,0.031859149025361556
9310,,78,3223,3301,7,109,4317,1269,3048,4317,366,0.018068102849200834,0.7465832754227473,0.0016214964095436647,0.2939541348158443,0.7060458651841557,0.02524901552003706
9311,,1192,37624,38816,91,1754,51916,14701,37215,51916,4075,0.022960166422682796,0.7247091455427999,0.0017528314970336697,0.2831689652515602,0.7168310347484398,0.03378534555820942
9312,23.0,168,2272,2440,12,147,3283,945,2338,3283,254,0.0511727078891258,0.6920499543100822,0.003655193420651843,0.2878464818763326,0.7121535181236673,0.04477611940298507
9313,15.0,133,5173,5306,9,125,7094,2038,5056,7094,652,0.01874823794756132,0.7292077812235692,0.001268677755850014,0.287285029602481,0.7127149703975191,0.017620524386805753
9314,26.0,213,2609,2822,38,105,3923,1087,2836,3923,233,0.054295182258475655,0.6650522559265868,0.009686464440479225,0.27708386438949784,0.7229161356105022,0.026765230690797857
9315,,6,5719,5725,6,445,7792,2100,5692,7792,560,0.0007700205338809035,0.7339579055441479,0.0007700205338809035,0.2695071868583162,0.7304928131416838,0.05710985626283368
9316,,95,1920,2015,7,108,2804,783,2021,2804,209,0.033880171184022825,0.6847360912981455,0.0024964336661911554,0.27924393723252494,0.7207560627674751,0.03851640513552068
9317,,429,10764,11193,54,441,14731,4200,10531,14731,1129,0.02912225918131831,0.7307039576403502,0.0036657389179281788,0.28511302694996943,0.7148869730500306,0.02993686782974679
9318,,440,8365,8805,34,403,12560,3402,9158,12560,1004,0.03503184713375796,0.6660031847133758,0.0027070063694267514,0.270859872611465,0.7291401273885351,0.0320859872611465
9319,,75,1759,1834,15,192,2640,598,2042,2640,167,0.028409090909090908,0.6662878787878788,0.005681818181818182,0.2265151515151515,0.7734848484848484,0.07272727272727272
9320,16.0,20,6702,6722,10,190,8522,2530,5992,8522,743,0.002346866932644919,0.7864351091293124,0.0011734334663224596,0.29687866697958226,0.7031213330204178,0.02229523586012673
9321,26.0,199,5124,5323,5,301,7097,2011,5086,7097,505,0.02804001690855291,0.7219952092433423,0.0007045230379033394,0.28335916584472315,0.7166408341552769,0.04241228688178104
9322,,1815,36115,37930,176,1640,48846,14364,34482,48846,3211,0.0371575973467633,0.7393645334316014,0.003603160954837653,0.294067067927773,0.705932932072227,0.03357490889735086
9323,17.0,139,2071,2210,48,200,3418,842,2576,3418,165,0.04066705675833821,0.6059098888238736,0.014043300175541252,0.24634289057928613,0.7536571094207138,0.058513750731421885
9324,15.0,155,5233,5388,25,341,7450,2039,5411,7450,562,0.02080536912751678,0.7024161073825503,0.003355704697986577,0.27369127516778524,0.7263087248322148,0.04577181208053691
9325,,612,6222,6834,123,567,9576,2523,7053,9576,549,0.06390977443609022,0.649749373433584,0.012844611528822054,0.26347117794486213,0.7365288220551378,0.05921052631578947
9326,24.0,1111,20003,21114,148,1653,28545,8004,20541,28545,1960,0.03892100192678227,0.7007531967069539,0.005184795936241023,0.28039936941671045,0.7196006305832895,0.05790856542301629
9327,24.0,775,17506,18281,85,802,24553,6873,17680,24553,1733,0.03156437095263308,0.7129882295442512,0.003461898749643628,0.2799250600741254,0.7200749399258747,0.03266403290840223
9328,,2210,75718,77928,110,5097,103433,29788,73645,103433,8187,0.021366488451461333,0.7320487658677598,0.0010634903754121025,0.28799319366159737,0.7120068063384026,0.04927827675886806
9329,,126,3501,3627,37,515,5146,1382,3764,5146,365,0.024485036921881073,0.6803342401865526,0.007190050524679362,0.268558103381267,0.731441896618733,0.10007773027594248
9330,34.0,829,16887,17716,102,944,24178,6698,17480,24178,1880,0.03428736868227314,0.6984448672346761,0.004218711225080652,0.27702870378029615,0.7229712962197039,0.03904375878898172
9331,25.0,191,1868,2059,0,133,2807,783,2024,2807,163,0.06804417527609548,0.6654791592447453,0.0,0.27894549340933383,0.7210545065906662,0.04738154613466334
9332,23.0,556,10871,11427,43,740,15025,4412,10613,15025,944,0.037004991680532444,0.7235274542429284,0.0028618968386023296,0.2936439267886855,0.7063560732113144,0.049251247920133114
9333,23.0,274,7308,7582,26,360,9973,2851,7122,9973,782,0.02747418028677429,0.7327785019552793,0.0026070390053143486,0.2858718540058157,0.7141281459941843,0.03609746315050637
9334,37.0,1904,51252,53156,233,1775,68755,20597,48158,68755,5561,0.02769253145225802,0.745429423314668,0.003388844447676533,0.2995709402952513,0.7004290597047488,0.02581630426878045
9335,17.0,458,5731,6189,15,504,10671,2163,8508,10671,407,0.04292006372411208,0.5370630681285727,0.0014056789429294349,0.20269890357042453,0.7973010964295755,0.04723081248242901
9336,,1679,40219,41898,199,1891,55403,15904,39499,55403,4308,0.030305218128982184,0.7259354186596394,0.0035918632565023556,0.28706026749454,0.7129397325054599,0.03413172571882389
9337,,7625,573136,580761,3243,30562,779152,218911,560241,779152,64838,0.009786280469022732,0.735589461363123,0.0041622173850545206,0.2809605827874407,0.7190394172125593,0.039224695566462
9338,,2157,40540,42697,507,1632,54080,16441,37639,54080,3406,0.039885355029585796,0.7496301775147929,0.009375,0.30401257396449705,0.695987426035503,0.03017751479289941
9339,15.0,1832,21773,23605,163,1799,32458,8781,23677,32458,2051,0.05644217142152936,0.670805348450305,0.005021874422330396,0.2705342288495902,0.7294657711504098,0.05542547291884897
9340,16.0,1287,21925,23212,86,1303,30357,8952,21405,30357,1771,0.042395493625852355,0.7222386928879665,0.002832954508021214,0.29489079948611524,0.7051092005138848,0.04292255492967026
9341,17.0,1847,40851,42698,141,1872,57556,16143,41415,57558,3917,0.0320893707217068,0.7097362660273115,0.002449702908370687,0.28046492233920567,0.7195350776607943,0.03252371520900657
9342,14.0,25,2502,2527,6,102,3321,966,2355,3321,274,0.007527853056308341,0.7533875338753387,0.0018066847335140017,0.2908762420957543,0.7091237579042458,0.03071364046973803
9343,,733,16402,17135,226,831,23029,6555,16474,23029,1679,0.031829432454730994,0.71223240262278,0.009813713144296321,0.2846411046940814,0.7153588953059187,0.0360849363845586
9344,,62,7631,7693,61,706,10542,2901,7641,10542,808,0.005881236956934168,0.7238664390058812,0.0057863782963384555,0.27518497438816164,0.7248150256118384,0.06697021438057295
9345,24.0,1708,32110,33818,129,3385,46016,12333,33683,46016,3296,0.03711752433936022,0.6978007649513213,0.002803372739916551,0.26801547287899863,0.7319845271210014,0.07356136995827538
9346,27.0,9587,112977,122564,798,6839,169212,47385,121827,169212,12660,0.056656738292792476,0.6676654138004396,0.0047159775902418264,0.2800333309694348,0.7199666690305652,0.04041675531286197
9347,,436,14821,15257,82,1751,21475,5762,15713,21475,1223,0.02030267753201397,0.690151338766007,0.003818393480791618,0.2683119906868452,0.7316880093131548,0.08153667054714785
9348,16.0,2701,50041,52742,222,2441,69992,20278,49714,69992,5525,0.038590124585666935,0.7149531375014287,0.0031717910618356384,0.28971882500857243,0.7102811749914276,0.03487541433306664
9349,15.0,248,9353,9842,37,538,13441,3644,9797,13441,938,0.018451008109515662,0.6958559630979838,0.00275277137117774,0.27111078044788334,0.7288892195521166,0.0400267837214493
9350,,640,12746,13386,69,1495,18580,5022,13558,18580,1241,0.03444564047362755,0.6860064585575888,0.003713670613562971,0.27029063509149626,0.7297093649085038,0.08046286329386437
9351,,431,5792,6223,389,1590,9787,2169,7618,9787,48,0.0440380096045775,0.5918054562174313,0.03974660263614999,0.22162051701236335,0.7783794829876367,0.16246040666189843
9352,41.0,163,2588,2751,7,153,3800,1055,2745,3800,259,0.04289473684210526,0.6810526315789474,0.0018421052631578947,0.2776315789473684,0.7223684210526315,0.04026315789473684
9353,23.0,794,8956,9750,167,628,13656,3411,10245,13656,643,0.05814294083186877,0.6558289396602226,0.012229056824838899,0.24978031634446396,0.750219683655536,0.045987111892208554
9354,,179,7781,7960,3,243,10665,2899,7766,10665,692,0.016783872480075013,0.7295827473042663,0.00028129395218002813,0.27182372245663383,0.7281762775433661,0.02278481012658228
9355,36.0,312,8887,9199,12,292,12042,3534,8508,12042,951,0.025909317389138018,0.7380003321707358,0.000996512207274539,0.29347284504235177,0.7065271549576483,0.02424846371034712
9356,16.0,136,2081,2217,12,79,3003,835,2168,3003,244,0.04528804528804529,0.6929736929736929,0.003996003996003996,0.2780552780552781,0.7219447219447219,0.026307026307026308
9357,,11147,240493,251640,2429,14331,333939,93930,240009,333939,23447,0.03338034790785143,0.7201704502918198,0.00727378353531633,0.2812789162092478,0.7187210837907522,0.0429150234024777
9358,15.0,651,4253,4904,16,551,7127,1924,5203,7127,324,0.09134278097376175,0.5967447733969412,0.002244983864178476,0.2699593096674618,0.7300406903325383,0.07731163182264628
9359,34.0,1763,34304,36067,231,1842,48662,13810,34852,48662,3451,0.036229501459044015,0.7049443097283301,0.004747030537174798,0.2837943364432206,0.7162056635567794,0.03785294480292631
9360,37.0,307,8984,9291,25,500,12262,3467,8795,12262,850,0.025036698744087423,0.7326700375142717,0.0020388191159680315,0.2827434350024466,0.7172565649975534,0.04077638231936063
9361,42.0,40,2694,2734,7,370,4131,1074,3057,4131,304,0.009682885499878963,0.6521423384168482,0.0016945049624788188,0.2599854756717502,0.7400145243282498,0.08956669087388042
9362,,24654,595553,620207,1715,29069,811394,236324,575070,811394,63652,0.03038474526555533,0.7339874339716587,0.0021136463912723043,0.29125677537669736,0.7087432246233026,0.03582599822034671
9363,,246,4524,4770,20,236,6353,1771,4582,6353,415,0.038721863686447346,0.7121045175507634,0.0031481189988981583,0.27876593735243194,0.7212340626475681,0.03714780418699827
9364,24.0,45,1654,1699,0,50,2187,672,1515,2187,194,0.0205761316872428,0.7562871513488797,0.0,0.30727023319615915,0.6927297668038409,0.022862368541380886
9365,,185,3907,4092,27,284,5682,1548,4134,5682,391,0.03255895811334037,0.6876099964801127,0.004751847940865892,0.27243928194297784,0.7275607180570222,0.049982400563181976
9366,,1652,71221,72873,110,2520,93355,28061,65294,93355,6583,0.01769589202506561,0.7629050399014514,0.0011782978951314874,0.3005837930480424,0.6994162069519576,0.02699373359755771
9367,,83,2952,3035,14,154,3928,1150,2778,3928,246,0.021130346232179225,0.7515274949083504,0.003564154786150713,0.29276985743380857,0.7072301425661914,0.03920570264765784
9368,,4786,87130,91916,378,5856,122913,34212,88701,122913,9632,0.03893811069618348,0.7088753834012675,0.0030753459764223477,0.27834321837397186,0.7216567816260282,0.047643455126797005
9369,16.0,224,4339,4563,21,469,6231,1680,4551,6231,433,0.035949285828919916,0.6963569250521585,0.003370245546461242,0.2696196437168994,0.7303803562831006,0.07526881720430108
9370,37.0,103,1670,1773,0,150,2471,688,1783,2471,195,0.04168352893565358,0.6758397409955483,0.0,0.2784297855119385,0.7215702144880615,0.060704168352893564
9371,17.0,728,22099,22827,276,2196,31331,8690,22641,31331,1645,0.023235772876703583,0.7053397593437809,0.00880916664006894,0.27736108008043153,0.7226389199195685,0.07009032587533114
9372,,199,2957,3156,26,118,4199,1222,2977,4199,275,0.04739223624672541,0.7042152893546082,0.006191950464396285,0.29102167182662536,0.7089783281733746,0.0281019290307216
9373,13.0,92,1977,2069,11,108,2804,781,2023,2804,219,0.03281027104136947,0.7050641940085592,0.0039229671897289585,0.2785306704707561,0.7214693295292439,0.03851640513552068
9374,16.0,76,3028,3104,11,114,3937,1186,2751,3937,278,0.019304038608077216,0.7691135382270764,0.0027940055880111762,0.301244602489205,0.6987553975107951,0.028956057912115824
9375,36.0,530,20482,21012,27,881,27422,7879,19543,27422,2176,0.019327547224855954,0.7469185325650938,0.0009846108963605864,0.28732404638611336,0.7126759536138867,0.032127488877543575
9376,,80,1820,1900,0,211,2713,734,1979,2713,203,0.029487652045705862,0.6708440840398083,0.0,0.2705492075193513,0.7294507924806487,0.0777736822705492
9377,13.0,1203,18718,19921,158,1967,26992,7622,19370,26992,1455,0.04456876111440427,0.6934647302904564,0.005853586247777119,0.28237996443390634,0.7176200355660937,0.0728734439834025
9378,15.0,277,4645,4922,31,245,6837,1809,5028,6837,489,0.040514845692555215,0.6793915459997075,0.0045341524060260345,0.26458973233874505,0.735410267661255,0.03583443030568963
9379,23.0,110,3643,3753,1,320,5039,1327,3712,5039,408,0.02182972812065886,0.7229609049414566,0.00019845207382417147,0.26334590196467556,0.7366540980353244,0.06350466362373487
9380,24.0,5744,120692,126436,646,8285,172602,47386,125216,172602,12424,0.03327887278247065,0.6992502983742946,0.003742714452903211,0.27453911310413553,0.7254608868958645,0.04800060254226486
9381,16.0,875,16851,17726,19,1453,24424,6515,17909,24424,1663,0.035825417622011135,0.6899361283982968,0.0007779233540779561,0.26674582377988865,0.7332541762201114,0.059490664919751066
9382,38.0,327,6670,6997,56,286,9378,2652,6726,9378,654,0.03486884197056942,0.7112390701642142,0.005971422478140328,0.2827895073576456,0.7172104926423545,0.03049690765621668
9383,33.0,447,11405,11852,47,719,15866,4538,11328,15866,1302,0.028173452666078406,0.7188327240640363,0.0029623093407286022,0.28602042102609354,0.7139795789739065,0.04531703012731628
9384,16.0,4588,52544,59733,297,4615,84481,23470,61011,84481,4301,0.05430806927001337,0.6219623347261515,0.003515583385613333,0.2778139463311277,0.7221860536688723,0.05462766775961459
9385,,14,3079,3093,4,312,4338,1153,3185,4338,364,0.003227293683725219,0.7097740894421393,0.0009220839096357768,0.2657906869525127,0.7342093130474873,0.07192254495159059
9386,,1532,41588,43120,242,1581,56104,16433,39671,56104,4416,0.027306430914016827,0.7412662198773706,0.0043134179381149294,0.2929024668472836,0.7070975331527164,0.028179808926279765
9387,,6750,121411,128161,952,9535,177149,48401,128835,177236,12226,0.03808481346904692,0.6850244871245119,0.005371369247782617,0.27308786025412446,0.7269121397458755,0.05379832539664628
9388,16.0,130,6426,6556,195,654,9370,2460,6910,9370,537,0.013874066168623266,0.6858057630736393,0.0208110992529349,0.26254002134471716,0.7374599786552828,0.06979722518676627
9389,17.0,517,11971,12488,33,835,17025,4730,12295,17025,1297,0.030367107195301026,0.7031424375917767,0.0019383259911894273,0.2778267254038179,0.7221732745961821,0.04904552129221733
9390,,111,3242,3353,20,123,4350,1295,3055,4350,325,0.025517241379310347,0.7452873563218391,0.004597701149425287,0.29770114942528736,0.7022988505747126,0.028275862068965516
9391,,219,1886,2105,25,144,2858,805,2053,2858,213,0.07662701189643108,0.6599020293911827,0.00874737578726382,0.281665500349895,0.718334499650105,0.05038488453463961
9392,14.0,670,681,1351,1,48,1843,520,1323,1843,105,0.36353771025501896,0.36950623982637004,0.0005425935973955507,0.2821486706456864,0.7178513293543136,0.026044492674986434
9393,27.0,291,3932,4223,43,230,5728,1605,4123,5728,329,0.050803072625698324,0.6864525139664804,0.007506983240223464,0.28020251396648044,0.7197974860335196,0.040153631284916204
9394,16.0,140,2781,2921,7,322,4238,1110,3128,4238,246,0.03303445021236432,0.6562057574327513,0.0016517225106182161,0.26191599811231714,0.7380840018876829,0.07597923548843795
9395,13.0,66,1920,1986,21,249,3003,752,2251,3003,189,0.02197802197802198,0.6393606393606394,0.006993006993006993,0.25041625041625043,0.7495837495837496,0.08291708291708291
9396,24.0,197,2562,2759,120,135,3653,1030,2623,3653,203,0.053928278127566384,0.7013413632630714,0.03284971256501506,0.28196003284971255,0.7180399671502874,0.036955926635641935
9397,,1267,8113,9863,851,1488,16645,2912,13834,16746,515,0.07565985907082289,0.48447390421593217,0.050818105816314345,0.17389227278155978,0.8261077272184403,0.08885704048728055
9398,15.0,5882,83415,89297,754,5574,114213,33031,81182,114213,6609,0.05150026704490732,0.7303459325996166,0.006601700331836131,0.2892052568446674,0.7107947431553325,0.04880355125948885
9399,,4646,92450,97096,433,9756,135475,37926,97549,135475,8493,0.034294150212216275,0.682413729470382,0.0031961616534415946,0.2799483299501753,0.7200516700498247,0.07201328658424064
9400,,538,10208,10746,44,774,14453,4102,10351,14453,976,0.037224105721995436,0.7062893516916903,0.0030443506538434927,0.28381650868331837,0.7161834913166817,0.05355289559261053
9401,,651,7625,8276,106,556,11707,3092,8615,11707,720,0.05560775604339284,0.6513197232425045,0.00905441189032203,0.2641154864610917,0.7358845135389084,0.04749295293414196
9402,17.0,950,42246,43196,323,3774,60093,16187,43906,60093,3702,0.015808829647379896,0.7030103339823274,0.005375002080109164,0.26936581631804035,0.7306341836819596,0.06280265588338076
9403,33.0,886,15234,16120,66,1290,22196,6103,16093,22196,1444,0.03991710218057307,0.6863398810596504,0.00297350874031357,0.2749594521535412,0.7250405478464588,0.05811857992431069
9404,27.0,8,1830,1838,4,95,2397,718,1679,2397,207,0.003337505214851898,0.7634543178973717,0.001668752607425949,0.29954109303295784,0.7004589069670422,0.03963287442636629
9405,25.0,121,2263,2384,10,122,3172,915,2257,3172,231,0.03814627994955864,0.7134300126103404,0.0031525851197982345,0.28846153846153844,0.7115384615384616,0.038461538461538464
9406,42.0,96,1646,1742,27,137,2445,637,1808,2445,152,0.0392638036809816,0.6732106339468302,0.011042944785276074,0.26053169734151327,0.7394683026584867,0.05603271983640082
9407,,221,6577,6798,14,311,9006,2579,6427,9006,715,0.024539196091494558,0.7302909171663335,0.001554519209415945,0.2863646457916944,0.7136353542083056,0.034532533866311346
9408,17.0,328,2328,2656,14,790,4214,872,3342,4214,170,0.07783578547698149,0.5524442335073564,0.0033222591362126247,0.20692928334124347,0.7930707166587565,0.1874703369719981
9409,33.0,416,11558,11974,34,721,16239,4437,11802,16239,1167,0.025617340969271506,0.7117433339491348,0.0020937249830654597,0.2732311102900425,0.7267688897099575,0.044399285670299896
9410,23.0,533,21226,21759,80,1238,29330,8193,21137,29330,2240,0.01817251960450051,0.7236958745311968,0.002727582679849983,0.2793385612001364,0.7206614387998637,0.042209341970678486
9411,27.0,492,10392,10884,45,260,14333,4073,10260,14333,1098,0.03432637968324845,0.7250401172120282,0.0031396078978580895,0.28416939928835555,0.7158306007116445,0.018139956743180075
9412,15.0,288,11363,11651,1,330,14960,4545,10415,14960,1214,0.019251336898395723,0.7595588235294117,6.684491978609626e-05,0.3038101604278075,0.6961898395721925,0.022058823529411766
9413,23.0,588,9906,10494,85,539,14200,3920,10280,14200,1008,0.04140845070422535,0.6976056338028169,0.005985915492957746,0.27605633802816903,0.723943661971831,0.03795774647887324
9414,16.0,479,5494,5973,33,341,8572,2331,6241,8572,442,0.055879608026131594,0.6409239384041064,0.003849743350443304,0.2719318712085861,0.7280681287914139,0.03978068128791414
9415,15.0,645,12072,12717,13,834,16635,4951,11684,16635,1162,0.0387736699729486,0.7256988277727683,0.0007814848211602044,0.29762548842801323,0.7023745115719868,0.05013525698827773
9416,,2091,44146,46237,313,2890,60987,17494,43493,60987,4469,0.03428599537606375,0.7238591831045961,0.00513224129732566,0.28684801679046357,0.7131519832095364,0.04738714808073852
9417,24.0,113,3788,3901,3,108,5078,1513,3565,5078,477,0.022252855454903506,0.7459629775502166,0.0005907837731390311,0.2979519495864514,0.7020480504135487,0.02126821583300512
9418,,144,2608,2752,2,292,3819,1052,2767,3819,256,0.037706205813040065,0.6829012830583923,0.0005236973029588898,0.27546478135637603,0.724535218643624,0.0764598062319979
9419,,2747,64306,67053,327,3420,87307,25896,61411,87307,5730,0.031463685615128224,0.7365503338792995,0.003745404148579152,0.2966085193627086,0.7033914806372914,0.03917211678330489
9420,23.0,58,1894,1952,3,68,2578,753,1825,2578,270,0.022498060512024826,0.734678044996121,0.0011636927851047323,0.2920868890612878,0.7079131109387122,0.026377036462373934
9421,,117,1807,1924,57,146,2750,732,2018,2750,140,0.042545454545454546,0.6570909090909091,0.020727272727272726,0.2661818181818182,0.7338181818181818,0.05309090909090909
9422,,796,19215,20011,78,716,26365,7542,18823,26365,2157,0.03019154181680258,0.7288071306656553,0.0029584676654655796,0.286061065806941,0.713938934193059,0.02715721600606865
9423,,366,3818,4184,198,409,5883,1638,4245,5883,280,0.062213156552779196,0.6489886112527622,0.033656297807241206,0.27842937276899543,0.7215706272310046,0.06952235254122047
9424,,400,14200,14600,44,434,18727,5654,13073,18727,1381,0.021359534362150906,0.7582634698563572,0.0023495487798365997,0.301917018209003,0.6980829817909969,0.023175094782933732
9425,34.0,3322,33717,37039,741,2111,49763,13847,35916,49763,2698,0.06675642545666459,0.6775515945582059,0.014890581355625666,0.2782589474107268,0.7217410525892731,0.04242107589976488
9426,17.0,168,4472,4640,21,198,6333,1910,4423,6333,566,0.026527711984841308,0.706142428548871,0.0033159639981051635,0.3015948207800411,0.6984051792199589,0.031264803410705824
9427,17.0,79,2235,2314,10,169,3217,870,2347,3217,256,0.02455704072116879,0.6947466583773703,0.003108486167236556,0.27043829654958035,0.7295617034504196,0.05253341622629779
9428,,381,12041,12422,45,508,16141,4683,11458,16141,1334,0.02360448547177994,0.7459884765503996,0.0027879313549346385,0.2901307230035314,0.7098692769964686,0.031472647295706584
9429,,355,6709,7064,32,389,9304,2670,6634,9304,559,0.03815563198624248,0.7210877042132416,0.0034393809114359416,0.28697334479793635,0.7130266552020637,0.04180997420464316
9430,15.0,185,3716,3901,17,376,5591,1498,4093,5591,383,0.03308889286353067,0.6646395993561081,0.003040600965837954,0.26793060275442676,0.7320693972455733,0.0672509390091218
9431,15.0,92,2224,2316,1,230,3236,841,2395,3236,170,0.02843016069221261,0.6872682323856613,0.00030902348578491963,0.2598887515451174,0.7401112484548825,0.07107540173053152
9432,23.0,192,2393,2585,44,220,3989,932,3057,3989,220,0.04813236400100276,0.5998997242416646,0.011030333416896465,0.23364251692153423,0.7663574830784657,0.055151667084482325
9433,14.0,611,15395,16006,51,927,21516,6088,15428,21516,1706,0.02839747164900539,0.7155140360661834,0.002370329057445622,0.28295222160252836,0.7170477783974717,0.043084216397099834
9434,26.0,246,5781,6027,9,213,7811,2272,5539,7811,673,0.03149404685699654,0.7401101011394188,0.0011522212264754833,0.2908718473946998,0.7091281526053003,0.027269235693253104
9435,,5651,123266,128917,768,10898,178718,48916,129802,178718,12236,0.03161964659407558,0.6897234749717432,0.004297272798487002,0.27370494298279974,0.7262950570172003,0.060978748643113735
9436,,239,6264,6503,16,400,8748,2430,6318,8748,645,0.02732053040695016,0.7160493827160493,0.001828989483310471,0.2777777777777778,0.7222222222222222,0.04572473708276177
9437,23.0,10983,211433,222416,2136,13702,303444,84238,219212,303450,19773,0.036193771626297576,0.6967638820233976,0.00703905091448344,0.27760092272202996,0.72239907727797,0.04515406162464986
9438,37.0,1125,25529,26654,250,1536,36150,10074,26076,36150,2613,0.03112033195020747,0.7061964038727524,0.006915629322268326,0.2786721991701245,0.7213278008298755,0.042489626556016596
9439,33.0,1161,32649,33810,75,1761,44699,12903,31796,44699,3685,0.025973735430322827,0.730419025034117,0.0016778898856797692,0.2886641759323475,0.7113358240676525,0.03939685451576098
9440,24.0,1028,24267,25295,104,1646,33783,9431,24352,33783,2464,0.03042950596453838,0.7183198650208685,0.0030784714205369565,0.27916407660657727,0.7208359233934227,0.04872273036734452
9441,16.0,279,8004,8283,0,432,11561,3177,8384,11561,847,0.024132860479197302,0.692327653317187,0.0,0.27480321771473054,0.7251967822852694,0.03736700977424098
9442,14.0,510,7120,7630,17,1001,10877,2654,8223,10877,601,0.04688792865679875,0.6545922588949159,0.001562930955226625,0.24400110324538016,0.7559988967546198,0.09202905212834421
9443,,86,1940,2026,52,142,2697,791,1906,2697,172,0.03188728216536893,0.7193177604746014,0.0192806822395254,0.2932888394512421,0.7067111605487579,0.05265109380793474
9444,17.0,2568,67358,69926,628,2148,92962,26631,66331,92962,7801,0.027624190529463653,0.7245756330543663,0.006755448462812762,0.28647189174071125,0.7135281082592887,0.02310621544286913
9445,16.0,113,4509,4622,13,399,6418,1718,4700,6418,450,0.017606731068868807,0.7025553131816765,0.0020255531318167652,0.26768463695855405,0.732315363041446,0.06216889996883764
9446,,2368,54525,56893,177,3357,75165,21559,53606,75165,5507,0.03150402447947848,0.7254041109558971,0.002354819397325883,0.2868223242200492,0.7131776757799507,0.04466174416284175
9447,,1502,38249,39751,161,2247,53172,14917,38255,53172,3899,0.028247950048897918,0.719344767922967,0.0030279094260136914,0.2805423907319642,0.7194576092680358,0.04225908372827804
9448,37.0,107,1492,1599,13,105,2289,579,1710,2289,141,0.04674530362603757,0.6518130187854958,0.005679335954565312,0.2529488859764089,0.747051114023591,0.045871559633027525
9449,23.0,58,2045,2103,0,110,2778,780,1998,2778,231,0.02087832973362131,0.7361411087113031,0.0,0.28077753779697623,0.7192224622030238,0.03959683225341973
9450,23.0,10359,260757,271116,1115,9867,358305,104759,253546,358305,28178,0.028911123205090636,0.7277514966299661,0.003111873962127238,0.2923738156040245,0.7076261843959755,0.027537991376062294
9451,24.0,397,8789,9186,38,441,12282,3528,8754,12282,943,0.03232372577756066,0.7156000651359713,0.003093958638658199,0.2872496336101612,0.7127503663898388,0.03590620420127015
9452,23.0,284,2460,2744,8,145,3751,1023,2728,3751,221,0.07571314316182351,0.6558251133031192,0.0021327645961077045,0.2727272727272727,0.7272727272727273,0.038656358304452146
9453,,8528,319092,327620,634,7001,414950,123926,291026,414952,33870,0.02055177466309356,0.7689853284235285,0.0015278875628988414,0.29865141028359904,0.7013485897164009,0.016871830958761495
9454,35.0,95,2098,2193,2,87,2909,865,2044,2909,201,0.03265727053970437,0.7212100378136816,0.0006875214850464077,0.2973530422825713,0.7026469577174287,0.029907184599518737
9455,44.0,751,8306,9057,51,356,11772,3482,8290,11772,754,0.06379544682296975,0.7055725450220863,0.004332313965341488,0.2957866123003738,0.7042133876996263,0.030241250424736663
9456,13.0,3900,36613,40513,245,2753,55904,15977,39927,55904,3381,0.06976244991413852,0.6549263022323984,0.004382512879221523,0.28579350314825414,0.7142064968517459,0.04924513451631368
9457,24.0,162,3823,3985,23,172,5265,1487,3778,5265,345,0.03076923076923077,0.7261158594491928,0.004368471035137701,0.28243114909781575,0.7175688509021843,0.03266856600189934
9458,24.0,742,29617,30359,104,909,39015,11578,27437,39015,3101,0.01901832628476227,0.759118287838011,0.0026656414199666793,0.29675765731129056,0.7032423426887094,0.023298731257208764
9459,33.0,590,13605,14195,50,404,18347,5436,12911,18347,1408,0.03215784596936829,0.741538126124162,0.0027252411838447703,0.2962882215076034,0.7037117784923965,0.022019948765465744
9460,,615,12638,13253,79,750,17959,5071,12888,17959,1316,0.03424466841138148,0.7037140152569742,0.004398908625201849,0.28236538782783005,0.71763461217217,0.04176179074558717
9461,14.0,10952,151570,162522,296,10004,219639,61279,158360,219639,13840,0.04986363988180605,0.6900869153474565,0.001347665942751515,0.27899872062793946,0.7210012793720605,0.045547466524615395
9462,45.0,113,2506,2619,44,100,3415,1019,2396,3415,225,0.03308931185944363,0.7338213762811128,0.01288433382137628,0.298389458272328,0.701610541727672,0.029282576866764276
9463,23.0,1947,44509,46456,103,2267,61978,17786,44192,61978,4813,0.031414372841976186,0.7181419213269224,0.0016618800219432702,0.2869727967988641,0.7130272032011359,0.03657749524024654
9464,,95,4822,4917,8,145,6241,1925,4316,6241,489,0.015221919564172409,0.7726325909309405,0.0012818458580355712,0.3084441595898093,0.6915558404101907,0.023233456176894728
9465,,63,1643,1706,25,71,2345,657,1688,2345,206,0.026865671641791045,0.7006396588486141,0.010660980810234541,0.2801705756929638,0.7198294243070362,0.030277185501066096
9466,,14,1552,1566,9,79,2217,584,1633,2217,147,0.006314839873703203,0.7000451059990979,0.0040595399188092015,0.2634190347316193,0.7365809652683807,0.03563373928732522
9467,,485,10594,11079,41,590,14761,4291,10470,14761,1097,0.032856852516767156,0.7177020527064562,0.002777589594200935,0.29069846216381007,0.70930153783619,0.039970191721428086
9468,36.0,3180,66560,69740,405,3547,91508,26364,65144,91508,5486,0.03475106001661057,0.727368098964025,0.004425842549285308,0.28810595794903177,0.7118940420509682,0.03876163832670368
9469,,420,15312,15732,61,1033,21787,6009,15778,21787,1718,0.01927755083306559,0.7028044246569055,0.002799834763850002,0.2758066737045027,0.7241933262954973,0.047413595263230364
9470,23.0,345,8917,9262,22,407,12052,3466,8586,12052,863,0.02862595419847328,0.7398771988051775,0.0018254231662794558,0.2875871224692997,0.7124128775307003,0.03377032857616993
9471,48.0,446,9928,10374,48,553,14631,3898,10733,14631,1060,0.03048322055908687,0.6785592235664001,0.003280705351650605,0.26642061376529286,0.7335793862347071,0.037796459572141346
9472,,449,7912,8361,62,446,11098,3136,7962,11098,754,0.04045774013335736,0.7129212470715445,0.00558659217877095,0.2825734366552532,0.7174265633447467,0.04018742115696522
9473,,322,10528,10850,94,521,14940,4066,10874,14940,1129,0.021552878179384203,0.7046854082998661,0.006291834002677376,0.2721552878179384,0.7278447121820616,0.034872824631860776
9474,,3389,82558,85947,428,4059,113539,32290,81249,113539,7178,0.029848774429931564,0.727133407903892,0.0037696298188287726,0.28439567021023615,0.7156043297897638,0.035749830454733615
9475,,233,4387,4620,15,373,6390,1734,4656,6390,486,0.03646322378716745,0.6865414710485133,0.002347417840375587,0.27136150234741785,0.7286384976525822,0.05837245696400626
9476,25.0,119,2266,2385,16,120,3171,905,2266,3171,220,0.037527593818984545,0.7146010722169662,0.005045726900031536,0.2853989277830337,0.7146010722169662,0.03784295175023652
9477,27.0,273,6582,6855,24,455,8985,2497,6488,8985,576,0.030383973288814693,0.7325542570951586,0.002671118530884808,0.2779076238174736,0.7220923761825264,0.05063995548135782
9478,27.0,446,29867,30313,42,1784,40139,11316,28823,40139,3691,0.011111387926953835,0.7440892897182292,0.0010463638854978949,0.2819203268641471,0.7180796731358529,0.04444555170781534
9479,14.0,1392,33901,35293,204,3107,49253,13421,35832,49253,3483,0.028262237833228433,0.6883032505634175,0.004141879682455891,0.2724910157756888,0.7275089842243112,0.06308245183034536
9480,,76,5060,5136,0,199,6606,1891,4715,6606,527,0.011504692703602786,0.7659703300030275,0.0,0.28625491976990614,0.7137450802300939,0.03012412957917045
9481,16.0,354,4838,5192,19,557,8981,1739,7242,8981,261,0.03941654604164347,0.5386927959024608,0.0021155773299187173,0.19363099877519208,0.8063690012248079,0.06201981961919608
9482,17.0,4,1733,1737,2,47,2228,673,1555,2228,198,0.0017953321364452424,0.7778276481149012,0.0008976660682226212,0.302064631956912,0.697935368043088,0.0210951526032316
9483,,267,8212,8479,12,381,11162,3234,7928,11162,822,0.023920444364809175,0.7357104461566027,0.0010750761512273786,0.28973302275577856,0.7102669772442215,0.03413366780146927
9484,,110,1760,1870,15,128,2507,694,1813,2507,141,0.043877143996808934,0.702034303948943,0.005983246908655764,0.27682489030714,0.72317510969286,0.05105704028719585
9485,23.0,18,5933,5951,36,282,7681,2235,5446,7681,503,0.0023434448639500067,0.7724254654341882,0.004686889727900013,0.29097773727379245,0.7090222627262075,0.036713969535216766
9486,40.0,44,3016,3060,4,237,4206,1165,3041,4206,343,0.010461245839277223,0.7170708511650024,0.0009510223490252021,0.2769852591535901,0.7230147408464099,0.056348074179743225
9487,25.0,759,17099,17858,80,947,24209,6892,17317,24209,1665,0.03135197653765129,0.7063075715642942,0.00330455615680119,0.2846875129084225,0.7153124870915775,0.03911768350613408
9488,14.0,469,7172,7641,20,347,10164,2913,7251,10164,784,0.046143250688705235,0.7056277056277056,0.0019677292404565133,0.28659976387249114,0.7134002361275088,0.0341401023219205
9489,,2235,41511,43746,355,2642,60899,16591,44308,60899,3431,0.0367001100182269,0.681636808486182,0.005829323962626644,0.27243468694067224,0.7275653130593277,0.043383306786646744
9490,23.0,91,8006,8097,49,366,10763,3069,7694,10763,911,0.008454891758803307,0.7438446529777943,0.004552634023971012,0.28514354733810277,0.7148564526618972,0.03400538883211
9491,17.0,894,5711,6605,8,285,8880,2551,6329,8880,590,0.10067567567567567,0.6431306306306306,0.0009009009009009009,0.28727477477477475,0.7127252252252252,0.03209459459459459
9492,23.0,125,3324,3449,12,159,4669,1348,3321,4669,370,0.02677232812165346,0.7119297494110087,0.002570143499678732,0.2887127864639109,0.7112872135360891,0.0340544013707432
9493,38.0,952,22162,23114,95,999,30275,8706,21569,30275,2312,0.03144508670520231,0.7320231213872832,0.003137902559867878,0.28756399669694466,0.7124360033030553,0.03299752270850537
9494,17.0,2058,29611,31669,122,1779,43348,12129,31219,43348,3262,0.04747623881147919,0.6830995663006367,0.0028144320383870075,0.27980529666881976,0.7201947033311802,0.04103995570729907
9495,17.0,8973,112155,121128,2331,6769,164334,45960,118375,164335,8967,0.054601880305473575,0.6824778653360514,0.014184440320077889,0.2796726199531445,0.7203273800468555,0.041190251620166124
9496,27.0,105,2015,2120,50,165,3094,815,2279,3094,188,0.033936651583710405,0.6512605042016807,0.01616031027795734,0.2634130575307046,0.7365869424692955,0.05332902391725921
9497,23.0,123,2606,2729,0,128,3710,1056,2654,3710,235,0.03315363881401617,0.7024258760107817,0.0,0.2846361185983827,0.7153638814016172,0.03450134770889488
9498,,256,5857,6113,13,288,8217,2323,5894,8217,555,0.03115492272118778,0.7127905561640502,0.001582085919435317,0.2827065839114032,0.7172934160885968,0.03504928806133625
9499,,624,13388,14012,107,1468,19862,5264,14598,19862,1156,0.03141677575269359,0.6740509515658041,0.005387171483234317,0.26502869801631257,0.7349713019836874,0.07390997885409324
9500,,91,3553,3644,8,156,4668,1397,3271,4668,329,0.019494430162810626,0.761139674378749,0.001713796058269066,0.29927163667523565,0.7007283633247644,0.033419023136246784
9501,15.0,80,1690,1770,2,94,2384,677,1707,2384,179,0.03355704697986577,0.7088926174496645,0.0008389261744966443,0.2839765100671141,0.7160234899328859,0.03942953020134228
9502,13.0,152,2398,2550,14,312,3580,976,2604,3580,160,0.042458100558659215,0.6698324022346369,0.003910614525139665,0.27262569832402234,0.7273743016759776,0.08715083798882682
9503,27.0,464,38570,39034,174,2283,51900,15005,36896,51901,4291,0.008940097493304561,0.7431456041309416,0.00335253655998921,0.2891081096703339,0.710891890329666,0.04398759176123774
9504,,551,6176,6727,206,530,9081,2564,6517,9081,482,0.060676136989318355,0.680101310428367,0.02268472635172338,0.2823477590573725,0.7176522409426275,0.05836361634181258
9505,34.0,889,35625,36514,105,2077,48386,14667,33719,48386,3242,0.01837308312321746,0.7362666887116108,0.0021700491877815896,0.3031248708304055,0.6968751291695945,0.04292563964783202
9506,16.0,450,7613,8063,24,575,10878,2996,7889,10885,690,0.04134129536058796,0.6994028479559026,0.0022048690858980247,0.2752411575562701,0.7247588424437299,0.05282498851630684
9507,23.0,807,20154,20961,55,2133,28618,8050,20568,28618,1978,0.02819903557201761,0.7042420854007967,0.0019218673562093787,0.2812914948633727,0.7187085051366273,0.07453351037808373
9508,15.0,79,4078,4157,13,177,5722,1636,4086,5722,500,0.013806361412093673,0.7126878713736455,0.002271932890597693,0.2859140160782943,0.7140859839217057,0.03093324012583013
9509,42.0,114,3434,3548,10,172,4802,1339,3463,4802,369,0.023740108288213244,0.7151187005414411,0.0020824656393169513,0.27884214910453975,0.7211578508954603,0.03581840899625156
9510,26.0,162,5541,5703,17,273,7454,1971,5483,7454,339,0.021733297558357928,0.7433592701905017,0.002280654682049906,0.26442178696002144,0.7355782130399785,0.03662463107056614
9511,17.0,1031,20933,21964,59,1514,30121,8529,21592,30121,2107,0.03422861126788619,0.6949636466252781,0.0019587663092194814,0.2831579296836094,0.7168420703163906,0.050263935460310084
9512,15.0,160,3553,3713,17,192,4974,1434,3540,4974,375,0.03216726980297547,0.7143144350623241,0.003417772416566144,0.2882991556091677,0.7117008443908324,0.038600723763570564
9513,,19,4680,4699,17,389,6306,1775,4531,6306,430,0.0030130034887408817,0.7421503330161751,0.0026958452267681573,0.2814779575007929,0.7185220424992071,0.06168728195369489
9514,16.0,55,1881,1936,0,109,2548,734,1814,2548,188,0.021585557299843013,0.7382260596546311,0.0,0.2880690737833595,0.7119309262166404,0.04277864992150707
9515,23.0,121,2166,2287,11,114,3893,871,3022,3893,152,0.03108142820446956,0.5563832519907527,0.0028255843822245054,0.22373490881068583,0.7762650911893142,0.029283329052144876
9516,24.0,2084,36036,38120,500,2069,52170,14523,37647,52170,3677,0.039946329308031436,0.6907418056354226,0.009584052137243627,0.27837837837837837,0.7216216216216216,0.03965880774391413
9517,,713,7368,8081,179,540,11049,3055,7994,11049,618,0.06453072676260295,0.6668476785229432,0.016200561136754457,0.2764956104624853,0.7235043895375147,0.04887320119467825
9518,24.0,2639,81011,83650,165,3756,108263,31951,76312,108263,7843,0.024375825535963347,0.7482796523281269,0.0015240663938741767,0.29512391121620496,0.704876088783795,0.03469329318419035
9519,,692,17230,17922,54,784,23812,6909,16903,23812,2088,0.029060977658323533,0.7235847471862926,0.002267764152528137,0.2901478246262389,0.7098521753737611,0.032924575844112215
9520,,473,15162,15635,33,659,20769,6067,14702,20769,1573,0.022774327122153208,0.7300303336703741,0.0015889065434060378,0.2921180605710434,0.7078819394289566,0.03172998218498724
9521,24.0,869,9328,10197,26,947,16357,3425,12932,16357,684,0.0531271015467384,0.570275722932078,0.0015895335330439568,0.20939047502598276,0.7906095249740173,0.05789570214587027
9522,13.0,552,8456,9008,88,784,12931,3299,9632,12931,711,0.042688113834970225,0.6539324104864279,0.0068053514809372825,0.25512334699559197,0.744876653004408,0.0606294950119867
9523,45.0,1405,35895,37300,82,1484,48562,14229,34333,48562,3577,0.028932086816852682,0.739158189530909,0.001688563074008484,0.2930068778056917,0.7069931221943083,0.030558873193031588
9524,26.0,30,2576,2606,16,130,3447,982,2465,3447,293,0.008703220191470844,0.7473165071076299,0.004641717435451117,0.2848854076008123,0.7151145923991877,0.037713954163040325
9525,,135,1623,1758,8,234,2475,604,1871,2475,114,0.05454545454545454,0.6557575757575758,0.0032323232323232323,0.24404040404040403,0.7559595959595959,0.09454545454545454
9526,24.0,105,3552,3657,20,152,4821,1348,3473,4821,445,0.021779713752333542,0.7367766023646546,0.004148516905206389,0.2796100394109106,0.7203899605890894,0.03152872847956856
9527,,36,2890,2926,6,224,3882,1069,2813,3882,294,0.00927357032457496,0.7444616177228233,0.0015455950540958269,0.2753735188047398,0.7246264811952602,0.05770221535291087
9528,16.0,22,1533,1555,2,126,2120,589,1531,2120,168,0.010377358490566037,0.7231132075471698,0.0009433962264150943,0.2778301886792453,0.7221698113207548,0.059433962264150944
9529,27.0,377,8096,8473,105,261,10933,3242,7691,10933,670,0.034482758620689655,0.7405103814140676,0.009603951339979877,0.29653343089728346,0.7034665691027165,0.023872679045092837
9530,14.0,326,12902,13228,54,498,17669,4935,12734,17669,1605,0.018450393344275284,0.7302054445639256,0.003056200124511857,0.2793027336012225,0.7206972663987775,0.02818495670383157
9531,15.0,133,1920,2053,94,179,3008,763,2245,3008,168,0.0442154255319149,0.6382978723404256,0.03125,0.253656914893617,0.746343085106383,0.059507978723404256
9532,,1481,48925,50406,500,4162,67519,18416,49103,67519,3488,0.021934566566447964,0.7246108502791807,0.007405322946133681,0.27275285475199573,0.7272471452480043,0.06164190820361676
9533,,22,2721,2743,9,357,4069,1024,3045,4069,221,0.005406733841238634,0.6687146719095601,0.0022118456623248955,0.25165888424674365,0.7483411157532563,0.08773654460555419
9534,23.0,172,4633,4805,14,248,6761,1783,4978,6761,493,0.025440023665138294,0.6852536607010797,0.0020706996006507913,0.2637183848543115,0.7362816151456885,0.03668096435438545
9535,15.0,1153,19321,20474,160,1105,27660,7740,19920,27660,1855,0.04168474331164136,0.6985177151120752,0.005784526391901663,0.279826464208243,0.720173535791757,0.03994938539407086
9536,26.0,283,11880,12163,4,1147,16768,4081,12687,16768,1118,0.016877385496183207,0.7084923664122137,0.00023854961832061068,0.24338024809160305,0.7566197519083969,0.06840410305343511
9537,34.0,1121,14071,15192,168,1109,22340,5403,16937,22340,940,0.05017905102954342,0.6298567591763653,0.0075201432408236344,0.2418531781557744,0.7581468218442255,0.04964189794091316
9538,17.0,3809,100536,104345,1080,5049,138802,39978,98824,138802,11095,0.027441967694989987,0.7243123297935188,0.007780867710839901,0.28802178642959037,0.7119782135704097,0.03637555654817654
9539,35.0,2087,63156,65243,226,2645,86618,25567,61051,86618,7592,0.0240942991064213,0.729132512872613,0.002609157449952666,0.2951695952342469,0.7048304047657531,0.030536378120021242
9540,16.0,2434,38149,40583,187,3238,56657,15439,41218,56657,4006,0.04296026969306529,0.6733325096634132,0.003300563037223997,0.27249942637273417,0.7275005736272658,0.0571509257461567
9541,15.0,2290,36602,38892,75,906,49359,14501,34858,49359,3585,0.04639478109362021,0.7415466277679855,0.0015194797301404,0.29378634089021255,0.7062136591097875,0.018355315140096033
9542,15.0,851,20517,21368,295,1504,29647,8234,21413,29647,1515,0.028704422032583398,0.692043039767936,0.009950416568286841,0.27773467804499613,0.7222653219550039,0.05073025938543529
9543,,97,1412,1509,17,127,2139,579,1560,2139,168,0.045348293595137916,0.6601215521271622,0.007947639083683964,0.270687237026648,0.729312762973352,0.05937353903693315
9544,25.0,7575,207286,214861,589,9977,285003,81634,203369,285003,19597,0.026578667592972706,0.7273116423335895,0.0020666449125096927,0.2864320726448494,0.7135679273551506,0.03500664905281699
9545,27.0,94,3100,3194,4,190,4208,1218,2990,4208,343,0.022338403041825095,0.7366920152091255,0.0009505703422053232,0.2894486692015209,0.7105513307984791,0.04515209125475285
9546,26.0,101,2653,2754,10,111,3636,1029,2607,3636,306,0.027777777777777776,0.7296479647964796,0.0027502750275027505,0.283003300330033,0.716996699669967,0.03052805280528053
9547,,911,18890,19801,102,1140,26534,7492,19042,26534,1887,0.03433330820833647,0.7119167860104018,0.003844124519484435,0.28235471470566065,0.7176452852943394,0.042963744629531925
9548,16.0,82,5426,5508,20,145,7333,2082,5251,7333,696,0.011182326469384971,0.7399427246693031,0.002727396699849993,0.2839219964543843,0.7160780035456157,0.01977362607391245
9549,,1664,36781,38445,454,2842,52456,14530,37926,52456,3609,0.03172182400488028,0.701178130242489,0.008654872655177673,0.2769940521579991,0.7230059478420009,0.05417874027756596
9550,,305,5455,5760,217,450,8176,2223,5953,8176,425,0.03730430528375734,0.6671966731898239,0.026541095890410957,0.27189334637964774,0.7281066536203522,0.05503913894324853
9551,,158,5068,5226,43,171,6524,1971,4553,6524,326,0.02421827099938688,0.776824034334764,0.006591048436541999,0.3021152667075414,0.6978847332924586,0.026210913549969343
9552,,1184,26503,27687,88,1487,36751,10573,26178,36751,2863,0.03221681042692716,0.7211504448858534,0.002394492666866208,0.2876928518951865,0.7123071481048134,0.04046148404125058
9553,,81,12776,12857,41,499,16836,4950,11886,16836,1321,0.00481111903064861,0.7588500831551437,0.0024352577809455926,0.2940128296507484,0.7059871703492516,0.02963886909004514
9554,16.0,146,5997,6143,13,304,8187,2304,5883,8187,662,0.01783315011603762,0.7325027482594357,0.001587883229510199,0.2814217662147307,0.7185782337852693,0.037132038597776966
9555,27.0,63,2182,2245,4,76,2908,865,2043,2908,212,0.021664374140302613,0.750343878954608,0.001375515818431912,0.29745529573590096,0.702544704264099,0.026134800550206328
9556,26.0,960,26012,26972,88,1156,35562,10331,25231,35562,2358,0.02699510713683145,0.7314549237950622,0.002474551487542883,0.29050672065688093,0.709493279343119,0.03250660817726787
9557,14.0,364,4300,4664,60,186,5926,1743,4183,5926,305,0.061424232197097535,0.7256159298008775,0.010124873439082012,0.2941275734053324,0.7058724265946675,0.03138710766115423
9558,26.0,421,11603,12024,90,422,15748,4518,11230,15748,1132,0.026733553467106933,0.7367919735839472,0.00571501143002286,0.2868935737871476,0.7131064262128525,0.02679705359410719
9559,,566,12773,13339,167,696,18443,5052,13391,18443,1269,0.030689150355148295,0.6925662853115003,0.009054925988179797,0.2739250664208643,0.7260749335791357,0.0377378951363661
9560,,16,1781,1797,12,83,2433,683,1750,2433,223,0.006576243321002877,0.7320180846691328,0.004932182490752158,0.28072338676531033,0.7192766132346897,0.034114262227702426
9561,,32,7330,7362,7,444,9817,2814,7003,9817,796,0.0032596516247326065,0.7466639502903127,0.0007130487929102577,0.2866456147499236,0.7133543852500764,0.045227666293164916
9562,,674,19137,19811,98,1241,26659,7482,19177,26659,1963,0.025282268652237518,0.7178438801155332,0.0036760568663490754,0.28065568851044675,0.7193443114895532,0.04655088337897145
9563,,63,1564,1627,6,45,2192,588,1604,2192,169,0.02874087591240876,0.7135036496350365,0.002737226277372263,0.26824817518248173,0.7317518248175182,0.02052919708029197
9564,15.0,843,20252,21095,25,1421,28141,7984,20157,28141,2109,0.029956291531928504,0.7196617035641946,0.0008883834973881526,0.2837141537258804,0.7162858462741196,0.05049571799154259
9565,,112,2066,2178,0,80,2846,852,1994,2846,220,0.03935347856640899,0.7259311314125088,0.0,0.29936753338018274,0.7006324666198173,0.028109627547434995
9566,26.0,554,15300,15854,13,867,21322,6021,15301,21322,1630,0.025982553231404183,0.7175687083763249,0.0006096989025419754,0.28238439170809493,0.7176156082919051,0.040662226807991746
9567,24.0,172,5675,5847,10,181,7713,2281,5432,7713,622,0.022300012965123815,0.7357707766109166,0.0012965123816932453,0.2957344742642292,0.7042655257357707,0.02346687410864774
9568,,207,3113,3320,48,186,4458,1308,3150,4458,299,0.046433378196500674,0.6982951996410947,0.010767160161507403,0.2934051144010767,0.7065948855989233,0.04172274562584118
9569,16.0,12191,249232,261423,1233,13029,343937,99779,244160,343939,24964,0.03544523883595638,0.7246401251384693,0.003584938026801264,0.29010667589310896,0.7098933241068911,0.03788171739756178
9570,25.0,280,4607,4887,9,207,6893,1844,5049,6893,512,0.04062091977368345,0.6683592049905701,0.001305672421296968,0.267517771652401,0.732482228347599,0.03003046568983026
9571,17.0,272,9103,9375,46,629,12601,3482,9119,12601,1022,0.02158558844536148,0.7224029838901674,0.003650503928259662,0.2763272756130466,0.7236727243869534,0.04991667327989842
9572,16.0,3894,39291,43185,138,3260,59845,16355,43490,59845,3782,0.0650680925724789,0.6565460773665303,0.0023059570557272956,0.2732893307711588,0.7267106692288412,0.05447405798312307
9573,,381,11016,11397,68,535,14441,4302,10139,14441,921,0.02638321445883249,0.7628280589986843,0.0047088151790042245,0.29790180735406135,0.7020981926459386,0.03704729589363617
9574,,588,23106,23694,98,1261,31258,8999,22259,31258,2767,0.018811184336809776,0.7392027640923924,0.0031351973894682963,0.2878942990594408,0.7121057009405592,0.04034167253183185
9575,,122,3961,4083,5,141,5315,1577,3738,5315,445,0.02295390404515522,0.7452492944496707,0.0009407337723424271,0.2967074317968015,0.7032925682031985,0.026528692380056444
9576,,4891,123926,128817,1380,19317,191501,48284,143217,191501,11784,0.025540336603986403,0.6471297800011488,0.007206228688100846,0.2521344536059864,0.7478655463940136,0.10087153591887249
9577,24.0,2272,54493,56765,65,4242,76151,21881,54270,76151,5335,0.029835458496933722,0.7155913907893527,0.0008535672545337554,0.28733700148389385,0.7126629985161061,0.05570511221126446
9578,,397,12796,13193,25,638,17418,5093,12325,17418,1414,0.022792513491790102,0.73464232403261,0.0014352968193822482,0.2923986680445516,0.7076013319554484,0.03662877483063497
9579,24.0,355,5675,6030,4,294,8235,2460,5775,8235,605,0.04310868245294475,0.6891317547055252,0.0004857316332726169,0.2987249544626594,0.7012750455373407,0.03570127504553734
9580,,61,1509,1570,4,53,2130,600,1530,2130,194,0.02863849765258216,0.7084507042253522,0.0018779342723004694,0.28169014084507044,0.7183098591549296,0.02488262910798122
9581,26.0,2334,53614,55948,341,1815,71817,21523,50294,71817,5494,0.03249926897531225,0.746536335408051,0.0047481794004205135,0.2996922734171575,0.7003077265828425,0.025272567776431765
9582,,1946,25529,27475,73,2521,38039,10430,27609,38039,2368,0.05115802203002182,0.671127001235574,0.00191908304634717,0.2741922763479587,0.7258077236520414,0.06627408712111255
9583,23.0,216,3524,3740,31,167,4998,1396,3602,4998,354,0.04321728691476591,0.7050820328131252,0.006202480992396959,0.279311724689876,0.720688275310124,0.03341336534613846
9584,25.0,14876,280487,295363,1425,14920,391441,113287,278154,391441,26624,0.03800317289195562,0.7165498759710914,0.0036403953597093815,0.2894101537651907,0.7105898462348094,0.038115578082009806
9585,24.0,106,2013,2119,11,215,2990,742,2248,2990,179,0.03545150501672241,0.6732441471571906,0.0036789297658862876,0.24816053511705685,0.7518394648829432,0.07190635451505016
9586,17.0,6562,161741,168303,1479,13328,227896,63998,163898,227896,17781,0.02879383578474392,0.7097140801067153,0.006489802365991505,0.2808210762804086,0.7191789237195914,0.0584828167234177
9587,25.0,2390,47190,49580,258,2838,67019,18672,48347,67019,4478,0.03566152882018532,0.704128679926588,0.0038496545755681223,0.27860755905041856,0.7213924409495814,0.04234620033124935
9588,36.0,185,5764,5949,22,239,7891,2260,5631,7891,690,0.023444430363705488,0.7304524141426942,0.0027879863135217334,0.2864022303890508,0.7135977696109492,0.0302876694968952
9589,27.0,177,6626,6803,15,232,8833,2570,6263,8833,717,0.02003849201856674,0.7501415147741424,0.0016981772897090455,0.2909543756368165,0.7090456243631835,0.026265142080833238
9590,37.0,5051,104090,109141,1417,4497,144434,41741,102693,144434,10247,0.034970990210061344,0.7206751872827728,0.009810709389755874,0.28899705055596325,0.7110029494440367,0.031135328246811693
9591,,933,17563,18496,58,1005,24517,7145,17372,24517,1681,0.0380552269853571,0.7163600766814863,0.002365705428886079,0.2914304360239834,0.7085695639760167,0.040991964759146717
9592,,344,9595,9939,44,395,12844,3774,9070,12844,846,0.02678293366552476,0.7470414201183432,0.003425724073497353,0.29383369666770476,0.7061663033322952,0.030753659296169418
9593,,4045,31492,35537,4566,5782,58707,12803,45904,58707,1639,0.06890149385933535,0.5364266612158687,0.07777607440339313,0.21808302246750813,0.7819169775324919,0.09848910692081013
9594,23.0,173,9244,9417,2,339,11926,3558,8368,11926,855,0.014506121079993292,0.7751131980546705,0.0001677008217340265,0.29833976186483313,0.7016602381351669,0.02842528928391749
9595,25.0,107,2274,2381,14,100,3105,922,2183,3105,238,0.03446054750402577,0.7323671497584541,0.0045088566827697265,0.2969404186795491,0.7030595813204509,0.0322061191626409
9596,,1859,45477,47336,310,2575,65061,17733,47328,65061,4310,0.028573185164691598,0.6989901784479181,0.004764759225957179,0.2725595979158021,0.7274404020841979,0.039578241957547534
9597,,169,3477,3646,10,256,5005,1363,3642,5005,380,0.033766233766233764,0.6947052947052947,0.001998001998001998,0.27232767232767235,0.7276723276723277,0.05114885114885115
9598,,93,2183,2276,3,134,3036,883,2153,3036,213,0.030632411067193676,0.719038208168643,0.0009881422924901185,0.29084321475625824,0.7091567852437418,0.04413702239789196
9599,,834,2837,3671,16,488,5268,1437,3831,5268,149,0.15831435079726652,0.5385345482156416,0.0030372057706909645,0.2727790432801822,0.7272209567198178,0.0926347760060744
9600,27.0,3222,43807,47029,487,4972,67668,17291,50377,67668,3268,0.04761482532363894,0.6473813323875391,0.007196902524088195,0.2555269846899568,0.7444730153100432,0.07347638470177928
9601,,62,3429,3491,15,85,4578,1310,3268,4578,394,0.013543031891655745,0.7490170380078637,0.00327653997378768,0.28615115771079075,0.7138488422892093,0.01856705985146352
9602,35.0,167,1455,1622,12,75,2163,645,1518,2163,181,0.077207582061951,0.6726768377253814,0.005547850208044383,0.29819694868238555,0.7018030513176144,0.03467406380027739
9603,14.0,1833,28394,30227,252,1619,41154,11789,29365,41154,2945,0.04454002041113865,0.6899450843174418,0.006123341594984692,0.2864606113622005,0.7135393886377995,0.039340039850318316
9604,14.0,362,3005,3367,35,334,4633,1258,3375,4633,308,0.07813511763436218,0.6486078135117634,0.0075545003237643,0.27153032592272824,0.7284696740772717,0.07209151737535074
9605,,205,3691,3896,19,294,5242,1513,3729,5242,341,0.03910721098817245,0.7041205646699733,0.0036245707745135446,0.28863029378099964,0.7113697062190004,0.056085463563525374
9606,,566,17259,17825,147,1049,24114,6601,17513,24114,1920,0.023471842083437007,0.7157253048021897,0.0060960437919880565,0.2737413950402256,0.7262586049597745,0.04350170025711205
9607,16.0,195,6097,6292,20,392,8535,2415,6120,8535,682,0.022847100175746926,0.7143526654950205,0.0023432923257176333,0.28295254833040423,0.7170474516695958,0.04592852958406561
9608,24.0,362,8923,9285,35,539,12426,3700,8726,12426,507,0.029132464187992917,0.7180910993079028,0.0028166747143087076,0.2977627555126348,0.7022372444873652,0.0433767906003541
9609,,184,2578,2762,1,186,3703,1073,2630,3703,257,0.049689440993788817,0.6961922765325412,0.00027005130974885227,0.2897650553605185,0.7102349446394814,0.05022954361328653
9610,17.0,474,23369,23843,93,810,31926,9045,22881,31926,2907,0.014846833302010901,0.7319739397356386,0.0029129862807742908,0.28331140763014473,0.7166885923698553,0.025371170832550274
9611,17.0,315,20079,20394,24,1094,27177,7710,19467,27177,2276,0.011590683298377305,0.7388232696765648,0.0008830996798763661,0.2836957721602826,0.7163042278397174,0.04025462707436435
9612,16.0,719,14736,15455,904,1101,23022,5897,17125,23022,1463,0.031230996438189558,0.6400833984884023,0.03926678828946226,0.2561462948484059,0.7438537051515941,0.04782382069324993
9613,17.0,403,9952,10355,43,921,14395,3733,10662,14395,833,0.027995831886071552,0.6913511635984717,0.0029871483153872873,0.259326154914901,0.740673845085099,0.06398054880166724
9614,17.0,95,2424,2519,2,168,3344,936,2408,3344,260,0.028409090909090908,0.7248803827751196,0.0005980861244019139,0.2799043062200957,0.7200956937799043,0.050239234449760764
9615,17.0,139,3989,4128,14,450,5585,1537,4048,5585,378,0.024888093106535364,0.7142345568487019,0.002506714413607878,0.27520143240823636,0.7247985675917636,0.08057296329453895
9616,,2009,38364,40373,100,2259,57432,15443,41989,57432,3775,0.03498049867669592,0.667989970748015,0.001741189580721549,0.2688919069508288,0.7311080930491712,0.03933347262849979
9617,,2308,48144,50452,270,2858,66530,18662,47868,66530,4864,0.03469111678941831,0.723643469111679,0.00405831955508793,0.28050503532241094,0.7194949646775891,0.04295806403126409
9618,,102,8073,8175,93,295,11325,3172,8153,11325,1071,0.009006622516556291,0.7128476821192054,0.008211920529801325,0.28008830022075054,0.7199116997792494,0.026048565121412803
9619,,181,3833,4014,0,260,5184,1524,3660,5184,322,0.034915123456790126,0.7393904320987654,0.0,0.29398148148148145,0.7060185185185185,0.05015432098765432
9620,,153,3934,4087,14,224,5454,1602,3852,5454,476,0.028052805280528052,0.7213054638797213,0.002566923359002567,0.29372937293729373,0.7062706270627063,0.04107077374404107
9621,37.0,1979,36279,38258,660,1739,51296,14379,36917,51296,3460,0.03858000623830318,0.7072481285090455,0.01286650031191516,0.2803142545227698,0.7196857454772302,0.03390127885215222
9622,24.0,438,4629,5067,81,443,6779,1826,4953,6779,188,0.06461129960171116,0.6828440772975365,0.011948664994836997,0.2693612627231155,0.7306387372768844,0.0653488715149727
9623,24.0,96,3897,3993,8,326,5439,1507,3932,5439,409,0.01765030336458908,0.716492002206288,0.0014708586137157566,0.27707299135870567,0.7229270086412943,0.05993748850891708
9624,,90,2091,2181,22,67,2948,840,2108,2948,207,0.030529172320217096,0.7092944369063772,0.007462686567164179,0.28493894165535955,0.7150610583446404,0.022727272727272728
9625,,79,1904,1983,14,127,2874,743,2131,2874,178,0.027487821851078637,0.662491301322199,0.0048712595685455815,0.2585247042449548,0.7414752957550452,0.0441892832289492
9626,24.0,162,3145,3307,11,202,4477,1248,3229,4477,321,0.03618494527585437,0.7024793388429752,0.002457002457002457,0.2787580969399151,0.7212419030600848,0.04511949966495421
9627,27.0,1251,26050,27301,169,1399,37009,10441,26568,37009,2646,0.03380258855953957,0.7038828393093571,0.004566456807803507,0.2821205652679078,0.7178794347320921,0.03780161582317815
9628,14.0,24,5443,5888,23,350,7810,2098,5739,7837,636,0.00306239632512441,0.6945259665688401,0.0029347964782442263,0.2677044787546255,0.7322955212453746,0.04465994640806431
9629,,50,3676,3726,5,169,4960,1407,3553,4960,453,0.010080645161290322,0.7411290322580645,0.0010080645161290322,0.2836693548387097,0.7163306451612903,0.03407258064516129
9630,27.0,91,3646,3737,5,227,5066,1404,3662,5066,411,0.01796288985392815,0.7196999605211212,0.0009869719699960521,0.27714172917489144,0.7228582708251086,0.044808527437820767
9631,25.0,127,4056,4183,13,206,5613,1584,4029,5613,410,0.022626046677356137,0.7226082308925709,0.0023160520220915732,0.2822020309994655,0.7177979690005345,0.036700516657758774
9632,17.0,95,2635,2730,42,186,3621,1059,2562,3621,260,0.02623584645125656,0.7276995305164319,0.0115990057995029,0.29246064623032314,0.7075393537696769,0.05136702568351284
9633,,162,3711,3873,14,138,5036,1493,3543,5036,352,0.03216838760921366,0.7368943606036537,0.0027799841143764893,0.29646544876886416,0.7035345512311358,0.027402700555996824
9634,,97,7586,7683,6,154,9529,2978,6551,9529,679,0.01017945219855179,0.7960961276104523,0.000629656837023822,0.312519676776157,0.687480323223843,0.016161192150278097
9635,,220,8227,8447,16,380,11115,3236,7879,11115,843,0.01979307242465137,0.7401709401709402,0.0014394961763382816,0.29113810166441745,0.7088618983355826,0.03418803418803419
9636,17.0,251,2262,2513,0,297,3528,830,2698,3528,213,0.07114512471655329,0.641156462585034,0.0,0.23526077097505668,0.7647392290249433,0.08418367346938775
9637,,1185,35306,36491,346,855,45962,14026,31955,45981,3044,0.02577151432113264,0.7678388899762946,0.007524847219503708,0.30503903786346537,0.6949609621365347,0.0185946369152476
9638,26.0,107,2660,2767,20,263,3800,1010,2790,3800,210,0.028157894736842104,0.7,0.005263157894736842,0.2657894736842105,0.7342105263157894,0.06921052631578947
9639,25.0,180,26367,26547,126,1534,35694,10058,25636,35694,3256,0.005042864346949067,0.7386955790889225,0.0035300050428643467,0.28178405334229845,0.7182159466577016,0.042976410601221496
9640,14.0,2244,25885,28129,103,3162,39677,10519,29158,39677,2111,0.05655669531466593,0.6523930740731406,0.0025959623963505304,0.26511581016709934,0.7348841898329007,0.07969352521612016
9641,25.0,396,8819,9215,20,527,12079,3391,8688,12079,807,0.03278417087507244,0.7301101084526865,0.0016557662058117393,0.2807351601953804,0.7192648398046196,0.04362943952313933
9642,,74,1949,2023,3,110,2662,768,1894,2662,175,0.02779864763335838,0.7321562734785876,0.0011269722013523666,0.28850488354620585,0.7114951164537942,0.04132231404958678
9643,17.0,11200,112574,123774,214,6717,167814,47303,120511,167814,12178,0.0667405579987367,0.6708260335848022,0.0012752213760472905,0.2818775549119859,0.7181224450880141,0.04002645786406379
9644,,357,5332,5689,217,471,7784,2064,5720,7784,361,0.045863309352517985,0.6849948612538541,0.02787769784172662,0.26515930113052416,0.7348406988694759,0.0605087358684481
9645,17.0,171,4627,4798,4,210,6341,1804,4537,6341,451,0.026967355306733953,0.729695631603848,0.0006308153288124901,0.2844977132944331,0.7155022867055669,0.03311780476265573
9646,,210,4456,4666,16,296,6518,1743,4775,6518,467,0.032218471923903036,0.6836452899662473,0.00245474071801166,0.2674133169683952,0.7325866830316048,0.045412703283215713
9647,14.0,102,1913,2015,4,51,2629,853,1776,2629,121,0.03879802206162039,0.7276531000380373,0.0015214910612400153,0.32445796880943323,0.6755420311905668,0.019399011030810195
9648,35.0,621,10271,10892,116,442,14034,4176,9858,14034,839,0.04424967935014964,0.731865469573892,0.008265640587145504,0.2975630611372381,0.7024369388627618,0.03149494085791649
9649,33.0,72,2210,2282,10,129,3192,871,2321,3192,260,0.022556390977443608,0.6923558897243107,0.003132832080200501,0.27286967418546365,0.7271303258145363,0.040413533834586464
9650,16.0,526,8477,9003,46,354,11967,3442,8525,11967,926,0.04395420740369349,0.7083646695078132,0.003843904069524526,0.28762430015876994,0.7123756998412301,0.02958134870894961
9651,26.0,1097,21884,22981,227,1229,30372,8755,21617,30372,2284,0.03611879362570789,0.7205320690109311,0.007473989200579481,0.28825892269195313,0.7117410773080469,0.04046490188331358
9652,27.0,333,5853,6186,25,283,8565,2354,6211,8565,595,0.03887915936952715,0.6833625218914186,0.002918855808523059,0.27483946293053124,0.7251605370694688,0.03304144775248103
9653,16.0,32,2324,2356,6,96,3100,909,2191,3100,312,0.01032258064516129,0.7496774193548387,0.001935483870967742,0.2932258064516129,0.7067741935483871,0.03096774193548387
9654,15.0,155,4211,4366,6,234,5844,1668,4176,5844,462,0.02652292950034223,0.7205681040383299,0.001026694045174538,0.28542094455852157,0.7145790554414785,0.04004106776180698
9655,,130,2550,2680,22,111,3526,1054,2472,3526,255,0.0368689733408962,0.7231990924560409,0.006239364719228588,0.29892229154849687,0.7010777084515031,0.031480431083380604
9656,37.0,446,14388,14834,38,701,19664,5607,14057,19664,1544,0.022681041497152155,0.7316924328722538,0.0019324654190398698,0.28514035801464604,0.7148596419853539,0.035648901545972334
9657,26.0,550,5837,6387,166,490,8498,2351,6147,8498,358,0.06472111084961167,0.6868674982348788,0.019534008001882795,0.27665333019534005,0.7233466698046599,0.057660626029654036
9658,,4,1903,1907,7,264,2718,699,2019,2718,171,0.0014716703458425313,0.7001471670345842,0.0025754231052244297,0.2571743929359823,0.7428256070640177,0.09713024282560706
9659,25.0,369,9693,10062,39,971,13613,3595,10018,13613,895,0.027106442371262765,0.7120399618012194,0.0028649085433041944,0.2640858003379123,0.7359141996620877,0.07132887680893264
9660,,371,8462,8833,17,485,11899,3390,8509,11899,995,0.031179090679889065,0.7111521976636692,0.001428691486679553,0.28489789057904025,0.7151021094209598,0.04075972770821078
9661,16.0,462,6632,7094,12,677,9984,2678,7306,9984,608,0.046274038461538464,0.6642628205128205,0.001201923076923077,0.2682291666666667,0.7317708333333334,0.06780849358974358
9662,17.0,35,1568,1603,5,62,2096,632,1464,2096,201,0.016698473282442748,0.7480916030534351,0.002385496183206107,0.3015267175572519,0.6984732824427481,0.029580152671755726
9663,,565,19304,19869,136,1486,27210,7230,19980,27210,2047,0.020764424843807423,0.7094450569643513,0.004998162440279309,0.2657111356119074,0.7342888643880926,0.054612274898934214
9664,27.0,186,7601,7787,76,142,11366,2926,8440,11366,696,0.016364596163997887,0.6687489002287524,0.00668660918528946,0.2574344536336442,0.7425655463663557,0.012493401372514517
9665,16.0,2970,52784,55754,454,4187,76600,21303,55297,76600,5920,0.03877284595300261,0.6890861618798956,0.005926892950391645,0.2781070496083551,0.7218929503916449,0.054660574412532636
9666,,2861,54077,56938,1244,2305,75893,21367,54526,75893,5506,0.03769781139235503,0.7125426587432306,0.016391498557179186,0.2815411170990737,0.7184588829009263,0.030371707535609346
9667,,146,4003,4149,59,182,5399,1597,3802,5399,411,0.027042044823115393,0.7414335988145953,0.010927949620300055,0.29579551768846085,0.7042044823115392,0.033709946286349324
9668,,69,3329,3398,18,124,4502,1330,3172,4502,352,0.015326521545979565,0.7394491337183474,0.003998223011994669,0.29542425588627275,0.7045757441137273,0.027543314082629944
9669,24.0,590,16392,16982,46,698,22181,6301,15880,22181,1969,0.026599341779000044,0.7390108651548623,0.0020738469861593255,0.2840719534736937,0.7159280465263063,0.03146837383346107
9670,24.0,840,24195,25035,270,1485,33564,9481,24083,33564,2661,0.025026814444047193,0.7208616374687165,0.008044333214158027,0.28247527112382315,0.7175247288761769,0.044243832677869147
9671,46.0,567,10228,10795,362,714,14617,4057,10560,14617,874,0.03879044947663679,0.6997331873845523,0.02476568379284395,0.2775535335568174,0.7224464664431826,0.04884723267428337
9672,27.0,316,4425,4741,11,340,7133,1646,5487,7133,404,0.044301135567082574,0.6203560914061405,0.0015421281368288237,0.2307584466563858,0.7692415533436142,0.0476657787747091
9673,14.0,22,2013,2035,38,162,2849,801,2048,2849,269,0.007722007722007722,0.7065637065637066,0.013338013338013339,0.28115128115128113,0.7188487188487188,0.056862056862056864
9674,25.0,550,11571,12121,19,772,16205,4730,11475,16205,1327,0.033940141931502625,0.7140388768898488,0.0011724776303609996,0.29188522061092254,0.7081147793890774,0.047639617402036406
9675,,821,79296,80117,396,3118,106087,30515,75572,106087,8506,0.007738931254536371,0.7474619887450866,0.003732785355415838,0.28764127555685426,0.7123587244431457,0.029390971561077228
9676,24.0,935,18264,19199,68,1147,25467,7242,18225,25467,2014,0.03671417913378097,0.7171633879137708,0.0026701221188204344,0.28436800565437625,0.7156319943456237,0.04503867750422115
9677,25.0,2489,58023,60512,220,3128,82251,22848,59403,82251,5776,0.03026103026103026,0.7054382317540212,0.00267473951684478,0.27778385673122513,0.7222161432687748,0.038029932766774875
9678,25.0,547,11884,12431,57,651,16755,4856,11899,16755,1070,0.03264697105341689,0.7092808116980006,0.0034019695613249777,0.2898239331542823,0.7101760668457177,0.03885407341092211
9679,,4,11396,11400,6,821,15261,4370,10891,15261,1381,0.00026210602188585284,0.7467400563527947,0.00039315903282877927,0.28635082891029423,0.7136491710897058,0.05379726099207129
9680,17.0,3003,69382,72385,607,12089,105416,27514,77902,105416,5094,0.028487136677544204,0.6581733323214692,0.00575813918190787,0.26100402215982393,0.738995977840176,0.11467898611216513
9681,27.0,8092,105532,113624,736,5471,152976,43500,109476,152976,9963,0.052897186486769165,0.6898598472963079,0.004811212216295367,0.2843583307185441,0.7156416692814559,0.03576377993933689
9682,23.0,3942,120775,124717,328,5791,167569,47746,119823,167569,13313,0.0235246376119688,0.7207478710262638,0.001957402622203391,0.2849333707308631,0.7150666292691369,0.034558898125548285
9683,,273,10903,11176,67,448,14604,4337,10267,14604,1033,0.018693508627773213,0.7465762804711038,0.0045877841687208985,0.29697343193645576,0.7030265680635442,0.030676526978909886
9684,16.0,106,2271,2377,9,108,3270,929,2341,3270,265,0.03241590214067278,0.6944954128440367,0.0027522935779816515,0.28409785932721715,0.7159021406727829,0.03302752293577982
9685,40.0,706,17044,17750,53,1125,23496,6816,16680,23496,1896,0.030047667688117126,0.7254000680966973,0.0022557030983997276,0.2900919305413687,0.7099080694586313,0.047880490296220636
9686,,2538,40248,42786,27,3897,58366,16209,42157,58366,4057,0.0434842202652229,0.6895795497378611,0.00046259808792790323,0.2777130521193846,0.7222869478806154,0.0667683240242607
9687,,755,19741,20496,35,1016,26710,7723,18987,26710,1774,0.028266566828903033,0.739086484462748,0.0013103706476974915,0.2891426432047922,0.7108573567952078,0.03803818794459004
9688,33.0,1543,38459,40002,238,2461,54268,14729,39539,54268,4144,0.028432962335077763,0.7086865187587529,0.004385641630426771,0.2714122503132601,0.7285877496867399,0.04534900862386673
9689,26.0,253,7995,8248,4,430,10744,3117,7627,10744,795,0.023548026805658973,0.7441362620997766,0.00037230081906180194,0.29011541325390916,0.7098845867460909,0.04002233804914371
9690,27.0,683,21644,22327,53,625,29052,8674,20378,29052,2553,0.023509569048602505,0.745008949469916,0.0018243150213410437,0.298568084813438,0.701431915186562,0.02151314883656891
9691,24.0,991,1127,2118,44,165,2965,836,2129,2965,86,0.3342327150084317,0.3801011804384486,0.014839797639123103,0.28195615514333894,0.7180438448566611,0.05564924114671164
9692,,681,12066,12747,32,1049,18207,4838,13369,18207,1081,0.037403196572746746,0.6627121436810018,0.0017575657714066018,0.2657219750645356,0.7342780249354643,0.057615202943922667
9693,23.0,207,4899,5106,6,269,6733,2000,4733,6733,493,0.030744096242388236,0.7276102777365216,0.0008911332244170504,0.2970444081390168,0.7029555918609832,0.039952472894697756
9694,40.0,107,2544,2651,30,121,3595,1047,2548,3595,298,0.02976356050069541,0.7076495132127956,0.008344923504867872,0.29123783031988876,0.7087621696801113,0.033657858136300414
9695,,59,2469,2528,76,129,3410,947,2463,3410,238,0.017302052785923755,0.7240469208211143,0.022287390029325515,0.2777126099706745,0.7222873900293255,0.03782991202346041
9696,24.0,2109,48649,50758,269,1973,65622,19657,45965,65622,4431,0.03213861205083661,0.7413519856145805,0.004099235012648197,0.29954893176069003,0.70045106823931,0.03006613635670964
9697,47.0,81,3722,3803,10,131,4948,1461,3487,4948,426,0.016370250606305578,0.7522231204527081,0.002021018593371059,0.2952708164915117,0.7047291835084882,0.026475343573160875
9698,17.0,261,6180,6441,7,189,8456,2411,6045,8456,760,0.03086565752128666,0.7308420056764428,0.0008278145695364238,0.28512298959318827,0.7148770104068117,0.022350993377483443
9699,,522,8376,8898,7,450,12502,3450,9052,12502,771,0.041753319468884977,0.6699728043513038,0.0005599104143337066,0.2759558470644697,0.7240441529355303,0.03599424092145257
9700,,827,22303,23130,7,1245,30401,8716,21685,30401,2442,0.027203052531166737,0.7336271833163382,0.00023025558369790466,0.2867010953587053,0.7132989046412946,0.040952600243413045
9701,23.0,449,17620,18069,120,696,23519,6949,16572,23521,1679,0.01908932443348497,0.7491178096169381,0.005101823902044981,0.2954381191275881,0.7045618808724119,0.02959057863186089
9702,26.0,1841,76763,78609,191,4740,103033,30035,72998,103033,7484,0.017868061688973435,0.7450331447206235,0.001853775004124892,0.2915085458057127,0.7084914541942873,0.046004678112837635
9703,25.0,54,4869,4923,23,194,6524,1810,4714,6524,578,0.00827713059472716,0.7463212752912324,0.003525444512568976,0.2774371551195586,0.7225628448804414,0.02973635806253832
9704,,889,13505,14394,82,2002,20670,5556,15114,20670,1440,0.04300919206579584,0.6533623609095307,0.003967102080309627,0.2687953555878084,0.7312046444121916,0.09685534591194969
9705,24.0,295,7588,7883,65,356,10592,2971,7621,10592,765,0.027851208459214502,0.7163897280966768,0.0061367069486404835,0.28049471299093653,0.7195052870090635,0.03361027190332326
9706,14.0,171,1865,2036,7,235,2901,757,2144,2901,188,0.05894519131334023,0.6428817649086522,0.002412961047914512,0.26094450189589796,0.739055498104102,0.08100654946570149
9707,25.0,2691,106882,109573,400,5698,142715,41708,101007,142715,10722,0.018855761482675263,0.7489191745787058,0.002802788774830957,0.29224678555162387,0.7077532144483761,0.03992572609746698
9708,14.0,173,3666,3839,28,493,5528,1458,4070,5528,421,0.03129522431259045,0.6631693198263386,0.005065123010130246,0.26374819102749636,0.7362518089725036,0.08918234442836469
9709,23.0,205,3776,3981,48,244,5624,1477,4147,5624,386,0.036450924608819345,0.6714082503556188,0.008534850640113799,0.26262446657183497,0.737375533428165,0.04338549075391181
9710,41.0,106,7820,7926,7,228,10263,2976,7287,10263,940,0.010328364026113222,0.761960440417032,0.0006820617753093638,0.28997369190295236,0.7100263080970477,0.022215726395790704
9711,16.0,274,15204,15478,325,3897,23909,5528,18381,23909,614,0.011460119620226692,0.6359111631603162,0.013593207578736041,0.23121000460077795,0.7687899953992221,0.16299301518256723
9712,25.0,63,1696,1759,1,131,2505,674,1831,2505,170,0.025149700598802394,0.6770459081836327,0.0003992015968063872,0.269061876247505,0.730938123752495,0.05229540918163673
9713,,1669,20825,22494,45,1643,31253,8616,22637,31253,1932,0.05340287332416088,0.6663360317409529,0.001439861773269766,0.2756855341887179,0.7243144658112821,0.052570953188493905
9714,,512,9927,10439,17,868,14489,3929,10560,14489,982,0.035337152322451514,0.6851404513769066,0.0011733038857063979,0.2711712333494375,0.7288287666505625,0.05990751604665608
9715,27.0,380,78143,78523,218,3795,104359,30163,74196,104359,9239,0.00364127674661505,0.7487902337124733,0.0020889429756896865,0.28903113291618354,0.7109688670838165,0.03636485593001083
9716,,283,4972,5255,13,312,7050,1994,5056,7050,517,0.0401418439716312,0.7052482269503546,0.0018439716312056737,0.2828368794326241,0.7171631205673759,0.04425531914893617
9717,23.0,394,6993,7387,191,450,10140,2800,7340,10140,614,0.0388560157790927,0.6896449704142011,0.01883629191321499,0.27613412228796846,0.7238658777120316,0.04437869822485207
9718,26.0,260,7001,7261,48,303,9430,2788,6642,9430,648,0.027571580063626724,0.7424178154825026,0.005090137857900318,0.2956521739130435,0.7043478260869566,0.03213149522799576
9719,48.0,86,2327,2413,5,109,3238,923,2315,3238,265,0.026559604694255712,0.7186534898085237,0.0015441630636195182,0.28505250154416306,0.7149474984558369,0.033662754786905495
9720,39.0,1035,29938,30973,111,1037,39973,11822,28151,39973,2943,0.025892477422260026,0.7489555449928702,0.002776874390213394,0.2957496310009256,0.7042503689990743,0.025942511195056663
9721,16.0,996,17603,18599,110,1808,25791,6870,18921,25791,1781,0.038618122600907294,0.6825249117909348,0.004265053700903416,0.2663719902291497,0.7336280097708503,0.07010197355666706
9722,37.0,289,6388,6677,16,257,8807,2648,6159,8807,634,0.032814806403996824,0.7253321221755422,0.0018167366867264676,0.30066992165323037,0.6993300783467696,0.029181333030543887
9723,,73,2985,3058,2,168,4095,1153,2942,4095,329,0.017826617826617826,0.7289377289377289,0.0004884004884004884,0.28156288156288156,0.7184371184371184,0.041025641025641026
9724,23.0,1209,21330,22539,106,1357,31154,8781,22373,31154,2102,0.03880721576683572,0.6846632856134044,0.0034024523335687232,0.2818578673685562,0.7181421326314438,0.04355780959106375
9725,15.0,38,4450,4488,1,366,6327,1782,4545,6327,349,0.006006006006006006,0.7033349138612297,0.000158052789631737,0.28165007112375534,0.7183499288762447,0.057847321005215745
9726,,593,4575,5168,41,319,8898,1676,7222,8898,248,0.0666441897055518,0.51416048550236,0.004607777028545741,0.18835693414250393,0.811643065857496,0.03585075297819735
9727,38.0,340,10566,10906,21,433,14290,4164,10126,14290,1054,0.023792862141357594,0.7393981805458363,0.0014695591322603219,0.2913925822253324,0.7086074177746676,0.030300909727081875
9728,,7251,153336,160587,481,7985,216652,60394,156258,216652,15842,0.03346841940069789,0.7077525247862932,0.0022201502870963573,0.2787604083968761,0.7212395916031239,0.03685634104462456
9729,,59,8439,8498,17,823,11689,3135,8554,11689,981,0.00504748053725725,0.7219608178629481,0.0014543587988707332,0.2682008726152793,0.7317991273847206,0.07040807596885962
9730,35.0,886,20847,21733,416,1195,29764,8173,21591,29764,2174,0.029767504367692516,0.7004098911436635,0.013976616046230345,0.27459346861980916,0.7254065313801908,0.040149173498185725
9731,25.0,4214,87308,91522,266,5668,122783,34878,87905,122783,9001,0.0343207121507049,0.711075637506821,0.002166423690576057,0.2840621258643298,0.7159378741356702,0.04616274239919207
9732,26.0,140,4638,4778,31,289,6401,1770,4631,6401,490,0.021871582565224184,0.7245742852679269,0.0048429932822996406,0.2765192938603343,0.7234807061396656,0.04514919543821278
9733,23.0,108,6672,6780,17,515,8952,2473,6479,8952,486,0.012064343163538873,0.7453083109919572,0.0018990169794459338,0.27625111706881145,0.7237488829311886,0.05752904378909741
9734,15.0,47,15249,15296,91,1153,20803,5766,15037,20803,1880,0.0022592895255491995,0.7330192760659521,0.004374369081382493,0.277171561793972,0.7228284382060279,0.055424698360813346
9735,,83,4797,4880,7,149,6287,1828,4459,6287,484,0.013201845077143311,0.7630030221091141,0.0011134086209638938,0.29075870844599966,0.7092412915540003,0.023699697789088595
9736,16.0,114,2823,2937,5,209,3920,1095,2825,3920,325,0.029081632653061223,0.7201530612244897,0.0012755102040816326,0.27933673469387754,0.7206632653061225,0.053316326530612246
9737,,324,7565,7889,8,681,10738,2856,7882,10738,819,0.03017321661389458,0.7045073570497299,0.0007450176941702365,0.26597131681877445,0.7340286831812256,0.06341963121624139
9738,,1156,31083,32239,121,1939,43375,12275,31103,43378,2825,0.026649453640094058,0.7165613905666467,0.0027894324311863155,0.282977546221587,0.717022453778413,0.044700078380746
9739,,85,1846,1931,0,54,2565,774,1791,2565,181,0.03313840155945419,0.7196881091617934,0.0,0.3017543859649123,0.6982456140350877,0.021052631578947368
9740,41.0,672,11930,12602,63,845,17372,4751,12621,17372,1194,0.038682938061247986,0.6867372783790007,0.0036265254432419985,0.2734860695371863,0.7265139304628138,0.048641492056182366
9741,,67,4666,4733,0,272,6376,1858,4518,6376,595,0.010508155583437892,0.7318067754077792,0.0,0.291405269761606,0.708594730238394,0.04265997490589712
9742,26.0,287,9518,9805,175,596,13369,3813,9557,13370,839,0.021465968586387434,0.7118922961854899,0.013089005235602094,0.28519072550486163,0.7148092744951384,0.044577412116679135
9743,17.0,623,7442,8065,29,877,11270,3139,8131,11270,723,0.055279503105590065,0.6603371783496007,0.0025732031943212067,0.2785270629991127,0.7214729370008873,0.07781721384205856
9744,24.0,1738,53651,55389,98,3323,74149,21020,53129,74149,5251,0.0234392911569947,0.7235566224763652,0.00132166313773618,0.2834832566858623,0.7165167433141377,0.04481516945609516
9745,16.0,12552,261258,273810,737,13536,370800,104891,265909,370800,27353,0.03385113268608414,0.70457928802589,0.001987594390507012,0.2828775620280475,0.7171224379719525,0.03650485436893204
9746,24.0,54,1675,1729,9,87,2420,653,1767,2420,198,0.02231404958677686,0.6921487603305785,0.00371900826446281,0.26983471074380166,0.7301652892561984,0.03595041322314049
9747,16.0,197,4252,4449,19,284,6248,1657,4591,6248,463,0.03153008962868118,0.6805377720870679,0.003040973111395647,0.26520486555697825,0.7347951344430218,0.045454545454545456
9748,26.0,5608,127867,133475,154,5350,176578,50889,125689,176578,15189,0.03175933581759902,0.7241389074516644,0.0008721358266601728,0.28819558495395803,0.711804415046042,0.03029822514696055
9749,23.0,649,14589,15238,99,879,20632,5723,14909,20632,1424,0.031455990694067466,0.7071054672353625,0.004798371461806902,0.2773846452113222,0.7226153547886778,0.0426037223730128
9750,,369,3275,3644,2,262,5019,1379,3640,5019,393,0.07352062163777645,0.6525204223948994,0.0003984857541342897,0.27475592747559274,0.7252440725244073,0.05220163379159195
9751,26.0,148,3362,3510,10,186,4709,1321,3388,4709,358,0.03142917816946273,0.713952006795498,0.0021235931195582925,0.28052665109365044,0.7194733489063495,0.03949883202378424
9752,,99,3402,3501,19,166,4730,1338,3392,4730,403,0.020930232558139535,0.7192389006342494,0.0040169133192389005,0.2828752642706131,0.7171247357293868,0.03509513742071882
9753,23.0,782,22526,23308,12,1077,30862,8885,21977,30862,2340,0.025338604108612533,0.7298943684790357,0.0003888276845311386,0.2878944980882639,0.7121055019117362,0.034897284686669694
9754,16.0,18,1914,1932,6,293,2682,605,2077,2682,149,0.006711409395973154,0.7136465324384788,0.0022371364653243847,0.2255779269202088,0.7744220730797912,0.1092468307233408
9755,24.0,379,7855,8234,54,392,10988,3092,7896,10988,729,0.03449217327994175,0.7148707681106662,0.004914452129595923,0.2813978886057517,0.7186021113942482,0.03567528212595559
9756,15.0,3588,39352,42940,366,5551,65445,16416,49029,65445,3429,0.05482466192986477,0.6012988005195202,0.005592482236992895,0.25083658033463213,0.7491634196653678,0.08481931392772557
9757,23.0,203,5417,5620,17,266,7476,2202,5274,7476,540,0.027153558052434457,0.7245853397538791,0.00227394328517924,0.2945425361155698,0.7054574638844302,0.035580524344569285
9758,14.0,252,5339,5591,11,628,7953,1851,6102,7953,489,0.03168615616748397,0.671318999119829,0.0013831258644536654,0.23274236137306678,0.7672576386269332,0.07896391298880925
9759,,4484,111874,116358,1174,8172,157506,44626,112880,157506,10075,0.028468756745774763,0.7102840526710094,0.007453684304090003,0.2833288890581946,0.7166711109418054,0.05188373776237096
9760,,8,2524,2532,11,280,3515,978,2537,3515,189,0.002275960170697013,0.7180654338549075,0.0031294452347083927,0.2782361308677098,0.7217638691322902,0.07965860597439545
9761,42.0,112,2275,2387,2,164,3302,930,2372,3302,254,0.03391883706844337,0.6889763779527559,0.0006056935190793458,0.2816474863718958,0.7183525136281042,0.04966686856450636
9762,,71,1810,1881,1,68,2478,708,1770,2478,211,0.028652138821630348,0.7304277643260694,0.0004035512510088781,0.2857142857142857,0.7142857142857143,0.02744148506860371
9763,,182,4889,5071,29,171,6740,1908,4832,6740,538,0.027002967359050445,0.7253709198813056,0.0043026706231454005,0.2830860534124629,0.716913946587537,0.02537091988130564
9764,16.0,1239,19670,20909,152,1752,28968,7756,21212,28968,1811,0.042771333885666944,0.6790251311792322,0.005247169290251312,0.2677437172051919,0.732256282794808,0.06048053024026512
9765,47.0,998,6881,7879,21,261,10617,3095,7522,10617,737,0.09400018837713102,0.6481115192615616,0.0019779598756710934,0.29151361024771594,0.7084863897522841,0.024583215597626447
9766,,113,3135,3248,11,569,5366,1126,4240,5366,225,0.021058516585911295,0.5842340663436452,0.002049944092433843,0.20983973164368244,0.7901602683563176,0.10603801714498695
9767,,139,4052,4191,19,291,5982,1564,4418,5982,388,0.023236375794048813,0.6773654296221999,0.0031761952524239387,0.2614510197258442,0.7385489802741558,0.04864593781344032
9768,14.0,29,3681,3710,20,332,5095,1385,3710,5095,292,0.005691854759568204,0.7224730127576054,0.003925417075564278,0.2718351324828263,0.7281648675171737,0.06516192345436703
9769,,70,3122,3192,6,118,4167,1267,2900,4167,282,0.016798656107511398,0.7492200623950084,0.0014398848092152627,0.3040556755459563,0.6959443244540436,0.028317734581233503
9770,14.0,363,8279,8642,24,589,11310,3197,8113,11310,720,0.03209549071618037,0.7320070733863837,0.002122015915119363,0.28267020335985854,0.7173297966401415,0.05207780725022104
9771,23.0,1005,4792,5797,149,803,8306,2285,6021,8306,191,0.12099686973272333,0.5769323380688659,0.017938839393209727,0.275102335660968,0.724897664339032,0.09667710089092223
9772,16.0,133,1355,1488,8,140,2068,554,1514,2068,121,0.06431334622823985,0.6552224371373307,0.0038684719535783366,0.2678916827852998,0.7321083172147002,0.06769825918762089
9773,23.0,877,16823,17700,377,901,23279,6777,16502,23279,1465,0.037673439580738,0.7226684995059925,0.016194853730830364,0.2911207526096482,0.7088792473903518,0.03870441170153357
9774,25.0,325,6910,7235,40,304,9529,2797,6732,9529,740,0.034106412005457026,0.7251547906391017,0.00419771224682548,0.2935250288592717,0.7064749711407283,0.03190261307587365
9775,,43,4827,4870,34,638,6870,1836,5034,6870,435,0.006259097525473071,0.7026200873362446,0.004949053857350801,0.26724890829694326,0.7327510917030567,0.09286754002911209
9776,24.0,17283,299190,316473,2814,22175,438172,120005,318178,438183,26737,0.03944242474034821,0.6827969136182828,0.006421974380567024,0.27386959329777744,0.7261304067022226,0.05060670998190254
9777,,164,4404,4568,6,141,6032,1740,4292,6032,556,0.027188328912466843,0.730106100795756,0.0009946949602122016,0.28846153846153844,0.7115384615384616,0.023375331564986737
9778,16.0,254,7893,8147,49,1476,12443,2881,9562,12443,701,0.020413083661496422,0.6343325564574459,0.003937957084304428,0.23153580326287873,0.7684641967371213,0.11862091135578237
9779,40.0,386,14860,15246,32,468,19776,5695,14081,19776,1502,0.019518608414239483,0.751415857605178,0.0016181229773462784,0.2879753236245955,0.7120246763754046,0.02366504854368932
9780,25.0,2959,67602,70561,225,2607,91798,26745,65053,91798,6794,0.032233817730233774,0.7364212727946142,0.0024510337915858733,0.2913462166931741,0.7086537833068258,0.028399311531841654
9781,16.0,420,7039,7459,47,388,9910,2778,7132,9910,743,0.04238143289606458,0.71029263370333,0.004742684157416751,0.28032290615539857,0.7196770938446014,0.03915237134207871
9782,24.0,337,5451,5788,93,461,8075,2258,5817,8075,573,0.04173374613003096,0.675046439628483,0.01151702786377709,0.2796284829721362,0.7203715170278637,0.057089783281733746
9783,16.0,2765,67320,70085,306,5477,98004,27156,70848,98004,7068,0.028213134157789477,0.6869107383372107,0.0031223215378964123,0.2770907309905718,0.7229092690094282,0.05588547406228317
9784,15.0,201,47407,47608,564,7384,69776,17956,51820,69776,4154,0.0028806466406787433,0.6794169915157074,0.008083008484292593,0.25733776656730106,0.7426622334326989,0.10582435221279524
9785,17.0,121,3158,3279,18,210,4358,1206,3152,4358,278,0.027765029830197338,0.7246443322625057,0.004130335016062414,0.27673244607618175,0.7232675539238183,0.048187241854061494
9786,16.0,18,2773,2791,13,156,3743,1054,2689,3743,290,0.004808976756612343,0.7408495858936682,0.003473149879775581,0.2815923056371894,0.7184076943628106,0.04167779855730697
9787,25.0,251,4048,4299,3,253,5717,1598,4119,5717,372,0.04390414553087284,0.7080636697568655,0.0005247507433968865,0.27951722931607487,0.7204827706839252,0.044253979359804095
9788,15.0,134,3662,3796,63,641,5344,1391,3953,5344,159,0.025074850299401198,0.6852544910179641,0.011788922155688622,0.26029191616766467,0.7397080838323353,0.11994760479041916
9789,,218,4797,7927,122,423,10480,1923,8557,10480,452,0.02080152671755725,0.45772900763358776,0.011641221374045801,0.18349236641221375,0.8165076335877862,0.04036259541984733
9790,15.0,121,2748,2869,23,141,4023,1068,2955,4023,298,0.030077056922694505,0.6830723340790454,0.00571712652249565,0.26547352721849365,0.7345264727815063,0.035048471290082026
9791,26.0,76,3046,3122,8,132,4047,1189,2858,4047,324,0.018779342723004695,0.752656288608846,0.0019767729182110206,0.2937978749691129,0.7062021250308871,0.03261675315048184
9792,,14861,360878,375739,1827,16653,496237,141729,354516,496245,33064,0.029946901228223962,0.7272174026942337,0.0036816491853822204,0.28560287761085756,0.7143971223891424,0.033558020735725294
9793,,1761,6205,7966,43,797,10852,3029,7823,10852,425,0.16227423516402506,0.5717840029487652,0.003962403243641725,0.2791190563951345,0.7208809436048654,0.07344268337633617
9794,26.0,12506,240989,253495,946,13137,341733,96990,244743,341733,25888,0.036595821884336605,0.7051967471681108,0.0027682430435456923,0.28381806849206836,0.7161819315079316,0.0384422926670822
9795,,520,9088,9608,45,433,14277,3621,10656,14277,702,0.03642221755270715,0.6365482944596204,0.0031519226728304265,0.253624711073755,0.746375288926245,0.030328500385234995
9796,27.0,4335,61932,66267,434,3826,88214,24705,63509,88214,5314,0.04914185956877593,0.7020654317908722,0.004919853991429932,0.2800575872310518,0.7199424127689482,0.0433718003944952
9797,15.0,10622,68079,78701,1452,7594,110665,29737,80928,110665,5764,0.09598337324357295,0.6151809515203542,0.013120679528306149,0.2687118781909366,0.7312881218090634,0.06862151538426783
9798,17.0,86,787,926,2,430,1686,315,1371,1686,68,0.051008303677342826,0.466785290628707,0.0011862396204033216,0.18683274021352314,0.8131672597864769,0.25504151838671413
9799,16.0,87,8142,8229,22,429,11432,3131,8301,11432,967,0.007610216934919524,0.7122113365990203,0.0019244226731980406,0.2738803358992302,0.7261196641007698,0.03752624212736179
9800,15.0,25,1392,1417,7,157,1965,528,1437,1965,163,0.01272264631043257,0.7083969465648855,0.0035623409669211198,0.2687022900763359,0.7312977099236642,0.07989821882951655
9801,17.0,19154,386714,405868,2768,22935,539003,155595,383408,539003,35684,0.035535980319219,0.7174616838867316,0.005135407409606254,0.28867186267979955,0.7113281373202004,0.04255078357634373
9802,25.0,285,7388,7673,19,284,10218,2894,7324,10218,892,0.027891955372871403,0.723037776472891,0.0018594636915247602,0.28322568017224503,0.716774319827755,0.027794088862791153
9803,,107,2155,2262,6,101,2989,847,2142,2989,242,0.035797925727668115,0.7209769153563065,0.0020073603211776514,0.28337236533957844,0.7166276346604216,0.03379056540649047
9804,14.0,241,3650,3891,8,226,5423,1456,3967,5423,349,0.044440346671583995,0.6730591923289692,0.0014751982297621243,0.26848607781670664,0.7315139221832934,0.04167434999078001
9805,,239,3229,3468,9,202,4727,1338,3389,4727,371,0.05056060926591919,0.6830971017558706,0.001903955997461392,0.2830547916225936,0.7169452083774064,0.04273323460968902
9806,,6448,129146,135594,661,9140,184343,50956,133387,184343,11457,0.034978274195385774,0.7005744725864286,0.003585707078652295,0.27641950060485077,0.7235804993951492,0.04958148668514671
9807,,15,5488,5503,31,308,7268,2028,5240,7268,586,0.0020638414969730325,0.7550908090258668,0.0042652724270776,0.279031370390754,0.720968629609246,0.04237754540451293
9808,14.0,613,1061,1674,17,77,2527,633,1894,2527,113,0.24258013454689356,0.41986545310645035,0.006727344677483181,0.2504946576968738,0.7495053423031263,0.030470914127423823
9809,17.0,1180,13126,14306,63,997,19263,5364,13899,19263,1185,0.06125733271037741,0.6814099569122152,0.0032705186108082855,0.27846129886310544,0.7215387011368946,0.051757254840886675
9810,35.0,329,9068,9397,22,377,12255,3612,8643,12255,863,0.026846185230518155,0.7399428804569563,0.001795185638514892,0.29473684210526313,0.7052631578947368,0.03076295389636883
9811,15.0,425,6225,6650,42,367,9367,2467,6900,9367,575,0.045372050816696916,0.6645670972563253,0.00448382619835593,0.26337141027009714,0.7366285897299029,0.03918010035230063
9812,26.0,122,2740,2862,20,117,4027,1096,2931,4027,240,0.030295505338962008,0.6804072510553762,0.004966476285075739,0.27216290042215047,0.7278370995778495,0.02905388626769307
9813,16.0,532,8913,9445,215,635,13062,3604,9458,13062,843,0.04072883172561629,0.6823610473128158,0.016459960189863728,0.27591486755473893,0.7240851324452611,0.04861430102587659
9814,,60,2961,3021,26,345,4170,1079,3091,4170,207,0.014388489208633094,0.7100719424460432,0.006235011990407674,0.25875299760191844,0.7412470023980815,0.08273381294964029
9815,25.0,125,3176,3301,27,126,4321,1223,3098,4321,318,0.028928488775746355,0.7350150428141634,0.006248553575561213,0.2830363341819023,0.7169636658180977,0.029159916685952327
9816,17.0,176,5339,5515,11,303,7406,2134,5272,7406,578,0.023764515257899,0.7209019713745611,0.0014852822036186875,0.2881447475020254,0.7118552524979747,0.04091277342695112
9817,,186,2784,2970,18,225,4058,1103,2955,4058,240,0.04583538689009364,0.6860522424839822,0.004435682602267127,0.27180877279448,0.72819122720552,0.05544603252833908
9818,24.0,3348,72330,75678,278,2885,100840,29058,71782,100840,8071,0.0332011106703689,0.717274890916303,0.002756842522808409,0.2881594605315351,0.7118405394684649,0.028609678698928998
9819,,531,10286,10817,75,652,15100,4051,11049,15100,1068,0.03516556291390729,0.6811920529801324,0.004966887417218543,0.26827814569536423,0.7317218543046358,0.043178807947019865
9820,,125,3899,4024,29,148,5236,1601,3635,5236,369,0.02387318563789152,0.7446524064171123,0.005538579067990833,0.3057677616501146,0.6942322383498855,0.02826585179526356
9821,16.0,913,9587,10500,46,872,14322,4016,10306,14322,822,0.06374807987711213,0.6693897500349113,0.003211841921519341,0.28040776427873204,0.719592235721268,0.060885351207931857
9822,,729,18528,19257,48,989,25622,7256,18366,25622,1939,0.0284521114667083,0.7231285613925533,0.0018733900554211225,0.283194130044493,0.716805869955507,0.03859964093357271
9823,27.0,223,2556,2779,2,147,3689,1084,2605,3689,256,0.06044998644619138,0.6928706966657631,0.0005421523448088912,0.2938465708864191,0.7061534291135809,0.03984819734345351
9824,14.0,142,3633,3775,4,155,5058,1467,3591,5058,366,0.02807433768287861,0.7182680901542111,0.0007908264136022143,0.2900355871886121,0.7099644128113879,0.030644523527085805
9825,17.0,371,9309,9680,121,382,13160,3625,9535,13160,1003,0.028191489361702127,0.7073708206686931,0.009194528875379939,0.2754559270516717,0.7245440729483282,0.029027355623100305
9826,35.0,766,22705,23471,91,683,30133,9041,21092,30133,2454,0.025420635184017524,0.7534928483722165,0.003019944910895032,0.30003650482859323,0.6999634951714068,0.022666179935618758
9827,,61022,1032595,1093617,3698,75387,1497742,415719,1082024,1497743,104871,0.04074263742177396,0.6894340350781142,0.002469048428201634,0.2775636407581274,0.7224363592418725,0.050333735494006646
9828,16.0,108,7983,8091,20,1049,11519,3163,8356,11519,764,0.009375813872732008,0.6930289087594409,0.001736261828283705,0.274589808143068,0.725410191856932,0.09106693289348033
9829,24.0,1153,24945,26098,131,1023,34464,10017,24447,34464,2368,0.033455199628597956,0.7237987465181058,0.003801067780872795,0.29065111420612816,0.7093488857938719,0.029683147632311977
9830,14.0,89,4181,4270,11,417,6026,1649,4377,6026,464,0.014769332890806505,0.693826750746764,0.0018254231662794558,0.2736475273813475,0.7263524726186525,0.06920013275804845
9831,,3914,105423,109337,1032,5495,146710,42015,104695,146710,11061,0.026678481357780656,0.7185808738327313,0.007034285324790402,0.28638129643514415,0.7136187035648558,0.03745484288732874
9832,13.0,507,28750,29257,92,3379,39944,10779,29165,39944,2633,0.01269276987782896,0.719757660725015,0.002303224514320048,0.26985279391147604,0.7301472060885239,0.08459343080312437
9833,39.0,557,15953,16510,98,748,22096,6420,15676,22096,1433,0.025208182476466327,0.7219858797972484,0.00443519188993483,0.29055032585083274,0.7094496741491673,0.03385228095582911
9834,25.0,382,13270,13652,83,684,17908,5115,12793,17908,1341,0.021331248603975877,0.7410096046459683,0.004634800089345544,0.2856265356265356,0.7143734643734644,0.03819522001340183
9835,,3,2075,2078,0,77,2769,784,1985,2769,258,0.0010834236186348862,0.7493680028891296,0.0,0.28313470566991694,0.7168652943300831,0.027807872878295413
9836,,339,25467,25806,132,1808,34512,9718,24794,34512,2631,0.009822670375521557,0.7379172461752433,0.0038247566063977748,0.28158321743161796,0.718416782568382,0.052387575336114975
9837,23.0,65,3650,3715,6,632,5214,1218,3996,5214,297,0.012466436517069428,0.7000383582662064,0.0011507479861910242,0.2336018411967779,0.766398158803222,0.12121212121212122
9838,,1205,21913,23118,197,1248,30644,8812,21918,30730,2141,0.0392124959323137,0.7130816791409047,0.006410673608851286,0.28675561340709405,0.713244386592906,0.040611780019524896
9839,25.0,488,31054,31542,132,1547,42119,11925,30194,42119,3200,0.011586219995726394,0.7372919584985399,0.0031339775398276314,0.283126380018519,0.716873619981481,0.03672926707661625
9840,15.0,451,34634,35085,64,1668,48171,13328,34843,48171,4631,0.009362479500114177,0.7189802993502314,0.0013286001951381536,0.2766809906375205,0.7233190093624795,0.03462664258578813
9841,24.0,364,9635,9999,14,371,12847,3856,8991,12847,986,0.028333463065307075,0.7499805402039387,0.0010897485794348874,0.3001478944500662,0.6998521055499338,0.02887833735502452
9842,15.0,292,5786,6078,10,283,8132,2358,5774,8132,596,0.03590752582390556,0.7115100836202656,0.0012297097884899164,0.2899655681259223,0.7100344318740777,0.03480078701426463
9843,17.0,1511,28178,29689,181,1805,41014,11199,29815,41014,2449,0.03684107865606866,0.6870336958111865,0.004413127224850051,0.2730531038182084,0.7269468961817915,0.044009362656653825
9844,13.0,262,14303,14565,84,1392,19674,5330,14344,19674,1287,0.013317068211853206,0.7270001016570092,0.004269594388533089,0.2709159296533496,0.7290840703466503,0.07075327843854834
9845,26.0,223,5010,5233,12,289,7072,1980,5092,7072,540,0.03153280542986425,0.7084276018099548,0.0016968325791855204,0.27997737556561086,0.7200226244343891,0.040865384615384616
9846,,863,17619,18482,88,1015,24778,7052,17726,24778,1692,0.034829284042295586,0.7110743401404471,0.0035515376543708128,0.2846073129388974,0.7153926870611026,0.040963758172572445
9847,23.0,1001,42737,43738,130,1106,56340,16693,39647,56340,5064,0.017767128150514733,0.7585552005679801,0.0023074192403265887,0.2962903798367057,0.7037096201632943,0.019630812921547745
9848,27.0,385,9460,9845,50,679,13366,3704,9662,13366,870,0.028804429148585966,0.7077659733652552,0.0037408349543618137,0.27712105341912313,0.7228789465808768,0.05080053868023343
9849,,407,7124,7531,30,708,10713,2790,7923,10713,641,0.03799122561374031,0.6649864650424717,0.002800336040324839,0.26043125175021004,0.73956874824979,0.0660879305516662
9850,,177,18984,19161,76,1144,25762,7377,18385,25762,2553,0.006870584581942396,0.7368993090598556,0.002950081515410294,0.2863519913050229,0.7136480086949771,0.0444064901793339
9851,23.0,131,2867,2998,9,155,3900,1197,2703,3900,298,0.03358974358974359,0.7351282051282051,0.002307692307692308,0.3069230769230769,0.693076923076923,0.03974358974358974
9852,,1107,58855,59962,628,2315,78890,22275,56615,78890,6412,0.014032196729623527,0.7460387881860819,0.007960451261249842,0.2823551780960832,0.7176448219039169,0.029344657117505387
9853,25.0,4271,71386,75657,511,4780,101270,28321,72949,101270,6518,0.0421743853066061,0.704907672558507,0.005045916855929693,0.2796583390935124,0.7203416609064877,0.04720055297718969
9854,23.0,3838,84498,88336,738,5435,122920,33645,89275,122920,7612,0.03122356003904979,0.6874227139602994,0.006003904978848031,0.2737146111291897,0.7262853888708103,0.04421575008135373
9855,39.0,3298,68098,71396,632,3652,96058,27149,68909,96058,6706,0.03433342355660122,0.7089258572945512,0.006579358304357784,0.28263132690666054,0.7173686730933394,0.038018697037206686
9856,24.0,16739,261288,278027,1255,19623,374595,105026,269574,374600,24610,0.04468499733048585,0.6975120128136679,0.0033502402562733584,0.28036839295248267,0.7196316070475174,0.05238387613454351
9857,15.0,1136,16798,17934,176,1055,24369,6729,17640,24369,1482,0.04661660306126636,0.6893183963231975,0.007222290615125774,0.2761295088021667,0.7238704911978333,0.04329270794862325
9858,16.0,70,2185,2255,1,134,3167,863,2304,3167,199,0.022102936532996525,0.6899273760656773,0.00031575623618566466,0.2724976318282286,0.7275023681717714,0.04231133564887907
9859,15.0,406,7863,8269,74,745,12189,3199,8990,12189,711,0.033308720977930924,0.6450898350972188,0.0060710476659282964,0.26244974977438673,0.7375502502256133,0.061120682582656495
9860,33.0,176,2660,2836,14,141,3738,1094,2644,3738,247,0.047084002140181914,0.7116104868913857,0.003745318352059925,0.2926698769395399,0.7073301230604602,0.0377207062600321
9861,47.0,133,3786,3919,10,225,5194,1504,3690,5194,392,0.025606469002695417,0.7289179822872546,0.0019252984212552945,0.2895648825567963,0.7104351174432036,0.04331921447824413
9862,26.0,169,6803,6972,13,300,8948,2787,6161,8948,636,0.018886902101028162,0.760281627179258,0.0014528386231560126,0.3114662494412159,0.6885337505587841,0.03352704514975414
9863,16.0,73,3885,3958,15,94,5129,1466,3663,5129,481,0.014232793916942875,0.7574575940729187,0.002924546695262234,0.28582569701696237,0.7141743029830376,0.01832715929031
9864,,74,2118,2192,2,121,2935,807,2128,2935,186,0.025212947189097105,0.7216354344122657,0.0006814310051107325,0.2749574105621806,0.7250425894378194,0.04122657580919932
9865,14.0,1730,37334,39064,207,2544,53252,14567,38685,53252,3824,0.03248704274017877,0.7010816495155111,0.0038871779463682116,0.2735484113272741,0.7264515886727259,0.04777285360174266
9866,15.0,646,14798,15444,57,1600,21996,5955,16041,21996,1815,0.029368976177486815,0.6727586833969813,0.002591380250954719,0.27073104200763776,0.7292689579923622,0.07274049827241316
9867,,495,50882,51377,239,2838,68654,19659,48995,68654,5514,0.0072100678765985955,0.7411367145395753,0.0034812246919334634,0.28634893815364,0.71365106184636,0.04133772249249862
9868,25.0,6827,142513,149340,430,9712,205414,57243,148171,205414,15151,0.03323531989056248,0.693784260079644,0.0020933334631524627,0.2786713661191545,0.7213286338808456,0.04728012696310865
9869,,843,18988,19831,59,718,26622,7683,18939,26622,2093,0.031665539779130045,0.7132446848471189,0.0022162121553602285,0.2885958981293667,0.7114041018706333,0.026970175043197354
9870,24.0,193,3759,3952,12,253,5324,1523,3801,5324,360,0.036250939143501124,0.7060480841472577,0.002253944402704733,0.28606311044327576,0.7139368895567243,0.047520661157024795
9871,17.0,713,27797,28510,174,1453,37350,10930,26420,37350,2910,0.019089692101740295,0.7442302543507363,0.00465863453815261,0.2926372155287818,0.7073627844712183,0.03890227576974565
9872,16.0,273,6564,6837,5,276,8902,2554,6348,8902,603,0.03066726578297012,0.7373623904740507,0.0005616715344866322,0.28690181981577173,0.7130981801842282,0.0310042687036621
9873,23.0,3195,89219,92414,356,4305,122909,35447,87462,122909,9206,0.02599484171216103,0.7258947676736447,0.002896451846488052,0.2884003612428707,0.7115996387571293,0.03502591348070524
9874,17.0,7645,122794,130439,253,7908,175805,50472,125333,175805,11883,0.04348568015699212,0.6984670515628111,0.0014390944512385883,0.2870908108415574,0.7129091891584426,0.04498165581183698
9875,24.0,8057,174676,182733,517,7700,239841,68832,171009,239841,15759,0.03359308875463328,0.7282991648633886,0.002155594748187341,0.2869901309617622,0.7130098690382378,0.03210460263257742
9876,,75,2439,2514,18,115,3581,955,2626,3581,306,0.020943870427254957,0.6810946662943312,0.00502652890254119,0.2666852834403798,0.7333147165596202,0.032113934655124264
9877,23.0,215,4691,4906,32,269,6864,1884,4980,6864,433,0.031322843822843824,0.683420745920746,0.004662004662004662,0.2744755244755245,0.7255244755244755,0.03918997668997669
9878,26.0,468,15867,16335,37,1690,22734,6198,16536,22734,1774,0.02058590657165479,0.6979414093428346,0.0016275182545966395,0.27263130113486406,0.7273686988651359,0.07433799595319786
9879,24.0,247,6057,6304,26,438,8530,2381,6149,8530,659,0.028956623681125438,0.7100820633059789,0.0030480656506447833,0.2791324736225088,0.7208675263774912,0.05134818288393904
9880,45.0,249,4792,5041,25,316,6811,1918,4893,6811,464,0.036558508295404496,0.7035677580384672,0.003670532961385993,0.2816032887975334,0.7183967112024666,0.046395536631918956
9881,17.0,218,10777,10995,0,323,14334,4356,9978,14334,1375,0.015208594949072136,0.7518487512208735,0.0,0.30389284219338636,0.6961071578066137,0.022533835635551835
9882,23.0,457,43836,44293,112,1494,59277,16647,42630,59277,4641,0.007709566948394825,0.7395111088617845,0.0018894343505912918,0.2808340503061896,0.7191659496938104,0.025203704640923124
9883,,304,2397,4102,185,958,6134,804,5330,6134,14,0.049559830453211606,0.39077274209325075,0.03015976524290838,0.13107270948809913,0.8689272905119009,0.15617867623084447
9884,17.0,48,2245,2293,2,118,3067,880,2187,3067,315,0.0156504727746984,0.7319856537332898,0.0006521030322791001,0.286925334202804,0.7130746657971959,0.038474078904466906
9885,46.0,149,4099,4248,22,226,5513,1538,3975,5513,370,0.02702702702702703,0.7435153274079449,0.0039905677489570105,0.27897696354072193,0.7210230364592781,0.04099401414837656
9886,,169,4517,4686,13,146,6124,1789,4335,6124,512,0.02759634225996081,0.7375898105813194,0.002122795558458524,0.29212932723709994,0.7078706727629,0.023840627041149576
9887,27.0,383,7616,7999,26,433,10570,3006,7564,10570,776,0.03623462630085147,0.7205298013245033,0.0024597918637653737,0.2843897824030274,0.7156102175969725,0.04096499526963103
9888,,1152,30551,31703,227,1527,41504,12038,29466,41504,2940,0.027756360832690823,0.7360977255204317,0.0054693523515805705,0.29004433307633,0.70995566692367,0.036791634541249035
9889,15.0,111,12375,12486,242,323,17100,4735,12365,17100,1361,0.006491228070175438,0.7236842105263158,0.014152046783625732,0.27690058479532165,0.7230994152046784,0.01888888888888889
9890,,2701,49775,52476,139,2743,71650,20252,51398,71650,4943,0.037697138869504536,0.6946964410327984,0.0019399860432658758,0.2826517794836008,0.7173482205163991,0.038283321702721564
9891,,595,23312,23907,220,1743,32406,9085,23321,32406,2347,0.018360797383200643,0.7193729556255014,0.006788866259334691,0.2803493180275258,0.7196506819724743,0.05378633586372894
9892,25.0,424,11663,12087,41,627,16202,4491,11711,16202,1024,0.02616960869028515,0.7198494013084804,0.0025305517837304037,0.27718800148129863,0.7228119985187014,0.038698926058511295
9893,24.0,368,9020,9388,129,309,12548,3624,8924,12548,896,0.029327382849856552,0.7188396557220275,0.010280522792476888,0.28881096589097865,0.7111890341090213,0.024625438316863243
9894,33.0,279,4676,4955,21,317,6957,1913,5044,6957,437,0.040103492884864166,0.6721287911456088,0.00301854247520483,0.2749748454793733,0.7250251545206267,0.04556561736380624
9895,24.0,161,1684,1845,7,179,2549,711,1838,2549,147,0.06316202432326402,0.6606512357787367,0.002746174970576697,0.2789329148685759,0.721067085131424,0.07022361710474696
9896,,313,6225,6538,154,915,9480,2419,7061,9480,470,0.0330168776371308,0.6566455696202531,0.016244725738396623,0.255168776371308,0.744831223628692,0.09651898734177215
9897,25.0,728,16536,17264,54,1206,23131,6585,16546,23131,1760,0.0314729151355324,0.7148847866499503,0.002334529419393887,0.284682893087199,0.715317106912801,0.05213782369979681
9898,,170,3134,3304,1,241,4531,1262,3269,4531,312,0.03751931141028471,0.6916795409401898,0.00022070183182520416,0.2785257117634076,0.7214742882365923,0.0531891414698742
9899,23.0,889,25146,26035,94,1251,34092,9800,24292,34092,2727,0.026076498885369,0.7375923970432946,0.0027572451014900856,0.2874574680276898,0.7125425319723102,0.0366948257655755
9900,16.0,77,2250,2327,7,72,3265,906,2359,3265,274,0.02358346094946401,0.6891271056661562,0.0021439509954058193,0.2774885145482389,0.7225114854517611,0.022052067381316997
9901,,376,6967,7343,42,284,9776,2819,6957,9776,756,0.038461538461538464,0.712663666121113,0.004296235679214402,0.2883592471358429,0.7116407528641571,0.02905073649754501
9902,25.0,267,7511,7778,17,323,10282,3005,7277,10282,873,0.02596771056214744,0.7304999027426571,0.0016533748297996498,0.29225831550282044,0.7077416844971796,0.03141412176619335
9903,17.0,4598,214459,219057,2259,10371,297835,82411,215424,297835,25227,0.015438078130508502,0.720059764634781,0.007584736515184582,0.2767001863447882,0.7232998136552118,0.034821293669313545
9904,24.0,2562,56330,58892,228,3445,80513,22403,58110,80513,5589,0.031820948169860766,0.6996385676847218,0.002831840820737024,0.27825320134636644,0.7217467986536336,0.042788121172978276
9905,24.0,414,6729,7143,50,502,9612,2709,6903,9612,710,0.04307116104868914,0.7000624219725343,0.005201831044527674,0.2818352059925094,0.7181647940074907,0.05222638368705784
9906,26.0,97,4133,4230,3,144,5408,1627,3781,5408,387,0.01793639053254438,0.7642381656804734,0.0005547337278106509,0.30085059171597633,0.6991494082840237,0.026627218934911243
9907,15.0,111,6727,6838,21,306,9202,2556,6646,9202,832,0.012062595088024342,0.7310367311454031,0.0022821125842208217,0.27776570310802,0.72223429689198,0.03325364051293197
9908,26.0,1206,28609,29815,95,1433,39357,11180,28177,39357,2516,0.030642579464898238,0.7269100795284194,0.002413801864979546,0.2840663668470666,0.7159336331529335,0.036410295500165155
9909,23.0,1763,45374,47137,138,1735,62232,18045,44195,62240,5256,0.028325835475578407,0.7290167095115682,0.0022172236503856043,0.28992609254498714,0.7100739074550129,0.027875964010282778
9910,36.0,1009,17559,18568,48,594,23809,7089,16720,23809,1651,0.0423789323365114,0.7374942248729472,0.0020160443529757656,0.2977445503801084,0.7022554496198916,0.0249485488680751
9911,35.0,154,2947,3101,24,153,4160,1202,2958,4160,328,0.03701923076923077,0.7084134615384615,0.0057692307692307696,0.28894230769230766,0.7110576923076923,0.036778846153846155
9912,34.0,606,11647,12253,70,653,16793,4773,12020,16793,1241,0.036086464598344546,0.6935627940213184,0.004168403501458941,0.2842255701780504,0.7157744298219496,0.03888524980646698
9913,25.0,1307,19899,21206,315,893,27812,7863,19949,27812,1912,0.04699410326477779,0.7154825255285489,0.011326046310944917,0.28271968934272973,0.7172803106572703,0.032108442398964473
9914,17.0,573,23925,24498,80,1915,32673,9405,23268,32673,2105,0.01753741621522358,0.7322559911853824,0.002448504881706608,0.28785235515563307,0.7121476448443669,0.058611085605851924
9915,33.0,541,17809,18350,82,810,23700,6966,16734,23700,1705,0.022827004219409284,0.7514345991561181,0.003459915611814346,0.2939240506329114,0.7060759493670886,0.03417721518987342
9916,37.0,2490,64190,66680,190,3704,89765,25112,64655,89767,7287,0.027738478505464147,0.7150734679782103,0.0021165907293326054,0.2797464547105284,0.7202535452894716,0.0412623792707788
9917,17.0,927,37953,39059,231,2842,52763,14634,38129,52763,3626,0.01756912988268294,0.7193108807308152,0.00437806796429316,0.2773534484392472,0.7226465515607527,0.05386350283342494
9918,,606,3334,3940,44,389,5714,1465,4249,5714,375,0.10605530276513826,0.583479173958698,0.0077003850192509625,0.25638781939096955,0.7436121806090304,0.06807840392019601
9919,14.0,403,14269,14672,102,692,19443,5558,13885,19443,1558,0.020727254024584682,0.7338888031682353,0.005246103996296868,0.28586123540605873,0.7141387645939412,0.035591215347425806
9920,,55,1613,1668,0,113,2236,613,1623,2236,173,0.024597495527728087,0.7213774597495528,0.0,0.27415026833631484,0.7258497316636852,0.050536672629695883
9921,36.0,3010,58411,61421,133,2692,81073,23464,57609,81073,6180,0.03712703366102155,0.7204741405893454,0.0016404968361846731,0.28941817867847497,0.710581821321525,0.03320464272939203
9922,,56,3354,3410,7,129,4503,1302,3201,4503,405,0.01243615367532756,0.7448367754830113,0.001554519209415945,0.28914057295136575,0.7108594270486343,0.028647568287808126
9923,23.0,33,10632,10665,29,454,14160,3997,10163,14160,1276,0.0023305084745762713,0.7508474576271187,0.0020480225988700564,0.282274011299435,0.7177259887005649,0.032062146892655366
9924,26.0,94,2904,2998,35,276,4031,1110,2921,4031,251,0.023319275613991566,0.72041677003225,0.008682709005209625,0.27536591416521955,0.7246340858347805,0.06846936244108162
9925,,278,9107,9385,45,619,12817,3633,9184,12817,1060,0.021689943044394165,0.7105406881485528,0.0035109620035889836,0.2834516657564173,0.7165483342435828,0.048295232893812906
9926,17.0,1246,11315,12561,45,811,16612,4830,11782,16612,1155,0.07500601974476283,0.6811341199133156,0.0027088851432699253,0.2907536720443053,0.7092463279556946,0.04882013002648688
9927,,1581,31017,32598,254,2223,44681,11991,32690,44681,2762,0.035384167767059826,0.6941876860410465,0.005684742955618719,0.2683691054363152,0.7316308945636848,0.049752691300552807
9928,35.0,261,3051,3312,66,106,4145,1291,2854,4145,180,0.06296743063932449,0.7360675512665863,0.015922798552472858,0.31145958986731004,0.68854041013269,0.0255729794933655
9929,26.0,2302,49731,52033,111,1943,66699,20217,46482,66699,4567,0.03451326106838183,0.7456033823595556,0.001664192866459767,0.30310799262357757,0.6968920073764224,0.029130871527309254
9930,23.0,229,175038,175267,499,6681,240466,67410,173056,240466,22867,0.000952317583358978,0.7279116382357589,0.0020751374414678166,0.2803306912411734,0.7196693087588266,0.02778355360009315
9931,,157,3270,3427,10,309,4952,1268,3684,4952,395,0.031704361873990304,0.6603392568659128,0.0020193861066235864,0.2560581583198708,0.7439418416801292,0.062399030694668824
9932,,220,4394,4614,46,208,6409,1729,4680,6409,447,0.03432672803869558,0.6855983772819473,0.007177406771727258,0.2697768762677485,0.7302231237322515,0.032454361054766734
9933,,109,1748,2360,5,139,3203,718,2485,3203,163,0.034030596315953794,0.5457383702778645,0.0015610365282547611,0.22416484545738372,0.7758351545426163,0.04339681548548236
9934,15.0,522,10204,10726,11,474,14284,4182,10102,14284,1108,0.036544385326239145,0.7143657238868665,0.0007700924110893308,0.2927751330159619,0.7072248669840381,0.03318398207784934
9935,17.0,191,4221,4412,31,319,5889,1695,4194,5889,413,0.032433350314145015,0.716760061130922,0.005264051621667516,0.28782475802343355,0.7121752419765665,0.054168789268127016
9936,42.0,90,1567,1657,4,175,2288,574,1714,2288,152,0.039335664335664336,0.6848776223776224,0.0017482517482517483,0.2508741258741259,0.7491258741258742,0.07648601398601398
9937,26.0,2392,75815,78207,282,2874,101593,29830,71763,101593,7677,0.02354492927662339,0.7462620456133788,0.0027757817959898814,0.29362259210772396,0.706377407892276,0.0282893506442373
9938,23.0,114,2084,2198,61,133,3358,883,2475,3358,189,0.033948779035139966,0.6206075044669446,0.01816557474687314,0.26295413936867185,0.7370458606313282,0.03960690887432996
9939,25.0,2889,75325,78214,234,3270,101408,29576,71832,101408,7226,0.02848887661722941,0.742791495739981,0.002307510255601136,0.29165351846008203,0.708346481539918,0.032245976648785105
9940,45.0,1114,21692,22806,41,1359,30758,8432,22326,30758,1976,0.036218219650172315,0.7052474153065869,0.001332986540087132,0.27414006112230965,0.7258599388776904,0.04418362702386371
9941,16.0,76,1801,1877,4,68,2441,801,1641,2442,188,0.031122031122031123,0.7375102375102375,0.001638001638001638,0.32800982800982803,0.671990171990172,0.027846027846027847
9942,16.0,2914,39199,42113,277,3271,59190,15211,43979,59190,3235,0.04923128906909951,0.6622571380300727,0.004679844568339246,0.25698597736104073,0.7430140226389593,0.05526271329616489
9943,,398,6309,6707,18,382,11085,2195,8890,11085,351,0.035904375281912496,0.5691474966170501,0.0016238159675236806,0.1980153360396933,0.8019846639603068,0.03446098331078033
9944,,75,1946,2021,4,95,2681,762,1919,2681,208,0.027974636329727715,0.7258485639686684,0.0014919806042521448,0.28422230511003355,0.7157776948899665,0.035434539350988434
9945,16.0,240,1524,1764,2,127,2420,635,1785,2420,97,0.09917355371900827,0.6297520661157024,0.0008264462809917355,0.26239669421487605,0.737603305785124,0.052479338842975204
9946,23.0,780,18853,19633,82,759,26317,7438,18879,26317,2254,0.029638636622715354,0.7163810464718623,0.003115856670593153,0.2826309989740472,0.7173690010259528,0.028840673329026865
9947,45.0,775,25768,26543,69,955,34047,9989,24058,34047,2439,0.02276265162863101,0.7568361382794373,0.0020266102740329546,0.2933885511205099,0.7066114488794901,0.02804946103915176
9948,,555,16871,17426,78,842,23009,6567,16442,23009,1699,0.024120996131948368,0.7332348211569386,0.003389977834760311,0.2854100569342431,0.7145899430657568,0.03659437611369464
9949,24.0,5927,175563,181490,481,8294,236480,69866,166614,236480,17591,0.025063430311231392,0.742401048714479,0.002033998646820027,0.2954414749661705,0.7045585250338295,0.03507273342354533
9950,23.0,131,3702,3833,8,285,5087,1426,3661,5087,358,0.02575191665028504,0.7277373697660704,0.001572636131315117,0.2803223904069196,0.7196776095930804,0.056025162178101044
9951,,1233,16917,18150,62,732,24684,7078,17612,24690,1616,0.04993924665856622,0.685176184690158,0.002511138112596193,0.2866747671121912,0.7133252328878088,0.029647630619684083
9952,27.0,136,3099,3235,21,188,4298,1242,3056,4298,294,0.0316426244765007,0.7210330386226151,0.004885993485342019,0.2889716147045137,0.7110283852954863,0.043741275011633315
9953,24.0,72,1743,1815,5,75,2544,668,1876,2544,203,0.02830188679245283,0.6851415094339622,0.0019654088050314465,0.26257861635220126,0.7374213836477987,0.0294811320754717
9954,15.0,113,10959,11072,41,1338,15646,4154,11492,15646,1120,0.007222293237888278,0.7004346158762623,0.0026204780774638885,0.2654991691167071,0.7345008308832929,0.08551706506455324
9955,24.0,482,17750,18232,13,548,23949,7009,16940,23949,2131,0.020126101298592842,0.7411582947095913,0.0005428201595056161,0.29266357676729715,0.7073364232327028,0.02288195749300597
9956,15.0,57,2804,2861,10,205,3868,1107,2761,3868,306,0.014736297828335057,0.7249224405377456,0.0025853154084798345,0.2861944157187177,0.7138055842812823,0.05299896587383661
9957,15.0,55,1590,1645,2,189,2320,607,1713,2320,137,0.023706896551724137,0.6853448275862069,0.0008620689655172414,0.26163793103448274,0.7383620689655173,0.0814655172413793
9958,26.0,901,17619,18520,188,1057,24756,7066,17690,24756,1764,0.03639521732105348,0.7117062530295686,0.007594118597511714,0.285425755372435,0.714574244627565,0.04269671998707384
9959,39.0,1161,30235,31396,173,1942,41187,11803,29384,41187,2556,0.02818850608201617,0.7340908539102143,0.004200354480782771,0.2865710054143298,0.7134289945856702,0.0471508000097118
9960,15.0,497,16895,33258,562,1076,41427,6798,34650,41448,1338,0.011990928392202277,0.4076191854854275,0.013559158463617063,0.16401273885350318,0.8359872611464968,0.025960239336035515
9961,24.0,368,6164,6532,61,359,9059,2465,6594,9059,584,0.04062258527431284,0.68042830334474,0.006733635059057291,0.27210508886190526,0.7278949111380947,0.03962909813445192
9962,41.0,402,11308,11710,71,638,15368,4540,10828,15368,1046,0.026158250910983862,0.7358146798542425,0.004619989588755856,0.2954190525767829,0.7045809474232171,0.04151483602290474
9963,24.0,82,2378,2460,23,92,3449,940,2509,3449,285,0.02377500724847782,0.6894752102058568,0.006668599594085242,0.27254276601913596,0.727457233980864,0.026674398376340967
9964,,133,4214,4347,3,141,5710,1692,4018,5710,448,0.02329246935201401,0.7380035026269702,0.0005253940455341507,0.2963222416812609,0.703677758318739,0.02469352014010508
9965,,50,2414,2464,2,59,3143,966,2177,3143,306,0.01590836780146357,0.7680559974546611,0.0006363347120585428,0.30734966592427615,0.6926503340757239,0.018771874005727014
9966,23.0,1650,43424,45074,165,2284,58838,17058,41780,58838,4258,0.028043101397056323,0.7380264454944083,0.0028043101397056324,0.28991468098847684,0.7100853190115232,0.03881845066113736
9967,27.0,0,1978,1978,0,86,2560,748,1812,2560,204,0.0,0.77265625,0.0,0.2921875,0.7078125,0.03359375
9968,15.0,565,16085,16650,60,1083,23269,6305,16964,23269,1689,0.024281232541149167,0.6912630538484679,0.002578537968971593,0.27096136490609823,0.7290386350939018,0.04654261033993726
9969,23.0,380,9739,10119,13,482,13241,3775,9466,13241,972,0.028698738765954232,0.735518465372706,0.0009817989577826447,0.2850993127407295,0.7149006872592705,0.036402084434710366
9970,13.0,1393,21652,23045,110,2217,32112,8574,23538,32112,2079,0.04337942202291978,0.674265072247135,0.003425510712506228,0.2670029895366218,0.7329970104633782,0.06903961136023916
9971,,1171,16816,17987,94,1242,24134,6278,17856,24134,1581,0.04852075909505262,0.6967763321455208,0.00389492002983343,0.26013093560951356,0.7398690643904865,0.051462666777160854
9972,,848,14176,15024,109,773,20644,5605,15039,20644,1435,0.041077310598721176,0.6866886262352258,0.005279984499128076,0.27150745979461344,0.7284925402053866,0.03744429374152296
9973,,117,2099,2216,0,124,2968,862,2106,2968,217,0.039420485175202157,0.7072102425876011,0.0,0.29043126684636117,0.7095687331536388,0.04177897574123989
9974,40.0,482,10393,10875,67,521,14688,4201,10487,14688,985,0.03281590413943355,0.7075844226579521,0.004561546840958605,0.2860157952069717,0.7139842047930284,0.03547113289760349
9975,25.0,304,5666,5970,29,280,7894,2264,5630,7894,573,0.038510260957689384,0.7177603242969344,0.0036736762097795794,0.286800101342792,0.713199898657208,0.0354699771978718
9976,23.0,1062,36425,37487,78,1413,47794,14252,33542,47794,3351,0.022220362388584342,0.762124952922961,0.0016320040172406577,0.2981964263296648,0.7018035736703352,0.0295643804661673
9977,43.0,1355,49414,50769,121,2693,65623,19358,46265,65623,4848,0.020648248327568078,0.7529981866114015,0.0018438657178123524,0.2949880377306737,0.7050119622693263,0.04103744114106335
9978,24.0,75,2140,2215,5,125,2992,855,2137,2992,242,0.025066844919786096,0.7152406417112299,0.0016711229946524064,0.2857620320855615,0.7142379679144385,0.04177807486631016
9979,43.0,4224,109077,113301,503,5207,149045,42724,106321,149045,10907,0.028340434097084772,0.7318393773692509,0.003374819685329934,0.28665168237780536,0.7133483176221946,0.034935757657083434
9980,,2406,46113,48519,295,3129,64983,19176,45807,64983,3876,0.037025068094732466,0.7096163612021605,0.004539648831232784,0.2950925626702368,0.7049074373297631,0.04815105489127926
9981,,119,3785,3904,12,134,5136,1452,3684,5136,364,0.023169781931464174,0.7369548286604362,0.002336448598130841,0.2827102803738318,0.7172897196261683,0.026090342679127725
9982,,2382,29024,31406,186,2142,42474,11784,30690,42474,2701,0.05608136742477751,0.6833356877148373,0.004379149597400763,0.2774403164288741,0.7225596835711259,0.05043085181522814
9983,,0,3486,3486,13,175,4581,1369,3212,4581,392,0.0,0.7609692206941716,0.0028378083387906572,0.29884304736956996,0.70115695263043,0.038201266099105
9984,15.0,516,12760,13276,84,774,17529,5022,12507,17529,1124,0.029436933082320725,0.7279365622682412,0.004792058873866164,0.2864966626732843,0.7135033373267158,0.04415539962348109
9985,33.0,94,2741,2835,9,126,3680,1068,2612,3680,287,0.025543478260869567,0.7448369565217391,0.0024456521739130437,0.2902173913043478,0.7097826086956521,0.034239130434782605
9986,33.0,93,2447,2540,2,149,3404,985,2419,3404,222,0.027320799059929495,0.7188601645123385,0.0005875440658049354,0.2893654524089307,0.7106345475910694,0.043772032902467686
9987,16.0,797,13123,13920,9,979,18997,5274,13723,18997,1245,0.04195399273569511,0.690793283149971,0.00047375901458124965,0.2776227825446123,0.7223772174553877,0.05153445280833816
9988,,479,9787,10266,26,752,13801,3688,10113,13801,854,0.03470762988189262,0.7091515107600899,0.0018839214549670313,0.26722701253532355,0.7327729874646765,0.054488805159046444
9989,14.0,7755,35375,43130,154,4636,64907,17639,47268,64907,2987,0.11947863866763216,0.5450105535612492,0.0023726254487189363,0.2717580538308657,0.7282419461691343,0.07142527000169473
9990,,1459,57465,58924,164,3285,79416,22187,57230,79417,6005,0.018371381442260474,0.7235856302806704,0.002065049044914817,0.27937343389954294,0.7206265661004571,0.0413639397106413
9991,26.0,5813,177634,183447,799,8065,241472,70821,170651,241472,18669,0.02407318446859263,0.7356298038695998,0.003308872250198781,0.2932886628677445,0.7067113371322555,0.03339931751921548
9992,41.0,127,2822,2949,40,119,4029,1132,2897,4029,382,0.031521469347232565,0.70042194092827,0.009928021841648052,0.2809630181186399,0.7190369818813601,0.029535864978902954
9993,16.0,214,3308,3522,56,363,5252,1295,3957,5252,315,0.040746382330540745,0.6298552932216298,0.010662604722010662,0.24657273419649658,0.7534272658035034,0.06911652703731912
9994,16.0,228,6047,6275,32,280,8137,2405,5732,8137,611,0.02802015484822416,0.7431485805579452,0.003932653312031461,0.2955634754823645,0.7044365245176355,0.034410716480275286
9995,17.0,468,6753,7221,40,417,9608,2674,6934,9608,671,0.04870940882597835,0.7028517901748543,0.004163197335553705,0.2783097418817652,0.7216902581182348,0.043401332223147376
9996,15.0,97,3580,3677,34,156,4863,1387,3476,4863,399,0.019946535060662143,0.7361710878058811,0.006991568990335184,0.28521488792926175,0.7147851120707382,0.032078963602714373
9997,,42,17830,17872,7,1160,24024,6717,17307,24024,2114,0.0017482517482517483,0.7421744921744922,0.0002913752913752914,0.2795954045954046,0.7204045954045954,0.04828504828504829
9998,,440,9932,10372,43,607,14777,4039,10738,14777,1052,0.029776003248291265,0.6721256005955201,0.002909927590173919,0.27333017527238274,0.7266698247276172,0.041077349935710904
9999,17.0,328,4177,4505,17,247,5934,1685,4249,5934,399,0.05527468823727671,0.7039096730704415,0.0028648466464442197,0.2839568587799124,0.7160431412200876,0.04162453656892484
10000,,155,6324,6479,15,241,8604,2474,6130,8604,790,0.01801487680148768,0.7350069735006973,0.0017433751743375174,0.28754067875406786,0.7124593212459321,0.02801022780102278
10001,,1766,38551,40317,207,2321,53842,15109,38733,53842,3433,0.0327996731176405,0.7160023773262508,0.0038445822963485755,0.28061736191077596,0.719382638089224,0.04310761115857509
10002,33.0,250,6688,6938,75,299,9033,2581,6452,9033,628,0.027676298018377062,0.7403963245876232,0.008302889405513119,0.2857301007417248,0.7142698992582752,0.03310085242997897
10003,,2130,47028,49158,217,2476,65653,18665,46988,65653,4242,0.03244330038231307,0.7163115166100559,0.0033052564239257915,0.28429774724688894,0.7157022527531111,0.03771343274488599
10004,27.0,131,8659,8790,2,388,11271,3367,7904,11271,861,0.0116227486469701,0.7682548132375122,0.00017744654422855114,0.29873125720876587,0.7012687427912342,0.03442462958033892
10005,27.0,113,2484,2597,2,123,3430,1015,2415,3430,272,0.03294460641399417,0.724198250728863,0.0005830903790087463,0.29591836734693877,0.7040816326530612,0.0358600583090379
10006,,54,1590,1644,6,163,2326,634,1692,2326,208,0.023215821152192607,0.6835769561478934,0.0025795356835769563,0.2725709372312984,0.7274290627687017,0.07007738607050731
10007,23.0,474,11966,12440,31,570,16863,4776,12087,16863,1346,0.028108877423945917,0.7096009013817233,0.0018383443040977288,0.2832236256893791,0.7167763743106209,0.03380181462373243
10008,,234,2641,2875,138,279,4418,1120,3298,4418,195,0.05296514259846084,0.5977818017202354,0.03123585332729742,0.2535083748302399,0.7464916251697601,0.0631507469443187
10009,16.0,1068,10003,11071,73,842,15189,4112,11077,15189,855,0.07031404305747581,0.6585687010336427,0.0048061096846402,0.2707222331950754,0.7292777668049246,0.055434854170781485
10010,,173,3919,4092,146,167,5443,1526,3917,5443,310,0.03178394267866985,0.7200073488884806,0.02682344295425317,0.28036009553555025,0.7196399044644497,0.030681609406577257
10011,24.0,4524,104986,109510,1396,6743,148608,41736,106872,148608,10227,0.03044250645994832,0.7064626399655469,0.00939384151593454,0.28084625322997414,0.7191537467700259,0.045374407838070625
10012,16.0,633,25037,25670,97,1331,33912,9777,24135,33912,2564,0.018665958952583158,0.7382932295352678,0.002860344420853975,0.2883050247699929,0.7116949752300071,0.039248643548006605
10013,,792,15353,16145,73,937,21770,6249,15521,21770,1691,0.03638033991731741,0.7052365640790078,0.0033532384014699126,0.2870463941203491,0.7129536058796508,0.043040881947634356
10014,,2867,72442,75309,142,4803,102111,28390,73721,102111,7760,0.028077288441010272,0.709443644661202,0.0013906435153901147,0.27803077043609403,0.721969229563906,0.047037047918441696
10015,24.0,394,10395,10789,19,888,14637,4164,10473,14637,1205,0.026918084306893488,0.7101865136298422,0.0012980802076928333,0.28448452551752407,0.7155154744824759,0.06066816970690715
10016,24.0,68,1695,1763,5,101,2438,688,1750,2438,190,0.02789171452009844,0.6952420016406891,0.002050861361771944,0.28219852337981954,0.7178014766201805,0.041427399507793276
10017,13.0,4,1815,1819,8,99,2365,685,1680,2365,211,0.0016913319238900633,0.7674418604651163,0.0033826638477801266,0.28964059196617337,0.7103594080338267,0.04186046511627907
10018,34.0,392,4317,4709,17,353,6389,1827,4562,6389,530,0.06135545468774456,0.6756925966504931,0.0026608232900297386,0.2859602441696666,0.7140397558303334,0.05525121302238222
10019,,523,29210,29733,129,1632,39781,11338,28443,39781,2999,0.013146979713933787,0.7342701289560343,0.0032427540785802266,0.2850104321158342,0.7149895678841658,0.041024609738317286
10020,44.0,125,2681,2806,55,145,3751,1044,2707,3751,266,0.03332444681418288,0.7147427352705945,0.01466275659824047,0.27832577979205547,0.7216742202079446,0.038656358304452146
10021,25.0,1927,69323,71250,281,3130,94246,26944,67302,94246,7849,0.02044649109776542,0.735553763554952,0.0029815588990514184,0.28589011735246056,0.7141098826475394,0.03321095855527025
10022,17.0,81,1582,1663,14,133,2682,636,2046,2682,162,0.030201342281879196,0.5898583146905294,0.005219985085756898,0.2371364653243848,0.7628635346756152,0.04958985831469053
10023,,8950,187038,195988,879,9726,261146,74813,186352,261165,18121,0.03426952309842437,0.7161679398081673,0.003365688357934639,0.2864587521298796,0.7135412478701204,0.03724082476595256
10024,,299,6248,6547,50,286,8630,2535,6095,8630,680,0.034646581691772885,0.7239860950173812,0.005793742757821553,0.29374275782155274,0.7062572421784473,0.03314020857473928
10025,23.0,359,8179,8538,2,572,11373,3284,8089,11373,802,0.03156598962454937,0.7191594126439813,0.00017585509540138925,0.28875406664908115,0.7112459333509188,0.05029455728479733
10026,17.0,258,6095,6353,8,561,8838,2398,6440,8838,709,0.029192124915139173,0.6896356641774157,0.0009051821679112921,0.2713283548314098,0.7286716451685902,0.06347589952477936
10027,,1223,41410,42633,223,2392,55871,15862,40009,55871,3274,0.021889710225340517,0.7411716274990603,0.003991337187449661,0.28390399312702475,0.7160960068729753,0.04281290830663493
10028,41.0,4055,62164,66219,508,3615,87873,25012,62861,87873,4984,0.04614614272871075,0.7074300410820161,0.005781070408430349,0.28463805719618085,0.7153619428038192,0.04113891639070021
10029,,1832,33570,35402,74,1549,47301,13546,33763,47309,3612,0.03872413282884863,0.7095901414107252,0.001564184404658733,0.2863302965609081,0.713669703439092,0.03274218436238348
10030,,73,1578,1651,19,122,2350,629,1721,2350,131,0.031063829787234043,0.6714893617021277,0.008085106382978723,0.2676595744680851,0.7323404255319149,0.05191489361702128
10031,25.0,462,3137,3599,0,230,4807,1352,3455,4807,316,0.09610983981693363,0.6525899729561057,0.0,0.2812565009361348,0.7187434990638651,0.04784688995215311
10032,,176,5598,5774,53,247,7813,2214,5599,7813,722,0.022526558300268784,0.7164981441187764,0.006783565851785486,0.2833738640726993,0.7166261359273006,0.03161397670549085
10033,23.0,3400,74024,77424,313,4132,101746,29164,72582,101746,6605,0.03341654708784621,0.7275372004796258,0.0030762880113223124,0.28663534684410197,0.713364653155898,0.04061093310793545
10034,16.0,642,20046,20688,42,1621,27409,7678,19731,27409,2006,0.023422963260242985,0.7313656098361851,0.0015323433908570178,0.2801269655952424,0.7198730344047576,0.05914115801379109
10035,26.0,141,1798,1939,7,142,2673,705,1968,2673,175,0.052749719416386086,0.6726524504302283,0.002618780396558174,0.26374859708193044,0.7362514029180696,0.05312383090160868
10036,16.0,1207,30845,32052,154,1769,42870,12132,30738,42870,3220,0.028154886867273153,0.7195008164217401,0.0035922556566363424,0.28299510146955914,0.7170048985304409,0.041264287380452534
10037,33.0,693,20278,20971,46,1043,27867,7983,19884,27867,2152,0.024868123587038434,0.7276707216420856,0.0016506979581583953,0.28646786521692325,0.7135321347830768,0.03742778196433057
10038,25.0,137,2482,2619,6,230,3633,982,2651,3633,250,0.03770988164051748,0.6831819432975502,0.0016515276630883566,0.27030002752546106,0.729699972474539,0.063308560418387
10039,,141,3463,3604,44,200,4868,1375,3493,4868,373,0.02896466721446179,0.711380443714051,0.009038619556285949,0.2824568611339359,0.7175431388660641,0.041084634346754315
10040,,7689,176848,184537,918,9383,248189,69232,178957,248189,19272,0.03098042217825931,0.712553739287398,0.0036987940642010724,0.27894870441478065,0.7210512955852193,0.03780586569106608
10041,14.0,118,2967,3085,133,252,4456,1159,3297,4456,220,0.026481149012567325,0.6658438061041293,0.029847396768402153,0.2600987432675045,0.7399012567324955,0.05655296229802514
10042,24.0,856,16055,16911,89,1229,23359,6471,16888,23359,1806,0.036645404340939255,0.6873153816516118,0.0038100946102144783,0.2770238451988527,0.7229761548011473,0.052613553662399934
10043,25.0,1992,55133,57125,377,2025,75056,21875,53193,75068,5815,0.026535940747056,0.7344407736985133,0.0050221132839558804,0.291402461767997,0.708597538232003,0.02697554217509458
10044,,166,3153,3319,35,130,4452,1281,3171,4452,293,0.03728661275831087,0.7082210242587601,0.007861635220125786,0.28773584905660377,0.7122641509433962,0.029200359389038633
10045,,41,2081,2122,3,287,3200,760,2440,3200,215,0.0128125,0.6503125,0.0009375,0.2375,0.7625,0.0896875
10046,23.0,125,4821,4946,30,263,6524,1881,4643,6524,484,0.01916002452483139,0.7389638258736971,0.004598405885959534,0.2883200490496628,0.7116799509503372,0.04031269160024525
10047,24.0,140,3414,3554,7,203,4830,1352,3478,4830,361,0.028985507246376812,0.7068322981366459,0.0014492753623188406,0.27991718426501033,0.7200828157349897,0.042028985507246375
10048,,1421,27287,28708,117,1398,38115,11017,27098,38115,2364,0.03728191000918274,0.715912370457825,0.0030696576151121604,0.2890463072281254,0.7109536927718746,0.0366784730421094
10049,24.0,307,4676,4983,9,283,6915,1890,5025,6915,462,0.04439624005784527,0.6762111352133044,0.0013015184381778742,0.27331887201735355,0.7266811279826464,0.04092552422270427
10050,16.0,987,17909,18896,87,775,26085,7211,18874,26085,1892,0.03783783783783784,0.6865631589035844,0.003335250143760782,0.27644239984665514,0.7235576001533448,0.029710561625455243
10051,,231,5896,6127,38,237,8342,2460,5882,8342,731,0.027691201150803164,0.706784943658595,0.004555262526971949,0.29489331095660515,0.7051066890433949,0.028410453128746103
10052,27.0,134,3637,3771,11,160,4985,1399,3586,4985,377,0.026880641925777334,0.7295887662988967,0.0022066198595787363,0.280641925777332,0.719358074222668,0.0320962888665998
10053,17.0,163,3756,3919,11,186,5115,1484,3631,5115,392,0.03186705767350929,0.7343108504398826,0.002150537634408602,0.2901270772238514,0.7098729227761486,0.03636363636363636
10054,,4912,11463,16375,114,1315,22731,6178,16553,22731,1038,0.2160925608200255,0.5042892965553649,0.0050151775108882145,0.27178742686199464,0.7282125731380054,0.05785051251594738
10055,23.0,978,28260,29238,164,1129,38753,11310,27443,38753,3101,0.025236755864062137,0.7292338657652311,0.004231930431192424,0.2918483730291848,0.7081516269708151,0.029133228395221016
10056,24.0,111,3399,3510,13,97,4484,1350,3134,4484,278,0.024754683318465656,0.758028545941124,0.0028991971454058875,0.3010704727921499,0.6989295272078502,0.021632471008028547
10057,17.0,353,7709,8062,39,558,10947,3067,7880,10947,860,0.032246277518954966,0.7042111994153649,0.00356261989586188,0.2801680825797022,0.7198319174202978,0.05097286927925459
10058,14.0,1730,35937,37667,225,2202,51166,14144,37024,51168,3560,0.03381019387116948,0.7023334896810507,0.004397279549718574,0.2764227642276423,0.7235772357723578,0.04303470919324578
10059,13.0,3067,61305,64372,294,5300,89472,24138,65334,89472,5668,0.03427888054363376,0.6851864270386266,0.0032859442060085837,0.2697827253218884,0.7302172746781116,0.05923640915593705
10060,16.0,160,6589,6749,7,147,8837,2681,6156,8837,908,0.018105691976915243,0.7456150277243409,0.0007921240239900419,0.303383501188186,0.696616498811814,0.016634604503790878
10061,,797,6740,7537,150,384,10341,2767,7574,10341,562,0.07707184991780291,0.6517744898945943,0.01450536698578474,0.2675756696644425,0.7324243303355575,0.03713373948360894
10062,,1282,24895,26177,41,1554,36009,9858,26151,36009,2493,0.03560221055847149,0.691354939043017,0.0011386042378294316,0.27376489211030575,0.7262351078896943,0.043155877697242356
10063,45.0,134,5208,5342,14,219,6821,2053,4768,6821,530,0.01964521331183111,0.7635244099105702,0.002052484972877877,0.30098226066559153,0.6990177393344085,0.03210672921858965
10064,,1604,70598,72202,36,832,94194,28045,66149,94194,11132,0.017028685478905237,0.7494957215958553,0.00038218994840435696,0.29773658619444976,0.7022634138055502,0.008832834363122917
10065,,449,11919,12368,25,549,16325,4698,11627,16325,1347,0.027503828483920367,0.7301071975497703,0.0015313935681470138,0.2877794793261868,0.7122205206738131,0.03362940275650842
10066,,764,10096,10860,57,1018,14864,4207,10657,14864,874,0.05139935414424112,0.6792249730893434,0.003834768568353068,0.2830328310010764,0.7169671689989235,0.0684876210979548
10067,25.0,805,17134,17939,86,978,24636,6610,18026,24636,1717,0.03267575905179412,0.6954862802402988,0.003490826432862478,0.26830654327001136,0.7316934567299886,0.039698002922552364
10068,,513,4720,5233,14,675,7814,2024,5790,7814,404,0.06565139493217302,0.6040440235474789,0.0017916560020476069,0.25902226772459686,0.7409777322754031,0.08638341438443818
10069,23.0,146,6228,6374,36,556,8863,2409,6454,8863,539,0.016472977547105947,0.7026966038587386,0.004061830080108316,0.2718041295272481,0.7281958704727519,0.0627327090150062
10070,15.0,431,24506,24937,59,1428,34042,9616,24426,34042,2767,0.0126608307384995,0.7198754479760296,0.0017331531637389107,0.2824745902120909,0.717525409787909,0.041948181657951944
10071,15.0,2891,4070,6961,23,641,10182,2602,7580,10182,447,0.2839324297780397,0.39972500491062657,0.002258888234138676,0.2555490080534276,0.7444509919465724,0.06295423296012571
10072,25.0,4847,83431,88278,685,4717,121956,33151,88805,121956,8218,0.039743842041391975,0.6841073829905868,0.005616779822230969,0.2718275443602611,0.7281724556397389,0.03867788382695398
10073,,310,23715,24025,20,1294,32214,9186,23028,32214,2548,0.009623145216365555,0.736170609051965,0.0006208480784751972,0.28515552244365805,0.714844477556342,0.04016887067734525
10074,26.0,752,18423,19175,38,2166,26437,7344,19093,26437,1826,0.028444982411014865,0.6968642432953814,0.0014373794303438362,0.2777924878011877,0.7222075121988123,0.08193062752959866
10075,24.0,139,4546,4685,2,339,6398,1771,4627,6398,460,0.02172553923100969,0.7105345420443888,0.00031259768677711783,0.27680525164113784,0.7231947483588621,0.052985307908721475
10076,14.0,120,5158,5278,12,848,7550,2045,5505,7550,527,0.015894039735099338,0.6831788079470199,0.0015894039735099338,0.27086092715231785,0.7291390728476821,0.112317880794702
10077,24.0,73,14010,14083,41,695,19296,5319,13977,19296,1510,0.003783167495854063,0.7260572139303483,0.002124792703150912,0.2756529850746269,0.7243470149253731,0.03601782752902156
10078,15.0,243,4044,4287,7,309,5664,1650,4014,5664,256,0.04290254237288135,0.7139830508474576,0.0012358757062146894,0.2913135593220339,0.7086864406779662,0.05455508474576271
10079,,574,13476,14050,56,998,19404,5363,14041,19404,1386,0.02958152958152958,0.6944959802102659,0.002886002886002886,0.27638631210059783,0.7236136878994022,0.05143269428983715
10080,27.0,12,2830,2842,54,206,4079,1069,3010,4079,121,0.0029418975239029173,0.6937974993871047,0.013238538857563127,0.26207403775435156,0.7379259622456484,0.050502574160333415
10081,16.0,879,6269,7148,43,855,10281,2618,7663,10281,669,0.08549751969652758,0.6097655870051552,0.004182472522128198,0.2546444898356191,0.745355510164381,0.083163116428363
10082,36.0,1971,164763,166734,743,6000,214678,63806,150872,214678,17583,0.009181192297301074,0.767488983500871,0.003460997400758345,0.2972172276618936,0.7027827723381064,0.02794883499939444
10083,23.0,72,3765,3837,4,156,5052,1483,3569,5052,402,0.014251781472684086,0.745249406175772,0.000791765637371338,0.2935471100554236,0.7064528899445764,0.030878859857482184
10084,17.0,84,1683,1767,6,74,2362,707,1655,2362,195,0.03556308213378493,0.7125317527519052,0.002540220152413209,0.2993226079593565,0.7006773920406435,0.03132938187976291
10085,24.0,4451,151378,155829,126,5699,200671,59232,141439,200671,15447,0.022180584140209597,0.7543591251351714,0.0006278934175840057,0.2951697056375859,0.7048302943624141,0.028399718942946416
10086,16.0,31,2790,2821,19,164,3833,1082,2751,3833,340,0.008087659796504044,0.727889381685364,0.004956952778502478,0.2822854161231411,0.7177145838768588,0.042786329246021396
10087,,2689,87113,89802,398,3065,118132,33940,84192,118132,9123,0.022762672264923983,0.7374208512511428,0.0033691125181999795,0.2873057257982596,0.7126942742017405,0.025945552432871704
10088,,26847,448671,475518,3053,28000,630310,182469,447841,630310,45913,0.04259332709301772,0.7118259269248465,0.004843648363503673,0.2894908854373245,0.7105091145626755,0.04442258571179261
10089,17.0,381,9593,9974,0,377,13264,3887,9377,13264,1010,0.028724366706875754,0.7232358262967431,0.0,0.2930488540410133,0.7069511459589868,0.028422798552472858
10090,,208,3413,3621,60,144,4793,1335,3458,4793,261,0.04339662007093678,0.7120801168370541,0.012518255789693303,0.278531191320676,0.7214688086793241,0.030043813895263928
10091,16.0,120,5372,5492,33,261,7368,2088,5280,7368,628,0.016286644951140065,0.7290988056460369,0.004478827361563518,0.28338762214983715,0.7166123778501629,0.035423452768729644
10092,25.0,556,17065,17621,63,742,22880,6686,16194,22880,1792,0.0243006993006993,0.7458479020979021,0.0027534965034965034,0.2922202797202797,0.7077797202797202,0.03243006993006993
10093,26.0,1064,29597,30661,90,1876,40789,11531,29258,40789,3299,0.02608546421829415,0.7256122974331315,0.0022064772365098435,0.28269876682438894,0.7173012331756111,0.04599279217436073
10094,14.0,1232,18314,19546,353,1223,27172,7242,19930,27172,1771,0.04534079199175622,0.674002649786545,0.012991314588547034,0.26652436331517737,0.7334756366848226,0.04500956867363463
10095,43.0,2837,69795,72632,374,3805,97432,27463,69969,97432,7489,0.029117743657114704,0.7163457590935216,0.0038385745956154038,0.28186837999835784,0.7181316200016422,0.03905287790458987
10096,,258,6583,6841,6,263,8883,2582,6301,8883,648,0.029044241810199257,0.7410784644827199,0.0006754474839581223,0.29066756726331194,0.709332432736688,0.029607114713497692
10097,14.0,236,7279,7515,6,348,10069,2817,7252,10069,751,0.023438275896315423,0.7229119078359321,0.0005958883702453074,0.2797695898301718,0.7202304101698281,0.034561525474227826
10098,15.0,266,5012,5278,27,332,7195,2002,5193,7195,576,0.03697011813759555,0.6965948575399583,0.0037526059763724807,0.27824878387769286,0.7217512161223072,0.046143154968728284
10099,23.0,330,10242,10572,29,287,13410,4063,9347,13410,1025,0.024608501118568233,0.763758389261745,0.002162565249813572,0.3029828486204325,0.6970171513795674,0.02140193885160328
10100,24.0,260,5962,6222,9,297,8355,2411,5944,8355,595,0.031119090365050867,0.7135846798324357,0.0010771992818671453,0.2885697187312986,0.7114302812687013,0.0355475763016158
10101,17.0,215,3026,3241,45,251,4500,1227,3273,4500,291,0.04777777777777778,0.6724444444444444,0.01,0.27266666666666667,0.7273333333333334,0.05577777777777778
10102,17.0,329,4428,4757,28,298,6405,1807,4598,6405,506,0.05136612021857923,0.6913348946135831,0.004371584699453552,0.2821233411397346,0.7178766588602654,0.04652615144418423
10103,15.0,109,2220,2329,9,132,3087,893,2194,3087,205,0.03530936183997409,0.7191448007774538,0.0029154518950437317,0.28927761580822803,0.7107223841917719,0.042759961127308066
10104,,122,1912,2034,0,99,2722,735,1987,2722,144,0.04481998530492285,0.7024246877296105,0.0,0.2700220426157237,0.7299779573842763,0.03637031594415871
10105,17.0,15,3158,3173,0,85,4145,1232,2913,4145,392,0.0036188178528347406,0.7618817852834741,0.0,0.29722557297949337,0.7027744270205066,0.020506634499396863
10106,25.0,1085,22752,23837,209,1364,31969,8962,23007,31969,2143,0.033939128530764175,0.7116894491538678,0.006537583283806187,0.2803340736338328,0.7196659263661672,0.04266633301010354
10107,,1594,8298,9892,30,259,12901,3748,9153,12901,889,0.12355631346407256,0.6432059530268971,0.0023254011316952176,0.29052011471978917,0.7094798852802109,0.020075963103635377
10108,,615,16978,17593,33,792,23156,6741,16415,23156,1654,0.02655899119018829,0.7332008982553118,0.0014251166004491276,0.2911124546553809,0.7088875453446191,0.03420279841077906
10109,,1141,34579,35720,106,2939,49661,13513,36148,49661,3591,0.02297577575965043,0.696300920239222,0.0021344717182497333,0.27210487102555325,0.7278951289744467,0.05918124886732043
10110,,1716,30789,32505,145,1915,43647,12422,31225,43647,2879,0.03931541686713864,0.7054093064815451,0.0033221069031090338,0.2846014617270374,0.7153985382729626,0.04387472220312966
10111,14.0,163,3992,4155,2,19,5344,1580,3764,5344,383,0.030501497005988025,0.7470059880239521,0.00037425149700598805,0.29565868263473055,0.7043413173652695,0.003555389221556886
10112,,238,8344,8582,67,299,11001,3218,7783,11001,872,0.021634396873011545,0.7584765021361695,0.0060903554222343425,0.2925188619216435,0.7074811380783566,0.027179347332060722
10113,36.0,455,10163,10618,52,696,14562,4058,10504,14562,970,0.031245708007141874,0.6979123746738085,0.0035709380579590716,0.2786705122922675,0.7213294877077324,0.047795632468067575
10114,42.0,178,4180,4358,15,179,5661,1711,3950,5661,430,0.03144320791379615,0.7383854442677972,0.002649708532061473,0.3022434198904787,0.6977565801095212,0.031619855149266914
10115,27.0,907,15749,16656,80,787,22342,6250,16092,22342,1338,0.0405961865544714,0.7049055590367916,0.0035807000268552503,0.2797421895980664,0.7202578104019336,0.03522513651418852
10116,17.0,107,4432,4539,21,343,6355,1717,4638,6355,456,0.016837136113296618,0.6974036191974823,0.0033044846577498033,0.2701809598741149,0.7298190401258852,0.05397324940991345
10117,,747,14396,15143,72,677,20590,5779,14811,20590,1630,0.03627974745021855,0.6991743564837299,0.0034968431277319087,0.2806702282661486,0.7193297717338514,0.03288003885381253
10118,,262,12123,12385,33,1092,16834,4629,12205,16834,1261,0.015563740049899013,0.7201496970417013,0.0019603184032315553,0.27497920874420817,0.7250207912557919,0.06486871807057146
10119,,1720,42639,44359,236,2332,60478,16564,43914,60478,4515,0.028440093918449684,0.7050332352260326,0.0039022454446244917,0.27388471841000034,0.7261152815899997,0.038559476173153875
10120,,42,3732,3774,2,456,5468,1465,4003,5468,411,0.007681053401609363,0.6825164594001463,0.000365764447695684,0.2679224579370885,0.7320775420629115,0.08339429407461595
10121,24.0,1886,26286,28872,168,1733,43679,10300,33379,43679,2212,0.043178644199729846,0.601799491746606,0.0038462419011424252,0.23581125941527967,0.7641887405847203,0.039675816754046564
10122,17.0,520,28325,28845,247,3304,40627,11162,29465,40627,2784,0.012799369877175278,0.6971964457134417,0.006079700691658257,0.27474339724813546,0.7252566027518645,0.08132522706574445
10123,,1708,44942,46650,163,3266,62849,17105,45744,62849,4590,0.027176247832105524,0.7150789988703082,0.0025935177966236534,0.2721602571242184,0.7278397428757817,0.051965822845232226
10124,14.0,3740,16145,19885,62,2104,28563,7671,20892,28563,863,0.13093862689493402,0.565241746315163,0.0021706403388999755,0.2685642264468018,0.7314357735531982,0.07366173021041207
10125,23.0,438,11147,11585,42,727,15422,4404,11018,15422,1016,0.0284009856049799,0.7227985994034496,0.0027233821812994424,0.28556607443911297,0.714433925560887,0.04714044870963559
10126,15.0,65,1897,1962,33,205,2806,752,2054,2806,170,0.02316464718460442,0.6760513186029936,0.011760513186029936,0.26799714896650034,0.7320028510334996,0.07305773342836779
10127,15.0,5411,93382,98793,134,7014,133133,37510,95623,133133,9541,0.040643566959356434,0.7014188818700097,0.0010065122847077734,0.2817483268611088,0.7182516731388912,0.05268415794731584
10128,23.0,333,7322,7655,28,393,10281,2940,7341,10281,737,0.032389845345783486,0.7121875303958759,0.002723470479525338,0.28596440035016046,0.7140355996498395,0.038225853516194924
10129,,3797,64758,68555,528,4088,94042,26002,68040,94042,6575,0.04037557686990919,0.6886072180515089,0.005614512664554135,0.27649348163586485,0.7235065183641352,0.04346993896344187
10130,26.0,12,9674,9686,39,519,12847,3658,9189,12847,1246,0.0009340702109441893,0.7530162683895073,0.0030357281855686153,0.28473573596948704,0.7152642640305129,0.04039853662333619
10131,,28565,427061,455626,4734,18881,591506,174586,416920,591506,31675,0.04829198689446937,0.7219892951212667,0.008003300051056117,0.2951550787312386,0.7048449212687614,0.03192021720827853
10132,17.0,33,9513,9546,19,492,12558,3637,8921,12558,1081,0.0026278069756330625,0.7575250836120402,0.001512979773849339,0.28961618092052877,0.7103838190794712,0.03917821309125657
10133,25.0,5734,142322,148056,611,6156,195273,56090,139183,195273,15066,0.02936401857911744,0.7288360398006893,0.0031289527994141533,0.28723889119335494,0.712761108806645,0.03152509563534129
10134,,118,2361,2479,0,96,3286,936,2350,3286,229,0.035909920876445525,0.7185027388922702,0.0,0.28484479610468655,0.7151552038953134,0.029214850882531954
10135,,4369,100542,104911,437,7101,146059,39944,106115,146059,10170,0.029912569578047228,0.688365660452283,0.0029919416126359894,0.27347852580121734,0.7265214741987827,0.048617339568256666
10136,17.0,353,10197,10550,42,367,13578,4054,9524,13578,954,0.02599793784062454,0.7509942554131683,0.0030932390631904553,0.2985712181470025,0.7014287818529975,0.027029017528354692
10137,,3144,80180,83324,285,3995,109486,31367,78119,109486,8089,0.02871600021920611,0.7323310742926036,0.002603072538954752,0.2864932502785744,0.7135067497214256,0.03648868348464644
10138,,26,1822,1848,0,152,2493,695,1798,2493,189,0.010429201764941836,0.7308463698355395,0.0,0.2787805856397914,0.7212194143602085,0.0609707180104292
10139,,1714,25455,27169,68,1590,36196,10377,25819,36196,2662,0.04735329870703945,0.7032545032600287,0.001878660625483479,0.2866891369212068,0.7133108630787932,0.04392750580174605
10140,17.0,531,13287,13818,36,758,18602,5283,13319,18602,1283,0.028545317707773358,0.7142780346199333,0.0019352757767981937,0.2840017202451349,0.7159982797548651,0.0407483066336953
10141,27.0,533,17828,18361,46,986,24837,7168,17669,24837,1526,0.021459918669726616,0.7178000563675162,0.0018520755324717155,0.28860168297298383,0.7113983170270162,0.03969883641341547
10142,23.0,421,12777,13198,45,568,17063,5169,11894,17063,1188,0.02467326964777589,0.7488132215905761,0.0026372853542753327,0.30293617769442654,0.6970638223055735,0.03328840180507531
10143,,608,20680,21288,108,1173,28614,8081,20533,28614,1940,0.021248339973439574,0.7227231425176487,0.003774376179492556,0.28241420283777174,0.7175857971622283,0.04099391906059971
10144,,262,4709,4971,23,186,6694,1917,4777,6694,606,0.039139527935464595,0.7034657902599343,0.0034359127576934568,0.2863758589781894,0.7136241410218106,0.027786077083955783
10145,24.0,165,4636,4801,14,122,6284,1816,4468,6284,508,0.02625716104392107,0.7377466581795035,0.0022278803309993636,0.28898790579248884,0.7110120942075111,0.01941438574156588
10146,26.0,910,23638,24548,121,752,31353,9286,22067,31353,2083,0.02902433578923867,0.7539310432813446,0.003859279813733933,0.2961758045482091,0.7038241954517909,0.023984945619238987
10147,,411,9482,9893,31,461,13148,3743,9405,13148,968,0.03125950714937633,0.7211743230909644,0.0023577730453300883,0.2846820809248555,0.7153179190751445,0.03506236689990873
10148,16.0,360,7815,8175,37,419,10836,3120,7716,10836,807,0.03322259136212625,0.7212070874861573,0.0034145441122185307,0.28792912513842744,0.7120708748615725,0.038667404946474714
10149,26.0,66,6285,6351,21,348,8500,2392,6108,8500,579,0.007764705882352941,0.7394117647058823,0.0024705882352941176,0.28141176470588236,0.7185882352941176,0.04094117647058824
10150,23.0,1493,24492,25985,128,1715,35920,9733,26187,35920,2598,0.04156458797327394,0.68184855233853,0.0035634743875278397,0.2709632516703786,0.7290367483296214,0.04774498886414254
10151,17.0,861,35364,36225,104,2355,48810,13232,35578,48810,3829,0.01763982790411801,0.7245236631837738,0.0021307109198934644,0.2710919893464454,0.7289080106535546,0.04824830977258759
10152,16.0,136,3125,3261,26,216,5399,1102,4297,5399,235,0.025189849972217078,0.5788108909057232,0.0048157066123356174,0.20411187256899427,0.7958881274310058,0.04000740877940359
10153,,233,7224,7457,36,433,10043,2853,7190,10043,751,0.0232002389724186,0.71930697998606,0.003584586279000299,0.2840784626107737,0.7159215373892264,0.043114607189086926
10154,,188,3491,3679,52,161,5164,1393,3771,5164,305,0.03640588690937258,0.6760263361735089,0.010069713400464756,0.26975213013168087,0.7302478698683191,0.03117738187451588
10155,16.0,266,6667,6933,7,482,9392,2657,6735,9392,717,0.028321976149914822,0.7098594548551959,0.0007453151618398638,0.2829003407155026,0.7170996592844975,0.05132027257240204
10156,,286,3850,4136,21,249,5598,1577,4021,5598,376,0.051089674883887104,0.6877456234369418,0.0037513397642015005,0.281707752768846,0.718292247231154,0.04448017148981779
10157,14.0,252,11121,11373,56,1435,15533,4243,11290,15533,673,0.01622352410995944,0.7159595699478529,0.003605227579990987,0.2731603682482457,0.7268396317517544,0.09238395673726904
10158,16.0,12505,241102,253607,1157,13639,339867,96634,243233,339867,24440,0.036793804635342646,0.7094010304030695,0.0034042728479081524,0.2843288698226071,0.7156711301773929,0.040130403952134214
10159,27.0,267,7765,8032,0,460,10796,3036,7760,10796,782,0.024731381993330862,0.7192478695813265,0.0,0.2812152649129307,0.7187847350870693,0.04260837347165617
10160,,174,3387,3561,7,130,4734,1315,3419,4734,381,0.036755386565272496,0.7154626108998733,0.001478664976763836,0.2777777777777778,0.7222222222222222,0.02746092099704267
10161,13.0,75,1917,1992,7,198,2942,537,2405,2942,80,0.02549286199864038,0.6515975526852481,0.002379333786539769,0.1825288919102651,0.8174711080897349,0.06730115567641061
10162,17.0,1300,33409,34709,73,4140,48359,12969,35390,48359,2872,0.0268822763084431,0.6908538224529043,0.0015095432080894974,0.2681817241878451,0.731818275812155,0.08560971070534958
10163,26.0,1426,29738,31164,115,1664,42683,11904,30779,42683,2992,0.033409085584424715,0.6967176627697209,0.002694281095518122,0.2788932361830237,0.7211067638169764,0.03898507602558396
10164,,9248,215967,225215,1071,11682,298547,85980,212567,298547,23664,0.030976697136464275,0.7233936365128438,0.003587374852200826,0.28799485508144446,0.7120051449185555,0.03912951729543422
10165,27.0,880,20452,21332,142,998,28441,8159,20282,28441,2070,0.03094124679160367,0.7191027038430435,0.004992792095917865,0.28687458246897085,0.7131254175310291,0.03509018670229598
10166,39.0,121,2434,2555,23,145,3393,962,2431,3393,209,0.03566165635131152,0.717359269083407,0.006778661951075744,0.2835249042145594,0.7164750957854407,0.042735042735042736
10167,13.0,15,11111,11126,23,2257,16140,4281,11859,16140,839,0.0009293680297397769,0.6884138785625774,0.0014250309789343248,0.26524163568773235,0.7347583643122677,0.13983890954151176
10168,14.0,79,2479,2558,197,257,3738,941,2797,3738,237,0.02113429641519529,0.6631888710540396,0.0527019796682718,0.25173889780631353,0.7482611021936865,0.06875334403424291
10169,27.0,74,34568,34642,11,1366,44898,13149,31749,44898,4155,0.001648180319836073,0.7699229364336941,0.00024499977727292975,0.2928638246692503,0.7071361753307497,0.030424517795892912
10170,16.0,179,3729,3908,0,162,5086,1479,3607,5086,351,0.03519465198584349,0.733189146677153,0.0,0.29079826976012585,0.7092017302398742,0.03185214313802595
10171,23.0,1366,27499,28865,208,1627,37845,11005,26840,37845,2491,0.036094596379970936,0.7266217465979654,0.005496102523450918,0.29079138591623727,0.7092086140837627,0.04299114810410887
10172,25.0,4276,74770,79046,504,4758,106835,29880,76955,106835,7088,0.04002433659381289,0.6998642766883512,0.004717555108344644,0.2796836242804324,0.7203163757195675,0.044535966677586934
10173,15.0,123,4028,4151,123,235,5659,1565,4094,5659,452,0.02173528892030394,0.7117865347234493,0.02173528892030394,0.27655062731931435,0.7234493726806857,0.04152677151440184
10174,27.0,283,10483,10766,39,591,13850,4063,9787,13850,967,0.020433212996389893,0.7568953068592058,0.0028158844765342962,0.29335740072202166,0.7066425992779783,0.04267148014440433
10175,16.0,96,2106,2202,12,101,2986,865,2121,2986,236,0.032150033489618215,0.7052913596784997,0.004018754186202277,0.2896851975887475,0.7103148024112526,0.033824514400535834
10176,14.0,395,6504,6899,360,418,9674,2475,7199,9674,521,0.04083109365309076,0.6723175522017779,0.03721314864585487,0.25584039694025223,0.7441596030597478,0.043208600372131485
10177,23.0,349,14508,14857,130,921,20794,5552,15242,20794,1609,0.01678368760219294,0.69770125997884,0.006251803404828316,0.2670000961815908,0.7329999038184092,0.04429162258343753
10178,24.0,246,6219,6465,66,317,8683,2415,6268,8683,660,0.028331221927905104,0.7162271104456985,0.007601059541633076,0.278129678682483,0.7218703213175169,0.03650811931360129
10179,,685,12705,13390,32,822,18063,5065,12998,18063,1360,0.03792282566572552,0.7033715329679455,0.0017715772573769584,0.2804074627691967,0.7195925372308033,0.04550739079887062
10180,17.0,223,6105,6328,3,183,8419,2411,6008,8419,739,0.026487706378429742,0.7251455042166528,0.0003563368571089203,0.2863760541632023,0.7136239458367977,0.021736548283644137
10181,25.0,1268,33228,34496,138,1472,46671,13089,33582,46671,3236,0.027168905744466586,0.7119624606286559,0.0029568682908015682,0.28045252940798354,0.7195474705920164,0.03153992843521673
10182,15.0,159,8013,8172,21,445,10838,3108,7730,10838,928,0.014670603432367596,0.7393430522236575,0.001937626868425909,0.28676877652703453,0.7132312234729655,0.04105923602140616
10183,,286,5556,5842,16,525,8040,2088,5952,8040,527,0.03557213930348259,0.691044776119403,0.001990049751243781,0.25970149253731345,0.7402985074626866,0.06529850746268656
10184,15.0,2185,38471,40656,317,3411,55564,15684,39881,55565,3877,0.039323315036443804,0.6923602987492127,0.005705030144875371,0.28226401511743004,0.71773598488257,0.0613875641141006
10185,,84,2064,2148,17,285,3048,835,2213,3048,175,0.027559055118110236,0.6771653543307087,0.00557742782152231,0.2739501312335958,0.7260498687664042,0.09350393700787402
10186,25.0,170,3949,4119,30,224,5549,1596,3953,5549,346,0.030636150657776175,0.7116597585150477,0.005406379527842855,0.2876193908812399,0.7123806091187601,0.040367633807893315
10187,,751,9988,10739,68,405,13976,4060,9916,13976,1040,0.05373497424155695,0.7146536920435032,0.004865483686319404,0.29049799656554093,0.7095020034344591,0.028978248425872925
10188,44.0,837,7451,8288,92,320,10820,3117,7703,10820,716,0.07735674676524953,0.6886321626617375,0.008502772643253234,0.2880776340110906,0.7119223659889095,0.029574861367837338
10189,25.0,156,10023,10179,58,635,13770,3821,9949,13770,981,0.011328976034858388,0.7278867102396515,0.004212055192447349,0.27748729121278143,0.7225127087872186,0.04611474219317357
10190,,1262,51507,52769,364,2987,70599,19967,50632,70599,4383,0.017875607303219593,0.7295712403858412,0.005155880394906443,0.28282270287114547,0.7171772971288545,0.04230938115270755
10191,15.0,28,3253,3281,7,87,4371,1250,3121,4371,371,0.006405856783344772,0.7442232898650194,0.001601464195836193,0.2859757492564631,0.7140242507435369,0.01990391214824983
10192,15.0,411,4134,4545,16,382,6297,1766,4531,6297,365,0.06526917579799904,0.6565030967127203,0.002540892488486581,0.2804510084167064,0.7195489915832937,0.06066380816261712
10193,14.0,2274,44494,46768,203,4129,64926,17725,47201,64926,4196,0.035024489418722854,0.6853032683362598,0.0031266364784523918,0.2730031112343283,0.7269968887656717,0.06359547792871885
10194,,533,14684,15217,10,957,20978,5881,15097,20978,1700,0.025407569835065306,0.6999713986080656,0.0004766898655734579,0.2803413099437506,0.7196586900562494,0.045619220135379925
10195,15.0,143,1745,1888,6,133,2692,711,1981,2692,144,0.05312035661218425,0.6482169390787519,0.002228826151560178,0.26411589895988113,0.7358841010401189,0.04940564635958395
10196,14.0,688,9321,10009,188,1111,15360,3768,11592,15360,958,0.04479166666666667,0.6068359375,0.012239583333333333,0.2453125,0.7546875,0.07233072916666666
10197,25.0,281,6284,6565,30,339,9095,2463,6632,9095,563,0.030896096756459594,0.6909290819131391,0.003298515667949423,0.2708081363386476,0.7291918636613524,0.037273227047828476
10198,36.0,625,13113,13738,75,940,18799,5087,13712,18799,1347,0.03324644927921698,0.6975371030373956,0.003989573913506038,0.2705994999734028,0.7294005000265972,0.05000265971594234
10199,,128,3223,3351,21,169,4464,1266,3198,4464,353,0.02867383512544803,0.7219982078853047,0.004704301075268817,0.28360215053763443,0.7163978494623656,0.037858422939068104
10200,,186,5248,5434,53,178,7203,2073,5130,7203,572,0.025822573927530196,0.7285853116756907,0.007358045258919895,0.28779675135360266,0.7122032486463973,0.024711925586561156
10201,25.0,581,18212,18793,18,2166,26636,7307,19329,26636,1651,0.021812584472142963,0.6837362967412525,0.0006757771437152726,0.2743279771737498,0.7256720228262502,0.0813185162937378
10202,23.0,806,21577,22383,330,857,28798,8568,20230,28798,1797,0.02798805472602264,0.7492534203764151,0.01145912910618793,0.2975206611570248,0.7024793388429752,0.029759011042433503
10203,17.0,149,3728,3877,2,209,5107,1449,3658,5107,335,0.029175641276679067,0.7299784609359702,0.00039161934599569217,0.283728216173879,0.716271783826121,0.04092422165654983
10204,23.0,1793,35855,37648,289,2053,49217,14249,34968,49217,3186,0.036430501655931896,0.7285084422049292,0.005871954812361582,0.2895137858869903,0.7104862141130097,0.041713229168783145
10205,25.0,273,3178,3451,8,150,4441,1328,3113,4441,344,0.06147264129700518,0.715604593560009,0.0018013960819635217,0.2990317496059446,0.7009682503940554,0.033776176536816034
10206,,2441,71569,74010,171,2754,95843,28145,67698,95843,6546,0.02546873532756696,0.7467316340264808,0.0017841678578508604,0.29365733543399103,0.706342664566009,0.028734492868545434
10207,,321,7568,7889,17,684,10754,2941,7813,10754,767,0.02984935837827785,0.7037381439464385,0.0015808071415287334,0.2734796354844709,0.7265203645155291,0.0636042402826855
10208,17.0,128,3204,3332,0,125,4372,1270,3102,4372,311,0.0292772186642269,0.7328453796889296,0.0,0.29048490393412624,0.7095150960658737,0.02859103385178408
10209,,111,2270,2381,3,174,3595,888,2707,3595,239,0.030876216968011128,0.631432545201669,0.0008344923504867872,0.24700973574408902,0.752990264255911,0.04840055632823366
10210,,858,7293,8151,180,619,11848,3060,8788,11848,566,0.07241728561782579,0.6155469277515192,0.015192437542201216,0.25827143821742066,0.7417285617825793,0.05224510465901418
10211,26.0,619,13142,13761,90,686,17986,5127,12859,17986,1257,0.03441565662181697,0.7306794173245857,0.005003891915934616,0.2850550428110753,0.7149449571889247,0.03814077615923496
10212,25.0,54,1728,1782,0,79,2355,695,1660,2355,193,0.022929936305732482,0.7337579617834394,0.0,0.2951167728237792,0.7048832271762208,0.03354564755838641
10213,,951,21628,22579,78,1095,29876,8572,21304,29876,2094,0.03183157049136431,0.7239255589771054,0.002610791270585085,0.2869192663007096,0.7130807336992904,0.036651492837059846
10214,,856,26068,26924,278,1375,36857,10122,26735,36857,3006,0.023224896220527987,0.7072740592017799,0.0075426648940499766,0.2746289714301218,0.7253710285698782,0.03730634614862848
10215,33.0,4342,108344,112686,943,4763,148258,42841,105417,148258,10825,0.029286783849775393,0.7307801265361734,0.006360533664287931,0.2889624843178783,0.7110375156821217,0.032126428253450065
10216,17.0,1187,18959,20146,121,875,27127,7529,19598,27127,1775,0.04375714233051941,0.6988977771224242,0.004460500608250083,0.27754635602904854,0.7224536439709515,0.03225568621668448
10217,23.0,635,12088,12723,71,563,16990,4986,12004,16990,1482,0.03737492642731018,0.7114773396115363,0.004178928781636257,0.29346674514420246,0.7065332548557975,0.03313713949381989
10218,,68,1651,1719,1,79,2299,674,1625,2299,177,0.02957807742496738,0.7181383210091344,0.00043497172683775554,0.29317094388864723,0.7068290561113527,0.03436276642018269
10219,17.0,0,1643,1643,6,106,2229,632,1597,2229,184,0.0,0.737101839389861,0.0026917900403768506,0.2835352175863616,0.7164647824136384,0.04755495737999103
10220,17.0,308,8353,8661,53,615,11792,3244,8548,11792,933,0.026119402985074626,0.7083616010854816,0.004494572591587517,0.27510176390773405,0.7248982360922659,0.052154002713704205
10221,17.0,301,8440,8741,22,503,11609,3217,8392,11609,836,0.025928159186837798,0.7270221379963822,0.0018950814023602376,0.27711258506331293,0.7228874149366871,0.04332845206305452
10222,27.0,11773,174392,186165,1747,7221,250911,69934,180977,250911,15882,0.046921019803834826,0.6950352913981451,0.006962628182901507,0.27872034306985344,0.7212796569301465,0.02877912885445437
10223,24.0,149,3741,3890,5,352,5491,1461,4030,5491,426,0.02713531232926607,0.6812966672737206,0.0009105809506465125,0.26607175377891096,0.7339282462210891,0.06410489892551448
10224,14.0,398,6718,7116,0,359,9510,2723,6787,9510,640,0.04185068349106204,0.7064143007360673,0.0,0.28633017875920086,0.7136698212407991,0.03774973711882229
10225,36.0,4525,65375,69900,568,3654,93265,26347,66918,93265,5059,0.048517664718811984,0.7009596311585268,0.006090173162493969,0.2824961132257546,0.7175038867742455,0.03917868439393127
10226,25.0,267,4722,4989,12,361,6868,1866,5002,6868,510,0.03887594641817123,0.6875364006988934,0.0017472335468841002,0.27169481654047756,0.7283051834595224,0.05256260920209668
10227,36.0,1432,30702,32134,93,1319,44718,12232,32486,44718,2594,0.032022899056308424,0.6865691667784785,0.002079699449885952,0.2735363835591932,0.7264636164408068,0.02949595241289861
10228,47.0,354,11799,12153,0,334,15495,4591,10904,15495,1208,0.022846079380445306,0.7614714424007745,0.0,0.2962891255243627,0.7037108744756373,0.021555340432397548
10229,,151,3081,3232,11,194,4342,1232,3110,4342,301,0.03477660064486412,0.7095808383233533,0.002533394748963611,0.28374021188392445,0.7162597881160755,0.04467987102717642
10230,,10217,167127,177344,1159,6662,245214,67491,177723,245214,17180,0.04166564714902086,0.6815557023660965,0.004726483805981714,0.2752330617338325,0.7247669382661676,0.027168106225582554
10231,,36,2051,2087,0,59,2701,809,1892,2701,193,0.013328396890040726,0.7593483894853758,0.0,0.29951869677897075,0.7004813032210292,0.021843761569788966
10232,,2999,64845,67844,124,3836,90106,25688,64418,90106,6975,0.033283022218276254,0.7196524093845027,0.001376156970678978,0.2850864537322709,0.7149135462677291,0.04257208177035936
10233,17.0,9634,166966,176600,906,8438,232310,68280,164032,232312,16530,0.041470091945314924,0.7187144874134784,0.0038999276834601744,0.29391507972037606,0.706084920279624,0.03632184303867213
10234,,208,3866,4074,14,208,5533,1557,3976,5533,402,0.03759262606181095,0.6987167901680824,0.0025302729080065064,0.2814024941261522,0.7185975058738479,0.03759262606181095
10235,26.0,1887,44589,46476,71,1713,60281,17362,42919,60281,5162,0.03130339576317579,0.7396858048141205,0.001177817222673811,0.2880177833811649,0.7119822166188351,0.028416914118876594
10236,,324,15734,16058,77,2251,22960,6157,16803,22960,1127,0.014111498257839722,0.6852787456445993,0.003353658536585366,0.26816202090592334,0.7318379790940767,0.09804006968641114
10237,15.0,12,2227,2239,36,59,3080,850,2230,3080,237,0.003896103896103896,0.7230519480519481,0.011688311688311689,0.275974025974026,0.724025974025974,0.019155844155844155
10238,,174,3495,3669,10,127,5125,1371,3764,5135,311,0.033885102239532616,0.6806231742940604,0.0019474196689386564,0.26699123661148977,0.7330087633885102,0.024732229795520935
10239,17.0,350,3163,3513,43,208,5531,1337,4194,5531,299,0.06327969625745797,0.5718676550352558,0.007774362683059121,0.24172843970348942,0.7582715602965105,0.03760621949014645
10240,,18408,242080,260490,6178,15624,343236,98997,244247,343244,16775,0.0536294880609712,0.7052708860169442,0.0179988579552738,0.28841582081551315,0.7115841791844868,0.04551863980142406
10241,,147,4052,4199,5,229,5620,1625,3995,5620,428,0.02615658362989324,0.7209964412811388,0.0008896797153024911,0.2891459074733096,0.7108540925266904,0.040747330960854096
10242,14.0,170,2477,2647,48,466,4014,969,3045,4014,94,0.04235176880916791,0.6170901843547584,0.01195814648729447,0.2414050822122571,0.7585949177877429,0.11609367214748381
10243,,274,6444,6718,46,268,9212,2530,6682,9212,778,0.029743812418584457,0.6995223621363439,0.00499348675640469,0.27464177160225794,0.7253582283977421,0.029092488059053408
10244,,1747,41817,43564,247,2181,58080,16995,41085,58080,3925,0.030079201101928375,0.7199896694214876,0.004252754820936639,0.29261363636363635,0.7073863636363636,0.03755165289256198
10245,,5166,99923,105089,529,7365,143222,40226,102996,143222,9249,0.03606987753278128,0.6976791275083437,0.0036935666308248734,0.2808646716286604,0.7191353283713396,0.051423663962240435
10246,,1346,18665,20011,120,1204,28925,7276,21649,28925,1423,0.046534140017286084,0.6452895419187554,0.00414866032843561,0.2515471045808124,0.7484528954191876,0.04162489196197061
10247,,7803,189908,197711,963,10643,264472,75056,189417,264473,18422,0.029503956925659706,0.7180619571752126,0.003641203449879572,0.2837945650406658,0.7162054349593342,0.04024229316414152
10248,14.0,620,34044,34664,592,4288,49959,12832,37127,49959,2216,0.012410176344602574,0.6814387797994356,0.011849716767749555,0.25685061750635524,0.7431493824936448,0.08583038091234813
10249,25.0,29,1969,3139,33,179,4031,795,3236,4031,179,0.007194244604316547,0.48846440089307863,0.008186554204911933,0.19722153311833293,0.8027784668816671,0.04440585462664351
10250,,432,11348,11780,123,624,16029,4475,11642,16117,1052,0.026803995780852515,0.7041012595396166,0.007631693243159397,0.2776571322206366,0.7223428677793634,0.03871688279456475
10251,,624,15114,15738,115,1029,21328,5997,15331,21328,1477,0.029257314328582147,0.7086459114778695,0.005391972993248312,0.2811796699174794,0.7188203300825207,0.04824643660915229
10252,,774,18631,19405,84,1313,26269,7433,18837,26270,1587,0.029463266082984392,0.7092120289303387,0.0031975637609440426,0.28294632660829844,0.7170536733917016,0.049980966882375334
10253,25.0,2780,30140,32920,340,1981,46104,12329,33775,46104,2743,0.06029845566545202,0.6537393718549367,0.007374631268436578,0.2674171438486899,0.7325828561513101,0.04296807218462606
10254,25.0,64,10088,10152,45,502,13882,3821,10061,13882,1072,0.004610286702204294,0.7266964414349517,0.0032416078374873938,0.2752485232675407,0.7247514767324593,0.03616193632041492
10255,15.0,81,5391,5472,41,743,8190,2030,6160,8190,488,0.00989010989010989,0.6582417582417582,0.0050061050061050065,0.24786324786324787,0.7521367521367521,0.09072039072039072
10256,36.0,236,6204,6440,26,434,8532,2466,6066,8532,685,0.027660571964369433,0.7271448663853727,0.0030473511486169714,0.2890295358649789,0.7109704641350211,0.050867323019221755
10257,27.0,526,25087,25613,231,918,33554,10145,23409,33554,2811,0.015676223401084818,0.7476604875722715,0.0068844251057996065,0.30234845323955417,0.6976515467604458,0.02735888418668415
10258,23.0,1600,39677,41277,72,2348,54241,15456,38785,54241,3474,0.029497981231909443,0.7314946258365443,0.0013274091554359249,0.2849504987002452,0.7150495012997548,0.043288287457827104
10259,23.0,1390,40241,41631,255,1937,53922,15931,37997,53928,3546,0.025775107550808484,0.7461986352173268,0.004728526924788607,0.29541240172081296,0.704587598279187,0.035918261385551105
10260,15.0,366,13313,13679,87,1265,18895,5074,13821,18895,1443,0.019370203757607833,0.7045779306694893,0.00460439269648055,0.2685366499073829,0.7314633500926171,0.06694892828790686
10261,16.0,3,5321,5324,1,338,7201,2024,5177,7201,588,0.00041660880433273156,0.7389251492848216,0.00013886960144424384,0.28107207332314954,0.7189279266768505,0.04693792528815442
10262,17.0,438,8676,9114,133,620,12424,3485,8939,12424,902,0.03525434642627173,0.6983258209916291,0.010705086928525434,0.28050547327752734,0.7194945267224726,0.04990341274951706
10263,35.0,697,15048,15745,88,619,20235,5874,14361,20235,1281,0.03444526809982703,0.7436619718309859,0.004348900420064245,0.29028910303928834,0.7097108969607117,0.030590560909315542
10264,34.0,4,1621,1625,2,84,2140,636,1504,2140,189,0.001869158878504673,0.7574766355140187,0.0009345794392523365,0.297196261682243,0.702803738317757,0.03925233644859813
10265,16.0,508,6915,7423,24,510,10067,2777,7290,10067,678,0.050461905234926,0.6868977848415615,0.002384027018972882,0.2758517929869872,0.7241482070130129,0.05066057415317374
10266,17.0,241,6180,6421,5,363,8483,2473,6010,8483,657,0.02840976069786632,0.7285158552398916,0.0005894141223623718,0.2915242249204291,0.7084757750795709,0.04279146528350819
10267,,107,1945,2052,24,80,2767,778,1989,2767,196,0.038670039754246474,0.7029273581496205,0.008673653776653415,0.2811709432598482,0.7188290567401517,0.028912179255511383
10268,24.0,515,10718,11233,100,480,15052,4230,10822,15052,1158,0.0342147222960404,0.7120648418814776,0.006643635397289397,0.2810257773053415,0.7189742226946585,0.0318894499069891
10269,25.0,167,4639,4806,73,217,6318,1836,4482,6318,414,0.02643241532130421,0.7342513453624565,0.01155428933206711,0.2905982905982906,0.7094017094017094,0.0343463121240899
10270,,1333,30287,31620,130,1352,41673,11931,29742,41673,2936,0.03198713795503084,0.7267775298154681,0.003119525832073525,0.28630048232668637,0.7136995176733136,0.03244306865356466
10271,,220,4345,4565,13,511,6457,1746,4711,6457,437,0.034071550255536626,0.6729131175468483,0.0020133188787362553,0.27040421248257707,0.7295957875174229,0.0791389190026328
10272,27.0,80,1716,1796,7,152,2941,667,2274,2941,174,0.027201632097925876,0.58347500850051,0.0023801428085685142,0.22679360761645698,0.773206392383543,0.05168310098605916
10273,,103,6276,6379,17,308,8316,2401,5915,8316,684,0.012385762385762385,0.7546897546897547,0.002044252044252044,0.2887205387205387,0.7112794612794613,0.037037037037037035
10274,,145,2546,2691,14,125,3560,1011,2549,3560,279,0.04073033707865169,0.7151685393258427,0.003932584269662922,0.28398876404494383,0.7160112359550562,0.0351123595505618
10275,,876,41300,42176,227,1266,52823,16282,36541,52823,3529,0.016583685137156162,0.7818563883156958,0.0042973704636238,0.30823694224106923,0.6917630577589308,0.02396683262972569
10276,,34,4074,4108,9,111,5533,1563,3970,5533,521,0.006144948490872944,0.7363094162298933,0.001626604012289897,0.28248689680101213,0.7175131031989879,0.02006144948490873
10277,26.0,91,2113,2204,1,129,2998,850,2148,2998,218,0.030353569046030687,0.7048032021347566,0.000333555703802535,0.2835223482321548,0.7164776517678453,0.043028685790527016
10278,17.0,13599,312926,326525,1210,15634,427187,125573,301614,427187,31187,0.03183383389475803,0.7325269729650012,0.002832483198224665,0.2939532335955916,0.7060467664044083,0.03659755563722679
10279,17.0,2,2151,2153,14,142,2975,829,2146,2975,297,0.0006722689075630252,0.7230252100840336,0.004705882352941176,0.27865546218487397,0.7213445378151261,0.04773109243697479
10280,14.0,889,12917,13812,244,1106,19751,5241,14510,19751,1447,0.04501037922130525,0.6539922029264341,0.012353804870639461,0.26535365297959596,0.734646347020404,0.05599716470052149
10281,,4704,77373,82077,617,6332,112735,30574,82161,112735,7891,0.04172617199627445,0.6863263405331086,0.005473011930633787,0.27120237725639773,0.7287976227436023,0.056167117576617735
10282,33.0,4481,116913,121394,520,6876,160563,45995,114568,160563,11770,0.027908048554150085,0.7281440929728518,0.0032386041616063476,0.2864607661790076,0.7135392338209924,0.042824311952317784
10283,23.0,714,16047,16761,63,791,22084,6304,15780,22084,1558,0.03233109943850752,0.7266346676326753,0.0028527440681036043,0.28545553341785906,0.7145444665821409,0.03581778663285637
10284,33.0,317,16415,16732,39,322,22190,6365,15825,22190,2021,0.014285714285714285,0.7397476340694006,0.001757548445245606,0.2868409193330329,0.7131590806669671,0.014511041009463722
10285,,66,2621,2687,12,92,3564,1014,2550,3564,316,0.018518518518518517,0.7354096520763187,0.003367003367003367,0.2845117845117845,0.7154882154882155,0.025813692480359147
10286,15.0,20,2512,2532,19,374,3647,938,2709,3647,150,0.005483959418700302,0.6887853029887578,0.005209761447765287,0.2571976967370441,0.7428023032629558,0.10255004112969564
10287,26.0,875,26271,27146,37,995,36033,10542,25491,36033,3115,0.02428329586767685,0.7290816751311298,0.0010268365109760498,0.2925651486137707,0.7074348513862293,0.02761357644381539
10288,,1146,31037,32183,38,1302,42260,12262,29998,42260,3132,0.027117841930903927,0.7344297207761477,0.0008991954566966398,0.2901561760530052,0.7098438239469947,0.030809275911026977
10289,15.0,339,3888,4227,78,351,5808,1521,4287,5808,354,0.05836776859504132,0.6694214876033058,0.013429752066115703,0.2618801652892562,0.7381198347107438,0.06043388429752066
10290,15.0,1048,25497,26545,75,1233,36170,9785,26385,36170,2620,0.028974288084047554,0.7049212054188554,0.002073541609068289,0.2705280619297761,0.7294719380702239,0.034089024053082666
10291,23.0,1369,29649,31018,50,938,40376,12006,28371,40377,3064,0.03390544121653417,0.7343041830745226,0.0012383287515169527,0.2973474998142507,0.7026525001857493,0.023231047378458033
10292,,422,10198,10620,76,482,14166,4057,10109,14166,981,0.029789637159395737,0.7198927008329804,0.005364958350981223,0.28638994776224763,0.7136100522377523,0.03402513059438091
10293,,131,2370,2501,0,166,3443,950,2493,3443,263,0.038048213767063604,0.6883531803659599,0.0,0.2759221609061865,0.7240778390938135,0.04821376706360732
10294,,1181,31505,32686,47,1419,42875,12394,30481,42875,3378,0.027545189504373176,0.7348104956268221,0.0010962099125364432,0.2890728862973761,0.710927113702624,0.033096209912536444
10295,24.0,323,6726,7049,33,350,9430,2741,6689,9430,665,0.03425238600212089,0.7132555673382821,0.0034994697773064686,0.2906680805938494,0.7093319194061506,0.03711558854718982
10296,13.0,52,2825,2877,0,111,3733,1062,2671,3733,252,0.013929815162068041,0.7567639967854273,0.0,0.28448968657915885,0.7155103134208411,0.029734797749799088
10297,33.0,171,2864,3035,17,145,3999,1163,2836,3999,287,0.04276069017254314,0.7161790447611903,0.0042510627656914225,0.2908227056764191,0.7091772943235809,0.03625906476619155
10298,17.0,871,4352,5223,99,465,7472,1893,5579,7472,382,0.11656852248394005,0.582441113490364,0.013249464668094218,0.2533458244111349,0.746654175588865,0.062232334047109206
10299,16.0,52,3039,3091,5,210,4313,1176,3137,4313,362,0.012056573150939021,0.704613957801994,0.001159285879897983,0.2726640389520056,0.7273359610479945,0.04869000695571528
10300,,3750,94073,97823,110,4182,128520,37142,91378,128520,9566,0.029178338001867414,0.7319716775599129,0.0008558979147214441,0.2889978213507625,0.7110021786492374,0.03253968253968254
10301,26.0,1024,26249,27273,216,1042,36649,10241,26408,36649,2838,0.027940735081448335,0.7162269093290403,0.005893748806243008,0.2794346366885863,0.7205653633114136,0.02843188081530192
10302,15.0,1441,86723,88164,240,5752,118421,33404,85017,118421,9550,0.012168449852644378,0.7323278810346138,0.0020266675674078076,0.2820783475903767,0.7179216524096232,0.04857246603220713
10303,,1436,26186,27622,40,1326,36803,10485,26319,36804,2624,0.03901749809803282,0.7114987501358548,0.0010868383871318334,0.28488751222693187,0.7151124877730681,0.03602869253342028
10304,25.0,134,3477,3611,3,95,4532,1361,3171,4532,308,0.029567519858781994,0.7672109443954104,0.0006619593998234775,0.3003089143865843,0.6996910856134158,0.020962047661076788
10305,27.0,2152,56954,59106,65,2544,78022,22736,55286,78022,6969,0.027581964061418576,0.729973597190536,0.0008330983568737022,0.291404988336623,0.708595011663377,0.0326061879982569
10306,17.0,258,4533,4791,15,458,6996,1839,5157,6996,521,0.03687821612349914,0.6479416809605489,0.002144082332761578,0.26286449399656947,0.7371355060034306,0.06546598056032019
10307,,167,5883,6050,37,329,7981,2317,5664,7981,633,0.02092469615336424,0.737125673474502,0.0046360105249968675,0.2903144969302092,0.7096855030697907,0.04122290439794512
10308,,153,2031,2184,22,130,3172,825,2347,3172,191,0.04823455233291299,0.6402900378310215,0.0069356872635561164,0.26008827238335436,0.7399117276166457,0.040983606557377046
10309,13.0,487,20305,20792,117,1120,28206,7879,20327,28206,2110,0.01726582996525562,0.7198822945472595,0.004148053605615826,0.27933772956108627,0.7206622704389137,0.03970786357512586
10310,25.0,398,12202,12600,88,622,16485,4787,11698,16485,905,0.024143160448892934,0.7401880497421899,0.005338186229905975,0.2903851986654534,0.7096148013345466,0.03773127085228996
10311,24.0,1646,38784,40430,54,1515,53727,15646,38082,53728,4292,0.03063579511614056,0.7218582489577129,0.0010050625372245384,0.29120756402620607,0.7087924359737939,0.028197587849910662
10312,40.0,76,2991,3067,0,65,3970,1208,2762,3970,351,0.019143576826196475,0.7534005037783376,0.0,0.30428211586901766,0.6957178841309823,0.0163727959697733
10313,,605,12796,13401,5,499,17760,5097,12663,17760,1573,0.034065315315315314,0.7204954954954955,0.00028153153153153153,0.28699324324324327,0.7130067567567567,0.028096846846846848
10314,,115,6652,6767,47,62,8866,2620,6246,8866,789,0.01297090006767426,0.7502819760884277,0.0053011504624407855,0.295510940672231,0.704489059327769,0.006993006993006993
10315,35.0,580,7934,8514,530,446,12006,3300,8706,12006,659,0.04830917874396135,0.6608362485423954,0.044144594369481926,0.2748625687156422,0.7251374312843578,0.03714809262035649
10316,17.0,881,17659,18540,251,1320,25161,7005,18156,25161,1707,0.03501450657764,0.7018401494376217,0.009975756130519455,0.2784070585429832,0.7215929414570168,0.05246214379396685
10317,27.0,248,7625,7873,14,327,10339,2886,7453,10339,761,0.023986845923203406,0.7374987909855886,0.0013540961408259986,0.279137247315988,0.720862752684012,0.03162781700357868
10318,14.0,2473,26610,29083,122,1937,40383,11107,29276,40383,2422,0.06123864002179135,0.6589406433400193,0.003021073223881336,0.27504147784959015,0.7249585221504098,0.04796572815293564
10319,27.0,76,1864,1940,7,138,2632,692,1940,2632,177,0.028875379939209727,0.7082066869300911,0.0026595744680851063,0.2629179331306991,0.7370820668693009,0.05243161094224924
10320,24.0,10530,202806,213336,10648,15987,304458,80789,223669,304458,19313,0.03458605127800879,0.6661214354689317,0.034973625261940894,0.2653535134567001,0.7346464865432999,0.05250970577222474
10321,,110,2024,2134,7,107,2885,820,2065,2885,246,0.038128249566724434,0.7015597920277297,0.0024263431542461003,0.28422876949740034,0.7157712305025996,0.03708838821490468
10322,14.0,351,3537,3888,19,282,5366,1498,3868,5366,311,0.06541185240402535,0.6591502049944092,0.0035408125232948193,0.2791651136787179,0.7208348863212821,0.05255311218784942
10323,24.0,9731,243327,253058,765,15612,339454,96750,242704,339454,26117,0.028666623460026984,0.7168187736777295,0.0022536190470579223,0.2850165265396784,0.7149834734603215,0.045991504003487955
10324,25.0,108,5691,5799,16,164,7620,2301,5319,7620,709,0.014173228346456693,0.7468503937007874,0.002099737532808399,0.30196850393700786,0.6980314960629921,0.02152230971128609
10325,23.0,121,2201,2322,10,63,2980,839,2141,2980,245,0.04060402684563758,0.7385906040268456,0.003355704697986577,0.2815436241610738,0.7184563758389262,0.021140939597315438
10326,15.0,390,11512,11902,61,1165,16439,4579,11860,16439,1221,0.023724070807226716,0.7002859054687025,0.0037106879980534097,0.2785449236571568,0.7214550763428432,0.07086805766774135
10327,,610,17153,17763,29,765,23688,6767,16921,23688,1898,0.02575143532590341,0.7241219182708545,0.0012242485646740966,0.28567207024653835,0.7143279297534617,0.03229483282674772
10328,14.0,346,7460,7806,31,435,10312,3133,7179,10312,695,0.033553141970519784,0.7234290147401086,0.0030062063615205587,0.30382079131109385,0.6961792086889061,0.042183863460046545
10329,,82,2421,2503,19,92,3296,942,2354,3296,296,0.02487864077669903,0.7345266990291263,0.0057645631067961165,0.2858009708737864,0.7141990291262136,0.027912621359223302
10330,13.0,31,2215,2246,1,106,3009,834,2175,3009,302,0.01030242605516783,0.7361249584579594,0.00033233632436025255,0.27716849451645065,0.7228315054835494,0.035227650382186775
10331,,133,3132,3265,21,252,4532,1224,3308,4532,352,0.0293468667255075,0.6910856134157105,0.004633715798764342,0.27007943512797883,0.7299205648720212,0.05560458958517211
10332,14.0,245,2541,2786,19,254,4017,1020,2997,4017,190,0.06099078914612895,0.6325616131441374,0.004729897933781429,0.25392083644510827,0.7460791635548917,0.06323126711476226
10333,17.0,1042,19461,20503,78,870,26915,7774,19141,26915,1859,0.03871447148430243,0.7230540590748653,0.0028980122608211036,0.28883522199517,0.71116477800483,0.032323982909158465
10334,,496,15145,15641,54,760,20895,5812,15083,20895,1681,0.02373773630055037,0.724814548935152,0.0025843503230437905,0.27815266810241684,0.7218473318975831,0.036372337879875566
10335,15.0,99,2534,2633,5,762,3809,553,3256,3809,148,0.025991073772643737,0.6652664741401942,0.0013126804935678655,0.14518246258860593,0.8548175374113941,0.20005250721974271
10336,23.0,768,20585,21353,67,877,27996,8069,19929,27998,2119,0.027430530752196584,0.7352310879348525,0.0023930280734338165,0.28819915708264876,0.7118008429173512,0.031323665976141155
10337,25.0,692,7568,8260,58,384,11427,3095,8332,11427,592,0.060558326769930865,0.6622910650214404,0.0050756979084624135,0.27084974183950294,0.7291502581604971,0.03360462063533736
10338,24.0,405,11504,11909,23,524,15495,4506,10989,15495,1222,0.026137463697967087,0.74243304291707,0.001484349790254921,0.29080348499515973,0.7091965150048403,0.033817360438851245
10339,15.0,3,2412,2415,3,238,3277,922,2355,3277,255,0.00091547146780592,0.7360390601159598,0.00091547146780592,0.2813548977723528,0.7186451022276472,0.07262740311260299
10340,23.0,377,7959,8336,7,532,11066,3159,7907,11066,930,0.03406831736851618,0.7192300741008495,0.0006325682270016266,0.2854690041568769,0.7145309958431231,0.04807518525212362
10341,23.0,3736,31697,35433,5271,5490,55821,13169,42652,55821,2575,0.06692821697927304,0.5678328944304115,0.09442682861288762,0.23591479908994822,0.7640852009100517,0.09835008330198312
10342,,193,5574,5767,75,411,7964,2164,5800,7964,504,0.024234053239578102,0.6998995479658463,0.00941737820190859,0.2717227523857358,0.7282772476142642,0.05160723254645907
10343,,692,15423,16115,3,531,21092,6070,15022,21092,1334,0.03280864782856059,0.7312251090460838,0.00014223402237815286,0.28778683861179594,0.712213161388204,0.025175421960933055
10344,15.0,94,10011,10105,142,425,13854,3750,10104,13854,766,0.006785044030604879,0.7226071892594197,0.01024974736538184,0.27067994802945,0.72932005197055,0.030677060776670997
10345,,1110,27859,28969,107,1502,38120,10922,27198,38120,2802,0.02911857292759706,0.7308237145855194,0.002806925498426023,0.2865162644281217,0.7134837355718783,0.039401888772298006
10346,45.0,264,8282,8546,15,319,11182,3267,7915,11182,863,0.023609372205329996,0.7406546235020569,0.0013414416025755679,0.2921659810409587,0.7078340189590413,0.028527991414773742
10347,24.0,244,9650,9894,23,291,12558,3869,8689,12558,896,0.01942984551680204,0.768434464086638,0.0018315018315018315,0.3080904602643733,0.6919095397356267,0.023172479694218824
10348,,250,9069,9319,14,402,12460,3555,8905,12460,1191,0.020064205457463884,0.7278491171749599,0.0011235955056179776,0.28531300160513645,0.7146869983948636,0.03226324237560193
10349,26.0,43,4432,4475,4,55,5718,1686,4032,5718,587,0.007520111927247289,0.7750961874781392,0.0006995452955578874,0.29485834207764955,0.7051416579223505,0.009618747813920952
10350,,228,5776,6004,14,809,8444,2217,6227,8444,581,0.02700142112742776,0.6840360018948366,0.0016579819990525818,0.26255329227854096,0.737446707721459,0.0958076740881099
10351,17.0,147,8251,8398,20,766,11485,3221,8264,11485,997,0.01279930343926861,0.7184153243360906,0.0017414018284719198,0.2804527644754027,0.7195472355245973,0.06669569003047453
10352,15.0,55,1511,1566,5,73,2089,611,1478,2089,155,0.026328386787936812,0.7233125897558641,0.0023934897079942556,0.292484442316898,0.7075155576831019,0.034944949736716135
10353,17.0,606,13495,14101,76,1178,19330,5356,13974,19330,1520,0.031350232798758405,0.698137609932747,0.003931712364200725,0.27708225556130367,0.7229177444386963,0.06094154164511122
10354,,557,16664,17221,56,797,22609,6653,15956,22609,1636,0.024636206820292803,0.7370516166128532,0.002476889734176655,0.29426334645495156,0.7057366535450484,0.03525144853819275
10355,,261,6126,6387,26,368,8639,2440,6199,8639,617,0.030211830072925105,0.7091098506771617,0.0030096075934714665,0.2824400972334761,0.7175599027665239,0.0425975228614423
10356,,842,21659,22501,127,1022,31005,8613,22392,31005,2633,0.0271569101757781,0.6985647476213513,0.004096113530075794,0.2777939042089985,0.7222060957910015,0.032962425415255604
10357,36.0,184,4967,5151,2,244,6668,1926,4742,6668,490,0.027594481103779243,0.7449010197960408,0.00029994001199760045,0.28884223155368927,0.7111577684463107,0.03659268146370726
10358,,283,4022,4305,0,112,5690,1618,4072,5690,500,0.049736379613356765,0.7068541300527241,0.0,0.2843585237258348,0.7156414762741652,0.01968365553602812
10359,,411,10262,10673,59,503,14097,4126,9971,14097,930,0.029155139391359865,0.7279563027594523,0.004185287649854579,0.2926863871745761,0.7073136128254238,0.035681350641980566
10360,26.0,101,2098,2199,8,60,2885,827,2058,2885,237,0.03500866551126516,0.727209705372617,0.0027729636048526864,0.28665511265164645,0.7133448873483536,0.02079722703639515
10361,,250,6771,7021,12,918,9930,2609,7321,9930,590,0.025176233635448138,0.6818731117824773,0.0012084592145015106,0.26273917421953674,0.7372608257804633,0.09244712990936556
10362,34.0,2429,52408,54837,336,2004,72252,20858,51394,72252,5172,0.03361844654819244,0.7253501633172784,0.004650390300614516,0.2886840502685047,0.7113159497314954,0.027736256435808005
10363,,34,3470,3504,26,258,4840,1350,3490,4840,376,0.0070247933884297524,0.7169421487603306,0.005371900826446281,0.27892561983471076,0.7210743801652892,0.05330578512396694
10364,24.0,2240,48258,50498,290,2656,67520,19019,48501,67520,5240,0.03317535545023697,0.7147215639810427,0.0042950236966824646,0.28167950236966827,0.7183204976303318,0.03933649289099526
10365,27.0,246,5405,5651,27,315,7600,2141,5459,7600,504,0.03236842105263158,0.7111842105263158,0.0035526315789473684,0.28171052631578947,0.7182894736842105,0.04144736842105263
10366,17.0,301,11294,11595,63,491,15469,4417,11052,15469,1155,0.019458271381472624,0.7301053720343914,0.00407266145193613,0.2855388195746331,0.7144611804253669,0.031740901157153015
10367,25.0,94,4759,4853,4,202,6249,1916,4333,6249,497,0.015042406785085614,0.7615618498959834,0.0006401024163866218,0.30660905744919187,0.6933909425508081,0.032325172027524406
10368,,6330,110507,116837,602,6809,154991,43734,111257,154991,10522,0.040841081095031324,0.7129897865037325,0.00388409649592557,0.28217122284519747,0.7178287771548025,0.043931583124181404
10369,24.0,1084,18846,19930,185,1141,27398,7593,19805,27398,2036,0.039564931746842835,0.6878604277684502,0.00675231768742244,0.27713701730053286,0.7228629826994671,0.04164537557485948
10370,42.0,1691,56857,58548,68,1879,75898,22169,53729,75898,5570,0.022279901973701548,0.7491238240796859,0.0008959392869377323,0.29208938311944976,0.7079106168805502,0.024756910590529396
10371,23.0,234,4158,4392,7,322,5943,1623,4320,5943,398,0.03937405350832913,0.6996466431095406,0.001177856301531213,0.2730943967693084,0.7269056032306915,0.05418138987043581
10372,17.0,54,3700,3754,8,198,5184,1423,3761,5184,431,0.010416666666666666,0.7137345679012346,0.0015432098765432098,0.27449845679012347,0.7255015432098766,0.03819444444444445
10373,,470,5862,6332,34,312,8649,2443,6206,8649,688,0.05434154237484102,0.6777662157474853,0.0039310902994565845,0.2824604000462481,0.7175395999537518,0.036073534512660425
10374,41.0,135,1745,1880,0,265,2609,734,1875,2609,126,0.05174396320429283,0.6688386354925259,0.0,0.2813338443848218,0.7186661556151782,0.10157148332694518
10375,33.0,127,2395,2522,80,142,3334,931,2403,3334,151,0.03809238152369526,0.7183563287342531,0.02399520095980804,0.27924415116976603,0.7207558488302339,0.04259148170365927
10376,48.0,9360,244902,254262,1918,9937,327349,95958,231391,327349,22212,0.028593336164155075,0.7481373091104601,0.0058591900387659655,0.2931366828675206,0.7068633171324794,0.030355980925556515
10377,,174,3411,3585,21,209,4941,1386,3555,4941,302,0.035215543412264724,0.6903460837887068,0.004250151791135397,0.28051001821493626,0.7194899817850637,0.04229912973082372
10378,13.0,46,1978,2024,9,182,2800,798,2002,2800,236,0.016428571428571428,0.7064285714285714,0.0032142857142857142,0.285,0.715,0.065
10379,,336,10524,10860,4,389,14001,4199,9802,14001,1029,0.023998285836725947,0.7516605956717377,0.00028569387900864224,0.2999071494893222,0.7000928505106778,0.02778372973359046
10380,,15620,345852,361472,1200,18421,480080,136231,343849,480080,33079,0.03253624395934011,0.7204049325112482,0.0024995834027662055,0.28376728878520247,0.7162327112147975,0.038370688218630225
10381,24.0,317,10501,10818,34,637,14163,4042,10121,14163,1107,0.022382263644708043,0.741438960672174,0.002400621337287298,0.2853915130975076,0.7146084869024925,0.04497634681917673
10382,24.0,46,2125,2171,0,67,2787,878,1909,2787,266,0.016505202726946538,0.7624686042339434,0.0,0.3150340868317187,0.6849659131682813,0.024040186580552566
10383,23.0,120,5188,5308,6,219,6813,2086,4727,6813,518,0.017613386173491855,0.7614853955672978,0.0008806693086745927,0.3061793629825334,0.6938206370174667,0.032144429766622636
10384,,531,9852,10383,68,626,14084,3950,10134,14084,950,0.03770235728486226,0.6995171826185743,0.004828173814257313,0.28046009656347626,0.7195399034365237,0.04444760011360409
10385,24.0,4410,88321,92731,439,3072,124138,35388,88750,124138,8374,0.03552498026389985,0.7114743269587073,0.0035363869242294866,0.28506984162786575,0.7149301583721343,0.024746652918526155
10386,,15620,345852,361472,1200,18421,480080,136231,343849,480080,33079,0.03253624395934011,0.7204049325112482,0.0024995834027662055,0.28376728878520247,0.7162327112147975,0.038370688218630225
10387,,70,6403,6473,31,181,8591,2473,6118,8591,824,0.008148061925270633,0.7453148643929693,0.0036084274240484227,0.2878593877313468,0.7121406122686532,0.02106856012105692
10388,17.0,858,26257,27115,154,1272,36130,10346,25784,36130,2890,0.023747578189869913,0.7267367838361473,0.00426238582895101,0.28635482978134513,0.7136451702186548,0.03520619983393302
10389,,393,10342,10735,122,626,14222,4100,10122,14222,1084,0.02763324426944171,0.7271832372380819,0.008578259035297426,0.2882857544649135,0.7117142455350864,0.044016312754886794
10390,,382,9262,9644,5,121,12471,3595,8876,12471,733,0.030631064068639243,0.7426830246171117,0.00040093015796648226,0.28826878357790076,0.7117312164220992,0.00970250982278887
10391,,4717,102073,106790,837,5043,140813,40745,100068,140813,9294,0.033498327569187504,0.7248833559401475,0.005944053460973064,0.28935538622144263,0.7106446137785574,0.03581345472364057
10392,16.0,8,2323,2331,14,177,3144,887,2257,3144,239,0.002544529262086514,0.7388676844783715,0.004452926208651399,0.2821246819338422,0.7178753180661578,0.05629770992366412
10393,17.0,1795,22898,30580,377,3925,46463,9088,37547,46635,2229,0.038490404202851936,0.49100461027125547,0.008084057038704835,0.19487509381365928,0.8051249061863407,0.08416425431542833
10394,23.0,73,2844,2917,4,142,3828,1137,2691,3828,279,0.019070010449320794,0.7429467084639498,0.0010449320794148381,0.29702194357366773,0.7029780564263323,0.03709508881922675
10395,16.0,113,5156,5269,44,248,6992,1935,5057,6992,628,0.01616132723112128,0.7374141876430206,0.006292906178489702,0.2767448512585812,0.7232551487414187,0.03546910755148741
10396,,60,2471,2531,6,53,3315,983,2332,3315,328,0.01809954751131222,0.7453996983408748,0.0018099547511312218,0.2965309200603318,0.7034690799396682,0.015987933634992457
10397,,298,7909,8207,11,727,11146,2932,8214,11146,706,0.026736048806746814,0.7095819127938274,0.0009869011304503858,0.263054010407321,0.736945989592679,0.06522519289431186
10398,,464,8900,9364,49,538,12949,3522,9427,12949,933,0.03583288284809638,0.6873117615259866,0.003784075990423971,0.27199011506680054,0.7280098849331995,0.04154760985404278
10399,,1099,47874,48973,1006,4539,69208,17965,51243,69208,4668,0.015879667090509766,0.6917408392093399,0.014535891804415675,0.2595798173621547,0.7404201826378454,0.06558490347936655
10400,,466,8992,9458,27,629,12693,3623,9070,12693,847,0.03671314897975262,0.7084219648625226,0.002127156700543607,0.28543291578035135,0.7145670842196487,0.049554872764515874
10401,26.0,1576,46114,47690,82,1684,62195,18180,44015,62195,5181,0.02533965752874025,0.7414422381220356,0.0013184339577136425,0.29230645550285395,0.707693544497146,0.027076131521826512
10402,,1133,31552,32685,111,908,41327,12583,28744,41327,3143,0.027415491083311153,0.7634718222953517,0.002685895419459433,0.30447407264016263,0.6955259273598374,0.021971108476298788
10403,14.0,784,2617,3401,19,444,5155,1288,3867,5155,128,0.15208535402521822,0.5076624636275461,0.0036857419980601356,0.2498545101842871,0.7501454898157129,0.08612997090203686
10404,23.0,234,7499,7733,11,302,10191,2941,7250,10191,785,0.022961436561672065,0.7358453537434991,0.0010793837699931313,0.2885879697772544,0.7114120302227456,0.029633990776175057
10405,27.0,537,6766,7303,39,354,10047,2689,7358,10047,608,0.053448790683786204,0.6734348561759729,0.003881755747984473,0.2676420822135961,0.7323579177864039,0.03523439832785906
10406,16.0,1610,63242,64852,37,3062,88752,25338,63414,88752,8227,0.018140436271858663,0.7125698575806743,0.0004168920137010997,0.2854921579232017,0.7145078420767983,0.034500630971696415
10407,35.0,476,6409,6885,6,384,9232,2669,6563,9232,616,0.05155979202772964,0.6942157712305026,0.0006499133448873484,0.28910311958405543,0.7108968804159446,0.0415944540727903
10408,23.0,207,2889,3096,12,181,4150,1133,3017,4150,264,0.04987951807228916,0.696144578313253,0.002891566265060241,0.2730120481927711,0.7269879518072289,0.0436144578313253
10409,,172,1752,1924,5,99,2597,718,1879,2597,172,0.06623026569118214,0.6746245668078552,0.0019252984212552945,0.2764728532922603,0.7235271467077397,0.03812090874085483
10410,26.0,94,2184,2278,5,128,3092,882,2210,3092,235,0.03040103492884864,0.7063389391979301,0.0016170763260025874,0.28525226390685643,0.7147477360931436,0.04139715394566624
10411,,227,6098,6325,53,216,8318,2456,5862,8318,665,0.027290213993748497,0.7331089204135609,0.00637172397210868,0.2952632844433758,0.7047367155566242,0.025967780716518393
10412,38.0,2267,59021,61288,194,2583,80180,23444,56736,80180,5541,0.028273883761536542,0.7361062609129458,0.002419555999002245,0.29239211773509605,0.707607882264904,0.03221501621351958
10413,13.0,144,2615,2759,55,132,3788,1049,2739,3788,241,0.03801478352692714,0.6903379091869061,0.014519535374868005,0.2769271383315734,0.7230728616684267,0.03484688489968321
10414,,183,2469,2652,9,207,3698,1002,2696,3698,252,0.0494862087614927,0.667658193618172,0.0024337479718766902,0.2709572742022715,0.7290427257977286,0.055976203353163875
10415,27.0,487,9275,9762,0,310,12806,3994,8812,12806,693,0.038029048883335935,0.7242698734967984,0.0,0.3118850538809933,0.6881149461190067,0.0242074027799469
10416,15.0,226,6027,6253,92,669,8757,2407,6350,8757,586,0.02580792508850063,0.6882494004796164,0.010505881009478132,0.27486582162841156,0.7251341783715884,0.0763960260363138
10417,24.0,1482,52925,54407,190,2903,74058,20591,53467,74058,6106,0.020011342461314106,0.7146425774393044,0.0025655567258095007,0.27803883442707067,0.7219611655729293,0.039199006184342
10418,,203,9084,9287,0,358,11891,3692,8199,11891,1001,0.017071734925573963,0.7639391136153393,0.0,0.31048692288285257,0.6895130771171474,0.030106803464805314
10419,37.0,335,9387,9722,57,439,13247,3721,9526,13247,1127,0.02528874462142372,0.708613270929267,0.004302861025137767,0.28089378727259,0.7191062127274099,0.033139578772552275
10420,,155,2116,2271,25,127,3064,854,2210,3064,208,0.050587467362924285,0.6906005221932114,0.008159268929503917,0.27872062663185376,0.7212793733681462,0.041449086161879894
10421,42.0,1036,20381,21417,296,1373,28584,7900,20684,28584,1997,0.036244052616848585,0.713021270640918,0.010355443604813882,0.276378393506857,0.723621606493143,0.04803386509935628
10422,,161,5210,5371,2,177,6975,2033,4942,6975,576,0.023082437275985662,0.7469534050179212,0.0002867383512544803,0.2914695340501792,0.7085304659498208,0.025376344086021504
10423,23.0,64,1622,1686,23,79,2295,647,1648,2295,183,0.027886710239651415,0.7067538126361655,0.010021786492374727,0.281917211328976,0.7180827886710239,0.03442265795206972
10424,15.0,446,5759,6205,54,300,8337,2284,6053,8337,650,0.05349646155691496,0.690776058534245,0.006477150053976251,0.273959457838551,0.726040542161449,0.035984166966534725
10425,48.0,1235,35955,37190,111,1049,47697,14078,33619,47697,3737,0.025892613791223765,0.7538209950311341,0.0023271903893326623,0.29515483154076777,0.7048451684592323,0.02199299746315282
10426,23.0,3138,90597,93735,485,4367,123031,35562,87469,123031,8503,0.025505766839251896,0.7363753850655526,0.003942095894530647,0.289049101445977,0.7109508985540229,0.03549511911632028
10427,25.0,192,5351,5543,21,288,7371,2074,5297,7371,588,0.026048026048026047,0.7259530592863926,0.002849002849002849,0.2813729480396147,0.7186270519603853,0.03907203907203907
10428,,880,20452,21332,142,998,28441,8159,20282,28441,2070,0.03094124679160367,0.7191027038430435,0.004992792095917865,0.28687458246897085,0.7131254175310291,0.03509018670229598
10429,,108,7462,7570,49,1233,11307,2858,8449,11307,580,0.009551605200318386,0.6599451667108871,0.004333598655700009,0.2527637746528699,0.7472362253471301,0.10904749270363491
10430,,133,3942,4075,13,154,5398,1499,3899,5398,440,0.024638755094479436,0.7302704705446461,0.0024082993701370877,0.2776954427565765,0.7223045572434235,0.02852908484623935
10431,16.0,496,13773,14269,15,679,18714,5364,13350,18714,1521,0.026504221438495245,0.735973068291119,0.0008015389547932029,0.2866303302340494,0.7133696697659506,0.03628299668697232
10432,17.0,690,12150,12840,153,1066,17818,4962,12856,17818,1274,0.03872488494780559,0.6818947132113593,0.008586822314513413,0.2784824334942193,0.7215175665057807,0.05982714109327646
10433,,722,16626,17348,89,1129,24888,6719,18169,24888,1803,0.029009964641594343,0.6680327868852459,0.0035760205721632916,0.2699694631951141,0.7300305368048859,0.04536322725811636
10434,,519,12260,12779,50,526,17268,4850,12418,17268,1189,0.030055594162612925,0.7099837850359045,0.0028955293027565438,0.2808663423673848,0.7191336576326153,0.03046096826499884
10435,25.0,58,5620,5678,7,446,7708,2158,5550,7708,510,0.007524649714582252,0.7291126102750389,0.0009081473793461339,0.27996886351842243,0.7200311364815776,0.05786196159833939
10436,,722,22926,23648,108,1056,31312,8996,22316,31312,2300,0.023058252427184466,0.7321793561573837,0.0034491568727644355,0.2873019928461932,0.7126980071538068,0.03372508942258559
10437,,101,2231,2332,0,198,3149,846,2303,3149,210,0.03207367418228009,0.7084788821848206,0.0,0.26865671641791045,0.7313432835820896,0.06287710384248968
10438,14.0,3458,44058,47516,1623,2679,65974,18245,47729,65974,3052,0.052414587564798255,0.6678085306332798,0.024600600236456785,0.2765483372237548,0.7234516627762452,0.040606905750750294
10439,33.0,1073,22726,23799,114,1209,31528,9126,22402,31528,2177,0.03403324029434154,0.7208195889368181,0.0036158335447855875,0.2894569906115199,0.71054300938848,0.03834686627759452
10440,,4193,81678,85871,383,5740,115837,32674,83163,115837,7875,0.03619741533361534,0.7051114928736069,0.0033063701580669388,0.2820687690461597,0.7179312309538403,0.049552388269723836
10441,,1905,41292,43197,250,2616,58248,16277,41971,58248,4185,0.032704985578904,0.7088998763906057,0.004291992858123884,0.2794430710067298,0.7205569289932702,0.04491141326740832
10442,16.0,12621,426254,438875,485,15961,563551,166290,397261,563551,40788,0.022395488607064844,0.7563716504806132,0.0008606142123782941,0.29507533479667325,0.7049246652033268,0.02832219266756691
10443,,1357,30218,31575,418,1542,41973,11897,30076,41973,3186,0.032330307578681536,0.7199390084101684,0.009958783027184143,0.2834441188383008,0.7165558811616992,0.03673790293760274
10444,42.0,776,21162,21938,39,928,29408,8367,21041,29408,2438,0.026387377584330796,0.7196001088139282,0.0013261697497279651,0.2845144178454842,0.7154855821545157,0.031556039173014146
10445,,187,3297,3484,83,236,4808,1340,3468,4808,307,0.03889351081530782,0.6857321131447587,0.017262895174708817,0.27870216306156403,0.721297836938436,0.04908485856905158
10446,,308,2222,3167,14,212,4310,989,3321,4310,251,0.071461716937355,0.5155452436194896,0.0032482598607888632,0.2294663573085847,0.7705336426914153,0.04918793503480278
10447,,426,9705,10131,33,1028,14717,3889,10828,14717,1036,0.028946116735747776,0.6594414622545356,0.0022423048175579264,0.26425222531765985,0.7357477746823402,0.06985119249847116
10448,,109,2710,2819,17,157,3797,1068,2729,3797,324,0.02870687384777456,0.713721358967606,0.004477218856992362,0.28127469054516724,0.7187253094548328,0.04134843297340005
10449,25.0,196,4849,5045,9,187,6653,1927,4726,6653,569,0.029460393807304974,0.7288441304674583,0.00135277318502931,0.28964376972794226,0.7103562302720577,0.028107620622275665
10450,14.0,172,3927,4099,50,154,5304,1555,3749,5304,334,0.032428355957767725,0.7403846153846154,0.00942684766214178,0.29317496229260936,0.7068250377073907,0.029034690799396683
10451,,417,1331,1748,44,66,2586,684,1902,2586,140,0.16125290023201855,0.5146945088940449,0.017014694508894045,0.26450116009280744,0.7354988399071926,0.025522041763341066
10452,,162,4804,4966,14,261,6942,1907,5035,6942,473,0.023336214347450302,0.6920195908959954,0.002016709881878421,0.2747046960530107,0.7252953039469894,0.03759723422644771
10453,,343,5601,5944,181,372,8522,2245,6277,8522,488,0.040248767894860364,0.6572400844872096,0.02123914574043652,0.2634358131893922,0.7365641868106079,0.04365172494719549
10454,15.0,12998,155065,168063,3419,16243,236808,62561,174247,236808,14986,0.05488834836660924,0.654813181987095,0.014437856829161176,0.26418448701057395,0.735815512989426,0.0685914327218675
10455,,1078,34566,35644,186,1838,47551,13210,34341,47551,3591,0.02267039599587811,0.7269247755041955,0.003911589661626465,0.2778069861832559,0.7221930138167442,0.03865323547349162
10456,24.0,302,7337,7639,63,252,10190,3007,7183,10190,709,0.029636898920510305,0.7200196270853778,0.006182531894013739,0.29509322865554466,0.7049067713444553,0.024730127576054955
10457,,1654,30709,32363,527,2155,45219,11648,33571,45219,2811,0.03657754483734713,0.6791171852539861,0.011654393064862115,0.2575908357106526,0.7424091642893474,0.04765695835821226
10458,13.0,1053,110233,111286,172,6724,148179,42993,105186,148179,12904,0.007106270119247667,0.7439178291120874,0.0011607582720898372,0.2901423278602231,0.7098576721397769,0.04537755012518643
10459,35.0,3331,79882,83213,178,6675,121449,32044,89405,121449,8434,0.027427150491152665,0.657741109436883,0.0014656357812744445,0.26384737626493426,0.7361526237350657,0.05496134179779166
10460,25.0,324,7146,7470,18,287,10276,2888,7388,10276,748,0.031529778123783575,0.6954067730634488,0.0017516543402101986,0.2810432074737252,0.7189567925262749,0.027929155313351498
10461,13.0,565,7209,7774,46,1280,11260,2929,8331,11260,540,0.05017761989342807,0.6402309058614565,0.004085257548845471,0.26012433392539963,0.7398756660746003,0.11367673179396093
10462,25.0,747,15984,16731,268,978,22813,6502,16311,22813,1434,0.032744487792048395,0.7006531363696138,0.011747687721912944,0.28501293122342525,0.7149870687765748,0.04287029325384649
10463,,830,11011,11841,381,626,15947,4482,11465,15947,863,0.052047407035806105,0.6904746974352542,0.02389164106101461,0.28105599799335296,0.718944002006647,0.03925503229447545
10464,,236,6416,6652,16,366,8661,2491,6170,8661,616,0.027248585613670478,0.7407920563445329,0.0018473617365200323,0.2876111303544625,0.7123888696455375,0.04225839972289574
10465,16.0,359,5817,6176,31,362,8206,2321,5885,8206,538,0.04374847672434804,0.7088715573970266,0.003777723616865708,0.2828418230563003,0.7171581769436998,0.04411406288081891
10466,,680,17344,18024,40,863,23149,6927,16222,23149,1621,0.02937491900298069,0.7492332282172016,0.0017279364119400407,0.29923538813771655,0.7007646118622834,0.03728022808760638
10467,14.0,1524,13230,14754,189,739,19900,5529,14371,19900,1179,0.07658291457286433,0.6648241206030151,0.00949748743718593,0.2778391959798995,0.7221608040201005,0.037135678391959796
10468,,296,6305,6601,20,338,8886,2462,6424,8886,715,0.033310826018455995,0.70954310150799,0.0022507314877335135,0.2770650461399955,0.7229349538600045,0.038037362142696374
10469,39.0,813,12899,13712,140,545,17980,5122,12858,17980,1185,0.04521690767519466,0.7174082313681869,0.00778642936596218,0.2848720800889878,0.7151279199110122,0.030311457174638488
10470,15.0,342,9010,9352,6,849,12666,3551,9115,12666,923,0.02700142112742776,0.711353229117322,0.0004737091425864519,0.2803568608874151,0.7196431391125848,0.06702984367598294
10471,,1142,21709,22851,47,1396,30483,8683,21800,30483,2426,0.037463504248269525,0.7121674375881639,0.0015418429944559263,0.2848472919332087,0.7151527080667913,0.04579601745235049
10472,,495,10465,10960,14,620,14833,4163,10670,14833,1167,0.033371536439021104,0.7055214723926381,0.0009438414346389807,0.28065799231443406,0.719342007685566,0.04179869210544057
10473,,3504,48736,52240,270,2638,69511,19777,49734,69511,5097,0.0504092877386313,0.7011264404195019,0.0038842773086274116,0.2845161197508308,0.7154838802491692,0.037950827926515225
10474,,1573,38879,40452,242,3091,55412,15240,40172,55412,3597,0.02838735291994514,0.7016350249043528,0.004367285064606944,0.2750306792752472,0.7249693207247527,0.055782141052479604
10475,,3981,113316,117297,405,5558,155956,44354,111602,155956,12419,0.025526430531688425,0.7265895508989715,0.002596886301264459,0.28440072841057734,0.7155992715894226,0.03563825694426633
10476,17.0,2550,50668,53218,216,3032,71405,20431,50974,71405,5175,0.03571178488901337,0.7095861634339332,0.0030249982494223093,0.2861284223793852,0.7138715776206148,0.04246201246411316
10477,33.0,147,3794,3941,6,240,5271,1544,3727,5271,388,0.027888446215139442,0.7197875166002656,0.0011383039271485487,0.2929235439195599,0.7070764560804401,0.045532157085941945
10478,16.0,3222,47551,50773,170,3027,68096,19247,48849,68096,4059,0.047315554511278196,0.6982935855263158,0.0024964755639097745,0.2826450892857143,0.7173549107142857,0.04445195018796992
10479,27.0,619,11925,12544,84,863,17001,4708,12293,17001,955,0.0364096229633551,0.7014293276866067,0.0049408858302452795,0.2769248867713664,0.7230751132286336,0.05076171989882948
10480,24.0,156,3689,3845,19,157,5298,1445,3853,5298,395,0.02944507361268403,0.6963004907512269,0.003586258965647414,0.27274443186107966,0.7272555681389203,0.029633824084560213
10481,33.0,235,5075,5310,27,233,6934,2044,4890,6934,442,0.03389097202192097,0.731900778771272,0.003893856359965388,0.29477934813960194,0.7052206518603981,0.03360253821747909
10482,17.0,225,4789,5014,30,265,6852,1905,4947,6852,376,0.03283712784588441,0.6989200233508465,0.0043782837127845885,0.27802101576182137,0.7219789842381786,0.03867483946293053
10483,27.0,566,9626,10192,72,595,13827,3802,10025,13827,771,0.04093440370290012,0.6961741520214074,0.005207203297895422,0.2749692630360888,0.7250307369639112,0.04303174947566356
10484,15.0,9761,130552,140313,887,10103,196798,53766,143032,196798,13692,0.04959908129147654,0.6633807254138762,0.004507159625605951,0.2732039959755689,0.7267960040244311,0.05133690383032348
10485,,213,10901,11114,41,320,14263,4178,10085,14263,1278,0.01493374465399986,0.7642852134894482,0.002874570567201851,0.2929257519455935,0.7070742480544066,0.0224356727196242
10486,25.0,1868,40427,42295,302,2621,56790,16104,40686,56790,3877,0.03289311498503258,0.7118682866701884,0.005317837647473147,0.28357105124141574,0.7164289487585842,0.04615249163585138
10487,,54,1685,1739,0,97,2416,655,1761,2416,180,0.022350993377483443,0.6974337748344371,0.0,0.2711092715231788,0.7288907284768212,0.04014900662251655
10488,36.0,13559,194964,208523,1394,10991,301123,77956,223167,301123,16697,0.045028111436190524,0.6474563550442842,0.004629337513242097,0.2588842433158543,0.7411157566841456,0.036500034869471946
10489,16.0,27,2782,2809,10,452,4087,1107,2980,4087,349,0.0066063126988010765,0.6806948862246146,0.002446782481037436,0.27085882065084416,0.7291411793491559,0.11059456814289209
10490,24.0,405,16093,16498,16,641,21186,6146,15040,21186,1510,0.019116397621070518,0.7596053997923157,0.0007552157084867366,0.2900972340224677,0.7099027659775323,0.030255829321249882
10491,43.0,142,3600,3742,10,153,5188,1468,3720,5188,381,0.027370855821125674,0.6939090208172706,0.0019275250578257518,0.28296067848882034,0.7170393215111797,0.029491133384734
10492,39.0,52,2186,2238,0,42,2978,857,2121,2978,247,0.017461383478844864,0.7340496977837475,0.0,0.2877770315648086,0.7122229684351914,0.014103425117528543
10493,15.0,45,2059,2104,10,526,3366,794,2572,3366,139,0.013368983957219251,0.6117052881758764,0.0029708853238265003,0.23588829471182413,0.7641117052881758,0.1562685680332739
10494,15.0,187,4637,4824,9,248,6442,1871,4571,6442,585,0.029028252095622476,0.7198075131946601,0.0013970816516609749,0.2904377522508538,0.7095622477491462,0.03849736106799131
10495,14.0,1433,13123,14556,21,1293,19554,5424,14130,19554,1212,0.0732842385189731,0.6711158842180628,0.0010739490641301012,0.2773857011353176,0.7226142988646824,0.0661245780914391
10496,41.0,11613,235785,247398,565,12498,331544,94269,237275,331544,25117,0.035027025070578865,0.711172574379268,0.00170414786574331,0.28433330116063027,0.7156666988393697,0.037696354028424583
10497,17.0,236,4527,4763,8,198,6240,1794,4446,6240,454,0.03782051282051282,0.7254807692307692,0.001282051282051282,0.2875,0.7125,0.03173076923076923
10498,16.0,1053,14407,15460,1755,1394,22574,5854,16720,22574,1263,0.04664658456631523,0.6382121024187118,0.07774430761052538,0.2593248870381855,0.7406751129618144,0.061752458580668024
10499,16.0,304,2118,2422,19,371,3599,923,2676,3599,143,0.08446790775215338,0.5884968046679633,0.005279244234509586,0.2564601278132815,0.7435398721867186,0.10308419005279244
10500,,441,20252,20693,1,825,26634,7717,18917,26634,2171,0.01655778328452354,0.7603814672974394,3.754599384245701e-05,0.28974243448224074,0.7102575655177592,0.03097544492002703
10501,26.0,97,4143,4240,11,135,5529,1609,3920,5529,464,0.017543859649122806,0.7493217580032555,0.0019895098571170193,0.2910110327364804,0.7089889672635197,0.024416711882799782
10502,27.0,180,6158,6338,32,248,8342,2343,5999,8342,686,0.021577559338288182,0.7381922800287701,0.0038360105490290097,0.2808678973867178,0.7191321026132822,0.029729081754974827
10503,23.0,8556,200315,208871,592,10003,275327,79641,195686,275327,21276,0.031075775350764726,0.7275530550944876,0.00215017052450359,0.2892596803074163,0.7107403196925838,0.036331344183461844
10504,34.0,21202,570100,591302,1790,23659,768028,223943,544085,768028,56311,0.027605764373173896,0.7422906456535439,0.0023306441952637143,0.2915818173295765,0.7084181826704234,0.03080486648924258
10505,37.0,2091,54123,56214,328,4192,76008,21579,54429,76008,5965,0.027510262077676033,0.712069782128197,0.00431533522787075,0.28390432586043574,0.7160956741395642,0.05515208925376276
10506,,417,9067,9673,24,1048,13812,3627,10185,13812,865,0.030191138140747177,0.6564581523313061,0.0017376194613379669,0.26259774109470024,0.7374022589052998,0.0758760498117579
10507,17.0,335,6905,7240,29,613,10261,2713,7548,10261,568,0.03264789006919404,0.6729363609784621,0.0028262352597212747,0.26439918136633855,0.7356008186336614,0.059740766007211774
10508,,244,5304,5548,22,236,7539,2109,5430,7539,548,0.03236503515055047,0.703541583764425,0.002918158907016846,0.27974532431356947,0.7202546756864305,0.0313038864570898
10509,,627,20039,20666,60,785,27713,7878,19835,27713,2279,0.022624760942517953,0.7230902464547324,0.0021650488940208566,0.28427091978493846,0.7157290802150615,0.02832605636343954
10510,,248,2369,2617,49,251,5595,904,4691,5595,134,0.04432529043789098,0.4234137622877569,0.00875781948168007,0.1615728328865058,0.8384271671134942,0.04486148346738159
10511,33.0,2109,56732,58841,54,3064,76071,22310,53761,76071,5264,0.027724099854083684,0.7457769715134546,0.0007098631541586149,0.29327864757923516,0.7067213524207648,0.04027816119151845
10512,17.0,19,10089,10108,40,942,14339,3790,10549,14339,1034,0.0013250575353929842,0.7036055512936746,0.0027895948113536508,0.2643141083757584,0.7356858916242416,0.06569495780737848
10513,26.0,5640,133182,138822,573,5117,184803,52546,132257,184803,13412,0.030518985081411015,0.7206701189915748,0.0031005990162497363,0.2843352110084793,0.7156647889915208,0.027688944443542585
10514,15.0,189,4316,4505,0,208,5970,1709,4261,5970,404,0.03165829145728643,0.7229480737018426,0.0,0.2862646566164154,0.7137353433835846,0.03484087102177554
10515,16.0,23,2199,2222,14,189,3148,853,2295,3148,240,0.007306226175349428,0.6985387547649301,0.0044472681067344345,0.27096569250317665,0.7290343074968234,0.06003811944091487
10516,25.0,2192,63925,66117,165,2272,86826,25378,61448,86826,7510,0.025245894087024625,0.7362426001428144,0.0019003524289959229,0.2922857208670214,0.7077142791329786,0.026167277082901435
10517,17.0,836,22038,22874,118,1166,30895,8690,22205,30895,2337,0.02705939472406538,0.7133193073312833,0.003819388250525975,0.2812752872633112,0.7187247127366888,0.03774073474672277
10518,26.0,380,6165,6545,84,378,8905,2396,6509,8905,499,0.04267265581134194,0.6923076923076923,0.009432902863559798,0.2690623245367771,0.7309376754632229,0.04244806288601909
10519,,102,1373,1475,0,104,2009,577,1432,2009,137,0.0507715281234445,0.6834245893479343,0.0,0.28720756595321056,0.7127924340467895,0.051767048282727726
10520,,781,18954,19735,33,1006,26005,7519,18486,26005,1931,0.030032686021918862,0.7288598346471832,0.0012689867333205154,0.2891367044799077,0.7108632955200923,0.038684868294558736
10521,,218,5576,5794,45,300,7659,2177,5482,7659,576,0.028463245854550203,0.7280323802062932,0.005875440658049354,0.28424076250163205,0.7157592374983679,0.03916960438699569
10522,24.0,378,7838,8216,32,337,10981,3088,7893,10981,792,0.03442309443584373,0.7137783444130771,0.0029141243966851835,0.2812130042801202,0.7187869957198798,0.030689372552590837
10523,44.0,343,10034,10377,38,531,13821,3932,9889,13821,1013,0.024817306996599377,0.7259966717314232,0.0027494392590984734,0.28449460965197887,0.7155053903480211,0.03841979596266551
10524,24.0,509,22386,22895,186,1672,32047,8593,23454,32047,2130,0.01588292195837364,0.6985365244796705,0.005803975411114925,0.26813742315973416,0.7318625768402659,0.052173370362280404
10525,17.0,120,10734,10854,67,880,14743,4026,10717,14743,1089,0.00813945601302313,0.7280743403649189,0.0045445296072712475,0.273078749236926,0.726921250763074,0.05968934409550295
10526,25.0,308,5251,5559,29,558,7579,2047,5532,7579,458,0.040638606676342524,0.6928354664203721,0.0038263623169283545,0.27008840216387386,0.7299115978361261,0.07362448871882835
10527,,293,3121,3416,7,318,4636,1305,3331,4636,260,0.06320103537532355,0.6732096635030198,0.0015099223468507334,0.2814926660914582,0.7185073339085418,0.06859361518550475
10528,16.0,485,5535,6020,55,406,8252,2266,5986,8252,522,0.058773630634997576,0.6707464857004363,0.006665050896752302,0.27460009694619486,0.7253999030538051,0.04920019389238972
10529,23.0,882,20573,21455,185,1091,29114,8149,20965,29114,2054,0.030294703579034143,0.7066359826887408,0.006354331249570654,0.2798997046094662,0.7201002953905338,0.037473380504224774
10530,44.0,990,27293,28283,333,1060,36322,10782,25540,36322,2439,0.027256208358570563,0.7514178734651176,0.009167997356973734,0.2968448873960685,0.7031551126039315,0.029183415010186665
10531,26.0,48,3433,3481,1,260,4934,1337,3597,4934,338,0.009728415079043373,0.6957843534657479,0.00020267531414673692,0.27097689501418726,0.7290231049858127,0.0526955816781516
10532,,709,24789,25498,185,900,33507,10006,23501,33507,1419,0.02115975766257797,0.7398155609275674,0.005521234368937834,0.2986241680842809,0.7013758319157191,0.026860059092130004
10533,25.0,14,12691,12705,51,601,17067,4771,12296,17067,1611,0.0008202964785844027,0.743598757836761,0.0029882228862717526,0.2795453213804418,0.7204546786195583,0.03521415597351614
10534,,968,22467,23435,106,887,31414,9071,22343,31414,2434,0.030814286623798308,0.7151906793149552,0.003374291717068823,0.28875660533520087,0.7112433946647991,0.028235818424906092
10535,,280,8459,8739,33,929,12340,3095,9245,12340,933,0.022690437601296597,0.6854943273905997,0.002674230145867099,0.2508103727714749,0.7491896272285251,0.07528363047001621
10536,24.0,2457,67951,70408,136,5163,96181,26929,69252,96181,7420,0.02554558592653435,0.7064908869735187,0.0014140006862062154,0.2799825329326998,0.7200174670673002,0.05368004075649037
10537,,400,10452,10852,15,514,13878,4097,9781,13878,983,0.02882259691598213,0.753134457414613,0.00108084738434933,0.29521544891194695,0.704784551088053,0.037037037037037035
10538,24.0,211,3027,3238,2,218,4334,1246,3088,4334,329,0.048684817720350715,0.6984310106137517,0.00046146746654360867,0.2874942316566682,0.7125057683433318,0.050299953853253344
10539,23.0,62,2057,2119,0,76,2757,819,1938,2757,224,0.022488211824446862,0.7461008342401161,0.0,0.2970620239390642,0.7029379760609358,0.02756619513964454
10540,,1376,40524,41900,313,1840,54553,16132,38421,54553,4001,0.025223177460451305,0.7428372408483493,0.005737539640349751,0.29571242644767476,0.7042875735523253,0.03372866753432442
10541,17.0,13488,319988,333476,2144,29068,446821,120813,326008,446821,30171,0.030186584784511025,0.7161436011288637,0.004798342065390839,0.2703834421390221,0.7296165578609779,0.06505513393506572
10542,25.0,392,8092,8484,28,422,11428,3235,8193,11428,909,0.03430171508575429,0.7080854042702135,0.002450122506125306,0.28307665383269165,0.7169233461673084,0.03692684634231712
10543,,11,10423,10434,85,416,13412,3946,9466,13412,1134,0.0008201610498061437,0.7771398747390397,0.006337608112138383,0.29421413659409484,0.7057858634059052,0.03101699970175962
10544,27.0,413,6969,7382,12,241,9720,2843,6877,9720,863,0.04248971193415638,0.7169753086419753,0.0012345679012345679,0.2924897119341564,0.7075102880658436,0.02479423868312757
10545,23.0,1344,62576,63920,223,4268,87597,24373,63224,87597,6601,0.01534299119832871,0.7143623640078998,0.0025457492836512665,0.2782401223786203,0.7217598776213797,0.0487231297875498
10546,41.0,137,3413,3550,6,108,4676,1391,3285,4676,361,0.029298545765611635,0.7298973481608212,0.0012831479897348161,0.2974764756201882,0.7025235243798118,0.023096663815226688
10547,25.0,2080,25183,27263,303,1292,37742,10239,27503,37742,2009,0.05511101690424461,0.6672407397594192,0.008028191404801018,0.2712892798473849,0.7287107201526152,0.03423242011552117
10548,23.0,981,23508,24489,243,1355,33127,9435,23692,33127,2453,0.029613306366408066,0.7096326259546594,0.007335406164156126,0.284812992423099,0.715187007576901,0.04090319075074712
10549,,3726,63533,67259,528,4015,92284,25510,66774,92284,6444,0.04037536300983919,0.6884508690563912,0.005721468510250964,0.27642928351610246,0.7235707164838975,0.04350700013003338
10550,,4487,82928,87415,213,5581,116311,33261,83050,116311,8365,0.038577606589230595,0.7129850143150691,0.0018312971258092527,0.28596607371615756,0.7140339262838424,0.04798342375183774
10551,25.0,237,6875,7112,14,342,9639,2715,6924,9639,766,0.024587612822906942,0.7132482622678701,0.0014524328249818446,0.28166822284469345,0.7183317771553066,0.035480859010270774
10552,27.0,971,20568,21539,58,1391,28645,8100,20545,28645,1970,0.03389771338802584,0.7180310699947635,0.0020247861755978355,0.2827718624541805,0.7172281375458195,0.04855995810787223
10553,34.0,328,5762,6090,39,348,8569,2314,6255,8569,483,0.03827751196172249,0.6724238534251371,0.0045512895320340765,0.2700431789006885,0.7299568210993115,0.04061150659353484
10554,,317,3507,3824,29,373,5618,1447,4171,5618,329,0.05642577429690281,0.6242435030259879,0.005161979352082592,0.25756496974012105,0.742435030259879,0.0663937344250623
10555,27.0,20840,320830,341670,1380,13929,444493,128666,315848,444514,33425,0.0468826628632619,0.7217545454136428,0.0031045141435365364,0.28945320057411017,0.7105467994258898,0.03133534601834813
10556,17.0,529,10877,11406,103,886,15517,4199,11318,15517,973,0.03409164142553329,0.7009731262486305,0.0066378810337049685,0.27060643165560355,0.7293935683443965,0.057098665979248564
10557,,70,1960,2030,5,136,2742,774,1968,2742,207,0.025528811086797956,0.7148067104303428,0.0018234865061998542,0.28227571115973743,0.7177242888402626,0.049598832968636035
10558,37.0,7614,158480,166094,1537,5444,218770,63954,154816,218770,15592,0.03480367509256296,0.7244137678840792,0.0070256433697490515,0.2923344151391873,0.7076655848608128,0.024884581981076015
10559,25.0,10026,200452,210478,692,13811,282006,78121,203886,282007,20325,0.03555230898523796,0.7108050509384519,0.002453839798302879,0.27701794636303356,0.7229820536369664,0.04897396163925009
10560,,9669,167887,177556,908,8561,233621,68646,164977,233623,16601,0.041387192185700895,0.7186235944234942,0.0038866036306356823,0.2938323709566267,0.7061676290433733,0.036644508460211535
10561,24.0,215,4652,4867,17,287,6587,1864,4723,6587,470,0.03264004858053742,0.7062395627751632,0.0025808410505541216,0.2829816304842872,0.7170183695157127,0.04357066950053135
10562,,154,2619,2773,24,137,3782,1060,2722,3782,302,0.040719196192490745,0.692490745637229,0.006345848757271285,0.28027498677948176,0.7197250132205183,0.03622421998942359
10563,25.0,38,1616,1654,6,156,2364,602,1762,2364,165,0.016074450084602367,0.6835871404399323,0.0025380710659898475,0.2546531302876481,0.745346869712352,0.06598984771573604
10564,15.0,459,9052,9511,71,597,13048,3635,9413,13048,931,0.035177805027590436,0.693746167995095,0.0054414469650521154,0.2785867565910484,0.7214132434089515,0.045754138565297364
10565,17.0,966,24593,25559,37,1319,33878,9723,24155,33878,2835,0.028514079933880394,0.7259283310703111,0.0010921542003660193,0.2870004132475353,0.7129995867524648,0.038933821358994036
10566,14.0,1134,33324,34458,58,2215,46889,13618,33271,46889,4081,0.024184776813325086,0.7106997376783467,0.0012369638934504894,0.29043059139670285,0.7095694086032972,0.04723922455160059
10567,,56,3260,3316,8,551,4858,1232,3626,4858,272,0.011527377521613832,0.6710580485796624,0.0016467682173734047,0.25360230547550433,0.7463976945244957,0.11342116097159324
10568,24.0,224,5667,5891,12,285,7802,2256,5546,7802,581,0.028710587028966932,0.726352217380159,0.0015380671622660857,0.2891566265060241,0.7108433734939759,0.036529095103819534
10569,17.0,495,19141,19636,50,1164,26428,7453,18975,26428,2258,0.018730134705615256,0.7242697139397608,0.0018919327985469957,0.28201150295141514,0.7179884970485848,0.04404419555017406
10570,,12596,86014,98610,193,10528,138450,37937,100513,138450,8288,0.09097869266883352,0.6212639942217407,0.001394005055976887,0.2740122788010112,0.7259877211989888,0.07604189237992055
10571,17.0,90,2309,2399,4,163,3257,946,2311,3257,216,0.0276327909118821,0.7089346023948419,0.0012281240405280934,0.29045133558489405,0.7095486644151059,0.0500460546515198
10572,26.0,263,6301,6564,39,657,9010,2386,6624,9010,639,0.029189789123196447,0.6993340732519423,0.004328523862375139,0.2648168701442841,0.7351831298557159,0.07291897891231965
10573,27.0,464,11314,11930,35,661,16078,4484,11594,16078,1090,0.02885931085955965,0.7036944893643488,0.002176887672596094,0.27889040925488245,0.7211095907451176,0.041112078616743375
10574,48.0,1550,5298,6848,32,229,9315,2616,6699,9315,565,0.16639828234031132,0.5687600644122384,0.0034353193773483627,0.28083735909822866,0.7191626409017713,0.024584004294149222
10575,,284,6714,6998,128,353,9310,2591,6719,9310,617,0.03050483351235231,0.7211600429645543,0.013748657357679914,0.2783029001074114,0.7216970998925886,0.037916219119226637
10576,,1980,29628,31608,99,1821,42921,12073,30848,42921,3079,0.04613126441602013,0.690291465716083,0.0023065632208010066,0.28128421984576313,0.7187157801542369,0.04242678409170336
10577,26.0,455,7957,8412,10,554,11181,3149,8032,11181,785,0.040694034522851266,0.7116536982380824,0.0008943743851176102,0.28163849387353546,0.7183615061264645,0.049548340935515606
10578,,906,29738,30644,112,1839,40427,11358,29069,40427,3131,0.022410765082741733,0.7355974967224874,0.002770425705592797,0.28095084967966955,0.7190491503203305,0.045489400648081726
10579,17.0,261,6301,6562,72,198,8774,2497,6277,8774,746,0.029746979712787783,0.7181445178937771,0.008206063369044905,0.2845908365625712,0.7154091634374288,0.02256667426487349
10580,,19,3004,3023,8,311,4268,1165,3103,4268,313,0.004451733833177133,0.703842549203374,0.0018744142455482662,0.27296157450796626,0.7270384254920338,0.07286785379568884
10581,23.0,285,9130,9415,31,387,12244,3660,8584,12244,974,0.02327670695851029,0.7456713492322771,0.0025318523358379614,0.298921920940869,0.701078079059131,0.031607317869977135
10582,,80,1925,2005,13,90,2607,770,1837,2607,185,0.03068661296509398,0.7383966244725738,0.004986574606827772,0.29535864978902954,0.7046413502109705,0.03452243958573072
10583,,318,10197,10515,21,687,14072,3949,10123,14072,1141,0.02259806708357021,0.7246304718590107,0.0014923251847640704,0.2806281978396816,0.7193718021603184,0.04882035247299602
10584,25.0,1521,25086,26607,335,1036,35749,10045,25705,35750,2383,0.042545454545454546,0.7017062937062937,0.009370629370629371,0.280979020979021,0.7190209790209791,0.02897902097902098
10585,35.0,1877,52382,54259,155,2173,70730,20688,50042,70730,5587,0.026537537112964797,0.7405909797822706,0.0021914322069843065,0.2924925774070409,0.7075074225929592,0.030722465714689666
10586,24.0,618,8655,9273,126,486,12500,3444,9056,12500,708,0.04944,0.6924,0.01008,0.27552,0.72448,0.03888
10587,16.0,852,11132,11984,3,1248,16903,4718,12185,16903,1079,0.05040525350529492,0.6585813169259894,0.00017748328699047507,0.2791220493403538,0.7208779506596462,0.07383304738803763
10588,24.0,4375,70268,74643,347,5096,99829,28020,71809,99829,6442,0.04382494064850895,0.7038836410261547,0.003475943864007453,0.28067996273627904,0.719320037263721,0.05104729086738322
10589,14.0,41,4222,4263,42,213,5796,1590,4206,5796,431,0.007073844030365769,0.7284334023464458,0.007246376811594203,0.2743271221532091,0.7256728778467909,0.03674948240165631
10590,17.0,321,10561,10882,22,375,14507,4171,10336,14507,1332,0.022127248914317225,0.7279933825049976,0.0015165092713862274,0.287516371406907,0.712483628593093,0.02584958985317433
10591,,138,4243,4381,10,205,5850,1681,4169,5850,434,0.02358974358974359,0.7252991452991453,0.0017094017094017094,0.2873504273504274,0.7126495726495726,0.03504273504273504
10592,16.0,411,14074,14485,19,811,19129,5483,13646,19129,1607,0.021485702336766166,0.7357415442521825,0.0009932563124052487,0.2866328611009462,0.7133671388990538,0.04239636154529772
10593,34.0,10753,226664,237417,1777,10173,310817,90181,220636,310817,21026,0.03459591978559731,0.7292522609767162,0.005717190501163064,0.2901417876113597,0.7098582123886402,0.03272986998780633
10594,40.0,166,2673,2839,4,160,4258,1045,3213,4258,229,0.038985439173320806,0.6277595115077501,0.0009394081728511038,0.24542038515735087,0.7545796148426491,0.03757632691404415
10595,,180,1987,2167,7,219,3171,773,2398,3171,132,0.05676442762535478,0.6266162093976664,0.002207505518763797,0.24377168085777356,0.7562283191422264,0.06906338694418164
10596,,1992,52073,54065,327,2110,69465,20436,49029,69465,4483,0.028676311811703735,0.7496293097243216,0.004707406607644137,0.29419131936946663,0.7058086806305334,0.030375008997336788
10597,17.0,468,5059,5527,31,541,7687,2033,5654,7687,325,0.06088200858592429,0.6581241056328867,0.004032782620007805,0.2644724860153506,0.7355275139846494,0.07037856120723299
10598,,88,3050,3138,0,134,4138,1178,2960,4138,340,0.02126631222812953,0.7370710488158531,0.0,0.28467858869018847,0.7153214113098115,0.032382793620106334
10599,26.0,65,1614,1679,15,55,2374,651,1723,2374,163,0.02737994945240101,0.6798652064026959,0.006318449873631003,0.2742207245155855,0.7257792754844145,0.02316764953664701
10600,,152,1959,2111,9,76,2721,810,1911,2721,161,0.05586181550900404,0.7199558985667034,0.0033076074972436605,0.29768467475192945,0.7023153252480706,0.02793090775450202
10601,26.0,73,1604,1677,26,153,2382,644,1738,2382,146,0.030646515533165407,0.6733837111670865,0.0109151973131822,0.2703610411418976,0.7296389588581025,0.06423173803526448
10602,17.0,1735,22688,24423,185,998,30551,9255,21296,30551,1595,0.056790285097050835,0.7426270825832215,0.00605544826683251,0.3029360741055939,0.697063925894406,0.032666688488101864
10603,,623,22204,22827,48,1258,30292,8605,21687,30292,2267,0.020566486200977157,0.7329988115674105,0.001584576785950086,0.28406840089792684,0.7159315991020732,0.041529116598441836
10604,24.0,202,4533,4735,62,236,6593,1819,4774,6593,511,0.0306385560442894,0.6875473987562566,0.009403913241316548,0.2758986804186258,0.7241013195813741,0.03579554072501138
10605,25.0,367,11229,11596,68,466,15437,4398,11039,15437,1168,0.023774049361922654,0.727408175163568,0.004405000971691391,0.2848999157867461,0.7151000842132539,0.030187212541296884
10606,,280,8311,8591,19,294,11047,3333,7714,11047,904,0.02534624785009505,0.7523309495790712,0.0017199239612564498,0.3017108717298814,0.6982891282701186,0.0266135602425998
10607,14.0,393,9338,9731,30,694,13590,3748,9842,13590,778,0.02891832229580574,0.6871228844738778,0.002207505518763797,0.27579102281089035,0.7242089771891096,0.051066961000735836
10608,,472,12074,12546,103,526,16984,4644,12340,16984,1333,0.027790861987753178,0.7109043805934998,0.0060645313235986814,0.2734338200659444,0.7265661799340556,0.03097032501177579
10609,34.0,6894,106315,113209,1338,4770,153633,42045,111588,153633,9502,0.044873171779500495,0.692006274693588,0.008709066411513151,0.2736716721016969,0.7263283278983031,0.031048017027591728
10610,,539,11398,11937,133,524,16344,4518,11826,16344,1097,0.03297846304454234,0.6973813020068527,0.008137542829172785,0.276431718061674,0.723568281938326,0.03206069505628977
10611,,229,6261,6490,13,249,8698,2504,6194,8698,655,0.02632789146930329,0.7198206484249253,0.0014945964589560819,0.2878822717866176,0.7121177282133824,0.02862727063692803
10612,17.0,889,17408,18297,46,1079,24761,6936,17825,24761,1803,0.03590323492589152,0.7030410726545777,0.0018577601873914623,0.2801179273858083,0.7198820726141917,0.043576592221638864
10613,45.0,1278,27633,28911,132,931,37241,10916,26325,37241,2610,0.034317016191831584,0.7420047796783116,0.0035444805456351872,0.29311780027389167,0.7068821997261083,0.024999328696866358
10614,23.0,501,8918,9419,59,754,12978,3539,9439,12978,927,0.0386037910309755,0.6871628910463862,0.004546155031591925,0.27269224842040374,0.7273077515795963,0.058098320234242565
10615,,170,9507,9677,28,55,12526,3680,8846,12526,1113,0.01357177071690883,0.7589813188567779,0.002235350471020278,0.2937889190483794,0.7062110809516207,0.004390866996646974
10616,16.0,449,23795,24244,211,1795,33075,9099,23976,33075,2490,0.013575207860922147,0.7194255479969766,0.006379440665154951,0.27510204081632655,0.7248979591836735,0.05427059712773998
10617,15.0,651,23346,23997,50,1949,33054,9217,23837,33054,2681,0.019695044472681066,0.7062987838083137,0.0015126762267804199,0.2788467356447026,0.7211532643552974,0.05896411931990077
10618,26.0,133,1985,2118,2,172,2895,823,2072,2895,212,0.0459412780656304,0.6856649395509499,0.000690846286701209,0.2842832469775475,0.7157167530224525,0.059412780656303975
10619,27.0,181,3221,3402,25,159,4562,1279,3283,4562,334,0.0396755808855765,0.7060499780797895,0.0054800526085050415,0.28035949145111794,0.7196405085488821,0.034853134590092066
10620,40.0,150,3887,4037,11,116,5177,1558,3619,5177,430,0.02897430944562488,0.750820938767626,0.002124782692679158,0.30094649410855706,0.6990535058914429,0.022406799304616573
10621,14.0,35,1830,1865,27,103,2532,703,1829,2532,198,0.01382306477093207,0.7227488151658767,0.01066350710900474,0.27764612954186413,0.7223538704581358,0.040679304897314375
10622,13.0,203,4053,4256,4,249,5915,1619,4296,5915,473,0.03431952662721893,0.685207100591716,0.000676246830092984,0.27371090448013524,0.7262890955198648,0.04209636517328825
10623,23.0,2328,46977,49305,677,2521,66685,18658,48027,66685,4527,0.034910399640098976,0.7044612731498838,0.01015220814276074,0.2797930569093499,0.72020694309065,0.03780460373397316
10624,15.0,509,7999,8508,60,756,11881,3288,8593,11881,851,0.042841511657267906,0.6732598266139214,0.00505007995959936,0.27674438178604494,0.723255618213955,0.06363100749095194
10625,27.0,184,3982,4166,17,191,5499,1551,3948,5499,409,0.03346062920531006,0.724131660301873,0.0030914711765775596,0.28205128205128205,0.717948717948718,0.03473358792507729
10626,27.0,159,4522,4681,15,224,6204,1781,4423,6204,490,0.02562862669245648,0.7288845905867183,0.0024177949709864605,0.2870728562217924,0.7129271437782077,0.036105738233397806
10627,23.0,2910,53824,56840,229,3236,76864,21792,55072,76864,5559,0.03785907577019151,0.7002497918401333,0.0029792880932556203,0.2835137385512073,0.7164862614487927,0.042100333055786844
10628,16.0,5226,79616,84842,272,6749,114940,32402,82538,114940,8661,0.045467200278406124,0.6926744388376544,0.0023664520619453627,0.28190360187924135,0.7180963981207586,0.05871759178701932
10629,,79,2018,2097,22,82,2800,782,2018,2800,191,0.028214285714285713,0.7207142857142858,0.007857142857142858,0.2792857142857143,0.7207142857142858,0.029285714285714286
10630,23.0,173,2258,2431,35,132,3332,902,2430,3332,227,0.05192076830732293,0.6776710684273709,0.01050420168067227,0.2707082833133253,0.7292917166866747,0.03961584633853541
10631,,206,6727,6933,4,193,9113,2706,6407,9113,809,0.02260506968067596,0.7381762317568309,0.0004389333918577856,0.29693843959179195,0.7030615604082081,0.021178536157138154
10632,17.0,266,8863,9129,12,386,11969,3580,8389,11969,906,0.022224078870415238,0.7404962820619935,0.0010025900242292588,0.29910602389506225,0.7008939761049378,0.03224997911270783
10633,16.0,196,11513,11709,40,852,16668,4207,12461,16668,1346,0.01175905927525798,0.6907247420206384,0.0023998080153587713,0.2523998080153588,0.7476001919846412,0.051115910727141826
10634,24.0,138,2354,2492,12,139,3438,947,2491,3438,259,0.04013961605584642,0.6847004072134962,0.0034904013961605585,0.2754508435136707,0.7245491564863292,0.040430482838859805
10635,33.0,391,7898,8289,48,421,11227,3216,8011,11227,886,0.03482675692526944,0.703482675692527,0.004275407499777322,0.28645230248508063,0.7135476975149194,0.03749888661263027
10636,26.0,629,9577,10206,79,842,14104,3791,10313,14104,747,0.044597277368122516,0.6790272263187748,0.005601247872943846,0.2687889960294952,0.7312110039705049,0.05969937606352808
10637,23.0,417,14333,14750,14,431,19530,5544,13986,19530,1519,0.021351766513056834,0.7338965693804403,0.0007168458781362007,0.2838709677419355,0.7161290322580646,0.022068612391193038
10638,23.0,1174,25992,27166,52,1639,36291,10282,26009,36291,2770,0.03234961836267945,0.716210630734893,0.0014328621421289024,0.28332093356479565,0.7166790664352043,0.04516271251825522
10639,25.0,2640,85691,88331,1175,5114,119283,33217,86066,119283,9048,0.022132240134805463,0.7183840111331875,0.009850523544847127,0.27847220475675494,0.7215277952432451,0.0428728318368921
10640,15.0,857,14615,15472,92,1151,21100,5858,15242,21100,1471,0.04061611374407583,0.692654028436019,0.004360189573459716,0.2776303317535545,0.7223696682464456,0.05454976303317535
10641,,468,8641,9109,2,637,12276,3401,8875,12276,827,0.03812316715542522,0.7038937764744216,0.00016291951775822744,0.27704463994786577,0.7229553600521342,0.05188986640599544
10642,17.0,372,7304,7676,10,364,10700,2909,7791,10700,723,0.034766355140186916,0.6826168224299065,0.0009345794392523365,0.27186915887850466,0.7281308411214953,0.034018691588785045
10643,23.0,765,14444,15209,120,848,20768,5702,15066,20768,1281,0.03683551617873652,0.6954930662557781,0.005778120184899846,0.27455701078582434,0.7254429892141756,0.040832049306625574
10644,16.0,57,1762,1819,0,54,2391,723,1668,2391,167,0.02383939774153074,0.7369301547469678,0.0,0.30238393977415307,0.6976160602258469,0.02258469259723965
10645,,1078,21859,22937,39,1123,29910,8562,21348,29910,1784,0.036041457706452694,0.7308258107656302,0.001303911735205617,0.28625877632898694,0.713741223671013,0.03754597124707456
10646,25.0,641,18669,19310,64,948,26036,7265,18771,26036,1875,0.024619757259179597,0.7170456291288985,0.0024581348901520973,0.27903671838992167,0.7209632816100784,0.036411123060377935
10647,24.0,416,13616,14032,42,470,18192,5236,12956,18192,1329,0.022867194371152155,0.7484608619173263,0.002308707124010554,0.2878188214599824,0.7121811785400176,0.025835532102022867
10648,17.0,121,1652,1773,32,132,2474,647,1827,2474,143,0.04890864995957963,0.6677445432497979,0.012934518997574777,0.261519805982215,0.738480194017785,0.05335489086499596
10649,17.0,109,3204,3313,6,127,4332,1281,3051,4332,390,0.025161588180978762,0.739612188365651,0.0013850415512465374,0.29570637119113574,0.7042936288088643,0.029316712834718376
10650,13.0,1995,21268,23263,124,1840,32457,8810,23647,32457,1945,0.06146593955079028,0.6552669686046153,0.0038204393505253103,0.27143605385587083,0.7285639461441291,0.05669039036263364
10651,25.0,149,2455,2604,7,168,3566,1006,2560,3566,183,0.04178351093662367,0.6884464385866517,0.001962983735277622,0.282108805384184,0.7178911946158161,0.04711160964666293
10652,24.0,42,7958,8000,13,537,10873,3075,7798,10873,988,0.0038627793617216958,0.7319047181090775,0.0011956221833900487,0.28281063184033844,0.7171893681596615,0.0493883932677274
10653,33.0,80,2285,2365,10,125,3119,894,2225,3119,227,0.025649246553382493,0.7326066046809875,0.0032061558191728116,0.2866303302340494,0.7133696697659506,0.04007694773966015
10654,16.0,2379,46410,48789,209,3093,64741,18515,46227,64742,4218,0.03674585276945414,0.7168453245188595,0.0032281980785270766,0.2859812795403293,0.7140187204596707,0.0477742423774366
10655,,124,7005,7129,86,851,10205,2593,7612,10205,678,0.012150906418422341,0.6864282214600685,0.008427241548260656,0.2540911317981382,0.7459088682018619,0.083390494855463
10656,,1170,6435,7605,227,464,10789,2870,7919,10789,774,0.10844378533691723,0.5964408193530447,0.021039948095282233,0.2660116785614978,0.7339883214385022,0.04300676615070906
10657,26.0,164,4635,4799,7,183,6302,1857,4445,6302,442,0.026023484608060934,0.7354807997461124,0.0011107584893684545,0.2946683592510314,0.7053316407489686,0.02903840050777531
10658,,315,8351,8666,57,303,11271,3329,7942,11271,635,0.027947830715996807,0.7409280454263153,0.005057226510513707,0.2953597728684234,0.7046402271315766,0.0268831514506255
10659,,6198,90807,97005,480,7568,134640,37042,97598,134640,9068,0.046033868092691624,0.6744429590017825,0.0035650623885918,0.27511883541295307,0.724881164587047,0.05620915032679739
10660,35.0,1088,21987,23075,49,1203,30340,8790,21550,30340,2453,0.03586025049439684,0.7246868820039551,0.0016150296638101516,0.2897165458141068,0.7102834541858932,0.03965062623599209
10661,23.0,195,5875,6070,25,292,7987,2266,5721,7987,558,0.02441467384499812,0.735570301740328,0.003130086390384375,0.28371103042443974,0.7162889695755603,0.036559409039689496
10662,16.0,177,3422,3599,47,587,5237,1439,3798,5237,192,0.033797975940423906,0.6534275348481955,0.008974603780790529,0.27477563490548024,0.7252243650945198,0.11208707275157533
10663,,3641,73867,77508,286,2983,101547,30210,71345,101555,7984,0.035852493722613364,0.7273595588597311,0.0028162079661267292,0.29747427502338636,0.7025257249766137,0.029373246024321797
10664,,187,4807,4994,35,472,6837,1861,4976,6837,442,0.027351177416995758,0.7030861488957145,0.005119204329384233,0.27219540734240166,0.7278045926575983,0.06903612695626737
10665,,775,180332,181107,875,7306,244035,68280,175755,244035,22746,0.0031757739668490177,0.7389595754707317,0.0035855512528940522,0.2797959309115496,0.7202040690884505,0.029938328518450224
10666,25.0,303,5415,5718,20,397,7954,2137,5817,7954,648,0.038094040734221776,0.6807895398541615,0.002514458134272064,0.2686698516469701,0.7313301483530299,0.04991199396530048
10667,13.0,471,4897,5368,19,751,7845,2042,5803,7845,480,0.060038240917782024,0.6242192479286169,0.0024219247928616953,0.2602931803696622,0.7397068196303378,0.09572976418100701
10668,27.0,310,11013,11323,14,385,14755,4294,10461,14755,1264,0.021009827177228057,0.7463910538800407,0.0009488309047780413,0.2910199932226364,0.7089800067773636,0.026092849881396138
10669,16.0,441,2676,3117,16,111,4034,1174,2860,4034,139,0.10932077342588002,0.6633614278631631,0.0039662865642042635,0.29102627664848785,0.7089737233515121,0.02751611303916708
10670,,552,9218,9770,28,645,13193,3675,9518,13193,986,0.041840369893125146,0.6987038581065717,0.0021223376032744636,0.27855681042977337,0.7214431895702267,0.04888956264685818
10671,34.0,86,1734,1820,0,70,2416,693,1723,2416,167,0.03559602649006623,0.7177152317880795,0.0,0.28683774834437087,0.7131622516556292,0.028973509933774833
10672,,432,10575,11007,63,456,14536,4241,10295,14536,1072,0.02971931755641167,0.727504127682994,0.0043340671436433685,0.291758392955421,0.708241607044579,0.03137039075399009
10673,33.0,141,2854,2995,6,215,4002,1109,2893,4002,262,0.03523238380809595,0.7131434282858571,0.0014992503748125937,0.27711144427786105,0.722888555722139,0.053723138430784606
10674,24.0,846,33371,34217,78,1383,44079,12761,31318,44079,3481,0.019192812904103997,0.7570725288686222,0.0017695501259102973,0.2895029379069398,0.7104970620930602,0.03137548492479412
10675,24.0,654,14517,15171,240,807,20682,5635,15047,20682,1471,0.031621700029010734,0.7019147084421236,0.011604293588627792,0.27245914321632336,0.7275408567836766,0.03901943719176095
10676,,572,23257,23829,109,2000,31859,9060,22799,31859,2129,0.017954110298502777,0.7299978028186698,0.0034213252142251795,0.2843780407420195,0.7156219592579804,0.0627766094353244
10677,17.0,790,10855,11645,109,1158,16248,4417,11831,16248,1034,0.04862136878385032,0.6680822255046776,0.006708517971442639,0.271848842934515,0.7281511570654849,0.07127031019202364
10678,25.0,628,18921,19549,28,865,25074,7586,17488,25074,1918,0.025045864241844143,0.7546063651591289,0.0011166945840312675,0.3025444683736141,0.6974555316263858,0.034497886256680224
10679,36.0,82,3257,3339,6,135,4492,1254,3238,4492,429,0.0182546749777382,0.72506678539626,0.0013357079252003562,0.27916295636687444,0.7208370436331255,0.030053428317008014
10680,24.0,23180,444131,467311,5741,30685,619306,174732,444646,619378,39558,0.037424642140986605,0.7170596953718085,0.009268976295573947,0.282108825305387,0.7178911746946129,0.04954163693253554
10681,,142,5345,5487,30,467,8025,2085,5940,8025,540,0.01769470404984424,0.6660436137071651,0.003738317757009346,0.25981308411214954,0.7401869158878505,0.05819314641744548
10682,23.0,836,22038,22874,118,1166,30895,8690,22205,30895,2337,0.02705939472406538,0.7133193073312833,0.003819388250525975,0.2812752872633112,0.7187247127366888,0.03774073474672277
10683,24.0,367,49181,49548,411,2514,66905,18945,47960,66905,5958,0.00548538973170914,0.7350870637471041,0.006143038636873178,0.283162693371198,0.7168373066288021,0.03757566699050893
10684,,560,21069,21629,92,1140,28872,8092,20780,28872,2393,0.019395954558049322,0.7297381546134664,0.0031864782488223884,0.2802715433638127,0.7197284566361873,0.03948462177888612
10685,,152,2177,2329,12,148,3202,886,2316,3202,227,0.047470331043098064,0.6798875702685822,0.0037476577139287947,0.2767020612117427,0.7232979387882573,0.0462211118051218
10686,,220,4536,4756,12,275,6369,1822,4547,6369,450,0.03454231433506045,0.7121997173810646,0.0018841262364578427,0.28607316690218243,0.7139268330978176,0.04317789291882556
10687,,1912,47763,49675,164,3864,67623,18308,49315,67623,4737,0.028274403679221568,0.7063129408633158,0.0024252103574227703,0.2707362879493663,0.7292637120506337,0.05714032207976576
10688,16.0,1152,18586,19738,42,1466,26928,7290,19638,26928,1723,0.0427807486631016,0.6902109328579917,0.0015597147950089127,0.27072192513368987,0.7292780748663101,0.054441473559120615
10689,39.0,548,11424,11972,58,1026,16261,4298,11963,16261,950,0.03370026443638153,0.7025398191993112,0.0035668163089600884,0.26431338786052516,0.7356866121394748,0.0630957505688457
10690,35.0,10866,217565,228431,1116,12365,306313,86904,219409,306313,22812,0.035473518916924844,0.710270213800916,0.0036433321471827837,0.2837098001064271,0.7162901998935729,0.04036720609311391
10691,44.0,28551,766535,795086,3908,33337,1018795,306281,712514,1018795,71381,0.028024283589927316,0.752393759294068,0.003835904180919616,0.3006306469898262,0.6993693530101738,0.03272199019429817
10692,34.0,2932,113575,116507,304,7417,156691,44658,112274,156932,11816,0.01868325134453139,0.7237211021334081,0.0019371447505926133,0.28456911273672675,0.7154308872632733,0.04726250860245202
10693,17.0,9,6067,6076,12,314,8158,2269,5889,8158,621,0.001103211571463594,0.7436871782299583,0.0014709487619514587,0.27813189507232167,0.7218681049276784,0.03848982593772984
10694,25.0,1218,30481,31699,383,1584,42882,12112,30770,42882,3129,0.02840352595494613,0.7108110629168416,0.008931486404552026,0.28244951261601603,0.717550487383984,0.03693857562613684
10695,,970,20389,21359,142,1481,28843,8108,20735,28843,2300,0.03363034358423188,0.7068959539576327,0.00492320493707312,0.2811080678154145,0.7188919321845855,0.05134694726623444
10696,16.0,642,54047,54689,132,4281,74542,20707,53835,74542,6507,0.008612594242172198,0.7250543317861071,0.0017708137694185829,0.2777897024496257,0.7222102975503742,0.057430710203643584
10697,14.0,245,7314,7559,39,358,10305,2857,7448,10305,808,0.023774866569626393,0.7097525473071324,0.003784570596797671,0.2772440562833576,0.7227559437166424,0.034740417273168366
10698,26.0,231,8748,8979,7,411,11560,3414,8146,11560,863,0.019982698961937717,0.7567474048442907,0.0006055363321799307,0.29532871972318336,0.7046712802768166,0.035553633217993076
10699,16.0,98,3209,3307,6,380,4589,1237,3352,4589,276,0.021355415123120506,0.6992808890825888,0.0013074743952930922,0.2695576378295925,0.7304423621704075,0.08280671170189584
10700,,131,4057,4188,22,152,5408,1585,3823,5408,392,0.024223372781065088,0.7501849112426036,0.0040680473372781065,0.2930843195266272,0.7069156804733728,0.028106508875739646
10701,13.0,1004,17261,18265,130,1819,25568,6877,18691,25568,1612,0.039267834793491864,0.675101689612015,0.005084480600750938,0.26896902377972465,0.7310309762202754,0.0711436170212766
10702,,127,3166,3293,19,120,4464,1258,3206,4464,408,0.028449820788530467,0.7092293906810035,0.004256272401433692,0.2818100358422939,0.7181899641577061,0.026881720430107527
10703,24.0,263,8273,8536,51,626,11471,3265,8206,11471,795,0.022927382093976115,0.7212100078458722,0.004445994246360387,0.28463080812483654,0.7153691918751635,0.054572399965129456
10704,24.0,2,13088,13090,23,678,17671,5013,12658,17671,1813,0.00011317978609020429,0.7406485201742968,0.0013015675400373493,0.283685133835097,0.7163148661649029,0.03836794748457925
10705,17.0,409,12435,12844,47,530,16597,4969,11628,16597,1355,0.024643007772489005,0.749231788877508,0.002831837078990179,0.2993914562872808,0.7006085437127192,0.0319334819545701
10706,45.0,246,6353,6599,31,297,8892,2513,6379,8892,628,0.02766531713900135,0.7144624381466487,0.0034862798020692757,0.28261358524516417,0.7173864147548358,0.03340080971659919
10707,25.0,1639,40037,41676,234,2093,55708,15758,39950,55708,4054,0.029421268040496877,0.7186939039276226,0.004200473899619445,0.2828678107273641,0.7171321892726359,0.03757090543548503
10708,16.0,123,2257,2380,15,188,3314,875,2439,3314,233,0.03711526855763428,0.6810500905250453,0.004526252263126132,0.264031382015691,0.735968617984309,0.056729028364514184
10709,13.0,394,6051,6445,12,556,8706,2460,6246,8706,612,0.0452561451872272,0.6950379048931771,0.0013783597518952446,0.28256374913852517,0.7174362508614749,0.063864001837813
10710,17.0,120,2240,2360,6,60,3211,936,2275,3211,232,0.03737153534724385,0.6976019931485519,0.0018685767673621925,0.291497975708502,0.708502024291498,0.018685767673621925
10711,23.0,74,1630,1704,12,109,2364,630,1734,2364,183,0.031302876480541454,0.6895093062605753,0.005076142131979695,0.26649746192893403,0.733502538071066,0.0461082910321489
10712,17.0,728,13335,14063,96,904,18783,5354,13429,18783,1553,0.038758451791513604,0.709950487142629,0.005111004631847948,0.28504498748868656,0.7149550125113134,0.048128626949901505
10713,,1314,41827,43141,282,1566,56096,16371,39725,56096,4087,0.02342413006274957,0.7456324871648602,0.005027096406160867,0.29183899030233884,0.7081610096976612,0.027916428978893324
10714,16.0,225,13782,14007,165,787,18900,5377,13523,18900,1725,0.011904761904761904,0.7292063492063492,0.00873015873015873,0.28449735449735447,0.7155026455026455,0.04164021164021164
10715,17.0,539,24107,24646,117,613,31779,9435,22344,31779,2667,0.016960886119764623,0.7585827118537399,0.0036816765788728408,0.29689417539884827,0.7031058246011517,0.01928946788759873
10716,,9,3118,3127,2,166,4214,1229,2985,4214,398,0.0021357380161366873,0.7399145704793545,0.00047460844803037496,0.2916468913146654,0.7083531086853346,0.03939250118652112
10717,,5173,171776,177199,500,11458,232827,67964,164863,232827,16649,0.02221821352334566,0.7377838480932194,0.0021475172553011464,0.29190772547857424,0.7080922745214258,0.04921250542248107
10718,14.0,463,9921,10384,105,494,13658,3933,9725,13658,1034,0.033899546053594964,0.726387465221848,0.007687802020793674,0.28796309855030017,0.7120369014496998,0.03616927807878167
10719,23.0,1050,23369,24419,138,841,31319,9285,22034,31319,2125,0.03352597464797727,0.746160477665315,0.004406270953734155,0.2964654043871133,0.7035345956128868,0.026852709218046552
10720,16.0,262,3718,3980,23,240,5279,1520,3759,5279,394,0.0496306118583065,0.7043000568289449,0.0043568857738207995,0.2879333207046789,0.7120666792953211,0.04546315590073877
10721,25.0,2922,74149,77071,335,2562,98451,29601,68850,98451,6235,0.029679739159581924,0.7531563925201369,0.0034027079460848546,0.30066733705091875,0.6993326629490813,0.026023097784684767
10722,,203,3105,3308,22,353,4779,1223,3556,4779,322,0.042477505754341914,0.6497175141242938,0.004603473530027202,0.25591127851014855,0.7440887214898514,0.07386482527725466
10723,,1015,16403,17418,106,1001,23608,6585,17023,23608,1313,0.042993900372754995,0.6948068451372416,0.004490003388681803,0.2789308708912233,0.7210691291087767,0.042400881057268726
10724,,338,10711,11049,73,897,14893,4192,10701,14893,1027,0.02269522594507487,0.7191969381588665,0.004901631639025046,0.28147451823004094,0.718525481769959,0.06022963808500638
10725,23.0,639,13922,14561,73,760,20085,5550,14535,20085,1449,0.03181478715459298,0.6931540950958427,0.003634553149116256,0.27632561613144135,0.7236743838685586,0.037839183470251433
10726,13.0,92,3813,3905,11,231,5405,1484,3921,5405,393,0.01702127659574468,0.7054579093432007,0.0020351526364477336,0.2745605920444033,0.7254394079555967,0.042738205365402404
10727,37.0,1730,53497,55227,372,2533,74068,20683,53385,74068,5748,0.023356915267051897,0.7222687260355349,0.0050224118377706975,0.2792433979586326,0.7207566020413674,0.0341983042609494
10728,14.0,131,2888,3019,47,173,4110,1110,3000,4110,315,0.03187347931873479,0.702676399026764,0.011435523114355231,0.27007299270072993,0.7299270072992701,0.04209245742092457
10729,24.0,275,5701,5976,18,323,8056,2285,5776,8061,576,0.0341148740851011,0.7072323533060414,0.002232973576479345,0.28346359012529465,0.7165364098747053,0.040069470289046026
10730,,264,6166,6430,18,622,8585,2225,6360,8585,509,0.030751310425160164,0.7182294700058242,0.00209668025626092,0.25917297612114154,0.7408270238788585,0.07245195107746069
10731,25.0,561,11368,11929,45,478,15881,4555,11326,15881,1111,0.03532523140860147,0.7158239405578993,0.0028335747119199043,0.2868207291732259,0.7131792708267741,0.03009886027328254
10732,34.0,34,3909,3943,22,237,5440,1499,3941,5440,465,0.00625,0.7185661764705882,0.004044117647058824,0.2755514705882353,0.7244485294117647,0.04356617647058823
10733,,285,10036,10321,13,211,13139,3998,9141,13139,975,0.021691148489230535,0.7638328639926935,0.000989420808280691,0.3042849531927848,0.6957150468072152,0.016059060811325063
10734,15.0,198,6543,6741,12,481,9736,2611,7125,9736,732,0.020336894001643385,0.6720419063270336,0.0012325390304026294,0.2681799506984388,0.7318200493015612,0.049404272801972064
10735,25.0,914,36502,37416,339,1981,49536,14113,35423,49536,3473,0.018451227390180878,0.7368782299741602,0.0068435077519379845,0.28490390826873385,0.7150960917312662,0.03999111757105943
10736,,313,6705,7018,71,457,9929,2664,7265,9929,632,0.03152381911572162,0.6752945916003625,0.00715077047033941,0.26830496525329844,0.7316950347467016,0.04602679021049451
10737,37.0,199,7383,7582,12,255,9975,2927,7048,9975,758,0.01994987468671679,0.7401503759398497,0.0012030075187969924,0.29343358395989977,0.7065664160401003,0.02556390977443609
10738,15.0,24,2753,2777,7,203,3844,1056,2788,3844,253,0.006243496357960458,0.7161810613943809,0.0018210197710718003,0.27471383975026015,0.7252861602497399,0.052809573361082204
10739,48.0,944,33502,34446,496,1601,45852,12852,33000,45852,3349,0.0205879787141237,0.7306551513565385,0.010817412544709065,0.2802931169850824,0.7197068830149176,0.03491668847596615
10740,,168,5071,5239,34,182,6978,1955,5023,6978,538,0.02407566638005159,0.7267125250788191,0.004872456291200917,0.2801662367440527,0.7198337632559473,0.026081971911722557
10741,16.0,126,4884,5010,1,199,6523,1905,4618,6523,531,0.01931626552199908,0.7487352445193929,0.00015330369461904033,0.2920435382492718,0.7079564617507282,0.030507435229189025
10742,26.0,14,6846,6860,14,240,9015,2580,6435,9015,757,0.001552967276760954,0.7594009983361065,0.001552967276760954,0.28618968386023297,0.7138103161397671,0.026622296173044926
10743,15.0,713,16793,17506,69,935,23160,6520,16640,23160,1785,0.030785837651122624,0.7250863557858377,0.0029792746113989636,0.2815198618307427,0.7184801381692574,0.0403713298791019
10744,15.0,209,5232,5441,0,173,7044,2082,4962,7044,558,0.029670641680863145,0.7427597955706985,0.0,0.29557069846678025,0.7044293015332198,0.02455990914253265
10745,,44,3092,3136,9,383,4399,1191,3208,4399,199,0.010002273243919073,0.7028870197772221,0.0020459195271652648,0.2707433507615367,0.7292566492384633,0.08706524210047738
10746,,1734,50875,52609,186,2475,70477,20133,50344,70477,5485,0.024603771443165855,0.7218667082878102,0.0026391588745264412,0.28566766462817655,0.7143323353718234,0.03511783986265023
10747,16.0,208,4746,4954,21,161,6671,1857,4814,6671,621,0.031179733173437266,0.7114375655823715,0.0031479538300104933,0.2783690601109279,0.7216309398890721,0.024134312696747113
10748,24.0,1388,30370,31758,345,1636,41925,12032,29893,41925,2986,0.033106738223017296,0.7243887895050686,0.008228980322003579,0.2869886702444842,0.7130113297555158,0.03902206320810972
10749,26.0,61,3650,3711,33,882,5731,1378,4358,5736,360,0.010634588563458856,0.6363319386331938,0.005753138075313808,0.2402370990237099,0.7597629009762901,0.15376569037656904
10750,24.0,202,5003,5205,2,248,6972,2015,4957,6972,566,0.028973034997131383,0.7175846242111302,0.00028686173264486515,0.2890131956397017,0.7109868043602984,0.03557085484796328
10751,24.0,158,2686,2844,16,144,3873,1083,2790,3873,234,0.040795249160857215,0.6935192357345726,0.004131164471985541,0.2796281951975213,0.7203718048024786,0.037180480247869865
10752,14.0,69,2187,2256,16,295,3471,869,2602,3471,243,0.019878997407087293,0.6300777873811582,0.004609622587150677,0.25036012676462116,0.7496398732353788,0.0849899164505906
10753,,399,9965,10364,51,715,14006,4051,9955,14006,1107,0.02848779094673711,0.7114807939454519,0.0036412965871769243,0.28923318577752394,0.7107668142224761,0.051049550192774525
10754,24.0,4923,144687,149610,659,8872,200230,57346,142884,200230,15865,0.024586725265944163,0.7226040053937971,0.0032912151026319733,0.28640063926484544,0.7135993607351546,0.04430904459871148
10755,,372,12615,12987,59,310,16800,4941,11882,16823,1411,0.022112583962432385,0.7498662545324853,0.003507103370385781,0.29370504666230757,0.7062949533376924,0.01842715330202699
10756,23.0,301,7379,7680,15,527,10815,2960,7855,10815,751,0.027831715210355986,0.682293111419325,0.0013869625520110957,0.2736939435968562,0.7263060564031438,0.0487286176606565
10757,40.0,7386,144196,151582,1353,6861,196899,57001,139898,196899,13075,0.037511617631374464,0.7323348518783742,0.006871543278533665,0.2894935982407224,0.7105064017592776,0.034845276004448984
10758,16.0,304,2200,2504,23,190,3353,980,2373,3353,152,0.09066507605129735,0.656128839844915,0.006859528780196839,0.29227557411273486,0.7077244258872651,0.05666567253206084
10759,,89,2482,2571,2,113,3581,971,2610,3581,298,0.024853392907009216,0.6931024853392908,0.0005585032113934655,0.2711533091315275,0.7288466908684725,0.031555431443730804
10760,24.0,1082,31413,32495,97,1060,42038,12652,29386,42038,3508,0.025738617441362577,0.7472524858461392,0.002307436129216423,0.3009657928540844,0.6990342071459156,0.02521528141205576
10761,27.0,650,18568,19218,106,1622,26485,7177,19308,26485,2007,0.024542193694544082,0.7010760808004531,0.004002265433264112,0.2709835756088352,0.7290164243911648,0.06124221257315462
10762,,642,18628,19270,50,483,23882,7564,16318,23882,1608,0.02688217067247299,0.7800016749015996,0.0020936269994137843,0.3167238924713173,0.6832761075286827,0.02022443681433716
10763,,59,2003,2062,6,120,2754,800,1954,2754,238,0.021423384168482208,0.7273057371096586,0.002178649237472767,0.29048656499636893,0.7095134350036311,0.04357298474945534
10764,24.0,231,3428,3659,7,205,5122,1341,3781,5122,278,0.04509957048028114,0.6692698164779383,0.0013666536509176104,0.26181179226864504,0.738188207731355,0.04002342834830144
10765,,366,9454,9820,32,460,13178,3718,9460,13178,996,0.027773561997268173,0.717407800880255,0.0024282895735316438,0.28213689482470783,0.7178631051752922,0.03490666261951738
10766,17.0,10,5098,5108,5,242,6716,1942,4774,6716,605,0.0014889815366289458,0.7590827873734366,0.0007444907683144729,0.2891602144133413,0.7108397855866587,0.03603335318642049
10767,,8634,150608,159242,558,7548,212477,61215,151262,212477,15664,0.04063498637499588,0.7088202487798679,0.002626166596855189,0.2881017710152158,0.7118982289847843,0.0355238449338046
10768,24.0,9567,422920,432487,745,37022,589099,176859,412240,589099,38089,0.0162400547276434,0.7179098929042487,0.0012646431245002961,0.3002194877261717,0.6997805122738283,0.06284512450369123
10769,,587,7163,7750,11,648,10793,2889,7904,10793,659,0.054387102751783566,0.6636708978041324,0.0010191790975632355,0.26767349207819885,0.7323265079218012,0.06003891411099787
10770,14.0,376,4979,5355,16,386,7220,2028,5192,7220,477,0.0520775623268698,0.689612188365651,0.00221606648199446,0.2808864265927978,0.7191135734072022,0.05346260387811634
10771,25.0,648,18368,19016,51,932,25484,7407,18077,25484,1775,0.02542771935331973,0.7207659708052111,0.0020012556898446085,0.2906529587191964,0.7093470412808036,0.03657196672421912
10772,16.0,138,3218,3356,11,159,4313,1280,3033,4313,292,0.031996290285184324,0.7461163923023417,0.002550428935775562,0.29677718525388364,0.7032228147461164,0.036865290980755853
10773,,712,8923,9635,31,454,13151,3620,9531,13151,830,0.05414036955364611,0.6785035358527869,0.00235723519124021,0.27526423846095355,0.7247357615390465,0.03452208957493727
10774,16.0,3251,31069,34320,32,3673,47673,13098,34575,47673,2799,0.0681937364965494,0.6517106118767436,0.0006712394856627441,0.27474671197533196,0.725253288024668,0.07704570721372685
10775,17.0,1099,17935,19034,120,1497,26511,7121,19390,26511,1800,0.04145449058881219,0.6765116366791143,0.004526422994228811,0.26860548451586136,0.7313945154841387,0.05646712685300442
10776,14.0,3550,26826,30376,782,2434,43037,11896,31141,43037,2330,0.08248716220926179,0.6233241164579315,0.018170411506378232,0.27641331877221925,0.7235866812277807,0.056555986709110766
10777,,1561,31991,33552,92,1515,45618,13142,32476,45618,3022,0.03421894866061642,0.7012801964136963,0.002016747775001096,0.2880880354246131,0.7119119645753869,0.033210574773115877
10778,,2309,51907,54216,225,2496,72292,20401,51891,72292,5581,0.031939910363525705,0.7180185912687435,0.003112377579815194,0.2822027333591545,0.7177972666408454,0.034526641952083215
10779,16.0,64,3019,3083,11,140,3972,1179,2793,3972,267,0.016112789526686808,0.7600704934541792,0.0027693856998992953,0.29682779456193353,0.7031722054380665,0.035246727089627394
10780,47.0,735,20244,20979,55,947,27317,8025,19292,27317,2260,0.026906322070505546,0.7410769850276384,0.0020133982501738842,0.29377310832082587,0.7062268916791742,0.034667057143903064
10781,,11444,214271,225715,1172,15367,308346,85611,222735,308346,23648,0.037114150986229756,0.6949044255479234,0.0038009249349756444,0.2776458913039248,0.7223541086960752,0.04983687156635727
10782,,1093,45802,46895,57,6904,66805,17607,49198,66805,4756,0.016361050819549434,0.6856073647182097,0.0008532295486864755,0.2635581169074171,0.7364418830925828,0.10334555796721802
10783,23.0,84,3341,3425,0,170,4527,1266,3261,4527,351,0.01855533465871438,0.7380163463662469,0.0,0.27965540092776675,0.7203445990722332,0.0375524629997791
10784,16.0,119,3296,3415,44,176,4693,1325,3368,4693,302,0.025356914553590452,0.7023226081397826,0.009375665885361177,0.28233539313871725,0.7176646068612828,0.03750266354144471
10785,26.0,204,10016,10220,41,341,13461,3917,9544,13461,1313,0.015154891909962113,0.7440754773048065,0.003045836119159052,0.2909887824084392,0.7090112175915608,0.025332441869103335
10786,,49,3533,3582,11,281,4868,1296,3572,4868,434,0.010065735414954808,0.725760065735415,0.0022596548890714873,0.26622843056696793,0.733771569433032,0.057723911257189814
10787,,441,11990,12431,10,679,16800,4802,11998,16800,1326,0.02625,0.7136904761904762,0.0005952380952380953,0.28583333333333333,0.7141666666666666,0.04041666666666666
10788,,199,5183,5382,16,352,7352,2025,5327,7352,504,0.02706746463547334,0.7049782372143635,0.002176278563656148,0.27543525571273125,0.7245647442872688,0.04787812840043525
10789,15.0,219,1984,2203,36,166,3175,798,2377,3175,148,0.06897637795275591,0.6248818897637796,0.011338582677165355,0.25133858267716536,0.7486614173228346,0.05228346456692914
10790,17.0,128,2828,2956,4,244,3923,1146,2777,3923,256,0.03262809074687739,0.7208768799388223,0.0010196278358399185,0.2921233749681366,0.7078766250318633,0.06219729798623502
10791,,222,5884,6106,22,402,8377,2234,6144,8378,670,0.02649797087610408,0.7023155884459298,0.0026259250417760803,0.26665075196944377,0.7333492480305562,0.047982812126999286
10792,38.0,825,26929,27754,36,1308,36110,10641,25469,36110,2467,0.02284685682636389,0.7457490999723069,0.0009969537524231514,0.29468291332040986,0.7053170866795901,0.03622265300470784
10793,,462,6836,7298,31,581,9986,2721,7265,9986,646,0.04626477067895053,0.6845583817344282,0.0031043460845183255,0.27248147406368917,0.7275185259363108,0.05818145403564991
10794,17.0,2105,15784,17889,205,1174,24035,6680,17355,24035,1431,0.08758061160807157,0.6567089660911172,0.008529228208862077,0.27792802163511543,0.7220719783648846,0.048845433742458914
10795,16.0,1019,11164,12183,63,473,16515,4572,11943,16515,1248,0.06170148349984862,0.6759915228580079,0.0038147138964577656,0.2768392370572207,0.7231607629427793,0.028640629730547987
10796,23.0,727,19100,19827,135,1087,26481,7407,19074,26481,2038,0.02745364601034704,0.7212718552924738,0.005097994788716438,0.2797099807409086,0.7202900192590914,0.04104829878025754
10797,,889,18232,19121,221,639,25233,7316,17917,25233,2060,0.03523164110490231,0.7225458724685927,0.008758371973209686,0.28993777989141206,0.710062220108588,0.025323980501723933
10798,23.0,119,2836,2955,29,105,3915,1111,2804,3915,322,0.030395913154533844,0.7243933588761174,0.007407407407407408,0.28378033205619413,0.7162196679438059,0.02681992337164751
10799,,123,2976,3099,31,136,4145,1158,2987,4145,310,0.02967430639324487,0.7179734620024125,0.007478890229191798,0.27937273823884196,0.720627261761158,0.032810615199034984
10800,16.0,147,16558,16705,20,627,22569,6246,16323,22569,1784,0.006513359032300944,0.7336612167131906,0.000886171296911693,0.27675129602552173,0.7232487039744783,0.027781470158181578
10801,,115,7487,7602,7,183,10396,2874,7522,10396,1036,0.011061946902654867,0.7201808387841477,0.0006733358984224702,0.2764524817237399,0.7235475182762601,0.017602924201616008
10802,,224,23601,23825,43,1733,32076,8989,23087,32076,2589,0.006983414390821798,0.7357837635615413,0.00134056615538097,0.28024067838882655,0.7197593216111735,0.05402793365756329
10803,26.0,2,3445,3447,164,314,4903,1281,3622,4903,345,0.0004079135223332653,0.7026310422190496,0.033448908831327756,0.2612686110544565,0.7387313889455436,0.06404242300632267
10804,,230,5690,5920,43,328,7840,2282,5558,7840,654,0.029336734693877552,0.7257653061224489,0.00548469387755102,0.2910714285714286,0.7089285714285715,0.04183673469387755
10805,,154,2595,2749,10,82,3568,1053,2515,3568,251,0.043161434977578475,0.7272982062780269,0.002802690582959641,0.2951233183856502,0.7048766816143498,0.02298206278026906
10806,16.0,62,2949,3011,5,90,4055,1133,2922,4055,360,0.015289765721331689,0.7272503082614057,0.0012330456226880395,0.27940813810110976,0.7205918618988902,0.02219482120838471
10807,,123,2430,2553,6,144,3426,967,2459,3426,217,0.03590192644483362,0.7092819614711033,0.0017513134851138354,0.2822533566841798,0.7177466433158202,0.04203152364273205
10808,16.0,117,3450,3567,27,131,4753,1328,3425,4753,372,0.02461603197980223,0.7258573532505785,0.005680622764569746,0.2794024826425415,0.7205975173574585,0.027561540079949504
10809,36.0,379,10932,11311,16,384,15048,4333,10715,15048,1276,0.02518607123870282,0.726475279106858,0.001063264221158958,0.28794524189261034,0.7120547581073897,0.025518341307814992
10810,17.0,131,3409,3540,32,126,4493,1335,3158,4493,280,0.02915646561317605,0.7587358112619631,0.007122190073447585,0.29712886712664144,0.7028711328733586,0.028043623414199866
10811,17.0,245,10785,11030,30,879,15183,4059,11124,15183,1059,0.016136468418626097,0.710333926101561,0.0019758940920766646,0.2673384706579727,0.7326615293420272,0.05789369689784628
10812,,142,3996,4138,11,186,5496,1583,3913,5496,439,0.02583697234352256,0.7270742358078602,0.0020014556040756915,0.2880276564774381,0.7119723435225619,0.03384279475982533
10813,15.0,79,8788,8867,42,635,11932,3312,8620,11932,803,0.0066208514917867915,0.736506872276232,0.003519946362722092,0.2775729131746564,0.7224270868253436,0.05321823667448877
10814,23.0,4055,72426,76481,235,3954,102320,29301,73021,102322,7876,0.03962979613377377,0.7078243193057212,0.0022966712925861494,0.28636070444283734,0.7136392955571627,0.03864271613142824
10815,36.0,306,8334,8640,54,379,11568,3319,8249,11568,950,0.026452282157676348,0.7204356846473029,0.00466804979253112,0.28691217150760717,0.7130878284923928,0.0327627939142462
10816,13.0,65,3157,3222,4,184,4260,1282,2978,4260,358,0.015258215962441314,0.7410798122065728,0.0009389671361502347,0.30093896713615026,0.6990610328638498,0.0431924882629108
10817,17.0,1089,21180,22269,141,1098,29782,8448,21334,29782,2113,0.036565710832046204,0.7111678194882816,0.004734403330870996,0.2836612719092069,0.7163387280907931,0.03686790678933584
10818,37.0,452,13326,13778,60,657,18642,5331,13311,18642,1549,0.024246325501555626,0.7148374637914386,0.0032185387833923397,0.2859671709044094,0.7140328290955906,0.03524299967814612
10819,14.0,161,1929,2090,1,95,2814,809,2005,2814,163,0.05721393034825871,0.685501066098081,0.00035536602700781805,0.2874911158493248,0.7125088841506751,0.03375977256574272
10820,25.0,44,1530,1574,0,48,2039,611,1428,2039,147,0.02157920549288867,0.7503678273663561,0.0,0.2996566944580677,0.7003433055419324,0.023540951446787643
10821,16.0,479,6972,7451,13,662,10407,2814,7593,10407,729,0.04602671278946863,0.6699336984721822,0.0012491592197559334,0.27039492649178437,0.7296050735082156,0.06361103103680216
10822,23.0,143,4204,4347,8,165,5674,1712,3962,5674,505,0.02520267888614734,0.7409235107507931,0.0014099400775467042,0.3017271765949947,0.6982728234050053,0.029080014099400777
10823,17.0,3392,50762,54154,247,3359,73769,20613,53156,73769,5169,0.04598137429001342,0.6881210264474237,0.0033482899320852934,0.2794263172877496,0.7205736827122504,0.04553403191042308
10824,17.0,100,4250,4350,35,130,5774,1700,4074,5774,565,0.017319016279875303,0.7360581918947003,0.006061655697956356,0.29442327675788016,0.7055767232421198,0.022514721163837893
10825,33.0,117,3216,3333,20,121,4323,1310,3013,4323,337,0.027064538514920196,0.7439278278972935,0.004626416840157298,0.30303030303030304,0.696969696969697,0.027989821882951654
10826,16.0,280,7029,7309,20,439,9700,2797,6903,9700,776,0.0288659793814433,0.7246391752577319,0.002061855670103093,0.28835051546391754,0.7116494845360825,0.045257731958762884
10827,34.0,2904,72697,75601,192,5089,101072,28140,72932,101072,7135,0.028731993034668356,0.7192595377552635,0.0018996359031185689,0.27841538705081526,0.7215846129491847,0.05035024536963749
10828,17.0,42,2457,2499,35,127,3390,963,2427,3390,308,0.012389380530973451,0.7247787610619469,0.01032448377581121,0.28407079646017697,0.715929203539823,0.03746312684365782
10829,,47,1785,1832,2,55,2380,683,1697,2380,183,0.019747899159663865,0.75,0.0008403361344537816,0.28697478991596637,0.7130252100840336,0.023109243697478993
10830,37.0,173,4852,5025,106,270,6949,1879,5070,6949,482,0.024895668441502376,0.6982299611454885,0.015253993380342496,0.2703986185062599,0.7296013814937401,0.03885451144049504
10831,40.0,5875,106929,112804,175,4018,150182,46252,103933,150185,13511,0.03911842061457536,0.7119818890035623,0.0011652295502213937,0.307966840896228,0.692033159103772,0.026753670473083198
10832,23.0,171,3394,3565,11,173,4682,1359,3323,4682,391,0.0365228534814182,0.7249038872276805,0.002349423323366083,0.2902605724049552,0.7097394275950448,0.03695002135839385
10833,,488,13838,14326,21,446,18587,5424,13163,18587,1543,0.026254909345241297,0.7444988432775596,0.0011298219185452197,0.2918168612471082,0.7081831387528918,0.023995265508150856
10834,,1270,8809,10079,124,713,14208,3799,10409,14208,1025,0.08938626126126126,0.6200028153153153,0.008727477477477477,0.26738457207207206,0.7326154279279279,0.05018299549549549
10835,47.0,730,16630,17360,61,1077,23406,6658,16748,23406,1823,0.03118858412372896,0.7105015807912501,0.0026061693582842007,0.2844569768435444,0.7155430231564556,0.0460138426044604
10836,26.0,1309,35202,36511,190,2304,49723,14111,35612,49723,3739,0.026325845182309997,0.7079621100898981,0.0038211692777990066,0.2837922088369567,0.7162077911630432,0.04633670534762585
10837,23.0,167,4476,4643,0,167,6047,1775,4272,6047,517,0.027617000165371258,0.7402017529353399,0.0,0.29353398379361667,0.7064660162063834,0.027617000165371258
10838,,1350,18557,19907,30,1512,27583,7564,20019,27583,1612,0.048943189645796324,0.672769459449661,0.0010876264365732517,0.2742268788746692,0.7257731211253308,0.05481637240329188
10839,15.0,622,11732,12354,29,935,17018,4623,12395,17018,1145,0.036549535785638736,0.6893877071336232,0.0017040780350217417,0.27165354330708663,0.7283464566929134,0.05494182630156305
10840,23.0,2434,42352,44786,252,3642,62336,17777,44561,62338,3709,0.03904520517180532,0.6793929866213224,0.004042478103243608,0.2851711636561969,0.7148288363438031,0.05842343353973499
10841,16.0,189,3376,3565,12,340,4861,1338,3523,4861,343,0.038880888706027565,0.6945073030240692,0.0024686278543509564,0.27525200576013165,0.7247479942398684,0.0699444558732771
10842,14.0,4549,73113,77662,1276,4192,105864,29294,76570,105864,6602,0.042970225950275824,0.6906313761051915,0.012053200332502078,0.2767135192322225,0.7232864807677776,0.03959797476006952
10843,15.0,538,7393,7931,100,936,11882,2959,8923,11882,678,0.04527857263087023,0.6222016495539472,0.00841609156707625,0.24903214946978622,0.7509678505302138,0.0787746170678337
10844,,1474,30167,31641,166,1416,42609,11945,30664,42609,3791,0.034593630453660026,0.7079959632941397,0.0038958905395573705,0.28033983430730597,0.7196601656926941,0.03323241568682673
10845,,1596,19020,20616,124,1076,27049,7846,19203,27049,1669,0.05900402972383452,0.703168324152464,0.004584272986062331,0.2900661761987504,0.7099338238012496,0.03977965913712152
10846,16.0,1139,9496,10635,314,1092,15309,4039,11270,15309,596,0.07440067933895095,0.6202887190541512,0.020510810634267424,0.2638317329675354,0.7361682670324645,0.07133058984910837
10847,,85,3382,3467,10,105,4569,1299,3270,4569,387,0.018603633180126943,0.740205734296345,0.002188662727073758,0.2843072882468812,0.7156927117531189,0.02298095863427446
10848,17.0,36,3471,3507,12,296,4795,1289,3506,4795,370,0.007507820646506778,0.7238790406673619,0.002502606882168926,0.26882168925964545,0.7311783107403546,0.06173096976016684
10849,27.0,423,8393,8816,102,563,11884,3356,8528,11884,843,0.03559407606866375,0.7062436889936049,0.00858296869740828,0.28239649949511947,0.7176035005048805,0.04737462133961629
10850,17.0,2449,53603,56052,320,4981,75478,21546,53932,75478,5262,0.03244654071385039,0.7101804499324307,0.004239645989559872,0.2854606640345531,0.7145393359654468,0.06599273960624288
10851,15.0,54,2407,2461,2,243,3310,941,2369,3310,214,0.016314199395770394,0.7271903323262839,0.0006042296072507553,0.28429003021148036,0.7157099697885196,0.07341389728096677
10852,26.0,116,3099,3215,1,229,4350,1195,3155,4350,316,0.02666666666666667,0.7124137931034483,0.00022988505747126436,0.2747126436781609,0.725287356321839,0.05264367816091954
10853,16.0,23072,470205,493277,963,27681,651285,188744,462541,651285,43138,0.03542535142065302,0.7219650383472673,0.0014786153527257652,0.28980246742977345,0.7101975325702266,0.0425021304037403
10854,15.0,2194,42205,44399,467,2659,60008,16891,43117,60008,4489,0.03656179176109852,0.7033228902812958,0.007782295693907479,0.28147913611518466,0.7185208638848154,0.0443107585655246
10855,14.0,507,14198,14705,63,925,19570,5474,14096,19570,1562,0.025907000510986204,0.7254982115482882,0.0032192130812468064,0.2797138477261114,0.7202861522738886,0.047266223811957074
10856,42.0,143,2735,2878,59,108,3879,1095,2784,3879,203,0.036865171435937094,0.7050786285125032,0.015210105697344677,0.2822892498066512,0.7177107501933488,0.027842227378190254
10857,16.0,170,3758,3928,4,184,5378,1548,3830,5378,502,0.03161026403867609,0.6987727779843809,0.0007437709185570844,0.2878393454815917,0.7121606545184084,0.034213462253625884
10858,24.0,460,8568,9028,46,506,12343,3352,8991,12343,858,0.037268087174916954,0.6941586324232358,0.0037268087174916957,0.27157093089200357,0.7284290691079964,0.04099489589240865
10859,34.0,92,4538,4630,10,389,6370,1669,4701,6370,522,0.014442700156985872,0.7124018838304552,0.0015698587127158557,0.26200941915227627,0.7379905808477237,0.061067503924646785
10860,23.0,895,19629,20524,59,870,27257,7782,19475,27257,1984,0.032835601863741425,0.7201452837803133,0.002164581575375133,0.2855046410096489,0.7144953589903511,0.03191840628095535
10861,23.0,456,2604,3191,9,518,4883,1167,3716,4883,231,0.0933852140077821,0.5332787220970715,0.0018431292238378046,0.23899242269096865,0.7610075773090313,0.10608232643866476
10862,13.0,57,4497,4554,40,169,6193,1698,4495,6193,539,0.009203939932181495,0.7261424188600032,0.006458905215565962,0.27418052640077506,0.7258194735992249,0.027288874535766186
10863,43.0,8787,257554,266341,1188,15009,356868,99805,257063,356868,28883,0.024622549514106057,0.7217066254189224,0.0033289619691314436,0.279669233442057,0.720330766557943,0.04205756750395104
10864,,2687,41505,44192,49,2614,58342,16770,41572,58342,3764,0.046056014534983376,0.7114085907236639,0.00083987521853896,0.2874430084673134,0.7125569915326866,0.04480477186246615
10865,23.0,46,1806,1852,0,72,2490,704,1786,2490,199,0.018473895582329317,0.7253012048192771,0.0,0.2827309236947791,0.7172690763052209,0.02891566265060241
10866,16.0,50,2075,2125,0,117,2768,819,1949,2768,218,0.018063583815028903,0.7496387283236994,0.0,0.2958815028901734,0.7041184971098265,0.04226878612716763
10867,14.0,26,6324,6350,109,331,8705,2321,6384,8705,658,0.002986789201608271,0.7264790350373349,0.012521539345203905,0.2666283744974153,0.7333716255025847,0.038024124066628376
10868,24.0,122,2559,2681,2,163,3793,1020,2773,3793,287,0.03216451357764303,0.6746638544687582,0.0005272871078302136,0.2689164249934089,0.731083575006591,0.04297389928816241
10869,,86,1779,1865,1,95,2535,723,1812,2535,192,0.033925049309664695,0.7017751479289941,0.0003944773175542406,0.285207100591716,0.714792899408284,0.03747534516765286
10870,,1242,23801,25043,229,1709,34175,9627,24548,34175,2363,0.03634235552304316,0.696444769568398,0.006700804681784931,0.28169714703730797,0.718302852962692,0.05000731528895391
10871,,299,11089,11388,52,490,14607,4431,10176,14607,1047,0.0204696378448689,0.7591565687683988,0.003559937016498939,0.3033477100020538,0.6966522899979462,0.03354556034777846
10872,17.0,58079,775339,833418,4004,60327,1116604,317490,799114,1116604,66789,0.05201396376871299,0.6943724006003918,0.0035858728788361856,0.28433535971570945,0.7156646402842906,0.05402721107930833
10873,27.0,200,5179,5379,25,218,6966,2025,4941,6966,451,0.02871088142405972,0.7434682744760264,0.003588860178007465,0.29069767441860467,0.7093023255813954,0.031294860752225095
10874,36.0,722,3811,4533,14,139,6154,1735,4419,6154,426,0.1173220669483263,0.619272018199545,0.0022749431264218393,0.2819304517387065,0.7180695482612934,0.022586935326616833
10875,15.0,413,5298,5711,96,558,8222,2161,6061,8222,483,0.050231087326684506,0.6443687667234249,0.011675991243006568,0.2628314278764291,0.7371685721235709,0.06786669909997567
10876,24.0,833,15662,16495,88,558,21303,6148,15155,21303,1551,0.039102473829976996,0.7352016147960381,0.004130873585879923,0.28859785006806554,0.7114021499319345,0.02619349387410224
10877,,2339,34587,36926,216,3815,52646,13911,38735,52646,3476,0.04442882650153858,0.6569729894009042,0.004102875812027505,0.2642365991718269,0.735763400828173,0.0724651445503932
10878,,232,4228,4460,110,371,6256,1645,4611,6256,390,0.0370843989769821,0.6758312020460358,0.01758312020460358,0.26294757033248084,0.7370524296675192,0.05930306905370844
10879,16.0,183,2389,2572,28,222,3583,984,2599,3583,217,0.051074518559866035,0.6667596985766118,0.007814680435389338,0.2746301981579682,0.7253698018420318,0.061959252023444045
10880,25.0,88,2107,2195,14,209,3086,834,2252,3086,227,0.028515878159429683,0.6827608554763448,0.004536616979909268,0.27025275437459495,0.729747245625405,0.06772521062864549
10881,15.0,206,3196,3402,14,217,4708,1338,3370,4708,291,0.0437553101104503,0.6788445199660152,0.002973661852166525,0.28419711129991504,0.715802888700085,0.04609175870858114
10882,15.0,25558,418110,443668,5817,30449,597330,169453,427877,597330,38862,0.04278706912426967,0.6999648435538145,0.009738335593390587,0.2836840607369461,0.7163159392630539,0.050975172852527076
10883,16.0,0,1885,1885,3,78,2509,739,1770,2509,292,0.0,0.7512953367875648,0.0011956954962136308,0.29453965723395775,0.7054603427660423,0.031088082901554404
10884,,146,5132,5278,0,154,6713,1930,4783,6713,474,0.021748845523610904,0.76448681662446,0.0,0.2875018620586921,0.7124981379413079,0.022940563086548488
10885,15.0,792,9398,10190,1022,877,17122,3825,13297,17122,716,0.0462562784721411,0.5488844761126037,0.059689288634505316,0.22339679943931784,0.7766032005606822,0.05122065179301483
10886,23.0,106,3511,3617,0,131,4817,1399,3418,4817,364,0.02200539755034254,0.7288768943325722,0.0,0.29042972804650197,0.709570271953498,0.027195349802781814
10887,26.0,127,3188,3315,1,188,4371,1287,3084,4371,333,0.029055136124456645,0.7293525509036833,0.00022878059940517045,0.29444063143445437,0.7055593685655457,0.043010752688172046
10888,,4671,80494,85165,336,8386,117525,32287,85238,117525,6910,0.03974473516273133,0.6849095937034674,0.002858966177409062,0.2747245266964476,0.7252754733035525,0.07135503084450116
10889,,72,1508,1580,3,100,2141,596,1545,2141,152,0.03362914525922466,0.7043437645959831,0.0014012143858010276,0.27837459131247083,0.7216254086875292,0.046707146193367584
10890,,2121,78703,80824,447,5841,109920,30457,79463,109920,8607,0.01929585152838428,0.7160025473071324,0.004066593886462882,0.27708333333333335,0.7229166666666667,0.05313864628820961
10891,27.0,115,3307,3422,0,226,4497,1281,3216,4497,314,0.025572603958194353,0.7353791416499889,0.0,0.2848565710473649,0.715143428952635,0.05025572603958194
10892,24.0,88,5481,5569,15,434,7469,2110,5359,7469,454,0.011782032400589101,0.7338331771321462,0.0020083009773731422,0.2825010041504887,0.7174989958495113,0.05810684161199625
10893,,1307,48222,49529,167,2295,64500,19051,45449,64500,4893,0.02026356589147287,0.7476279069767442,0.0025891472868217053,0.2953643410852713,0.7046356589147287,0.03558139534883721
10894,36.0,1726,21654,23380,107,1054,32696,8768,23928,32696,2026,0.05278933202838268,0.662282848054808,0.0032725715683875702,0.268167359921703,0.7318326400782971,0.03223635918766821
10895,23.0,508,12372,12880,40,1112,18306,4773,13533,18306,1175,0.02775046432863542,0.6758439855784989,0.002185075931388616,0.2607341855129466,0.7392658144870534,0.06074511089260352
10896,37.0,229,6363,6592,25,386,9060,2516,6544,9060,700,0.025275938189845474,0.702317880794702,0.0027593818984547464,0.27770419426048565,0.7222958057395144,0.04260485651214128
10897,,13,3008,3021,3,181,4144,1152,2992,4144,384,0.003137065637065637,0.7258687258687259,0.0007239382239382239,0.277992277992278,0.722007722007722,0.04367760617760618
10898,26.0,65,3947,4012,18,245,5591,1504,4087,5591,414,0.011625827222321588,0.7059560007154355,0.003219459846181363,0.2690037560364872,0.7309962439635128,0.04382042568413522
10899,24.0,195,3457,3652,16,307,5062,1350,3712,5062,323,0.03852232319241407,0.6829316475701304,0.0031608060055314103,0.26669300671671275,0.7333069932832872,0.060647965231133937
10900,,601,19875,20476,116,2334,28158,7544,20614,28158,1539,0.021343845443568436,0.7058384828467931,0.004119610767810214,0.2679167554513815,0.7320832445486185,0.08288940975921585
10901,13.0,216,3461,3677,35,544,5366,1414,3952,5366,321,0.04025344763324636,0.6449869549012299,0.006522549385016773,0.2635109951546776,0.7364890048453224,0.1013790532985464
10902,26.0,229,1631,1860,8,177,2540,683,1857,2540,133,0.09015748031496063,0.6421259842519685,0.0031496062992125984,0.2688976377952756,0.7311023622047244,0.06968503937007874
10903,15.0,388,3995,4383,71,922,6516,1658,4858,6516,178,0.05954573357888275,0.6131062001227747,0.010896255371393493,0.25445058317986496,0.7455494168201351,0.14149785144260282
10904,,1275,33606,34881,135,1705,45463,13155,32308,45463,2997,0.028044783670237335,0.7391945098211733,0.002969447682731012,0.2893561797505664,0.7106438202494336,0.03750302443745463
10905,34.0,187,4355,4542,8,146,5915,1717,4198,5915,434,0.031614539306846996,0.7362637362637363,0.001352493660185968,0.29027895181741337,0.7097210481825866,0.024683009298393913
10906,17.0,285,5292,5577,14,278,7569,2108,5461,7569,590,0.037653586999603646,0.6991676575505351,0.0018496498876998282,0.27850442594794556,0.7214955740520544,0.03672876205575373
10907,17.0,41,4043,4084,19,411,5617,1537,4080,5617,341,0.0072992700729927005,0.7197792415880363,0.0033825885704112514,0.2736336122485312,0.7263663877514688,0.07317073170731707
10908,,4730,102436,107166,837,5057,141348,40892,100456,141348,9327,0.033463508503834505,0.7247078133401251,0.005921555310297988,0.2893001669638056,0.7106998330361943,0.03577694767524125
10909,16.0,92,1874,1966,2,101,2778,747,2031,2778,186,0.03311735061195104,0.6745860331173507,0.0007199424046076314,0.2688984881209503,0.7311015118790497,0.03635709143268539
10910,,8843,200575,209418,1118,9349,276389,79685,196704,276389,20635,0.03199476100713125,0.7256982007243414,0.00404502349948804,0.2883074217859611,0.7116925782140389,0.033825514039994356
10911,,2144,35007,37151,91,2150,48534,14087,34447,48534,3706,0.044175217373387726,0.7212881691185561,0.0018749742448592739,0.29025013392673177,0.7097498660732682,0.04429884204887295
10912,17.0,414,8813,9227,31,626,12702,3620,9082,12702,932,0.03259329239489844,0.6938277436624154,0.0024405605416469847,0.28499448905684144,0.7150055109431586,0.049283577389387496
10913,27.0,142,4420,4562,10,148,5988,1746,4242,5988,493,0.023714094856379427,0.7381429525718103,0.0016700066800267202,0.29158316633266534,0.7084168336673347,0.024716098864395457
10914,24.0,381,12078,12459,25,554,16485,4742,11743,16485,1111,0.023111919927206553,0.7326660600545951,0.001516530178950561,0.28765544434334245,0.7123445556566576,0.033606308765544435
10915,,15866,325529,341395,5097,17231,433710,130603,303108,433711,22822,0.03658196356560013,0.7505666215521396,0.011752065315382825,0.3011290928752095,0.6988709071247905,0.03972922061003756
10916,,409,11611,12020,48,540,16033,4428,11605,16033,1340,0.025509885860412897,0.7241938501839955,0.0029938252354518805,0.276180377970436,0.7238196220295641,0.03368053389883366
10917,17.0,16,5876,5892,31,643,8442,2221,6221,8442,549,0.0018952854773750297,0.6960435915659796,0.00367211561241412,0.2630893153281213,0.7369106846718787,0.076166785122009
10918,16.0,2315,53536,55851,209,2249,73323,21217,52106,73323,5960,0.03157263068886979,0.7301392468938805,0.0028504016475048755,0.28936350122062654,0.7106364987793734,0.030672503852815624
10919,17.0,44,1769,1813,3,82,2402,673,1729,2402,186,0.018318068276436304,0.7364696086594504,0.0012489592006661116,0.2801831806827644,0.7198168193172356,0.03413821815154038
10920,17.0,3289,55331,58620,533,3762,80233,22135,58098,80233,5357,0.04099310757419017,0.689628955666621,0.006643151820323308,0.2758839878852841,0.7241160121147159,0.046888437425996785
10921,,80,1674,1754,6,83,2342,697,1645,2342,185,0.034158838599487616,0.7147736976942783,0.0025619128949615714,0.29760888129803587,0.7023911187019641,0.035439795046968404
10922,13.0,449,5766,6215,24,417,8931,2470,6461,8931,491,0.05027432538349569,0.6456163923412832,0.0026872690628149142,0.2765647743813683,0.7234352256186317,0.04669129996640914
10923,,260,24886,25146,136,1854,34431,9203,25228,34431,2939,0.0075513345531643,0.7227788911155645,0.003949928843193634,0.26728819958758093,0.732711800412419,0.053846824082948504
10924,15.0,91,2305,2396,3,131,3125,929,2196,3125,223,0.02912,0.7376,0.00096,0.29728,0.70272,0.04192
10925,16.0,487,13398,13885,33,584,17952,5244,12708,17952,1186,0.02712789661319073,0.7463235294117647,0.001838235294117647,0.29211229946524064,0.7078877005347594,0.03253119429590018
10926,36.0,2262,57180,59442,178,1935,75993,23053,52940,75993,5307,0.02976589949074257,0.7524377245272591,0.0023423210032502994,0.30335688813443346,0.6966431118655666,0.02546287158027713
10927,16.0,149,11028,11177,44,830,16376,4181,12195,16376,1053,0.009098680996580361,0.6734245236932096,0.00268685881778212,0.2553126526624328,0.7446873473375671,0.05068392769907181
10928,15.0,754,17410,18164,124,1091,24994,6942,18052,24994,1888,0.03016724013763303,0.6965671761222694,0.004961190685764584,0.27774665919820757,0.7222533408017924,0.04365047611426742
10929,26.0,4,2374,2378,4,123,3200,912,2288,3200,218,0.00125,0.741875,0.00125,0.285,0.715,0.0384375
10930,,255,5404,5659,9,351,7839,2177,5662,7839,560,0.032529659395331034,0.6893736445975251,0.001148105625717566,0.27771399413190456,0.7222860058680954,0.04477611940298507
10931,,402,6758,7160,23,431,9594,2669,6925,9594,638,0.041901188242651655,0.704398582447363,0.0023973316656243485,0.2781947050239733,0.7218052949760266,0.04492391077756931
10932,,79,3824,3903,8,458,5519,1429,4090,5519,398,0.014314187352781301,0.6928791447726037,0.0014495379597753216,0.2589237180648668,0.7410762819351332,0.08298604819713716
10933,,660,19735,20395,247,877,27733,7749,19984,27733,2091,0.02379836296109328,0.7116071106623878,0.008906357047560667,0.2794144160386543,0.7205855839613456,0.031622976237695166
10934,24.0,413,9524,9937,41,816,13784,3945,9839,13784,1031,0.029962275101567033,0.6909460243760882,0.002974463145676146,0.2862013929193268,0.7137986070806732,0.0591990713871155
10935,25.0,54,1636,1690,8,68,2263,652,1611,2263,135,0.023862129916040652,0.7229341581970835,0.003535130357931949,0.28811312417145385,0.7118868758285462,0.030048608042421564
10936,17.0,77,2017,2094,15,72,2782,790,1992,2782,239,0.027677929547088427,0.7250179726815241,0.005391804457225018,0.2839683680805176,0.7160316319194824,0.025880661394680086
10937,24.0,1005,25811,26816,106,1206,35590,10158,25432,35590,2878,0.028238269176735036,0.7252318066872717,0.0029783647091879742,0.28541725203708906,0.7145827479629109,0.03388592301208204
10938,,775,23185,23960,65,909,30949,9158,21793,30951,2312,0.02503957868889535,0.7490872669703725,0.002100093696487997,0.29588704726826276,0.7041129527317372,0.029369002617039838
10939,42.0,338,9797,10135,11,1483,13957,3102,10855,13957,823,0.024217238661603496,0.7019416780110339,0.0007881349860285161,0.22225406606004156,0.7777459339399584,0.10625492584366268
10940,17.0,847,15149,15996,162,1112,21787,6094,15693,21787,1499,0.03887639418001561,0.6953228989764538,0.007435626749896727,0.2797080828016707,0.7202919171983293,0.051039610777068894
10941,,415,12744,13159,54,408,17223,4991,12232,17223,1446,0.024095686001277362,0.7399407768681414,0.003135342274865006,0.28978691284909713,0.7102130871509028,0.02368925274342449
10942,,824,13231,14055,22,604,18713,5355,13358,18713,1496,0.04403355955752685,0.7070485758563565,0.0011756532891572704,0.28616469833805375,0.7138353016619462,0.032277026665954146
10943,27.0,442,26102,26544,71,2020,35625,10626,24999,35625,2956,0.01240701754385965,0.7326877192982456,0.0019929824561403507,0.2982736842105263,0.7017263157894736,0.05670175438596491
10944,,645,25571,26216,234,1185,34148,10288,23860,34148,2038,0.018888368279255007,0.7488286283237672,0.006852524305962282,0.3012767951270938,0.6987232048729062,0.03470188590839873
10945,,373,4416,4789,40,534,7452,1710,5742,7452,252,0.05005367686527107,0.5925925925925926,0.005367686527106817,0.22946859903381642,0.7705314009661836,0.071658615136876
10946,35.0,182,2076,2258,5,91,3049,860,2189,3049,227,0.059691702197441784,0.6808789767136766,0.0016398819285011479,0.28205969170219747,0.7179403082978025,0.029845851098720892
10947,,238,7140,7378,26,396,9871,2810,7061,9871,792,0.024111032316887854,0.7233309695066356,0.0026339783203322867,0.2846722723128356,0.7153277276871645,0.04011751595583021
10948,36.0,795,31376,32171,116,1143,41569,12682,28887,41569,2981,0.01912482859823426,0.7547932353436455,0.0027905410281700307,0.30508311482114076,0.6949168851788593,0.027496451682744352
10949,15.0,1142,25534,26676,75,973,37066,10041,27025,37066,2979,0.030809906652997356,0.6888792963902228,0.0020234176873684777,0.27089515998489183,0.7291048400151082,0.02625047213079372
10950,23.0,374,11269,11643,44,653,15421,4437,10984,15421,1067,0.024252642500486348,0.7307567602619804,0.002853252058880747,0.2877245314830426,0.7122754685169574,0.04234485441929836
10951,16.0,1250,20658,21908,315,1344,30400,8366,22034,30400,2054,0.04111842105263158,0.6795394736842105,0.010361842105263157,0.27519736842105263,0.7248026315789474,0.04421052631578947
10952,,795,16473,17268,177,768,22660,6792,15873,22665,1249,0.03507610853739246,0.7268034414295169,0.007809397749834547,0.299669093315685,0.700330906684315,0.03388484447385837
10953,,541,10714,11255,86,1680,16151,4143,12008,16151,1141,0.033496377933254905,0.663364497554331,0.00532474769364126,0.2565166243576249,0.7434833756423751,0.10401832703857346
10954,26.0,3207,66586,69793,182,5341,94847,26564,68283,94847,6583,0.03381235041698736,0.70203591046633,0.001918879880228157,0.28007211614494926,0.7199278838550508,0.05631174417746476
10955,26.0,670,13660,14330,93,860,19268,5491,13777,19268,1302,0.03477268009134316,0.7089474776832053,0.004826655594768528,0.2849802781814407,0.7150197218185592,0.044633589370977785
10956,,611,15596,16207,25,685,21550,6200,15350,21550,1693,0.028352668213457076,0.7237122969837587,0.001160092807424594,0.2877030162412993,0.7122969837587007,0.03178654292343387
10957,,425,21823,22248,51,1291,29626,8671,20955,29626,2290,0.01434550732464727,0.7366164855194761,0.0017214608789576722,0.2926821035576858,0.7073178964423141,0.04357658813204618
10958,26.0,1029,28850,29879,120,1582,39542,11555,27987,39542,2459,0.02602296292549694,0.7296039654038744,0.003034747863031713,0.2922209296444287,0.7077790703555713,0.04000809266096809
10959,15.0,1878,34414,36292,1022,2947,49951,13952,35999,49951,3377,0.03759684490800985,0.6889551760725511,0.020460050849832837,0.27931372745290384,0.7206862725470962,0.05899781786150427
10960,43.0,2598,54586,57184,205,2918,74626,21484,53142,74626,5188,0.03481360383780452,0.7314608849462654,0.0027470318655696407,0.28788893951169836,0.7121110604883016,0.039101653579181515
10961,25.0,256,8902,9158,12,509,12256,3490,8766,12256,929,0.020887728459530026,0.7263381201044387,0.0009791122715404699,0.2847584856396867,0.7152415143603134,0.04153067885117494
10962,37.0,834,19610,20444,284,979,26942,7939,19003,26942,1734,0.030955385643233614,0.7278598470789103,0.010541162497216242,0.2946700319204216,0.7053299680795784,0.03633731719991092
10963,44.0,637,22684,23321,45,798,30140,9023,21117,30140,2303,0.021134704711347048,0.752621101526211,0.0014930325149303252,0.2993696084936961,0.7006303915063039,0.02647644326476443
10964,15.0,78,1341,1419,28,225,2234,558,1676,2234,142,0.03491495076096687,0.6002685765443151,0.012533572068039392,0.24977618621307074,0.7502238137869293,0.10071620411817368
10965,14.0,353,6224,6577,54,366,9392,2551,6841,9392,627,0.03758517887563884,0.6626916524701874,0.005749574105621806,0.27161413969335607,0.728385860306644,0.03896933560477002
10966,26.0,675,4984,5659,3,189,7249,2124,5125,7249,525,0.09311629190233135,0.6875431093943992,0.00041385018623258383,0.2930059318526693,0.7069940681473307,0.02607256173265278
10967,,73,2489,2562,3,108,3392,965,2427,3392,280,0.02152122641509434,0.7337853773584906,0.000884433962264151,0.2844929245283019,0.7155070754716981,0.031839622641509434
10968,23.0,207,4000,4207,6,274,5790,1535,4255,5790,331,0.035751295336787565,0.690846286701209,0.0010362694300518134,0.2651122625215889,0.7348877374784111,0.04732297063903282
10969,,89,2382,2471,12,110,3261,965,2296,3261,267,0.027292241643667586,0.7304507819687213,0.0036798528058877645,0.2959214964734744,0.7040785035265256,0.033731984053971174
10970,15.0,374,9903,10277,29,378,13217,3936,9281,13217,916,0.028296890368464857,0.7492623136869183,0.002194143905576152,0.2977982900809563,0.7022017099190436,0.028599530907165015
10971,25.0,280,6137,6417,49,358,8695,2417,6278,8695,596,0.03220241518113859,0.7058079355951696,0.0056354226566992524,0.27797584818861415,0.7220241518113859,0.04117308798159862
10972,,80,1840,1920,12,126,2593,743,1850,2593,154,0.030852294639413805,0.7096027767065175,0.004627844195912071,0.28654068646355574,0.7134593135364443,0.048592364057076745
10973,23.0,3901,113333,117234,505,4677,153222,44310,108912,153222,10916,0.02545979036952918,0.7396653222122149,0.0032958713500672227,0.2891882366761953,0.7108117633238047,0.03052433723616713
10974,,1348,2591,3939,5,506,5452,1466,3986,5452,74,0.24724871606749815,0.4752384446074835,0.000917094644167278,0.2688921496698459,0.731107850330154,0.09280997798972854
10975,17.0,1268,23203,24471,248,2762,34196,9258,24938,34196,2410,0.03708036027605568,0.6785296525909463,0.007252310211720669,0.2707334191133466,0.7292665808866534,0.0807696806644052
10976,17.0,259,4084,4343,11,333,6073,1636,4437,6073,444,0.04264778527910423,0.6724847686481146,0.0018112958998847356,0.269389099291948,0.730610900708052,0.05483286678741973
10977,23.0,1133,29182,30315,102,1316,40061,11432,28629,40061,3179,0.028281870148024264,0.7284391303262525,0.0025461171713137467,0.2853648186515564,0.7146351813484436,0.03284990389655775
10978,16.0,3521,52983,56504,407,3517,77118,21254,55864,77118,5015,0.04565730439067403,0.6870380455924687,0.005277626494463031,0.2756036204258409,0.724396379574159,0.045605435825617886
10979,,240,3751,3991,20,248,5653,1489,4164,5653,285,0.042455333451264815,0.6635414823987263,0.0035379444542720678,0.2633999646205555,0.7366000353794445,0.04387051123297364
10980,24.0,163,5667,5830,3,184,7393,2128,5265,7393,558,0.022047883132693086,0.7665359123495198,0.00040578926011091576,0.2878398485053429,0.7121601514946571,0.0248884079534695
10981,26.0,592,19745,20337,58,1214,26852,7678,19174,26852,2021,0.0220467749143453,0.735326977506331,0.0021599880828243705,0.2859377327573365,0.7140622672426635,0.04521078504394459
10982,,433,8744,9177,28,571,12232,3489,8743,12232,874,0.03539895356442119,0.7148463047743623,0.002289077828646174,0.28523544800523215,0.7147645519947678,0.04668083714846305
10983,25.0,3402,59032,62434,182,3577,82844,23675,59169,82844,5870,0.041065134469605524,0.7125682004731785,0.0021969001979624354,0.28577808893824536,0.7142219110617546,0.043177538506107865
10984,33.0,103,2001,2104,3,87,2795,820,1975,2795,182,0.03685152057245081,0.7159212880143113,0.001073345259391771,0.29338103756708406,0.7066189624329159,0.031127012522361358
10985,,9797,161087,170884,655,10132,226205,65032,161173,226205,15600,0.04331027165624102,0.7121283791251298,0.002895603545456555,0.28749143476050487,0.7125085652394951,0.04479122919475697
10986,13.0,235,2636,2871,41,222,3992,1056,2936,3992,241,0.05886773547094189,0.6603206412825652,0.010270541082164329,0.26452905811623245,0.7354709418837675,0.05561122244488978
10987,24.0,426,21229,21655,130,1769,29754,8086,21668,29754,2116,0.014317402702157693,0.7134839013241917,0.0043691604490152585,0.27176177992874906,0.7282382200712509,0.0594541910331384
10988,,291,4580,4871,19,254,6355,1897,4458,6355,466,0.04579071597167585,0.7206923682140047,0.002989771833202203,0.2985051140833989,0.7014948859166011,0.03996852871754524
10989,26.0,989,2934,3923,5,93,5171,1499,3672,5171,348,0.19125894411139044,0.5673950879907175,0.0009669309611293754,0.2898859021465867,0.7101140978534133,0.01798491587700638
10990,,4249,44618,48867,435,2847,66669,18885,47784,66669,4843,0.06373276935307265,0.6692465763698271,0.006524771632992845,0.2832650857219997,0.7167349142780003,0.042703505377311796
10991,14.0,454,13736,14190,50,447,18257,5245,13012,18257,1343,0.024867174234540178,0.7523689543736649,0.002738675576491209,0.28728706797392783,0.7127129320260722,0.024483759653831406
10992,16.0,241,8772,9013,5,372,11495,3389,8111,11500,783,0.020956521739130436,0.7627826086956522,0.0004347826086956522,0.294695652173913,0.705304347826087,0.03234782608695652
10993,14.0,264,5703,5967,24,152,7720,2255,5465,7720,639,0.03419689119170984,0.7387305699481865,0.0031088082901554403,0.2920984455958549,0.707901554404145,0.019689119170984457
10994,17.0,453,12743,13196,18,606,17588,5053,12535,17588,1396,0.025756197407323173,0.724528087332272,0.0010234250625426426,0.28729815783488744,0.7127018421651126,0.03445531043893564
10995,26.0,444,2735,3179,103,292,4645,1152,3493,4645,103,0.09558665231431647,0.5888051668460711,0.02217438105489774,0.2480086114101184,0.7519913885898816,0.06286329386437028
10996,,79,1876,1955,3,90,2627,768,1859,2627,160,0.030072325846973735,0.7141225732775028,0.0011419870574800152,0.2923486867148839,0.7076513132851161,0.03425961172440046
10997,13.0,56,19476,19532,65,1285,26794,7577,19217,26794,2345,0.0020900201537657685,0.7268791520489661,0.0024259162499066953,0.28278719116220047,0.7172128088377995,0.047958498171232364
10998,,3833,65005,68838,370,4572,94377,25935,68442,94377,5769,0.040613708848554204,0.6887801053222713,0.003920446719009928,0.2748021233987094,0.7251978766012905,0.04844400648463079
10999,23.0,77,1870,1947,0,113,2582,720,1862,2582,214,0.029821843532145623,0.7242447714949651,0.0,0.278853601859024,0.721146398140976,0.04376452362509682
11000,,654,11932,12586,179,776,17059,4821,12238,17059,1294,0.0383375344392989,0.6994548332258632,0.010492994900052758,0.28260742130253824,0.7173925786974618,0.04548918459464212
11001,16.0,264,5652,5916,44,708,8592,2236,6356,8592,534,0.030726256983240222,0.6578212290502793,0.005121042830540037,0.2602420856610801,0.7397579143389199,0.0824022346368715
11002,,213,3659,3872,76,282,5450,1464,3986,5450,422,0.03908256880733945,0.6713761467889908,0.013944954128440367,0.2686238532110092,0.7313761467889909,0.05174311926605504
11003,16.0,126,2280,2406,9,214,4115,858,3257,4115,157,0.030619684082624544,0.5540704738760632,0.002187120291616039,0.20850546780072904,0.7914945321992709,0.052004860267314705
11004,14.0,138,1933,2071,0,224,2925,759,2166,2925,149,0.04717948717948718,0.6608547008547009,0.0,0.2594871794871795,0.7405128205128205,0.07658119658119658
11005,16.0,59,8006,8065,110,1189,11870,3040,8834,11874,719,0.0049688394812194715,0.6742462523159845,0.009263938015832912,0.2560215597102914,0.7439784402897086,0.10013474818932121
11006,14.0,10141,174589,184730,1240,14117,257286,71155,186131,257286,18514,0.03941528104910489,0.6785794796452197,0.004819539345319994,0.2765599371905195,0.7234400628094805,0.05486890075635674
11007,,225,21188,21413,45,1110,28251,8141,20110,28251,2268,0.00796431984708506,0.7499911507557254,0.0015928639694170119,0.2881667905560865,0.7118332094439135,0.039290644578952955
11008,,4463,108505,112968,361,5252,146548,42575,103973,146548,11262,0.030454185659306167,0.7404058738433824,0.0024633567158883094,0.29051914731009637,0.7094808526899037,0.03583808717962715
11009,,879,11650,12529,68,573,17261,4837,12424,17261,1206,0.05092404843288338,0.6749319274665431,0.003939516829847633,0.2802271015584265,0.7197728984415734,0.033196222698569026
11010,,799,12989,13788,199,830,18590,5203,13387,18590,1304,0.042980096826250674,0.6987089833243679,0.010704679935449166,0.2798816568047337,0.7201183431952662,0.04464766003227542
11011,36.0,219,4699,4918,27,283,6551,1820,4731,6551,429,0.033430010685391545,0.7172950694550451,0.004121508166692108,0.27782018012517173,0.7221798198748283,0.043199511524958024
11012,,207,3477,3684,9,168,4918,1463,3455,4918,294,0.04209028060187068,0.7069947132980886,0.0018300122000813339,0.2974786498576657,0.7025213501423343,0.03416022773485156
11013,24.0,111,3429,3540,15,181,4837,1351,3486,4837,401,0.0229481083316105,0.7089104817035352,0.0031010957204879058,0.2793053545586107,0.7206946454413893,0.037419888360554064
11014,,1507,22749,24256,101,1539,32689,9156,23533,32689,2326,0.04610113493835847,0.6959221756554193,0.003089724372112943,0.28009422129768424,0.7199057787023158,0.04708005751170118
11015,,801,19352,20153,116,1173,27261,7603,19658,27261,1817,0.029382634532849124,0.7098785811232163,0.004255163053446315,0.27889659220131324,0.7211034077986868,0.04302850225597007
11016,,2397,55659,58056,336,3362,79526,22120,57406,79526,5400,0.030141085934159897,0.6998843145637904,0.00422503332243543,0.2781480270603325,0.7218519729396675,0.042275482232225936
11017,,121,12436,12557,48,1025,17404,4832,12572,17404,1287,0.006952424729947139,0.7145483796828316,0.002757986669731096,0.27763732475293035,0.7223626752470697,0.05889450700988279
11018,27.0,367,6745,7112,31,449,9324,2659,6665,9324,612,0.039360789360789364,0.7234019734019734,0.0033247533247533247,0.2851780351780352,0.7148219648219648,0.048155298155298155
11019,38.0,515,16252,16767,50,1136,22382,6191,16191,22382,1553,0.023009561254579574,0.7261192029309267,0.002233937985881512,0.27660620141184883,0.7233937985881512,0.05075507103922795
11020,14.0,1434,48245,50036,248,5483,67543,18443,49100,67543,4244,0.02123091956235287,0.7142857142857143,0.0036717350428615843,0.27305568304635564,0.7269443169536444,0.08117791629036318
11021,24.0,150,3080,3230,7,145,4279,1251,3028,4279,321,0.03505491937368544,0.7197943444730077,0.001635896237438654,0.29235802757653656,0.7076419724234634,0.03388642206122926
11022,16.0,80,1597,1677,4,67,2242,604,1638,2242,181,0.03568242640499554,0.7123104371097234,0.001784121320249777,0.2694023193577163,0.7305976806422837,0.029884032114183764
11023,25.0,402,9412,9814,23,592,13238,3726,9512,13238,986,0.030367124943344915,0.7109835322556277,0.0017374225713854058,0.2814624565644357,0.7185375434355643,0.044719746185224354
11024,23.0,362,10044,10406,37,385,13386,3929,9457,13386,1036,0.02704317944120723,0.7503361721201255,0.0027640818765874795,0.29351561332735693,0.706484386672643,0.028761392499626476
11025,16.0,66,2443,2509,30,323,3547,925,2622,3547,216,0.018607273752466874,0.6887510572314632,0.00845785170566676,0.2607837609247251,0.7392162390752749,0.09106287003101213
11026,16.0,651,14887,15658,0,725,21557,6133,15439,21572,1435,0.030178008529575376,0.6901075468199518,0.0,0.284303727053588,0.715696272946412,0.033608381234934176
11027,16.0,394,10757,11151,43,2465,17115,2889,14226,17115,803,0.023020742039146946,0.6285130002921414,0.0025124160093485245,0.16879929886064857,0.8312007011393514,0.14402570844288637
11028,25.0,441,4538,4979,9,200,6573,1865,4708,6573,372,0.0670926517571885,0.6904001217100258,0.0013692377909630307,0.2837364977940058,0.7162635022059942,0.030427506465845123
11029,15.0,167,2048,2215,33,110,2941,845,2096,2941,229,0.056783407004420264,0.6963617817069024,0.011220673240394424,0.2873172390343421,0.712682760965658,0.03740224413464808
11030,27.0,113,4491,4604,0,178,6082,1790,4292,6082,553,0.018579414666228214,0.7384084182834594,0.0,0.2943110818809602,0.7056889181190398,0.029266688589279843
11031,23.0,103,2255,2358,16,167,3244,879,2365,3244,228,0.03175092478421702,0.6951294697903823,0.004932182490752158,0.2709617755856967,0.7290382244143033,0.05147965474722565
11032,,1135,19907,21042,185,1583,29050,7976,21074,29050,1781,0.03907056798623064,0.6852667814113598,0.006368330464716007,0.27456110154905333,0.7254388984509467,0.05449225473321859
11033,14.0,72,5163,5235,23,410,7050,1928,5122,7050,414,0.010212765957446808,0.7323404255319149,0.0032624113475177305,0.2734751773049645,0.7265248226950355,0.05815602836879433
11034,,162,2831,2993,9,181,4007,1134,2873,4007,265,0.04042924881457449,0.7065136011979036,0.002246069378587472,0.28300474170202145,0.7169952582979785,0.045170950836036936
11035,,545,18023,18568,64,529,24120,6946,17174,24120,1845,0.022595356550580432,0.7472222222222222,0.0026533996683250414,0.28797678275290217,0.7120232172470978,0.02193200663349917
11036,,3317,40804,44121,122,2033,58973,16727,42246,58973,4982,0.056246078713987756,0.6919098570532277,0.002068743323215709,0.283638275142862,0.716361724857138,0.03447340308276669
11037,23.0,419,11232,11651,17,591,15121,4565,10556,15121,1113,0.027709807552410554,0.7428080153429006,0.0011242642682362278,0.3018980226175518,0.6981019773824483,0.03908471661927121
11038,16.0,219,1294,1513,4,57,2630,586,2044,2630,141,0.08326996197718631,0.4920152091254753,0.001520912547528517,0.22281368821292777,0.7771863117870722,0.02167300380228137
11039,26.0,252,39986,40238,150,1904,53396,15178,38218,53396,5073,0.0047194546407970635,0.7488575923290134,0.002809199190950633,0.2842535021349914,0.7157464978650087,0.0356581017304667
11040,24.0,65,1784,1849,26,95,2557,669,1888,2557,190,0.025420414548298787,0.697692608525616,0.010168165819319515,0.261634728197106,0.738365271802894,0.037152913570590536
11041,14.0,199,1731,1930,67,252,2986,742,2244,2986,178,0.0666443402545211,0.5797052913596785,0.022438044206296047,0.24849296718017413,0.7515070328198259,0.08439383791024782
11042,23.0,4589,64203,68800,969,5397,91859,25177,66724,91901,4521,0.0499341682897901,0.6986104612572225,0.010543954907998825,0.27395784594291683,0.7260421540570832,0.05872623801699655
11043,,213,4183,4396,7,312,5948,1663,4285,5948,378,0.035810356422326835,0.7032616005379959,0.0011768661735036988,0.2795897780766644,0.7204102219233356,0.05245460659045057
11044,25.0,2511,74228,76739,236,3595,100500,29194,71306,100500,7114,0.02498507462686567,0.738587064676617,0.0023482587064676615,0.29048756218905475,0.7095124378109453,0.03577114427860697
11045,23.0,3645,83569,87214,1048,2164,108296,33583,74713,108296,5931,0.033657752825589124,0.7716720839181502,0.009677181059318904,0.3101037896136515,0.6898962103863485,0.019982270813326437
11046,14.0,15,4397,4412,40,381,6177,1595,4582,6177,380,0.0024283632831471587,0.7118342237332038,0.006475635421725757,0.25821596244131456,0.7417840375586855,0.06168042739193783
11047,,1610,17282,18892,452,1191,25687,7144,18543,25687,1290,0.06267761902908085,0.6727916845096742,0.01759644956592829,0.2781173356172383,0.7218826643827617,0.04636586600225795
11048,,2064,36559,38623,237,1707,50521,14803,35725,50528,2952,0.04084863837872071,0.7235394236858771,0.004690468651044965,0.2929662761241292,0.7070337238758708,0.03378324889170361
11049,,121,4948,5069,0,178,6514,1943,4571,6514,494,0.018575376112987412,0.7595947190666257,0.0,0.2982806263432607,0.7017193736567393,0.027325759901750075
11050,,1518,30431,31949,166,2306,43339,11943,31396,43339,2859,0.03502618888299222,0.702162024965966,0.003830268349523524,0.2755716560142135,0.7244283439857865,0.05320842659036895
11051,23.0,1235,24336,25571,76,1343,33730,9775,23955,33730,2435,0.03661428994959976,0.7214942187963237,0.002253187073821524,0.28980136377112364,0.7101986362288764,0.03981618737029351
11052,24.0,492,11837,12329,74,477,16329,4674,11655,16329,1234,0.03013044277053096,0.7249066078755588,0.004531814563047339,0.28623920632004407,0.7137607936799559,0.029211831710453794
11053,35.0,206,4055,4261,19,219,5805,1628,4177,5805,367,0.03548664944013781,0.6985357450473729,0.003273040482342808,0.28044788975021534,0.7195521102497847,0.03772609819121447
11054,16.0,873,41830,42703,160,2138,55873,16352,39521,55873,4549,0.015624720347931918,0.7486621445062911,0.0028636371771696527,0.2926637195067385,0.7073362804932615,0.038265351779929485
11055,,84,3317,3401,6,186,4504,1292,3212,4504,443,0.018650088809946713,0.7364564831261101,0.0013321492007104796,0.28685612788632325,0.7131438721136767,0.04129662522202487
11056,27.0,8802,151541,160343,2213,9801,221033,60884,160180,221064,14164,0.03981652372163717,0.6855073643831651,0.010010675641443203,0.2754134549270799,0.7245865450729201,0.04433557702746716
11057,17.0,6933,9595,16528,20,3198,31141,5899,25242,31141,636,0.2226325423075688,0.30811470408785846,0.0006422401335859478,0.1894287274011753,0.8105712725988247,0.10269419736039305
11058,17.0,517,7000,7517,19,532,10397,2904,7493,10397,688,0.04972588246609599,0.6732711359045879,0.0018274502260267386,0.27931133980956047,0.7206886601904395,0.05116860632874868
11059,24.0,1274,30032,31306,147,1491,41835,11897,29938,41835,3021,0.030452970001195172,0.7178678140313135,0.003513804230907135,0.2843791084020557,0.7156208915979443,0.03564001434205809
11060,,121,2876,2997,8,132,4002,1152,2850,4002,320,0.03023488255872064,0.7186406796601699,0.001999000499750125,0.28785607196401797,0.712143928035982,0.03298350824587706
11061,,206,11631,11837,45,696,15825,4547,11278,15825,1327,0.0130173775671406,0.7349763033175355,0.002843601895734597,0.2873301737756714,0.7126698262243286,0.043981042654028434
11062,,2,2419,2421,23,258,3268,914,2354,3268,185,0.0006119951040391676,0.7402080783353733,0.007037943696450428,0.27968176254589966,0.7203182374541004,0.07894736842105263
11063,,820,12601,13421,148,877,18684,4973,13711,18684,992,0.043887818454292446,0.6744273174909013,0.007921216013701562,0.266163562406337,0.733836437593663,0.04693855705416399
11064,,555,17862,18417,67,782,24351,6907,17444,24351,2010,0.02279167179992608,0.7335222372797832,0.0027514270461172024,0.28364338220196295,0.716356617798037,0.03211367089647242
11065,15.0,293,2203,2496,24,165,3477,959,2518,3477,224,0.08426804716709807,0.633592177164222,0.006902502157031924,0.27581248202473396,0.724187517975266,0.04745470232959448
11066,,101,2507,2608,21,145,3524,993,2531,3524,268,0.02866061293984109,0.7114074914869466,0.005959137343927355,0.2817820658342792,0.7182179341657208,0.04114642451759364
11067,,140,2338,2478,4,115,3276,963,2313,3276,214,0.042735042735042736,0.7136752136752137,0.001221001221001221,0.29395604395604397,0.7060439560439561,0.035103785103785104
11068,24.0,4405,142933,147338,269,5592,193356,55256,138100,193356,14980,0.022781811787583525,0.7392219532882351,0.0013912162022383582,0.2857733920850659,0.7142266079149341,0.028920747222739403
11069,,182,3511,3693,21,210,5064,1337,3727,5064,356,0.03593996840442338,0.6933254344391785,0.004146919431279621,0.2640205371248025,0.7359794628751974,0.041469194312796206
11070,24.0,167,24056,24223,155,2148,33327,9219,24108,33327,2902,0.00501095208089537,0.721817145257599,0.004650883667896901,0.27662255828607435,0.7233774417139256,0.06445224592672608
11071,16.0,432,10076,10508,17,445,13769,4027,9742,13769,1062,0.031374827511075606,0.7317888009296245,0.001234657564093253,0.29246858885903115,0.7075314111409688,0.03231897741302927
11072,25.0,749,19557,20306,27,1420,26879,7772,19107,26879,2043,0.027865620000744076,0.7275940325160907,0.0010045016555675435,0.2891476617433684,0.7108523382566315,0.05282934632984858
11073,,474,12050,12524,18,518,16459,4786,11673,16459,1253,0.02879883346497357,0.7321222431496446,0.0010936265872774774,0.29078315815055594,0.7092168418494441,0.03147214290054074
11074,25.0,6157,116997,123154,1123,5998,171843,47070,124773,171843,12294,0.035829216203162186,0.6808365775737155,0.006535034886495231,0.2739128157678811,0.7260871842321188,0.034903953026890824
11075,,2539,33909,36448,248,1425,48023,13824,34199,48023,2707,0.052870499552297855,0.7060991608187743,0.005164192157924328,0.28786206609333026,0.7121379339066697,0.029673281552589383
11076,14.0,258,6609,6867,23,406,9707,2543,7164,9707,705,0.026578757597609973,0.6808488719480787,0.0023694241269187183,0.2619758936849696,0.7380241063150303,0.04182548676213042
11077,24.0,1338,28392,29730,122,1478,40274,11300,28974,40274,3287,0.033222426379301784,0.7049709489993544,0.0030292496399662314,0.28057804042310175,0.7194219595768983,0.03669861449073844
11078,33.0,17211,426432,443643,3300,22422,579783,173100,406690,579790,38770,0.029684885906966316,0.7354938857172425,0.005691715966125666,0.29855637385950085,0.7014436261404992,0.03867262284620294
11079,17.0,191,4034,4225,13,385,5804,1588,4216,5804,350,0.03290833907649897,0.6950379048931771,0.0022398345968297727,0.27360441075120606,0.7263955892487939,0.06633356305995865
11080,23.0,1541,35984,37525,173,2221,50809,13858,36951,50809,3269,0.030329272373004784,0.7082209844712551,0.0034049085791887264,0.2727469542797536,0.7272530457202464,0.043712728059989374
11081,16.0,280,5183,5463,18,376,7467,2092,5375,7467,529,0.037498325967590736,0.6941207981786527,0.0024106066693451184,0.2801660640149993,0.7198339359850007,0.0503548948707647
11082,24.0,2476,53826,56302,157,3555,76104,21689,54415,76104,6066,0.032534426574161675,0.7072690003153579,0.002062966466939977,0.2849915904551666,0.7150084095448334,0.0467123935666982
11083,16.0,166,3897,4063,38,174,5650,1539,4111,5650,366,0.02938053097345133,0.6897345132743363,0.006725663716814159,0.27238938053097345,0.7276106194690265,0.030796460176991152
11084,23.0,514,19338,19852,115,1245,27213,7597,19616,27213,2028,0.01888803145555433,0.7106162495865946,0.004225921434608459,0.2791680446845258,0.7208319553154742,0.04575019292250027
11085,17.0,27,1861,1888,0,82,2446,745,1701,2446,207,0.011038430089942763,0.7608340147179068,0.0,0.3045789043336059,0.6954210956663941,0.033524121013900246
11086,,29562,650246,679808,2872,37622,911893,259128,652765,911893,60197,0.032418277144357945,0.7130726960290297,0.003149492319822611,0.28416491847179437,0.7158350815282056,0.04125703344580998
11087,16.0,353,7309,7662,111,675,11755,2982,8773,11755,616,0.030029774564015312,0.6217779668226286,0.00944279030199915,0.25367928541046364,0.7463207145895364,0.057422373458102936
11088,16.0,255,24574,24846,54,2236,34148,9487,24661,34148,2505,0.007467494435984538,0.7196321892936629,0.0015813517629143727,0.27782007731053066,0.7221799226894694,0.06547967670141736
11089,36.0,1888,30126,32014,312,1417,42631,12059,30572,42631,2427,0.04428702118176914,0.7066688559968098,0.007318617907156764,0.2828692735333443,0.7171307264666558,0.03323872299500363
11090,,125,3204,3329,22,205,4406,1262,3144,4406,337,0.028370403994552883,0.7271901951883795,0.004993191103041307,0.2864275987290059,0.7135724012709941,0.046527462551066726
11091,16.0,33,3069,3102,10,151,4120,1118,3002,4120,339,0.008009708737864078,0.7449029126213592,0.0024271844660194173,0.2713592233009709,0.7286407766990292,0.036650485436893206
11092,45.0,1147,27940,29087,203,784,37496,11350,26146,37496,2331,0.030589929592489865,0.7451461489225517,0.00541391081715383,0.30269895455515256,0.6973010454448475,0.020908896949007893
11093,,13,2042,2055,15,327,3000,807,2193,3000,173,0.004333333333333333,0.6806666666666666,0.005,0.269,0.731,0.109
11094,,5,20861,20866,36,2533,28587,7909,20678,28587,2177,0.00017490467695106167,0.7297372931752195,0.001259313674047644,0.27666421800118934,0.7233357819988107,0.08860670934340785
11095,34.0,52,1633,1685,8,73,2301,666,1635,2301,149,0.022598870056497175,0.7096914385049978,0.003476749239461104,0.2894393741851369,0.7105606258148631,0.03172533681008257
11096,36.0,71,1689,1760,5,62,2330,674,1656,2330,165,0.030472103004291845,0.7248927038626609,0.002145922746781116,0.2892703862660944,0.7107296137339055,0.026609442060085836
11097,27.0,1023,22729,23752,76,1524,31881,8986,22895,31881,2340,0.03208807753834572,0.7129324676139394,0.002383864997961168,0.2818606693641981,0.7181393306358019,0.047802766538063424
11098,24.0,1167,19816,20983,95,1050,28607,7807,20800,28607,1993,0.040794211207047223,0.6926975914985842,0.0033208655224245816,0.27290523298493374,0.7270947670150663,0.03670430314258748
11099,15.0,588,13221,13809,42,464,18068,5267,12801,18068,1414,0.032543723710427276,0.7317356652645561,0.0023245516936019482,0.29150985167146337,0.7084901483285366,0.025680761567412
11100,,747,18662,19409,18,1226,25756,7343,18413,25756,1826,0.02900295076875291,0.7245690324584563,0.0006988662835844075,0.28509861779779466,0.7149013822022053,0.047600559093026865
11101,17.0,177,3792,3969,9,120,5175,1471,3704,5175,417,0.034202898550724635,0.7327536231884058,0.0017391304347826088,0.2842512077294686,0.7157487922705315,0.02318840579710145
11102,,15,1541,1556,1,104,2100,605,1495,2100,193,0.007142857142857143,0.7338095238095238,0.0004761904761904762,0.28809523809523807,0.7119047619047619,0.049523809523809526
11103,38.0,243,3981,4224,29,119,5405,1581,3824,5405,318,0.04495837187789084,0.7365402405180389,0.005365402405180388,0.29250693802035155,0.7074930619796485,0.022016651248843663
11104,16.0,244,5587,5831,18,347,7957,2195,5762,7957,540,0.03066482342591429,0.7021490511499309,0.002262159105190398,0.27585773532738467,0.7241422646726153,0.04360940052783713
11105,,90,5391,5481,0,179,6887,2096,4791,6887,513,0.013068099317554814,0.7827791491215333,0.0,0.3043415129954988,0.6956584870045013,0.02599099753158124
11106,36.0,463,13242,13705,47,646,18051,5118,12933,18051,1503,0.025649548501468063,0.7335881668605617,0.002603733865159825,0.2835299983380422,0.7164700016619577,0.035787490997728655
11107,,130,2139,2269,7,83,2984,917,2067,2984,232,0.0435656836461126,0.7168230563002681,0.0023458445040214475,0.30730563002680966,0.6926943699731903,0.02781501340482574
11108,,367,9552,9919,2,821,13163,3796,9367,13163,936,0.027881182101344677,0.7256704398693307,0.00015194104687381296,0.288384106966497,0.711615893033503,0.06237179974170022
11109,44.0,166,2500,2666,9,214,3622,1034,2588,3622,270,0.04583103257868581,0.6902263942573164,0.002484815019326339,0.28547763666482606,0.7145223633351739,0.059083379348426286
11110,17.0,1071,25144,26215,31,1391,34854,9869,24985,34854,2744,0.030728180409709073,0.7214093073965685,0.0008894244563034372,0.2831525793309233,0.7168474206690767,0.039909336087680033
11111,25.0,511,8555,9066,24,451,12086,3501,8585,12086,889,0.04228032434221413,0.7078437861989079,0.0019857686579513485,0.289674002978653,0.710325997021347,0.037315902697335764
11112,26.0,14696,362398,377094,921,15566,491921,143273,348648,491921,35601,0.02987471565556258,0.7366995920076598,0.001872251845316626,0.29125205063414655,0.7087479493658535,0.031643292317262324
11113,35.0,515,15957,16472,53,665,21926,6403,15523,21926,1688,0.023488096323998904,0.7277661224117487,0.002417221563440664,0.2920277296360485,0.7079722703639515,0.030329289428076257
11114,17.0,266,16356,16622,75,744,22149,6354,15795,22149,2092,0.01200957153821843,0.7384532033048896,0.0033861573885954218,0.28687525396180413,0.7131247460381959,0.03359068129486659
11115,24.0,9979,186175,196154,2021,16050,280549,74289,206260,280549,19508,0.03556954400122617,0.6636095655304421,0.007203732681278493,0.26479866262221574,0.7352013373777843,0.05720925756284998
11116,26.0,6161,145720,151881,403,7957,201782,57696,144086,201782,15056,0.030532951402999275,0.722165505347355,0.0019972049043026634,0.28593234282542546,0.7140676571745745,0.03943364621224886
11117,23.0,655,16969,17624,85,1219,23979,6637,17342,23979,1815,0.027315567788481588,0.7076608699278535,0.0035447683389632596,0.2767838525376371,0.7232161474623628,0.05083614829642604
11118,,710,19771,20481,96,1167,27237,7592,19645,27237,2174,0.026067481734405405,0.725887579395675,0.0035246172485956604,0.2787384807431068,0.7212615192568932,0.042846128428240995
11119,17.0,71,3152,3223,0,151,4288,1241,3047,4288,354,0.01655783582089552,0.7350746268656716,0.0,0.2894123134328358,0.7105876865671642,0.03521455223880597
11120,15.0,304,16842,17146,192,1474,24117,6336,17781,24117,1960,0.012605216237508812,0.698345565368827,0.007961189202637144,0.26271924368702576,0.7372807563129743,0.06111871294107891
11121,,492,10635,11127,69,704,15181,4222,10959,15181,1052,0.03240893221790396,0.7005467360516435,0.004545155128120677,0.2781107963902246,0.7218892036097754,0.046373756669521114
11122,,217,7640,7857,23,280,10331,3069,7262,10331,851,0.021004743006485336,0.7395218275094376,0.0022263091665860033,0.29706707966314977,0.7029329203368503,0.027102894201916562
11123,25.0,2369,61689,64058,551,2623,82823,24608,58216,82824,5461,0.028602820438520235,0.7448203419298755,0.00665266106442577,0.29711194822756687,0.7028880517724331,0.031669564377475125
11124,17.0,46,3402,3448,11,124,4807,1329,3478,4807,415,0.009569377990430622,0.7077179113792386,0.002288329519450801,0.27647181194091947,0.7235281880590805,0.025795714582899937
11125,24.0,90,2969,3059,4,181,3961,1189,2772,3961,232,0.022721534965917698,0.7495581923756627,0.001009845998485231,0.3001767230497349,0.6998232769502651,0.0456955314314567
11126,,517,8329,8846,41,944,12481,3368,9113,12481,834,0.04142296290361349,0.6673343482092781,0.0032849931896482653,0.269850172261838,0.7301498277381621,0.07563496514702348
11127,,235,4863,5098,24,415,6986,1900,5086,6986,515,0.03363870598339536,0.6961064987117092,0.0034354423131978244,0.2719725164614944,0.7280274835385055,0.05940452333237904
11128,17.0,163,6340,6503,35,194,8504,2491,6015,8506,750,0.019162943804373382,0.745356219139431,0.004114742534681401,0.2928521043968963,0.7071478956031036,0.02280743004937691
11129,23.0,348,6786,7134,77,285,10014,2711,7303,10014,564,0.0347513481126423,0.6776512881965249,0.007689235070900739,0.2707209906131416,0.7292790093868584,0.028460155781905333
11130,,3320,60355,63675,376,3031,83782,23847,59935,83782,5815,0.03962665011577666,0.7203814661860543,0.0044878374829915735,0.2846315437683512,0.7153684562316488,0.03617722183762622
11131,,251,4681,4932,31,268,6571,1845,4726,6571,472,0.03819814335717547,0.7123725460356111,0.004717698980368285,0.28077918125095114,0.7192208187490489,0.040785268604474206
11132,,510,20927,21437,52,2513,29042,7052,21990,29042,1629,0.01756077405137387,0.7205770952413746,0.0017905102954341987,0.2428207423731148,0.7571792576268852,0.08652985331588733
11133,,4811,66548,71359,1273,6953,99728,27083,72645,99728,7464,0.048241216107813255,0.6672950425156425,0.012764720038504733,0.27156866677362423,0.7284313332263758,0.06971963741376544
11134,17.0,932,15812,16744,127,980,22639,6290,16349,22639,1637,0.041167896108485355,0.6984407438491099,0.005609788418216352,0.277839127169928,0.722160872830072,0.04328813110119705
11135,14.0,127,2899,3026,2,162,4023,1148,2875,4023,292,0.03156848123291076,0.7206065125528213,0.0004971414367387521,0.2853591846880437,0.7146408153119562,0.040268456375838924
11136,16.0,197,1941,2138,121,190,3122,765,2357,3122,184,0.06310057655349136,0.6217168481742473,0.038757206918641894,0.24503523382447148,0.7549647661755285,0.060858424087123636
11137,14.0,15,1667,1682,0,340,2455,628,1827,2455,193,0.006109979633401222,0.6790224032586558,0.0,0.25580448065173117,0.7441955193482689,0.1384928716904277
11138,24.0,300,5371,5671,88,416,7995,2116,5879,7995,405,0.0375234521575985,0.6717948717948717,0.011006879299562226,0.2646654158849281,0.7353345841150719,0.05203252032520325
11139,,158,4027,4185,13,137,5446,1634,3812,5446,445,0.029012118986412046,0.7394417921410209,0.0023870730811604846,0.3000367242012486,0.6999632757987514,0.025156077855306647
11140,24.0,187,7569,7756,0,179,9804,2926,6878,9804,723,0.019073847409220725,0.77203182374541,0.0,0.29844961240310075,0.7015503875968992,0.018257853937168503
11141,16.0,416,23896,24312,75,1723,32753,9496,23257,32753,2876,0.012701126614355936,0.729582023020792,0.0022898665771074406,0.2899276402161634,0.7100723597838366,0.05260586816474827
11142,,706,17044,17750,53,1125,23496,6816,16680,23496,1896,0.030047667688117126,0.7254000680966973,0.0022557030983997276,0.2900919305413687,0.7099080694586313,0.047880490296220636
11143,16.0,92,2707,2799,5,129,3650,1058,2592,3650,235,0.025205479452054796,0.7416438356164383,0.0013698630136986301,0.28986301369863016,0.7101369863013699,0.03534246575342466
11144,24.0,78,11710,11788,14,463,15759,4533,11226,15759,1420,0.004949552636588616,0.7430674535186242,0.0008883812424646234,0.2876451551494384,0.7123548448505616,0.02938003680436576
11145,13.0,110,2267,2377,1,172,3201,907,2294,3201,214,0.03436426116838488,0.7082161824429866,0.00031240237425804435,0.28334895345204625,0.7166510465479538,0.05373320837238363
11146,27.0,677,18627,19304,70,1146,26086,7257,18829,26086,1919,0.025952618262669633,0.7140611822433489,0.002683431725829947,0.27819520049068464,0.7218047995093153,0.04393161082573028
11147,,403,7970,8373,72,435,11930,3181,8749,11930,743,0.033780385582564965,0.6680637049455155,0.006035205364626991,0.26663872590108967,0.7333612740989103,0.036462699077954734
11148,17.0,116,1841,1957,17,136,2701,731,1970,2701,160,0.042947056645686786,0.6815994076268049,0.006293965198074787,0.27064050351721586,0.7293594964827842,0.050351721584598295
11149,,8122,175765,183887,517,7762,241413,69241,172172,241413,15849,0.03364359003036291,0.7280676682697287,0.002141558242513866,0.2868155401738929,0.7131844598261071,0.03215236959070141
11150,27.0,97,2648,2745,1,111,3656,1036,2620,3656,277,0.026531728665207876,0.7242888402625821,0.0002735229759299781,0.2833698030634573,0.7166301969365426,0.03036105032822757
11151,26.0,70,1624,1694,2,90,2210,601,1609,2210,164,0.03167420814479638,0.7348416289592761,0.0009049773755656109,0.27194570135746604,0.7280542986425339,0.04072398190045249
11152,26.0,1487,36093,37580,298,1775,48939,14447,34493,48940,3543,0.03038414384961177,0.7374948917041275,0.0060890886800163465,0.2951982018798529,0.7048017981201471,0.03626890069472824
11153,17.0,2378,81282,83660,177,4675,111485,31395,80090,111485,8627,0.021330223796923353,0.729084630219312,0.0015876575324034624,0.2816073911288514,0.7183926088711485,0.04193389245189936
11154,,9191,147415,156606,537,7341,207559,60068,147491,207559,15161,0.04428138505196113,0.7102317895152703,0.002587216165042229,0.2894020495377218,0.7105979504622782,0.03536825673663874
11155,34.0,316,4669,4985,8,372,6671,1944,4727,6671,491,0.04736921001349123,0.6998950682056663,0.0011992205066706642,0.29141058312097134,0.7085894168790287,0.055763753560185876
11156,,539,26194,26733,91,1780,35208,10202,25006,35208,2788,0.015309020677118836,0.743978641217905,0.002584639854578505,0.28976369007043856,0.7102363099295614,0.05055669166098614
11157,,156,11930,12086,153,1225,16765,4632,12133,16765,1223,0.009305099910527885,0.7116015508499851,0.009126155681479273,0.2762898896510588,0.7237101103489413,0.07306889352818371
11158,23.0,165,4195,4360,3,240,6039,1663,4376,6039,542,0.0273224043715847,0.6946514323563504,0.0004967709885742673,0.27537671799966884,0.7246232820003312,0.03974167908594138
11159,37.0,1367,32251,33618,155,1772,44261,12827,31434,44261,3211,0.03088497774564515,0.72865502360995,0.0035019543164411106,0.28980366462574275,0.7101963353742572,0.040035245475700955
11160,15.0,2688,82774,85462,2101,5001,115853,31937,83916,115853,9307,0.02320181609453359,0.7144743770122483,0.018135050451865725,0.2756683037987795,0.7243316962012205,0.043166771684807474
11161,,12512,262146,274658,3068,20256,364219,101883,262336,364219,21994,0.03435295797308762,0.7197482833130616,0.00842350344161068,0.2797300525233445,0.7202699474766555,0.05561489104082983
11162,25.0,143,4489,4632,2,148,6128,1765,4363,6128,515,0.0233355091383812,0.7325391644908616,0.00032637075718015666,0.28802219321148825,0.7119778067885117,0.024151436031331592
11163,36.0,700,16405,17105,172,782,24586,6475,18111,24586,1646,0.028471487838607337,0.6672496542747905,0.006995851297486374,0.2633612625071179,0.7366387374928821,0.031806719271129914
11164,,3330,86576,89906,181,3263,119878,34512,85366,119878,10581,0.027778241211898765,0.7222009042526568,0.0015098683661722752,0.2878926909024175,0.7121073090975826,0.02721933966198969
11165,15.0,131,4130,4261,0,98,5441,1662,3779,5441,454,0.024076456533725418,0.7590516449182135,0.0,0.30545855541260797,0.694541444587392,0.018011394964161
11166,14.0,63,14624,14687,112,1158,20385,5488,14897,20385,1061,0.0030905077262693157,0.7173902379200392,0.005494235957812117,0.2692175619327937,0.7307824380672063,0.056806475349521705
11167,,288,8231,8519,24,502,11092,3199,7893,11092,756,0.02596465921384782,0.742066354129102,0.002163721601153985,0.2884060584204832,0.7115939415795167,0.04525784349080418
11168,,156,4658,4814,37,240,6294,1784,4510,6294,481,0.02478551000953289,0.7400699078487448,0.005878614553543057,0.2834445503654274,0.7165554496345726,0.03813155386081983
11169,26.0,3995,686808,690804,5447,39358,926369,263738,662631,926369,72600,0.004312536365098573,0.7413978662930215,0.0058799463280830855,0.28470080497080535,0.7152991950291946,0.04248630945120141
11170,,495,39357,39852,65,2553,53578,14864,38714,53578,5439,0.009238866699018253,0.734573892269215,0.0012131845160327,0.2774273022509239,0.7225726977490761,0.04765015491433051
11171,17.0,84,3873,3957,14,241,5306,1518,3788,5306,442,0.0158311345646438,0.7299283829626838,0.002638522427440633,0.2860912174896344,0.7139087825103656,0.04542027892951376
11172,,446,12282,12728,43,763,17159,4766,12393,17159,1177,0.025992190687102977,0.7157759776210735,0.0025059735415816774,0.27775511393437846,0.7222448860656215,0.04446646074946092
11173,,317,5335,5652,26,273,7669,2176,5493,7669,683,0.04133524579475812,0.6956578432650933,0.0033902725257530316,0.28373973138609987,0.7162602686139001,0.03559786152040683
11174,25.0,329,8602,8931,23,337,11778,3459,8319,11778,918,0.02793343521820343,0.7303447104771608,0.0019527933435218203,0.293683138053999,0.7063168619460011,0.028612667685515368
11175,,1073,22034,23107,414,1251,31762,8853,22909,31762,2281,0.033782507398778416,0.6937220578049241,0.01303444367483156,0.27872929916252126,0.7212707008374788,0.03938668849568667
11176,17.0,132,2523,2655,19,217,3729,1011,2718,3729,216,0.035398230088495575,0.6765888978278359,0.005095199785465273,0.2711182622687047,0.7288817377312953,0.05819254491820863
11177,26.0,153,5111,5264,19,229,6917,2015,4902,6917,538,0.022119415931762323,0.738904149197629,0.0027468555732253867,0.29131126210785024,0.7086887378921498,0.03310683822466387
11178,,792,15171,15963,64,840,21650,6142,15508,21650,1487,0.03658198614318707,0.7007390300230947,0.002956120092378753,0.2836951501154734,0.7163048498845266,0.03879907621247113
11179,14.0,136,2944,3080,9,208,4182,1183,2999,4182,307,0.032520325203252036,0.7039693926351028,0.002152080344332855,0.28287900526064086,0.7171209947393592,0.04973696795791487
11180,34.0,397,6664,7061,7,389,9594,2686,6908,9594,633,0.041380029184907234,0.6946007921617677,0.000729622680842193,0.27996664582030434,0.7200333541796956,0.04054617469251615
11181,,189,3316,3505,36,129,4678,1347,3331,4678,356,0.0404018811457888,0.70884993587003,0.007695596408721676,0.28794356562633605,0.712056434373664,0.027575887131252672
11182,,1265,32059,33324,203,2018,44539,12600,31939,44539,3491,0.02840207458631761,0.719796133725499,0.004557803273535553,0.28289813421944815,0.7171018657805519,0.04530860594086082
11183,34.0,1229,18551,19780,113,1525,26935,7423,19512,26935,1874,0.04562836458139967,0.6887321329125673,0.004195284945238537,0.27558938184518283,0.7244106181548171,0.05661778355299796
11184,,139,6319,6458,35,391,8504,2442,6062,8504,663,0.016345249294449672,0.7430620884289746,0.004115710253998118,0.2871589840075259,0.7128410159924742,0.045978363123236124
11185,,77,13629,13706,92,366,18267,5164,13103,18267,1643,0.004215251546504626,0.7460995237313188,0.005036404445174358,0.2826955712486998,0.7173044287513002,0.020036130727541467
11186,24.0,1742,45131,46873,286,2543,61952,17871,44081,61952,4451,0.028118543388429753,0.7284833419421488,0.004616477272727273,0.28846526342975204,0.7115347365702479,0.04104790805785124
11187,14.0,1576,32560,34136,92,1533,46438,13378,33060,46438,3084,0.03393772341616779,0.7011499203238727,0.001981136138507257,0.2880830354451096,0.7119169645548904,0.03301175761230027
11188,23.0,977,94749,95726,277,5784,129945,36612,93334,129946,12001,0.007518507687808782,0.7291413356317239,0.002131654687331661,0.28174780293352625,0.7182521970664738,0.04451079679251382
11189,,606,14616,15222,56,714,20056,5736,14320,20056,1387,0.030215396888711606,0.7287594734742721,0.002792181890706023,0.28599920223374553,0.7140007977662545,0.03560031910650179
11190,24.0,568,14009,14577,39,675,19013,5587,13426,19013,1392,0.029874296533950455,0.7368116551832956,0.0020512281070846263,0.29385157523799504,0.7061484247620049,0.03550202493031084
11191,17.0,155,2713,2868,12,173,3971,1092,2879,3971,296,0.039032989171493324,0.6832032233694284,0.0030219088390833542,0.27499370435658527,0.7250062956434148,0.04356585243011836
11192,16.0,261,9937,10198,65,412,13612,3812,9800,13612,991,0.01917425800764032,0.7300176315016162,0.004775198354393183,0.28004701733764326,0.7199529826623567,0.030267411107846018
11193,26.0,218,3937,4155,11,230,5680,1563,4117,5680,366,0.03838028169014084,0.6931338028169014,0.0019366197183098592,0.27517605633802816,0.7248239436619718,0.040492957746478875
11194,24.0,855,11942,12797,156,688,17487,4813,12674,17487,1133,0.048893463715903245,0.6829073025676217,0.008920912677989364,0.2752330302510436,0.7247669697489564,0.03934351232344027
11195,25.0,120,2647,3091,36,126,4017,1054,2963,4017,262,0.029873039581777446,0.6589494647747075,0.008961911874533234,0.2623848643266119,0.7376151356733881,0.03136669156086632
11196,25.0,314,7438,7752,13,356,10079,2966,7113,10079,759,0.031153884313920032,0.7379700367099911,0.0012898104970731224,0.294275225716837,0.705724774283163,0.03532096438138704
11197,23.0,65,1948,2013,18,101,2707,743,1964,2707,210,0.024011821204285185,0.7196158108607315,0.0066494274104174364,0.2744735869966753,0.7255264130033248,0.03731067602512006
11198,,10,3924,3934,9,265,5410,1498,3912,5410,520,0.0018484288354898336,0.7253234750462108,0.0016635859519408503,0.27689463955637705,0.723105360443623,0.048983364140480594
11199,,157,2286,2443,59,106,3313,949,2364,3313,224,0.04738907334741926,0.6900090552369453,0.01780863265922125,0.2864473287051011,0.7135526712948989,0.031995170540295804
11200,15.0,158,3927,4085,10,179,5378,1531,3847,5378,385,0.029378951283004835,0.7301970992934176,0.001859427296392711,0.28467831907772406,0.715321680922276,0.03328374860542953
11201,15.0,50,1853,1903,5,280,2702,565,2137,2702,179,0.018504811250925242,0.6857883049592894,0.001850481125092524,0.20910436713545522,0.7908956328645448,0.10362694300518134
11202,17.0,263,4514,4777,17,363,6596,1834,4762,6596,466,0.03987265009096422,0.6843541540327471,0.002577319587628866,0.27804730139478473,0.7219526986052153,0.05503335354760461
11203,,75,1708,1783,8,86,2403,684,1719,2403,211,0.031210986267166042,0.7107781939242613,0.0033291718684977114,0.2846441947565543,0.7153558052434457,0.0357885975863504
11204,23.0,275,9833,10108,20,444,13157,4092,9065,13157,1134,0.02090142129664817,0.7473588203997872,0.0015201033670289579,0.3110131488941248,0.6889868511058752,0.03374629474804287
11205,16.0,253,54578,54831,261,1973,72937,20639,52298,72937,6918,0.0034687470008363383,0.7482896198088762,0.003578430700467527,0.28297023458601256,0.7170297654139874,0.027050742421541877
11206,24.0,879,20860,21739,80,1380,29308,7891,21417,29308,1985,0.02999181110959465,0.7117510577316774,0.0027296301351166915,0.2692438924525727,0.7307561075474274,0.04708611983076293
11207,23.0,1329,63794,65123,240,3067,85374,24402,60972,85374,6576,0.015566800196781222,0.7472298357813855,0.0028111603064164734,0.28582472415489496,0.7141752758451051,0.035924286082413846
11208,,3225,96637,99862,211,3892,130534,38210,92324,130534,10217,0.024706206812018325,0.7403205295172139,0.0016164370968483307,0.2927206704766574,0.7072793295233426,0.029815986639496223
11209,,505,3640,4145,17,357,5825,1552,4273,5825,376,0.08669527896995709,0.6248927038626609,0.0029184549356223175,0.2664377682403433,0.7335622317596566,0.06128755364806867
11210,,420,10276,10696,72,615,14867,4067,10800,14867,1181,0.028250487657227416,0.6911952646801641,0.0048429407412389856,0.27355888881415213,0.7264411111858479,0.041366785498083
11211,,309,4876,5185,5,333,6943,1965,4978,6943,532,0.04450525709347544,0.7022900763358778,0.0007201497911565605,0.2830188679245283,0.7169811320754716,0.04796197609102693
11212,16.0,329,7249,7578,26,290,9639,2861,6778,9639,609,0.03413217138707335,0.7520489677352422,0.0026973752463948543,0.2968150223052184,0.7031849776947816,0.030086108517481065
11213,,220,5155,5375,36,162,6823,2032,4791,6823,441,0.03224388099076653,0.7555327568518247,0.005276271434852704,0.2978162098783526,0.7021837901216473,0.023743221456837167
11214,23.0,44,3077,3121,8,161,4561,1147,3414,4561,321,0.009647007235255427,0.674632755974567,0.0017540013155009867,0.25147993860995393,0.748520061390046,0.03529927647445735
11215,17.0,61,1999,2060,15,166,3234,797,2437,3234,185,0.01886209029066172,0.6181199752628324,0.00463821892393321,0.24644403215831787,0.7535559678416821,0.051329622758194186
11216,34.0,976,18304,19280,100,1084,25743,7242,18501,25743,1724,0.03791321912752981,0.7110282406867886,0.0038845511401157597,0.2813191935671833,0.7186808064328167,0.04210853435885484
11217,23.0,603,15747,16350,102,1391,23641,6067,17574,23641,1530,0.02550653525654583,0.6660885749333785,0.0043145383021022795,0.2566304301848484,0.7433695698151517,0.058838458610041874
11218,14.0,346,3562,3908,33,206,5240,1510,3730,5240,448,0.06603053435114503,0.6797709923664123,0.006297709923664122,0.2881679389312977,0.7118320610687023,0.03931297709923664
11219,,109,1816,1925,4,110,2689,747,1942,2689,200,0.0405355150613611,0.6753439940498327,0.0014875418371141688,0.277798438081071,0.7222015619189289,0.040907400520639646
11220,15.0,210,2173,2383,25,224,3536,877,2659,3536,222,0.05938914027149321,0.6145361990950227,0.007070135746606335,0.24802036199095023,0.7519796380090498,0.06334841628959276
11221,25.0,103,3253,3356,9,199,4571,1222,3349,4571,352,0.022533362502734633,0.7116604681688908,0.001968934587617589,0.26733756289652155,0.7326624371034784,0.04353533143732225
11222,26.0,120,1848,2057,6,215,2915,779,2137,2916,149,0.0411522633744856,0.6337448559670782,0.00205761316872428,0.2671467764060357,0.7328532235939643,0.07373113854595337
11223,,295,4158,4453,13,432,6429,1639,4790,6429,381,0.04588582983356665,0.6467568828744751,0.0020220874163944624,0.2549385596515788,0.7450614403484213,0.06719552029864675
11224,37.0,137,7444,7581,29,259,9592,2923,6669,9592,674,0.014282735613010843,0.7760633861551293,0.003023352793994996,0.3047331109257715,0.6952668890742285,0.027001668056713928
11225,25.0,1690,35428,37118,71,2369,50399,13991,36408,50399,3364,0.0335324113573682,0.702950455366178,0.001408758110279966,0.27760471437925355,0.7223952856207464,0.04700490089089069
11226,26.0,432,8940,9372,39,516,13203,3519,9684,13203,978,0.032719836400818,0.6771188366280391,0.002953874119518291,0.2665303340149966,0.7334696659850034,0.03908202681208816
11227,42.0,57,1910,1967,0,102,2561,708,1853,2561,171,0.02225693088637251,0.7458024209293245,0.0,0.276454509957048,0.723545490042952,0.03982819211245607
11228,,1878,11772,13650,20,1336,19052,5349,13703,19052,655,0.09857232836447617,0.6178878857862692,0.0010497585555322277,0.2807579256770943,0.7192420743229058,0.07012387150955281
11229,16.0,143,4170,4313,8,200,5677,1622,4055,5677,522,0.025189360577769947,0.7345428923727321,0.0014091949973577594,0.2857142857142857,0.7142857142857143,0.035229874933943986
11230,16.0,337,9270,9607,22,398,12646,3642,9004,12646,1030,0.02664874268543413,0.7330381148189151,0.001739680531393326,0.2879962043333861,0.712003795666614,0.03147240234066108
11231,48.0,2628,102322,104950,140,2750,135650,40085,95565,135650,13249,0.01937338739402875,0.7543088831551787,0.0010320678215997052,0.29550313306302983,0.7044968669369701,0.020272760781422778
11232,,91,2601,2692,39,125,3556,1034,2522,3556,289,0.025590551181102362,0.7314398200224972,0.010967379077615299,0.2907761529808774,0.7092238470191226,0.03515185601799775
11233,24.0,64,5505,5569,1,279,7416,2095,5321,7416,627,0.008629989212513484,0.7423139158576052,0.00013484358144552318,0.28249730312837107,0.7175026968716289,0.03762135922330097
11234,,1427,29453,30880,216,1626,40601,11742,28859,40601,2776,0.03514691756360681,0.725425482130982,0.005320066008226399,0.2892046993916406,0.7107953006083594,0.04004827467303761
11235,,89,2716,2805,38,105,3875,1049,2826,3875,304,0.02296774193548387,0.7009032258064516,0.009806451612903225,0.27070967741935487,0.7292903225806452,0.027096774193548386
11236,36.0,2394,77112,79506,134,3854,104229,30367,73862,104229,7507,0.02296865555651498,0.7398324842414299,0.0012856306786019247,0.29134885684406453,0.7086511431559355,0.03697627339799864
11237,14.0,128,2831,2959,8,145,3894,1137,2757,3894,307,0.03287108371854135,0.7270159219311761,0.002054442732408834,0.29198767334360554,0.7080123266563945,0.037236774524910116
11238,,178,4826,5004,32,323,6672,1880,4792,6672,489,0.026678657074340528,0.7233213429256595,0.004796163069544364,0.28177458033573144,0.7182254196642686,0.04841127098321343
11239,23.0,628,17504,18132,87,844,23249,6896,16353,23249,1542,0.027011914490945848,0.7528925975310766,0.0037420964342552367,0.29661490816809327,0.7033850918319068,0.036302636672545054
11240,36.0,789,19210,19999,125,837,26378,7627,18751,26378,1980,0.029911289711122904,0.7282583971491394,0.004738797482750777,0.2891424672075214,0.7108575327924785,0.0317309879444992
11241,,1173,24703,25876,40,3553,36694,9889,26805,36694,2838,0.03196707908649916,0.6732163296451736,0.0010900964735379081,0.26949910067040933,0.7305008993295906,0.09682781926200469
11242,16.0,462,5741,6203,272,684,8729,2404,6325,8729,469,0.05292702485966319,0.6576927483102303,0.03116049948447703,0.27540382632603966,0.7245961736739603,0.07835949135067018
11243,14.0,215,3191,3406,3,378,4975,1298,3677,4975,293,0.04321608040201005,0.6414070351758794,0.0006030150753768845,0.26090452261306535,0.7390954773869347,0.07597989949748744
11244,26.0,927,7457,8384,243,339,11021,3142,7879,11021,541,0.08411214953271028,0.6766173668451139,0.022048815896924055,0.2850920969059069,0.7149079030940931,0.030759459214227385
11245,,261,6492,6753,19,651,10047,2610,7437,10047,488,0.02597790385189609,0.6461630337414154,0.0018911117746591023,0.2597790385189609,0.7402209614810391,0.06479546133174081
11246,36.0,74,1921,1995,4,63,2565,770,1795,2565,193,0.02884990253411306,0.7489278752436647,0.0015594541910331384,0.3001949317738791,0.6998050682261209,0.02456140350877193
11247,38.0,9980,215384,225364,837,11626,302860,85454,217408,302862,24068,0.032952301708368825,0.7111621794744801,0.002763634922836143,0.28215490883636773,0.7178450911636323,0.03838712020656272
11248,27.0,54,2439,2493,8,80,3244,942,2302,3244,234,0.016646115906288533,0.7518495684340321,0.002466091245376079,0.2903822441430333,0.7096177558569667,0.02466091245376079
11249,34.0,272,7207,7479,4,485,9923,2736,7187,9923,705,0.02741106520205583,0.7262924518794719,0.0004031039000302328,0.2757230676206792,0.7242769323793208,0.048876347878665724
11250,47.0,26135,658775,684910,5437,18837,868704,264856,603903,868759,58183,0.030083141584720273,0.758294302562621,0.006258352431456825,0.30486705749235404,0.695132942507646,0.021682653071795514
11251,,246,6123,6369,19,481,8744,2414,6330,8744,693,0.028133577310155537,0.7002516010978957,0.00217291857273559,0.2760750228728271,0.723924977127173,0.055009149130832574
11252,,834,15976,16810,242,919,22369,6363,16006,22369,1501,0.037283740891412225,0.7142026912244624,0.010818543520050069,0.28445616701685367,0.7155438329831463,0.04108364254101658
11253,,515,11127,11743,3,606,16068,4488,11588,16076,1234,0.032035332172182136,0.6921497885046032,0.00018661358546902214,0.2791739238616571,0.7208260761383428,0.03769594426474247
11254,16.0,8,8846,8854,24,596,11910,3366,8544,11910,937,0.0006717044500419815,0.742737195633921,0.0020151133501259445,0.2826196473551637,0.7173803526448362,0.050041981528127624
11255,39.0,163,4401,4564,26,196,6075,1738,4337,6075,449,0.02683127572016461,0.7244444444444444,0.004279835390946502,0.2860905349794239,0.7139094650205762,0.032263374485596706
11256,,357,4931,5288,25,447,7594,2004,5590,7594,454,0.047010797998419805,0.6493284171714512,0.0032920726889649724,0.2638925467474322,0.7361074532525678,0.058862259678693706
11257,,673,12876,13549,4,794,18049,5162,12887,18049,1251,0.03728738434262286,0.7133913236190371,0.0002216189262563023,0.28599922433375813,0.7140007756662419,0.043991356861876
11258,,5459,108162,113621,563,5648,149719,43554,106165,149719,10125,0.03646163813544039,0.7224333584915742,0.0037603777743639754,0.2909049619620756,0.7090950380379244,0.037724002965555475
11259,,558,12637,13195,38,848,17870,5117,12753,17870,1355,0.03122551762730834,0.7071628427532177,0.0021264689423615,0.2863458310016788,0.7136541689983212,0.047453833240067154
11260,14.0,434,3077,3511,1,193,4862,1413,3449,4862,365,0.08926367749897161,0.6328671328671329,0.00020567667626491157,0.29062114356232005,0.70937885643768,0.039695598519127934
11261,26.0,208,4693,4901,37,200,6562,1906,4656,6562,461,0.03169765315452606,0.7151782992989942,0.005638524839987808,0.2904602255409936,0.7095397744590064,0.03047851264858275
11262,16.0,191,5282,5473,33,369,7477,2129,5348,7477,402,0.0255450046810218,0.7064330613882573,0.004413534840176541,0.2847398689313896,0.7152601310686104,0.049351344121974054
11263,,165,5031,5196,9,106,6877,2007,4870,6877,650,0.023993020212301874,0.7315689981096408,0.0013087101933982842,0.29184237312781736,0.7081576268721826,0.01541369783335757
11264,26.0,5233,115900,121133,373,7017,162785,44950,117835,162785,12451,0.03214669656295113,0.7119820622293209,0.0022913659120926376,0.27613109315968914,0.7238689068403108,0.04310593727923334
11265,23.0,8670,227291,235961,668,12407,317491,90084,227407,317491,23230,0.0273078606952638,0.7158974585106349,0.002103996648723901,0.2837371768018621,0.7162628231981379,0.03907827308490634
11266,16.0,387,18298,18685,104,575,24871,7163,17708,24871,2151,0.015560291102086768,0.7357162960878131,0.004181576936994893,0.2880061115355233,0.7119938884644768,0.023119295565115997
11267,15.0,623,12940,13563,36,1014,18310,5059,13251,18310,1247,0.03402512288367013,0.7067176406335336,0.0019661387220098305,0.27629710540688146,0.7237028945931185,0.0553795740032769
11268,,453,6454,6907,864,1016,13751,2753,10998,13751,168,0.03294305868664097,0.4693476838048142,0.06283179405134172,0.200203621554796,0.799796378445204,0.0738855355974111
11269,,721,16687,17408,57,894,23636,6707,16929,23636,1784,0.030504315451006937,0.7059993230665087,0.002411575562700965,0.2837620578778135,0.7162379421221865,0.03782365882552039
11270,14.0,345,1406,1751,23,702,2986,653,2333,2986,72,0.11553918285331548,0.4708640321500335,0.007702612190221032,0.2186872069658406,0.7813127930341595,0.23509711989283322
11271,,178,2906,3084,79,203,4624,1049,3575,4624,263,0.038494809688581315,0.6284602076124568,0.017084775086505192,0.2268598615916955,0.7731401384083045,0.04390138408304498
11272,17.0,177,7071,7248,51,530,9800,2715,7085,9800,720,0.01806122448979592,0.721530612244898,0.005204081632653061,0.2770408163265306,0.7229591836734693,0.05408163265306123
11273,17.0,604,14145,14749,32,1015,20184,5665,14519,20184,1539,0.02992469282600079,0.7008026159334126,0.0015854141894569957,0.28066785572730873,0.7193321442726912,0.05028735632183908
11274,14.0,1153,17545,18698,239,1101,25102,7118,17984,25102,1639,0.045932595012349614,0.6989482909728308,0.009521153692932834,0.283563062704167,0.716436937295833,0.04386104692853159
11275,24.0,212,7043,7255,16,299,9420,2786,6634,9420,659,0.022505307855626325,0.7476645435244161,0.0016985138004246285,0.2957537154989384,0.7042462845010615,0.031740976645435244
11276,38.0,163,3593,3756,47,255,4982,1356,3626,4982,325,0.032717784022480934,0.7211963067041349,0.009433962264150943,0.27217984745082296,0.7278201525491771,0.05118426334805299
11277,,97,2204,2301,9,123,3131,873,2258,3131,236,0.030980517406579366,0.7039284573618653,0.0028744809964867456,0.2788246566592143,0.7211753433407857,0.03928457361865219
11278,,396,6650,7046,44,761,9710,2660,7050,9710,609,0.0407826982492276,0.6848609680741503,0.004531410916580845,0.27394438722966014,0.7260556127703398,0.07837281153450051
11279,27.0,203,3109,3312,12,138,4486,1239,3247,4486,312,0.045251894783771736,0.693045028979046,0.0026749888542131075,0.27619259919750333,0.7238074008024966,0.030762371823450735
11280,15.0,4666,72043,76709,666,5638,109713,29071,80642,109713,6535,0.042529144221742185,0.6566496221960935,0.00607038363730825,0.2649731572375197,0.7350268427624803,0.05138862304375963
11281,26.0,1109,21748,22857,129,1237,32239,8665,23574,32239,2050,0.034399330004032384,0.6745866807283104,0.004001364806600701,0.26877384534259746,0.7312261546574025,0.03836967647879897
11282,34.0,4086,88408,92494,457,3665,123356,35049,88307,123356,8524,0.033123642141444275,0.7166899056389636,0.0037047245371120982,0.28412886280359284,0.7158711371964072,0.02971075586108499
11283,25.0,505,10726,11231,49,714,15297,4307,10990,15297,1149,0.033013009086749034,0.7011832385435053,0.0032032424658429755,0.28155847551807545,0.7184415244819246,0.04667581878799765
11284,35.0,2077,44888,46965,253,2417,61439,17812,43627,61439,4443,0.03380588876772083,0.7306108497859666,0.00411790556486922,0.2899135728120575,0.7100864271879425,0.039339833005094485
11285,41.0,3416,45235,48651,306,2093,63902,18853,45049,63902,4627,0.053456855810459766,0.7078808175017997,0.004788582516979124,0.29502988951832493,0.704970110481675,0.03275327845763826
11286,33.0,4336,111713,116049,298,3277,149727,44401,105326,149727,10449,0.028959372725026213,0.7461112558189238,0.0019902889926332592,0.2965463810802327,0.7034536189197673,0.021886500096842922
11287,23.0,686,18128,18814,152,743,24368,7256,17142,24398,1877,0.028117058775309452,0.7430117222723174,0.0062300188540044266,0.29740142634642186,0.7025985736535781,0.030453315845561112
11288,16.0,189,2201,2390,12,131,3153,912,2241,3153,213,0.05994291151284491,0.6980653346019664,0.003805899143672693,0.28924833491912466,0.7107516650808754,0.04154773231842689
11289,,580,13126,13706,13,480,17806,5232,12574,17806,1417,0.03257328990228013,0.7371672469953948,0.0007300909805683477,0.2938335392564304,0.7061664607435696,0.026957205436369765
11290,26.0,2624,72522,75146,474,2075,96610,28891,67719,96610,7492,0.027160749404823516,0.7506676327502328,0.004906324397060346,0.29904771762757476,0.7009522823724252,0.021478107856329573
11291,14.0,53,4441,4494,28,399,6402,1678,4724,6402,449,0.008278662917838176,0.6936894720399875,0.0043736332396126214,0.2621055920024992,0.7378944079975008,0.06232427366447985
11292,,492,9560,10052,56,502,13444,3812,9632,13444,1075,0.036596251115739366,0.7110978875334721,0.0041654269562630165,0.2835465635227611,0.7164534364772389,0.037340077357929186
11293,23.0,801,32260,33061,85,1472,42944,12492,30452,42944,3251,0.018652198211624442,0.7512108792846498,0.0019793219076005963,0.2908904619970194,0.7091095380029806,0.03427719821162444
11294,,1036,13096,14132,118,874,19518,5344,14174,19518,1255,0.05307920893534174,0.6709703863100728,0.00604570140383236,0.27379854493288247,0.7262014550671175,0.04477917819448714
11295,26.0,660,18821,19481,112,621,25936,7488,18448,25936,1813,0.025447254780999382,0.7256708821714991,0.00431832202344232,0.2887106724244294,0.7112893275755706,0.023943553362122148
11296,17.0,81,10684,10765,4,522,14236,4077,10159,14236,1369,0.005689800505760045,0.7504917111548187,0.0002809778027535825,0.28638662545658894,0.7136133745434111,0.03666760325934251
11297,,5302,73114,78416,295,3460,109750,29385,80365,109750,6225,0.04830979498861048,0.6661867881548975,0.0026879271070615034,0.267744874715262,0.732255125284738,0.03152619589977221
11298,24.0,3577,107390,110967,2560,7466,149970,43393,106577,149970,7182,0.02385143695405748,0.7160765486430619,0.01707008068280323,0.2893445355737814,0.7106554644262186,0.0497832899913316
11299,,143,2952,3095,293,248,4833,1148,3685,4833,215,0.029588247465342436,0.6108007448789572,0.0606248706807366,0.23753362300848335,0.7624663769915166,0.05131388371611835
11300,,412,9786,10198,143,364,13497,3891,9606,13497,961,0.03052530191894495,0.7250500111135808,0.010594947025264874,0.28828628584129806,0.7117137141587019,0.026968956064310587
11301,43.0,138,4167,4305,2,118,5632,1656,3976,5632,350,0.024502840909090908,0.7398792613636364,0.0003551136363636364,0.2940340909090909,0.7059659090909091,0.020951704545454544
11302,33.0,2385,60200,62585,263,3149,86334,23413,62939,86352,6166,0.027619510839355196,0.6971465629053177,0.003045673522327219,0.2711344265332592,0.7288655734667407,0.03646701871410043
11303,37.0,594,24896,25490,13,896,32907,9757,23150,32907,2632,0.018050870635427114,0.7565563557905612,0.0003950527243443644,0.2965022639559972,0.7034977360440028,0.02722824930865773
11304,,119,2840,2959,2,222,4060,1213,2847,4060,174,0.029310344827586206,0.6995073891625616,0.0004926108374384236,0.29876847290640396,0.701231527093596,0.054679802955665026
11305,17.0,100,3585,3685,2,198,4817,1451,3366,4817,339,0.02075980900975711,0.7442391529997924,0.00041519618019514223,0.3012248287315757,0.6987751712684244,0.04110442183931908
11306,13.0,525,10422,10947,67,779,15137,4097,11040,15137,1028,0.034683226531016714,0.6885115941071547,0.0044262403382440375,0.2706612935191914,0.7293387064808086,0.051463301843165755
11307,17.0,1833,89327,91160,355,5888,123228,34390,88838,123228,9459,0.014874866101859967,0.7248920699840945,0.0028808387704093224,0.27907618398415945,0.7209238160158405,0.047781348394845324
11308,15.0,91,2624,2715,5,136,3708,1017,2691,3708,299,0.02454153182308522,0.7076591154261057,0.001348435814455232,0.27427184466019416,0.7257281553398058,0.036677454153182305
11309,,343,31334,31677,122,2995,43498,12111,31387,43498,2810,0.007885420019311232,0.7203549588486827,0.002804726654099039,0.2784265943261759,0.7215734056738241,0.06885374040185756
11310,23.0,2540,45897,48437,448,2543,66014,18639,47375,66014,4622,0.03847668676341382,0.6952616111733875,0.006786439240161178,0.28234919865483077,0.7176508013451692,0.0385221316690399
11311,15.0,192,2686,2878,10,120,3787,1069,2718,3787,294,0.05069976234486401,0.7092685503036704,0.0026406126221283337,0.2822814893055189,0.7177185106944811,0.031687351465540005
11312,15.0,431,9523,9954,59,486,13381,3727,9654,13381,920,0.032209849787011434,0.711680741349675,0.004409236977804349,0.27852925790299676,0.7214707420970032,0.03632015544428668
11313,25.0,188,5638,5826,6,436,8063,2184,5879,8063,659,0.02331638348009426,0.6992434577700608,0.0007441398983008806,0.27086692298152054,0.7291330770184795,0.05407416594319732
11314,15.0,4004,175351,179355,3046,9677,250814,68143,182671,250814,19510,0.015964021147144895,0.6991276404028484,0.012144457645904933,0.27168738587160207,0.728312614128398,0.038582375784445844
11315,27.0,436,13306,13742,15,497,17989,5195,12794,17989,1337,0.024237033742842848,0.7396742453721719,0.000833842903996887,0.2887875924175885,0.7112124075824114,0.02762799488576352
11316,33.0,3136,60823,63959,130,4389,89349,23944,65405,89349,6222,0.03509832230914728,0.680735094964689,0.0014549687181725592,0.2679828537532597,0.7320171462467403,0.04912198233891817
11317,,526,8191,8717,66,689,11920,3299,8621,11920,709,0.04412751677852349,0.6871644295302013,0.0055369127516778525,0.27676174496644296,0.7232382550335571,0.05780201342281879
11318,23.0,229,3531,3760,100,226,5174,1456,3718,5174,272,0.04425976034016235,0.6824507151140317,0.019327406262079627,0.2814070351758794,0.7185929648241206,0.04367993815229996
11319,,93,3160,3253,2,66,4226,1237,2989,4226,347,0.022006625650733556,0.7477520113582584,0.000473260766682442,0.2927117841930904,0.7072882158069096,0.015617605300520587
11320,,63,2666,2729,2,99,3536,1056,2480,3536,263,0.017816742081447963,0.7539592760180995,0.0005656108597285068,0.2986425339366516,0.7013574660633484,0.027997737556561087
11321,,997,20866,21863,120,928,29198,8220,20978,29198,2287,0.03414617439550654,0.7146379889033495,0.004109870539078019,0.2815261319268443,0.7184738680731557,0.03178299883553668
11322,16.0,1313,24744,26057,76,1926,37106,9999,27107,37106,2575,0.03538511291974344,0.6668463321295748,0.002048186277151943,0.2694712445426616,0.7305287554573384,0.05190535223414003
11323,24.0,303,12647,12950,20,591,16806,4934,11872,16806,1374,0.01802927525883613,0.7525288587409259,0.0011900511722004047,0.2935856241818398,0.7064143758181601,0.035166012138521954
11324,,396,25149,25545,43,2043,34682,9890,24792,34682,2794,0.011418026642062165,0.7251311919727813,0.001239836226284528,0.28516233204544145,0.7148376679545586,0.058906637448820715
11325,15.0,437,8510,8947,45,425,11802,3375,8427,11802,888,0.03702762243687511,0.7210642264023047,0.0038129130655821047,0.28596847991865787,0.7140315200813422,0.03601084561938654
11326,,355,9439,9794,42,380,12991,3655,9336,12991,797,0.027326610730505733,0.7265799399584327,0.0032330074667077206,0.28134862597182664,0.7186513740281734,0.02925101993687938
11327,23.0,3176,74058,77234,273,3119,103935,29299,74636,103935,8733,0.03055756001346996,0.7125414922788281,0.002626641651031895,0.281897339683456,0.718102660316544,0.03000914032808967
11328,34.0,127,3327,3454,3,199,4518,1305,3213,4518,334,0.028109783089862773,0.7363877822045153,0.0006640106241699867,0.28884462151394424,0.7111553784860558,0.04404603806994245
11329,,116,3987,4103,10,149,5190,1572,3618,5190,343,0.022350674373795763,0.7682080924855491,0.0019267822736030828,0.30289017341040464,0.6971098265895954,0.028709055876685933
11330,,70,1757,1827,3,94,2498,691,1807,2498,183,0.02802241793434748,0.7033626901521217,0.0012009607686148918,0.2766212970376301,0.72337870296237,0.03763010408326661
11331,,3658,63649,67307,204,3692,91040,25485,65555,91040,6030,0.04018014059753954,0.6991322495606327,0.0022407732864674866,0.2799318980667838,0.7200681019332161,0.04055360281195079
11332,,317,5288,5605,27,266,7511,2138,5373,7511,517,0.042204766342697375,0.7040340833444282,0.0035947277326587672,0.2846491812009053,0.7153508187990947,0.035414725069897485
11333,17.0,2665,95186,97851,219,9437,133852,37017,96835,133852,10640,0.01991004990586618,0.7111287093207423,0.0016361354331649882,0.2765517138331889,0.7234482861668111,0.07050324238711413
11334,39.0,86,3082,3168,10,94,4166,1217,2949,4166,355,0.020643302928468554,0.7397983677388382,0.002400384061449832,0.29212674027844454,0.7078732597215555,0.02256361017762842
11335,,118,4957,5075,14,285,6797,1902,4895,6797,518,0.017360600264822716,0.7292923348536119,0.0020597322348094747,0.27982933647197294,0.720170663528027,0.04193026335147859
11336,26.0,33,3365,3398,12,414,4703,1325,3378,4703,142,0.0070167977886455455,0.7155007442058261,0.0025515628322347436,0.28173506272591964,0.7182649372740804,0.08802891771209866
11337,24.0,188,7548,7736,28,359,10123,2933,7190,10123,795,0.01857156969277882,0.7456287661760348,0.002765978464881952,0.2897362441963845,0.7102637558036156,0.0354637953175936
11338,14.0,291,4491,4782,20,303,6603,1809,4794,6603,509,0.04407087687414812,0.680145388459791,0.0030289262456459185,0.2739663789186733,0.7260336210813266,0.045888232621535664
11339,,5855,112325,118180,515,6320,156979,44653,112326,156979,10169,0.03729798253269546,0.7155415692544863,0.003280693595958695,0.28445206046668664,0.7155479395333134,0.040260162187298935
11340,24.0,346,11726,12072,52,602,15830,4463,11367,15830,998,0.021857233101705623,0.7407454200884397,0.0032849020846494,0.2819330385344283,0.7180669614655717,0.03802905874921036
11341,,204,3673,3877,6,379,5246,1403,3843,5246,350,0.03888677087304613,0.7001524971406786,0.001143728555089592,0.26744186046511625,0.7325581395348837,0.07224552039649257
11342,,102,2732,2834,4,186,3818,1093,2725,3818,275,0.02671555788370875,0.7155578837087481,0.0010476689366160294,0.28627553693033003,0.71372446306967,0.04871660555264536
11343,,1965,51046,53011,193,2969,69994,20111,49883,69994,5361,0.028073834900134296,0.7292910820927508,0.0027573792039317655,0.28732462782524215,0.7126753721747578,0.04241792153613167
11344,24.0,1134,21874,23008,129,805,30234,8662,21572,30234,1804,0.03750744195276841,0.7234901104716545,0.0042667195872196865,0.28649864391082885,0.7135013560891711,0.02662565323807634
11345,37.0,18431,222542,240973,6684,14543,337019,90281,246738,337019,16575,0.05468831134149707,0.6603247888101265,0.019832709728531624,0.26788103934792995,0.73211896065207,0.04315186977588801
11346,14.0,179,4297,4476,10,178,5744,1665,4079,5744,383,0.031162952646239556,0.7480849582172702,0.0017409470752089136,0.28986768802228413,0.7101323119777159,0.030988857938718663
11347,,127,29033,29160,216,1597,38254,10998,27256,38254,2676,0.0033199142573325665,0.7589533120719402,0.005646468343179798,0.2874993464735714,0.7125006535264287,0.04174726825952842
11348,45.0,2726,78745,81471,185,2999,105816,30693,75123,105816,8070,0.025761699553942693,0.744169123762002,0.0017483178347319876,0.2900601043320481,0.7099398956679519,0.028341649656006652
11349,,57,1356,1413,0,69,1929,540,1389,1929,159,0.029548989113530325,0.702954898911353,0.0,0.27993779160186627,0.7200622083981337,0.03576982892690513
11350,16.0,11,5739,5750,2,369,7560,2209,5351,7560,630,0.001455026455026455,0.7591269841269841,0.00026455026455026457,0.2921957671957672,0.7078042328042328,0.04880952380952381
11351,15.0,13,4468,4481,12,143,5892,1655,4237,5892,538,0.0022063815342837747,0.758316361167685,0.002036659877800407,0.28088934147997285,0.7191106585200272,0.024270196877121522
11352,14.0,61,4372,4433,32,267,6041,1653,4388,6041,487,0.010097665949346135,0.7237212382055951,0.005297136235722562,0.2736301936765436,0.7263698063234564,0.04419798046681013
11353,23.0,384,7473,7857,31,368,10475,2928,7547,10475,733,0.03665871121718377,0.7134128878281623,0.0029594272076372313,0.27952267303102624,0.7204773269689737,0.03513126491646778
11354,15.0,121,2058,2179,43,145,2981,809,2172,2981,223,0.04059040590405904,0.6903723582690372,0.01442468970144247,0.2713854411271385,0.7286145588728614,0.04864139550486414
11355,25.0,716,19456,20172,97,745,26221,7554,18667,26221,1947,0.02730635749971397,0.7420006864726746,0.003699324968536669,0.2880896990961443,0.7119103009038557,0.028412341253194005
11356,,79,5758,5837,2,224,7395,2168,5227,7395,588,0.01068289384719405,0.7786342123056119,0.0002704530087897228,0.2931710615280595,0.7068289384719405,0.03029073698444895
11357,16.0,265,2681,2946,46,330,4165,1043,3122,4165,145,0.06362545018007203,0.6436974789915967,0.011044417767106842,0.2504201680672269,0.7495798319327731,0.07923169267707082
11358,,322,7842,8164,111,392,11022,3142,7880,11022,790,0.029214298675376518,0.7114861186717474,0.010070767555797496,0.2850662311740156,0.7149337688259844,0.03556523317002359
11359,15.0,208,4652,4860,50,450,6926,1880,5046,6926,460,0.03003176436615651,0.6716719607276928,0.007219174126479931,0.2714409471556454,0.7285590528443546,0.06497256713831938
11360,24.0,2335,185412,187747,680,12450,258411,71491,186920,258411,20081,0.00903599304983147,0.7175081556125706,0.002631466926717516,0.27665617949700283,0.7233438205029972,0.04817906358475452
11361,25.0,123,3228,3351,23,135,4410,1283,3127,4410,336,0.027891156462585033,0.7319727891156462,0.005215419501133787,0.2909297052154195,0.7090702947845805,0.030612244897959183
11362,,643,14849,15492,42,1109,20966,5704,15262,20966,1417,0.03066870170752647,0.7082419154822093,0.002003243346370314,0.2720595249451493,0.7279404750548507,0.05289516359820662
11363,14.0,386,12971,13357,10,490,17397,5091,12306,17397,1554,0.022187733517273094,0.7455883198252572,0.0005748117491521527,0.29263666149336093,0.7073633385066391,0.028165775708455482
11364,,115,2541,2656,17,98,3429,1013,2416,3429,209,0.033537474482356375,0.7410323709536308,0.004957713619130942,0.29542140565762615,0.7045785943423739,0.02857976086322543
11365,16.0,315,5507,5822,6,426,7672,2220,5452,7672,489,0.04105839416058394,0.7178050052137643,0.0007820646506777894,0.28936392075078204,0.7106360792492179,0.055526590198123046
11366,,55,1492,1547,4,49,2093,580,1513,2093,197,0.026278069756330624,0.712852365026278,0.0019111323459149545,0.2771141901576684,0.7228858098423315,0.023411371237458192
11367,23.0,211,6287,6498,17,222,8374,2497,5877,8374,606,0.025197038452352518,0.7507762120850251,0.002030093145450203,0.2981848578934798,0.7018151421065202,0.02651062813470265
11368,40.0,113,2484,2597,5,133,3490,992,2498,3490,270,0.032378223495702005,0.7117478510028653,0.0014326647564469914,0.2842406876790831,0.7157593123209169,0.03810888252148997
11369,39.0,1350,31344,32694,480,1859,43763,12443,31320,43763,3214,0.03084797660123849,0.7162214656216439,0.01096816945821813,0.28432694285126703,0.715673057148733,0.0424788062975573
11370,24.0,108,1775,1883,5,81,2501,742,1759,2501,197,0.04318272690923631,0.7097161135545782,0.001999200319872051,0.2966813274690124,0.7033186725309876,0.032387045181927226
11371,25.0,2934,43530,46464,310,2525,61673,17633,44040,61673,4091,0.04757349245212654,0.7058194023316524,0.005026510790783649,0.2859111766899616,0.7140888233100384,0.04094174111847972
11372,,1588,72121,73709,123,8747,103329,28067,75262,103329,8813,0.015368386416204551,0.6979744311858239,0.0011903724994919143,0.27162751986373623,0.7283724801362638,0.0846519370167136
11373,15.0,292,5330,5622,18,466,8029,2214,5815,8029,547,0.036368165400423466,0.6638435670693735,0.0022418732096151452,0.27575040478266283,0.7242495952173371,0.0580396064267032
11374,24.0,139,5274,5413,37,610,7076,2225,4851,7076,271,0.019643866591294516,0.7453363482193329,0.005228942905596382,0.3144431882419446,0.6855568117580554,0.08620689655172414
11375,24.0,369,5683,6052,172,517,8894,2259,6635,8894,531,0.041488644029682935,0.6389700921969867,0.01933888014391725,0.2539914549134248,0.7460085450865752,0.05812907578142568
11376,25.0,98,2011,2109,30,100,2865,804,2061,2865,226,0.03420593368237347,0.7019197207678883,0.010471204188481676,0.2806282722513089,0.7193717277486911,0.034904013961605584
11377,26.0,272,4641,4913,15,247,6781,1857,4924,6781,501,0.04011207786462174,0.6844123285651084,0.0022120631175342868,0.27385341395074475,0.7261465860492553,0.03642530600206459
11378,,60,1873,1933,0,154,2619,737,1882,2619,176,0.022909507445589918,0.7151584574264986,0.0,0.28140511645666283,0.7185948835433371,0.05880106911034746
11379,38.0,153,2957,3110,28,138,4172,1176,2996,4172,273,0.03667305848513902,0.7087727708533078,0.006711409395973154,0.28187919463087246,0.7181208053691275,0.03307766059443912
11380,,635,11791,12426,74,931,16867,4630,12237,16867,1098,0.037647477322582557,0.6990573308827889,0.004387265073812771,0.27450050394260983,0.7254994960573902,0.05519653761783364
11381,,212,3114,3326,62,349,4883,1156,3727,4883,273,0.0434159328281794,0.6377227114478804,0.012697112430882654,0.2367397091951669,0.763260290804833,0.07147245545771043
11382,15.0,99,4170,4269,27,462,5866,1604,4262,5866,437,0.016876917831571768,0.7108762359359018,0.004602795772246846,0.27344016365496077,0.7265598363450392,0.07875894988066826
11383,,298,6016,6314,30,331,8471,2388,6084,8472,590,0.03517469310670444,0.7101038715769594,0.0035410764872521247,0.2818696883852691,0.7181303116147308,0.03906987724268177
11384,,738,15346,16084,52,1580,23387,5967,17420,23387,1431,0.03155599264548681,0.6561765083165861,0.0022234574763757642,0.25514174541411894,0.7448582545858811,0.06755890024372514
11385,,147,5425,5572,10,192,7244,2155,5089,7244,593,0.0202926559911651,0.7488956377691883,0.0013804527885146328,0.2974875759249034,0.7025124240750966,0.02650469353948095
11386,24.0,204,4528,4732,22,199,6426,1797,4629,6426,443,0.031746031746031744,0.7046374105197635,0.0034235916588857764,0.2796451914098973,0.7203548085901027,0.030967942732648614
11387,24.0,5221,61444,66665,267,5485,91203,25145,66058,91203,6197,0.057245923927940964,0.6737059087968598,0.002927535278444788,0.2757036500992292,0.7242963499007709,0.06014056555157177
11388,23.0,1321,31687,33008,84,1628,43250,12323,30927,43250,3334,0.03054335260115607,0.7326473988439306,0.0019421965317919076,0.28492485549132945,0.7150751445086705,0.03764161849710983
11389,,77,1529,1606,15,66,2162,599,1563,2162,157,0.035615171137835334,0.7072155411655874,0.006938020351526364,0.27705827937095284,0.7229417206290472,0.030527289546716005
11390,,214,3308,3522,56,363,5252,1295,3957,5252,315,0.040746382330540745,0.6298552932216298,0.010662604722010662,0.24657273419649658,0.7534272658035034,0.06911652703731912
11391,,1114,18610,19724,119,1635,27067,7299,19768,27067,1592,0.041157128606790556,0.6875531089518602,0.004396497580079063,0.26966416669745447,0.7303358333025456,0.06040566002881738
11392,33.0,193,4884,5077,23,204,6814,1932,4882,6814,565,0.028324038743762842,0.7167596125623716,0.0033754035808629293,0.2835339007924861,0.7164660992075139,0.029938362195479896
11393,,101,2513,2614,11,96,3441,1021,2420,3441,280,0.02935193257773903,0.7303109561174077,0.0031967451322290033,0.2967160709096193,0.7032839290903807,0.02789886660854403
11394,15.0,1298,21169,22467,41,1457,30050,8633,21417,30050,2068,0.04319467554076539,0.7044592346089851,0.0013643926788685524,0.287287853577371,0.7127121464226289,0.04848585690515807
11395,,276,7321,7597,27,267,9717,2869,6848,9717,627,0.02840382834208089,0.7534218380158485,0.002778635381290522,0.29525573736750027,0.7047442626324998,0.02747761654831738
11396,23.0,137,3183,3320,47,206,4584,1263,3321,4584,328,0.02988656195462478,0.694371727748691,0.01025305410122164,0.2755235602094241,0.724476439790576,0.04493891797556719
11397,25.0,1298,28314,29612,115,1562,39132,11175,27957,39132,2616,0.03316978431973832,0.7235510579576817,0.0029387713380353677,0.28557191045691505,0.7144280895430849,0.03991618113053256
11398,40.0,95,2704,2799,26,130,3777,1070,2707,3777,290,0.025152237225311094,0.7159120995499073,0.006883770187979878,0.28329361927455654,0.7167063807254435,0.03441885093989939
11399,17.0,389,7966,8355,54,512,11365,3118,8247,11365,766,0.034227892652881654,0.7009238891333041,0.00475142982842059,0.27435107787065555,0.7256489221293445,0.04505059392872855
11400,,831,14180,15011,177,713,19965,5669,14296,19965,1303,0.04162283996994741,0.7102429251189581,0.008865514650638617,0.28394690708740294,0.716053092912597,0.035712496869521666
11401,39.0,2079,59952,62031,171,2953,81046,23823,57223,81046,6125,0.0256520988080843,0.7397280556720874,0.0021099128889766304,0.2939441798484811,0.7060558201515189,0.036436098018409295
11402,15.0,1163,38118,39281,125,1378,50788,14773,36015,50788,3838,0.02289911002599039,0.7505316216429078,0.0024612113097582104,0.2908757974324644,0.7091242025675356,0.027132393478774514
11403,,857,31126,31983,9,1257,41179,12307,28872,41179,3375,0.020811578717307367,0.7558707107991938,0.00021855800286553825,0.29886592680735324,0.7011340731926468,0.03052526773355351
11404,43.0,3,4416,4419,1,240,5830,1650,4180,5830,466,0.0005145797598627787,0.7574614065180103,0.00017152658662092623,0.2830188679245283,0.7169811320754716,0.0411663807890223
11405,25.0,41,1892,1933,0,112,2577,761,1816,2577,222,0.01590997283663174,0.7341870391928599,0.0,0.2953046177726038,0.7046953822273962,0.04346138921226232
11406,23.0,370,10674,11044,20,639,14783,4136,10647,14783,1047,0.025028749238990733,0.7220455929107759,0.0013529053642697692,0.2797808293309883,0.7202191706690118,0.04322532638841913
11407,24.0,699,21017,21716,363,1587,29990,8366,21624,29990,2142,0.023307769256418805,0.7008002667555852,0.012104034678226076,0.27895965321773925,0.7210403467822607,0.05291763921307102
11408,,610,15785,16395,13,855,21948,6046,15902,21948,1467,0.027792965190450155,0.7191999271004191,0.0005923090942227083,0.27546929105157647,0.7245307089484235,0.03895571350464735
11409,23.0,548,9871,10419,17,590,13673,3974,9699,13673,1015,0.04007898778614788,0.7219337380238426,0.001243326263438894,0.290645798288598,0.7093542017114021,0.04315073502523221
11410,,169,3396,3565,8,302,4819,1270,3549,4819,384,0.03506951649719859,0.7047105208549491,0.0016600954554886907,0.26354015355882965,0.7364598464411704,0.06266860344469807
11411,23.0,222,3785,4007,9,259,5336,1515,3821,5336,360,0.041604197901049474,0.7093328335832084,0.001686656671664168,0.2839205397301349,0.716079460269865,0.04853823088455772
11412,,246,3672,3918,12,528,5681,1474,4207,5681,307,0.04330223552191516,0.6463650765710263,0.002112304171800739,0.25946136243619083,0.7405386375638092,0.09294138355923252
11413,24.0,1491,37164,38655,142,2235,51641,14363,37278,51641,4147,0.02887240758312194,0.7196607346875544,0.0027497531031544704,0.2781317170465328,0.7218682829534672,0.043279564686973526
11414,16.0,530,6876,7406,145,329,10075,2761,7314,10075,590,0.05260545905707196,0.6824813895781637,0.014392059553349877,0.27404466501240693,0.725955334987593,0.03265508684863524
11415,17.0,201,4210,4411,22,217,5920,1713,4207,5920,481,0.0339527027027027,0.7111486486486487,0.0037162162162162164,0.2893581081081081,0.7106418918918919,0.036655405405405406
11416,25.0,104,4963,5067,9,132,6347,1931,4416,6347,461,0.016385694028674964,0.7819442256184024,0.0014179927524814874,0.3042382227824169,0.6957617772175831,0.02079722703639515
11417,16.0,574,11703,12277,29,1313,16933,4665,12268,16933,1142,0.03389830508474576,0.6911356522766197,0.0017126321384279219,0.27549754916435365,0.7245024508356463,0.07754089647434005
11418,16.0,135,2165,2300,25,224,3161,835,2326,3161,199,0.042708003796267005,0.6849098386586523,0.007908889591901298,0.26415691236950334,0.7358430876304967,0.07086365074343562
11419,14.0,348,5540,5888,0,586,7959,2217,5742,7959,505,0.04372408594044478,0.6960673451438623,0.0,0.27855258198266114,0.7214474180173389,0.07362734011810529
11420,16.0,70,2138,2208,1,130,3094,828,2266,3094,294,0.02262443438914027,0.6910148674854557,0.0003232062055591467,0.2676147382029735,0.7323852617970265,0.04201680672268908
11421,33.0,107,3599,3706,120,126,5013,1395,3618,5013,416,0.021344504288848994,0.717933373229603,0.023937761819269897,0.27827648114901254,0.7217235188509874,0.025134649910233394
11422,26.0,206,1867,2073,39,110,2841,785,2056,2841,139,0.0725096796902499,0.6571629707849349,0.013727560718057022,0.27631115804294265,0.7236888419570574,0.03871876099964801
11423,,94,2596,2690,10,102,3475,1035,2440,3475,250,0.027050359712230215,0.7470503597122302,0.0028776978417266188,0.29784172661870506,0.702158273381295,0.02935251798561151
11424,25.0,79,2764,2843,14,142,3785,1084,2701,3785,306,0.020871862615587846,0.7302509907529723,0.0036988110964332895,0.28639365918097753,0.7136063408190224,0.037516512549537646
11425,24.0,78,1402,1480,0,82,1959,585,1374,1959,157,0.039816232771822356,0.7156712608473711,0.0,0.2986217457886677,0.7013782542113323,0.04185809086268504
11426,26.0,23286,337520,360806,1872,18933,485053,138415,346638,485053,34441,0.04800712499458822,0.6958414853634551,0.0038593720686193054,0.28536056884505406,0.714639431154946,0.039032847956821215
11427,38.0,840,19235,20075,109,909,27074,7669,19405,27074,1812,0.03102607667873236,0.7104602201374012,0.004026002807121223,0.2832606929157125,0.7167393070842875,0.033574647263056805
11428,14.0,2106,110957,113063,350,12995,158436,42438,115998,158436,12323,0.013292433537832311,0.7003269458961348,0.002209093892802141,0.26785579035067786,0.7321442096493221,0.0820205003913252
11429,16.0,77,11359,11436,41,609,15434,4201,11233,15434,1441,0.004988985357004017,0.7359725281845276,0.0026564727225605804,0.27219126603602434,0.7278087339639756,0.03945833873266814
11430,,111,1638,1749,0,111,2383,653,1730,2383,136,0.04657994125052455,0.6873688627780109,0.0,0.2740243390684012,0.7259756609315988,0.04657994125052455
11431,16.0,2,2281,2283,1,80,3104,853,2251,3104,318,0.0006443298969072165,0.7348582474226805,0.00032216494845360824,0.27480670103092786,0.7251932989690721,0.02577319587628866
11432,,75,1993,2068,0,106,2716,792,1924,2716,225,0.027614138438880706,0.7337997054491899,0.0,0.2916053019145803,0.7083946980854198,0.0390279823269514
11433,,200,7236,7436,16,273,9611,2903,6708,9611,672,0.02080948912704193,0.7528873166163771,0.0016647591301633545,0.30204973467901364,0.6979502653209864,0.028404952658412235
11434,43.0,615,13088,13703,48,609,18316,5137,13179,18316,1261,0.033577200262065954,0.714566499235641,0.00262065953264905,0.2804651670670452,0.7195348329329548,0.03324961782048482
11435,13.0,311,4561,4872,33,712,7043,1891,5152,7043,507,0.044157319324151637,0.6475933551043589,0.004685503336646316,0.2684935396847934,0.7315064603152066,0.10109328411188415
11436,,33,6271,6304,33,447,8548,2405,6143,8548,719,0.00386055217594759,0.7336218998596162,0.00386055217594759,0.2813523631258774,0.7186476368741226,0.05229293401965372
11437,,101,3270,3371,9,193,4554,1288,3266,4554,371,0.02217830478700044,0.7180500658761528,0.001976284584980237,0.2828282828282828,0.7171717171717171,0.04238032498902064
11438,26.0,3656,111289,114945,592,6858,154297,42807,111490,154297,11375,0.023694563082885603,0.7212648334057046,0.0038367563854125484,0.27743248410532934,0.7225675158946707,0.044446748802633884
11439,24.0,101,1895,1996,10,106,2670,749,1921,2670,160,0.037827715355805244,0.7097378277153558,0.003745318352059925,0.2805243445692884,0.7194756554307116,0.039700374531835204
11440,24.0,127,1910,2037,21,107,2800,774,2026,2800,213,0.04535714285714286,0.6821428571428572,0.0075,0.2764285714285714,0.7235714285714285,0.038214285714285715
11441,,92,1630,1722,6,108,2456,684,1772,2456,173,0.03745928338762215,0.6636807817589576,0.0024429967426710096,0.2785016286644951,0.7214983713355049,0.043973941368078175
11442,23.0,79,2405,2484,1,95,3248,921,2327,3248,238,0.02432266009852217,0.7404556650246306,0.0003078817733990148,0.2835591133004926,0.7164408866995073,0.029248768472906403
11443,,633,23455,24088,9,1205,31039,8966,22073,31039,2276,0.02039369825058797,0.7556622313863204,0.00028995779503205644,0.2888623989174909,0.7111376010825091,0.038822127001514224
11444,17.0,58,2976,3034,19,380,4373,1194,3179,4373,322,0.013263206037045507,0.680539675280128,0.004344843356963183,0.27303910359021266,0.7269608964097873,0.08689686713926366
11445,17.0,3843,89194,93037,239,4977,125412,35581,89831,125412,9747,0.030643000669792364,0.7112078588970753,0.0019057187509967147,0.283712882339808,0.716287117660192,0.03968519758874749
11446,23.0,10954,89775,100729,2697,5118,141155,37582,103573,141155,8531,0.07760263540080053,0.6360029754525167,0.01910665580390351,0.2662463249619213,0.7337536750380788,0.03625801423966562
11447,25.0,4294,146793,151087,429,9009,204808,57789,147019,204808,14440,0.020965977891488612,0.7167346978633647,0.0020946447404398267,0.28216182961603065,0.7178381703839694,0.04398753954923636
11448,,2712,61529,64242,356,2080,80254,25235,55019,80254,3239,0.03379270815161861,0.7666782964089017,0.004435915966805393,0.31443915568071373,0.6855608443192862,0.02591771126672814
11449,15.0,511,10048,10559,26,529,14099,4061,10038,14099,957,0.03624370522732109,0.7126746577771473,0.001844102418611249,0.288034612383857,0.711965387616143,0.037520391517128875
11450,15.0,130,3519,3649,2,205,4962,1470,3492,4962,368,0.026199113260781944,0.7091898428053204,0.00040306328093510683,0.2962515114873035,0.7037484885126964,0.04131398629584845
11451,,169,2674,2843,26,161,3815,1079,2736,3815,294,0.044298820445609434,0.7009174311926606,0.006815203145478375,0.28283093053735253,0.7171690694626475,0.04220183486238532
11452,24.0,248,2281,2529,23,131,3400,960,2440,3400,194,0.07294117647058823,0.6708823529411765,0.006764705882352941,0.2823529411764706,0.7176470588235294,0.03852941176470588
11453,23.0,399,10339,10738,16,451,14442,4073,10369,14442,1113,0.02762775238886581,0.7158980750588562,0.001107879795042238,0.28202465032543966,0.7179753496745603,0.031228361722753083
11454,17.0,280,6759,7039,25,282,9157,2649,6508,9157,750,0.03057770012012668,0.7381238396854866,0.002730151796439882,0.2892868843507699,0.7107131156492301,0.03079611226384187
11455,,780,16128,16908,64,584,21657,6315,15342,21657,1438,0.036016068707577224,0.7447014821997506,0.0029551646119037726,0.29159163319019255,0.7084083668098075,0.026965877083621925
11456,25.0,300,4304,4604,8,139,6013,1726,4287,6013,381,0.04989190088142358,0.715782471312157,0.0013304506901712955,0.287044736404457,0.712955263595543,0.02311658074172626
11457,,4682,94189,98871,711,6533,132261,36993,95270,132263,8939,0.03539916681157996,0.712134156944875,0.005375653054898196,0.27969273341750905,0.720307266582491,0.0493940104186356
11458,27.0,216,4858,5074,9,389,6987,1925,5062,6987,491,0.030914555603263203,0.6952912551882067,0.0012881064834693002,0.2755116645198225,0.7244883354801774,0.05567482467439531
11459,25.0,3774,69723,73497,242,8282,101453,25460,75993,101453,6257,0.03719949139010182,0.6872443397435266,0.0023853409953377425,0.25095364355908645,0.7490463564409136,0.08163386001399663
11460,15.0,745,13437,14182,88,834,19223,5359,13864,19223,1348,0.03875565728554336,0.6990063985850283,0.004577849451178276,0.2787806273734589,0.7212193726265411,0.0433855277532123
11461,16.0,4921,79451,84372,397,6522,117644,31747,85897,117644,8481,0.0418295875692768,0.6753510591275373,0.0033745877392812214,0.26985651626942303,0.730143483730577,0.05543844139947639
11462,13.0,277,4424,4701,46,379,6390,1780,4610,6390,359,0.0433489827856025,0.6923317683881064,0.007198748043818467,0.27856025039123633,0.7214397496087637,0.059311424100156496
11463,,417,29464,29881,228,1780,39842,11463,28379,39842,3313,0.010466342051101852,0.7395211083780935,0.005722604286933387,0.2877114602680588,0.7122885397319412,0.04467647206465539
11464,,2112,61069,63181,189,2769,83606,23944,59662,83606,6019,0.025261344879554098,0.7304380068416142,0.002260603305982824,0.28639092888070233,0.7136090711192976,0.0331196325622563
11465,,93,1657,1750,1,247,2535,639,1896,2535,189,0.036686390532544376,0.6536489151873768,0.0003944773175542406,0.25207100591715975,0.7479289940828402,0.09743589743589744
11466,17.0,523,18923,19446,90,1134,25891,7344,18547,25891,2213,0.0202000695222278,0.7308717314897069,0.0034761113900583216,0.28365068942875904,0.716349310571241,0.04379900351473485
11467,26.0,545,11497,12042,73,534,15942,4548,11394,15942,1204,0.034186425793501445,0.7211767657759378,0.004579099234725882,0.2852841550621001,0.7147158449378999,0.033496424538953705
11468,23.0,3071,81684,84755,296,3470,110146,32479,77667,110146,8057,0.027881175893813667,0.7415975160241861,0.0026873422548254135,0.2948722604543061,0.7051277395456939,0.03150364062244657
11469,33.0,250,2135,2385,32,237,3334,912,2422,3334,181,0.07498500299940011,0.640371925614877,0.009598080383923215,0.2735452909418116,0.7264547090581883,0.07108578284343131
11470,24.0,339,5735,6083,37,349,8128,2371,5757,8128,493,0.04170767716535433,0.7055856299212598,0.004552165354330708,0.29170767716535434,0.7082923228346457,0.04293799212598425
11471,27.0,1479,55559,57038,137,2659,74584,21781,52803,74584,5546,0.019829990346455002,0.7449184811755872,0.0018368550895634453,0.2920331438378204,0.7079668561621796,0.035651077979191245
11472,16.0,112,5149,5261,0,192,6812,1932,4880,6812,546,0.01644157369348209,0.755871990604815,0.0,0.28361714621256606,0.7163828537874339,0.028185554903112156
11473,24.0,134,4616,4750,0,285,6449,1852,4597,6449,536,0.020778415258179563,0.7157698868041557,0.0,0.28717630640409364,0.7128236935959064,0.04419289812374012
11474,14.0,431,9055,9486,29,719,13428,3526,9902,13428,1059,0.03209711051534108,0.6743372058385463,0.0021596663687816504,0.2625856419422103,0.7374143580577897,0.053544831694965746
11475,23.0,151,5747,5898,13,218,7600,2285,5315,7600,602,0.01986842105263158,0.7561842105263158,0.0017105263157894738,0.3006578947368421,0.6993421052631579,0.028684210526315788
11476,17.0,1921,29489,31410,196,1575,42832,11792,31040,42832,2459,0.04484964512514008,0.6884805752708255,0.004576017930519238,0.27530818079940234,0.7246918192005977,0.036771572655958165
11477,,230,7288,7518,41,247,9833,2900,6933,9833,813,0.023390623410963082,0.7411776670395607,0.004169632868910811,0.2949252517034476,0.7050747482965525,0.025119495576121226
11478,16.0,1689,27832,29521,95,1556,39463,11187,28276,39463,2576,0.04279958442084991,0.7052682259331525,0.002407318247472316,0.28348072878392416,0.7165192712160758,0.03942933887438867
11479,,1216,12392,13608,636,1466,19880,5039,14841,19880,1174,0.06116700201207243,0.6233400402414487,0.03199195171026157,0.2534708249496982,0.7465291750503018,0.07374245472837022
11480,16.0,128,4128,4256,6,190,5663,1597,4066,5663,455,0.022602860674554123,0.7289422567543705,0.0010595090941197245,0.2820060038848667,0.7179939961151334,0.033551121313791274
11481,34.0,127,3245,3372,3,163,4505,1264,3241,4505,335,0.028190899001109878,0.7203107658157603,0.0006659267480577136,0.28057713651498334,0.7194228634850166,0.03618201997780244
11482,16.0,199,3917,4116,8,190,5486,1579,3907,5486,386,0.03627415238789646,0.7139992708713088,0.0014582573824279985,0.28782355085672623,0.7121764491432738,0.034633612832664966
11483,24.0,536,17718,18254,11,1455,24608,6711,17897,24608,1901,0.021781534460338103,0.7200097529258778,0.00044700910273081924,0.2727161898569571,0.7272838101430429,0.05912711313394018
11484,16.0,166,3172,3338,16,99,4509,1293,3216,4509,327,0.036815258372144596,0.7034819250388112,0.0035484586382789974,0.2867598137059215,0.7132401862940785,0.021956087824351298
11485,,29,1727,1756,33,39,2369,632,1737,2369,152,0.012241452089489235,0.7289995778809625,0.013929928239763613,0.2667792317433516,0.7332207682566484,0.01646264246517518
11486,36.0,644,4884,5528,105,317,8272,1976,6296,8272,292,0.07785299806576403,0.5904255319148937,0.012693423597678917,0.23887814313346228,0.7611218568665378,0.0383220502901354
11487,,197,5662,5859,25,222,7733,2282,5451,7733,661,0.025475236001551792,0.7321867321867321,0.003232897969740075,0.2950989266778741,0.7049010733221259,0.028708133971291867
11488,23.0,395,22145,22540,22,468,29011,8485,20526,29011,2953,0.013615525145634414,0.7633311502533522,0.0007583330460859674,0.2924752680017924,0.7075247319982075,0.016131812071283308
11489,25.0,4696,92883,97579,854,6994,130546,36907,93639,130546,7554,0.03597199454598379,0.7114963307952752,0.006541755396565195,0.28271260705038836,0.7172873929496116,0.05357498506273651
11490,,595,11696,12291,37,797,16848,4735,12113,16848,1176,0.03531576448243115,0.6942070275403609,0.0021961063627730293,0.28104226020892686,0.7189577397910731,0.04730531813865147
11491,26.0,57,1724,1781,7,58,2356,675,1681,2356,191,0.024193548387096774,0.7317487266553481,0.0029711375212224107,0.2865025466893039,0.7134974533106961,0.02461799660441426
11492,,1512,20364,21876,254,1505,30177,8353,21824,30177,2291,0.05010438413361169,0.6748185704344368,0.008417006329323656,0.27680021208204925,0.7231997879179508,0.04987241939225238
11493,,231,6583,6814,15,269,8968,2640,6328,8968,701,0.025758251561106154,0.7340544157002676,0.001672613737734166,0.2943800178412132,0.7056199821587869,0.029995539696699377
11494,,1161,30235,31396,173,1942,41187,11803,29384,41187,2556,0.02818850608201617,0.7340908539102143,0.004200354480782771,0.2865710054143298,0.7134289945856702,0.0471508000097118
11495,23.0,63,1952,2015,4,67,2657,779,1878,2657,215,0.023710952201731274,0.7346631539330072,0.0015054572826496049,0.29318780579601056,0.7068121942039894,0.02521640948438088
11496,15.0,538,9973,11342,71,855,16656,3987,12670,16657,1039,0.03229873326529387,0.5987272618118509,0.00426247223389566,0.23935882812030979,0.7606411718796903,0.05132977126733505
11497,16.0,136,53287,53423,709,2810,72017,19716,52301,72017,5493,0.0018884430065123513,0.7399225182942917,0.00984489773247983,0.27376869350292293,0.7262313064970771,0.03901856506102726
11498,,6826,154595,161421,661,7191,212721,61259,151462,212721,17160,0.03208898040155885,0.7267500622881615,0.0031073565844462934,0.28797814978304914,0.7120218502169509,0.03380484296331815
11499,16.0,93,5770,5892,23,1806,9701,2128,7573,9701,487,0.009586640552520358,0.5947840428821771,0.0023708895990104113,0.2193588289867024,0.7806411710132976,0.18616637460055666
11500,,91,2317,2408,11,103,3204,933,2271,3204,265,0.0284019975031211,0.7231585518102372,0.003433208489388265,0.29119850187265917,0.7088014981273408,0.032147315855181026
11501,27.0,175,4797,4972,13,573,6809,1932,4877,6809,379,0.02570127772066383,0.7045087384344251,0.001909237773535027,0.28374210603612865,0.7162578939638713,0.08415332647965927
11502,,12102,147581,159683,6396,14262,228788,61936,166857,228793,14554,0.05289497493367367,0.6450415878108159,0.027955400733414047,0.2707075828368875,0.7292924171631125,0.06233582321137447
11503,27.0,1565,48121,49686,59,1923,65066,19068,45998,65066,5404,0.02405250053791535,0.7395721267635939,0.0009067715857744444,0.29305628131435774,0.7069437186856423,0.029554606092275535
11504,27.0,399,9602,10001,77,512,12880,3828,9052,12880,808,0.03097826086956522,0.7454968944099379,0.005978260869565218,0.29720496894409937,0.7027950310559006,0.03975155279503106
11505,,2070,31805,33875,209,3185,46943,13091,33852,46943,3010,0.04409603135717785,0.6775238054662037,0.00445220799693245,0.2788701190805871,0.7211298809194129,0.06784824148435337
11506,,263,7078,7341,24,961,10489,2799,7690,10489,679,0.025073886929163885,0.674802173705787,0.0022881113547525977,0.2668509867480217,0.7331490132519782,0.09161979216321861
11507,,89,15181,15270,75,2009,21877,5733,16144,21877,1535,0.004068199478904786,0.6939251268455455,0.0034282579878411115,0.2620560405905746,0.7379439594094255,0.09183160396763725
11508,41.0,4440,125128,129568,479,3882,167897,50041,117856,167897,12368,0.026444784600082195,0.7452664431169109,0.002852939599873732,0.298045825714575,0.701954174285425,0.02312131842736916
11509,,126,3865,3991,3,266,5351,1532,3819,5351,374,0.02354700056064287,0.7222948981498786,0.0005606428704914969,0.28630162586432445,0.7136983741356756,0.04971033451691273
11510,41.0,766,25267,26033,53,1166,34242,9888,24354,34242,2765,0.022370188657204602,0.737894982769698,0.0015478067869867415,0.2887681794287717,0.7112318205712284,0.03405174931370831
11511,16.0,8303,102760,111063,3398,8060,153324,41078,112246,153324,9035,0.054153296287600114,0.6702147087214004,0.02216221856982599,0.26791630794917953,0.7320836920508205,0.05256841720800397
11512,24.0,70,2007,2077,15,85,2792,786,2006,2792,234,0.025071633237822348,0.7188395415472779,0.0053724928366762174,0.2815186246418338,0.7184813753581661,0.03044412607449857
11513,,67,1371,1438,10,88,2048,529,1519,2048,156,0.03271484375,0.66943359375,0.0048828125,0.25830078125,0.74169921875,0.04296875
11514,,947,11842,12789,189,507,16588,4824,11764,16588,847,0.057089462261876056,0.7138895587171449,0.011393778635157946,0.29081263564022186,0.7091873643597781,0.030564263322884012
11515,16.0,1069,23456,24525,113,1404,32415,9403,23012,32415,2378,0.0329785593089619,0.7236156100570723,0.0034860404133888632,0.29008175227518124,0.7099182477248187,0.04331328088847756
11516,37.0,625,15394,16019,38,664,21118,6036,15082,21118,1529,0.02959560564447391,0.7289516052656502,0.0017994128231840136,0.28582252107207123,0.7141774789279288,0.03144237143668908
11517,24.0,2929,65220,68149,250,2899,89380,25580,63800,89380,6244,0.03277019467442381,0.729693443723428,0.002797046319087044,0.2861937793689863,0.7138062206310136,0.03243454911613336
11518,15.0,534,7929,8463,2,396,11781,3267,8514,11781,796,0.045327221797810034,0.6730328495034378,0.0001697648756472286,0.2773109243697479,0.7226890756302521,0.03361344537815126
11519,23.0,14018,246435,260453,2260,11123,357810,100008,257802,357810,25389,0.03917721695872111,0.68873144965205,0.00631620133590453,0.27950029345183197,0.720499706548168,0.031086330734188535
11520,23.0,351,5321,5672,39,313,7483,2129,5354,7483,583,0.04690632099425364,0.7110784444741414,0.00521181344380596,0.2845115595349459,0.7154884404650541,0.04182814379259655
11521,24.0,118,4458,4576,5,231,6021,1745,4276,6021,464,0.019598073409732603,0.7404085700049826,0.0008304268393954493,0.28981896694901177,0.7101810330509882,0.038365719980069754
11522,37.0,187,3395,3582,34,226,4796,1318,3478,4796,327,0.0389908256880734,0.7078815679733111,0.007089241034195163,0.27481234361968304,0.7251876563803169,0.04712260216847373
11523,,93,2585,2678,11,72,3584,1002,2582,3584,281,0.025948660714285716,0.7212611607142857,0.0030691964285714285,0.27957589285714285,0.7204241071428571,0.020089285714285716
11524,34.0,161,4198,4359,10,232,5727,1605,4122,5727,388,0.028112449799196786,0.7330190326523486,0.001746114894360049,0.28025144054478784,0.7197485594552121,0.04050986554915313
11525,17.0,2522,308058,310580,831,9751,414521,119345,295176,414521,40756,0.006084130840174563,0.7431662087083646,0.002004723524260532,0.28791062455219396,0.712089375447806,0.023523536805131706
11526,36.0,2648,32016,34664,340,1641,46763,13077,33686,46763,2855,0.056625964972307166,0.6846438423539978,0.007270705472275089,0.27964416312041573,0.7203558368795843,0.03509184611765712
11527,,137,2752,2889,0,118,3650,1102,2548,3650,230,0.03753424657534247,0.753972602739726,0.0,0.3019178082191781,0.6980821917808219,0.03232876712328767
11528,15.0,179,2666,2845,13,158,3773,1095,2678,3773,250,0.047442353564802545,0.7065995229260535,0.0034455340577789558,0.29021998409753513,0.7097800159024649,0.04187649085608269
11529,16.0,27,3932,3959,11,409,5535,1462,4073,5535,334,0.004878048780487805,0.7103884372177055,0.001987353206865402,0.26413730803974705,0.7358626919602529,0.07389340560072268
11530,15.0,5512,99619,105131,934,8378,143521,39737,103786,143523,9413,0.03840499432146764,0.6940978101070908,0.006507667760567992,0.27686851584763417,0.7231314841523658,0.05837391916278227
11531,14.0,658,11363,12021,36,1250,17163,4613,12550,17163,1151,0.038338285847462565,0.6620637417700869,0.002097535395909806,0.2687758550369982,0.7312241449630018,0.07283109013575716
11532,16.0,395,5133,5528,18,538,7693,2122,5571,7693,442,0.05134537891589757,0.6672299493045626,0.0023397894189522944,0.2758351748342649,0.7241648251657351,0.06993370596646302
11533,17.0,22,13636,13658,1,443,17924,5220,12704,17924,1769,0.0012274045971881276,0.7607676857844231,5.57911180540058e-05,0.2912296362419103,0.7087703637580897,0.02471546529792457
11534,16.0,532,6412,6944,77,582,9762,2609,7153,9762,680,0.05449702929727515,0.6568326162671584,0.007887727924605613,0.267260807211637,0.7327391927883631,0.059618930547019056
11535,,98,2825,2923,34,81,3784,1191,2593,3784,288,0.025898520084566595,0.7465644820295984,0.008985200845665961,0.3147463002114165,0.6852536997885835,0.021405919661733615
11536,23.0,573,13707,14280,196,605,19627,5492,14135,19627,1675,0.02919447699597493,0.6983746879298925,0.009986243440158965,0.2798186172109849,0.7201813827890151,0.030824884088245783
11537,,175,2763,2938,33,145,4142,975,3167,4142,92,0.042250120714630614,0.6670690487687108,0.0079671656204732,0.23539352969579913,0.7646064703042008,0.0350072428778368
11538,25.0,102,2817,2919,20,122,3814,1127,2687,3814,261,0.026743576297850027,0.7385946512847404,0.005243838489774515,0.2954902988987939,0.704509701101206,0.03198741478762454
11539,,76,2775,2851,9,79,3722,1068,2654,3722,301,0.02041912950026867,0.745566899516389,0.0024180548092423426,0.28694250403009136,0.7130574959699086,0.02122514777001612
11540,,7050,151371,158421,631,11382,210888,60040,150848,210888,15692,0.0334300671446455,0.7177791054967566,0.0029921095557831645,0.2847008838814916,0.7152991161185084,0.053971776487993624
11541,27.0,532,15514,16046,33,1008,21990,6081,15909,21990,1794,0.02419281491587085,0.7055025011368804,0.0015006821282401092,0.27653478854024555,0.7234652114597544,0.04583901773533424
11542,23.0,195,4220,4415,202,494,6453,1471,4982,6453,392,0.030218503021850304,0.6539593987292732,0.031303269796993646,0.2279559894622656,0.7720440105377344,0.07655354098868743
11543,27.0,673,12444,13117,81,976,17251,5231,12020,17251,608,0.039012231175004346,0.7213494869862617,0.004695379977972291,0.30322879833053157,0.6967712016694685,0.05657643035186366
11544,39.0,6035,141924,147959,422,7296,202637,55589,147048,202637,13423,0.029782320109358114,0.7003854182602387,0.0020825416878457537,0.274327985511037,0.725672014488963,0.03600527050834744
11545,23.0,93,2140,2233,9,158,2936,851,2085,2936,220,0.03167574931880109,0.728882833787466,0.0030653950953678476,0.289850136239782,0.7101498637602179,0.05381471389645776
11546,25.0,3576,57985,61561,344,3098,81801,23062,58739,81801,4987,0.04371584699453552,0.708854414982702,0.0042053275632327235,0.28192809378858447,0.7180719062114155,0.037872397647950515
11547,,113,3461,3574,7,467,4914,1105,3809,4914,357,0.022995522995522995,0.7043142043142043,0.0014245014245014246,0.22486772486772486,0.7751322751322751,0.09503459503459503
11548,,15,7125,7140,27,634,9836,2722,7114,9836,745,0.0015250101667344449,0.7243798291988613,0.0027450183001220007,0.2767385115900773,0.7232614884099228,0.06445709638064254
11549,17.0,1204,23976,25180,97,1949,34711,9178,25533,34711,2308,0.034686410647921405,0.6907320445968137,0.0027945031834288843,0.2644118579124773,0.7355881420875227,0.056149347469102016
11550,,608,10367,10975,40,600,14761,4164,10597,14761,980,0.04118962129936996,0.7023236908068559,0.0027098435065374973,0.2820947090305535,0.7179052909694466,0.04064765259806246
11551,23.0,160,4493,4653,16,236,6147,1801,4346,6147,484,0.026028957214901578,0.730925654790955,0.002602895721490158,0.2929884496502359,0.7070115503497642,0.038392711891979826
11552,,394,8783,9177,19,381,11989,3493,8496,11989,926,0.03286345816998916,0.7325882058553674,0.001584786053882726,0.2913504045374927,0.7086495954625073,0.03177913086996413
11553,,1742,31927,33669,69,1534,43681,12753,30928,43681,2922,0.039880039376387906,0.7309127538288959,0.0015796341658844807,0.2919576017032577,0.7080423982967423,0.03511824362995353
11554,44.0,1202,28256,29458,138,1271,39128,11216,27912,39128,3164,0.03071968922510734,0.7221427111020241,0.0035268861173584133,0.28664894704559396,0.713351052954406,0.03248313228378655
11555,,31,2072,2103,13,177,2984,812,2172,2984,257,0.010388739946380697,0.6943699731903485,0.00435656836461126,0.27211796246648795,0.7278820375335121,0.05931635388739946
11556,17.0,383,6437,6820,47,771,9784,2714,7070,9784,744,0.03914554374488961,0.6579108748977923,0.004803761242845462,0.27739165985282094,0.7226083401471791,0.07880212591986917
11557,15.0,3851,59166,63017,320,4022,85845,23769,62076,85845,5682,0.04485992195235599,0.6892189411148,0.003727648669112936,0.2768827538004543,0.7231172461995456,0.046851884209913215
11558,24.0,7044,143647,150691,698,7507,202244,57661,144583,202244,15345,0.034829216194299954,0.7102658175273432,0.003451276675698661,0.28510610945194914,0.7148938905480509,0.03711853009236368
11559,14.0,78,1889,1967,7,123,2790,729,2061,2790,229,0.02795698924731183,0.6770609318996416,0.0025089605734767025,0.26129032258064516,0.7387096774193549,0.04408602150537634
11560,,104,2049,2153,21,120,2908,804,2104,2908,179,0.03576341127922971,0.7046079779917469,0.007221458046767538,0.2764786795048143,0.7235213204951857,0.04126547455295736
11561,,359,3598,3957,36,476,5843,1432,4411,5843,332,0.06144104056135547,0.6157795652918021,0.00616121855211364,0.24507958240629812,0.7549204175937019,0.08146500085572479
11562,,69,1658,1727,2,51,2326,670,1656,2326,176,0.029664660361134996,0.7128116938950989,0.0008598452278589854,0.2880481513327601,0.7119518486672399,0.021926053310404127
11563,16.0,362,11505,11867,45,1762,17042,4574,12468,17042,1311,0.02124163830536322,0.6750968196221101,0.002640535148456754,0.2683957282009154,0.7316042717990846,0.10339162070179557
11564,15.0,73,12890,12963,87,1074,17545,4796,12749,17545,1211,0.0041607295525790825,0.7346822456540325,0.0049586776859504135,0.27335423197492165,0.7266457680250784,0.061214021088629236
11565,17.0,97,1438,1535,13,96,2052,570,1482,2052,170,0.047270955165692005,0.7007797270955166,0.006335282651072124,0.2777777777777778,0.7222222222222222,0.04678362573099415
11566,14.0,297,5694,5991,40,521,8033,2262,5771,8033,404,0.03697248848499938,0.708826092368978,0.004979459728619445,0.2815884476534296,0.7184115523465704,0.06485746296526827
11567,48.0,58,1965,2023,2,79,2643,811,1832,2643,217,0.02194475974271661,0.7434733257661748,0.0007567158531971245,0.306848278471434,0.6931517215285661,0.02989027620128642
11568,15.0,1060,16057,17117,99,1181,22931,6430,16501,22931,1579,0.04622563342200515,0.70023112816711,0.004317299725262745,0.2804064367014086,0.7195935632985915,0.051502333086215164
11569,24.0,154,3276,3430,8,148,4818,1315,3503,4818,344,0.0319634703196347,0.6799501867995019,0.0016604400166044002,0.2729348277293483,0.7270651722706517,0.030718140307181403
11570,17.0,1112,27069,28181,28,1479,37336,10594,26742,37336,2842,0.029783586886650955,0.7250107135204629,0.0007499464323976858,0.28374758945789585,0.7162524105421041,0.03961324191129205
11571,17.0,142,3027,3169,6,211,4271,1178,3093,4271,322,0.03324748302505268,0.7087333177241864,0.0014048232264106766,0.2758136267852962,0.7241863732147038,0.049402950128775464
11572,17.0,2199,44713,46912,44,2597,63362,17990,45372,63362,5942,0.03470534389697295,0.7056753259051166,0.0006944225245415233,0.2839241185568637,0.7160758814431363,0.04098671127805309
11573,,715,9497,10212,60,451,14179,3890,10289,14179,985,0.0504266873545384,0.6697933563720996,0.004231610127653572,0.2743493899428733,0.7256506100571267,0.03180760279286268
11574,25.0,61,9370,9431,65,352,12214,3516,8698,12214,1025,0.004994268871786474,0.7671524480104798,0.005321761912559358,0.28786638283936467,0.7121336171606354,0.028819387588013754
11575,26.0,411,5352,5763,67,645,9228,2047,7181,9228,370,0.044538361508452536,0.5799739921976593,0.0072605114867793676,0.2218248807975726,0.7781751192024274,0.0698959687906372
11576,,1261,21279,22540,129,939,29874,8585,21289,29874,2156,0.04221061792863359,0.7122916248242619,0.004318136171922073,0.2873736359376046,0.7126263640623954,0.03143201446073509
11577,45.0,45,18446,18491,89,1355,25037,6845,18192,25037,2291,0.0017973399368933977,0.736749610576347,0.0035547389863002754,0.2733953748452291,0.726604625154771,0.05411990254423453
11578,39.0,84,5064,5148,10,128,6506,1983,4523,6506,520,0.01291115893021826,0.7783584383645865,0.001537042729787888,0.3047955733169382,0.6952044266830618,0.019674146941284967
11579,17.0,970,10878,11848,89,916,16362,4423,11939,16362,1293,0.059283706148392616,0.6648331499816649,0.0054394328321721065,0.27032147659210365,0.7296785234078963,0.05598337611538932
11580,,421,13193,13614,40,489,17968,5266,12702,17968,1572,0.02343054318788958,0.7342497773820125,0.002226179875333927,0.29307658058771147,0.7069234194122885,0.027215048975957258
11581,,108,2826,2934,47,251,4063,1081,2982,4063,235,0.026581343834604972,0.6955451636721635,0.011567807039133645,0.26605956190007385,0.7339404380999262,0.06177701206005415
11582,26.0,1688,52042,53730,123,2466,70698,20397,50301,70698,4954,0.02387620583326261,0.7361170047243204,0.0017397946193668844,0.28850886870915726,0.7114911312908427,0.034880760417550706
11583,26.0,1174,25642,26816,58,1302,34977,10078,24899,34977,2567,0.03356491408639963,0.7331103296451954,0.0016582325528204248,0.28813220116076277,0.7118677988392372,0.037224461789175746
11584,15.0,127,9837,9964,37,761,13462,3762,9700,13462,1064,0.009433962264150943,0.7307235180508097,0.0027484771950675975,0.27945327588768387,0.7205467241123161,0.0565294904174714
11585,36.0,472,12905,13377,39,822,17924,4906,13018,17924,1293,0.02633340772149074,0.7199843784869449,0.002175853604106226,0.2737112251729525,0.7262887748270476,0.04586029904039277
11586,23.0,23,2979,3002,6,193,4265,1149,3116,4265,326,0.005392731535756155,0.6984759671746776,0.001406799531066823,0.2694021101992966,0.7305978898007034,0.04525205158264947
11587,26.0,115,2794,2909,6,242,4119,1079,3040,4119,298,0.02791939791211459,0.6783199805778102,0.0014566642388929353,0.2619567856275795,0.7380432143724205,0.058752124302015055
11588,14.0,113,1998,2111,2,161,2824,805,2019,2824,177,0.04001416430594901,0.7075070821529745,0.000708215297450425,0.28505665722379603,0.714943342776204,0.05701133144475921
11589,,128,3941,4069,338,655,6718,1327,5391,6718,245,0.019053289669544508,0.5866329264662102,0.05031259303364097,0.19752902649598095,0.8024709735040191,0.09749925573087229
11590,,953,18760,19713,81,767,26023,7470,18553,26023,1912,0.03662145025554318,0.7209007416516159,0.003112631133996849,0.28705376013526496,0.712946239864735,0.029473926910809668
11591,26.0,49,1621,1670,2,67,2277,662,1615,2277,200,0.021519543258673692,0.7119016249451032,0.000878348704435661,0.2907334211682038,0.7092665788317962,0.029424681598594644
11592,27.0,478,46090,46568,111,2397,63029,17684,45345,63029,5701,0.007583810626854305,0.7312506941249266,0.001761094099541481,0.2805692617683923,0.7194307382316076,0.0380301131225309
11593,17.0,351,14774,15125,29,848,20272,5648,14624,20272,1720,0.017314522494080505,0.7287884767166535,0.001430544593528019,0.2786108918705604,0.7213891081294396,0.041831097079715863
11594,26.0,503,11580,12083,116,446,16254,4528,11726,16254,1223,0.030946228620647224,0.7124400147655962,0.007136704811123416,0.2785775809031623,0.7214224190968377,0.02743939953242279
11595,41.0,474,12446,12920,46,360,16876,4925,11951,16876,1496,0.028087224460772695,0.7374970372126096,0.0027257643991467173,0.2918345579521214,0.7081654420478787,0.02133206921071344
11596,24.0,3179,86959,90138,307,3465,119376,34041,85335,119376,8280,0.026630143412411204,0.7284462538533708,0.002571706205602466,0.28515782066747086,0.7148421793325291,0.02902593486127865
11597,48.0,2694,76797,79491,499,4039,104151,30333,73991,104324,7698,0.025823396342164795,0.7361393351481922,0.00478317549173728,0.29075763966105594,0.7092423603389441,0.03871592346919213
11598,27.0,729,12228,12957,34,638,17295,4883,12412,17295,1306,0.04215091066782307,0.7070251517779705,0.001965886094246892,0.28233593524139927,0.7176640647586008,0.036889274356750504
11599,23.0,202,6633,6835,37,357,8986,2607,6379,8986,686,0.02247941241931894,0.7381482305809036,0.004117516136211885,0.2901179612730915,0.7098820387269085,0.039728466503449814
11600,,4460,153826,158286,420,11020,207960,61630,146330,207960,11254,0.02144643200615503,0.739690325062512,0.002019619157530294,0.29635506828236197,0.703644931717638,0.05299095979996153
11601,23.0,632,19922,20554,45,457,26697,7798,18899,26697,2060,0.023673071880735662,0.7462261677342024,0.0016855826497359254,0.29209274450312767,0.7079072554968723,0.017118028242873732
11602,,387,9630,10017,372,1094,15155,3852,11303,15155,732,0.0255361266908611,0.6354338502144506,0.024546354338502146,0.25417354008578025,0.7458264599142197,0.0721873968987133
11603,26.0,777,20587,21364,47,1075,27756,8079,19677,27756,1596,0.027993947254647645,0.7417135033866551,0.00169332756881395,0.29107220060527456,0.7089277993947255,0.038730364605850984
11604,15.0,68,1962,2030,9,90,2671,767,1904,2671,212,0.02545862972669412,0.734556345937851,0.0033695245226506927,0.2871583676525646,0.7128416323474355,0.03369524522650692
11605,16.0,3459,57461,60920,563,7368,87748,22935,64813,87748,5077,0.03941970187354697,0.6548411359803072,0.006416100651866709,0.2613734785978028,0.7386265214021972,0.08396772576013128
11606,17.0,1059,33831,34890,147,3353,46936,12196,34740,46936,3119,0.022562638486449633,0.7207900119311402,0.003131924322481677,0.25984319072779954,0.7401568092722004,0.07143770240327255
11607,16.0,206,6721,6927,52,566,9614,2641,6973,9614,682,0.021427085500312044,0.6990846681922197,0.005408778864156439,0.274703557312253,0.7252964426877471,0.0588724776367797
11608,25.0,365,8272,8637,37,491,11824,3330,8494,11824,891,0.030869418132611636,0.699594046008119,0.003129228687415426,0.2816305818673884,0.7183694181326117,0.041525710419485794
11609,16.0,1030,21362,22392,48,1450,29858,8457,21401,29858,2206,0.034496617321990754,0.7154531448857927,0.0016076093509277245,0.2832406725165785,0.7167593274834215,0.04856319914260834
11610,15.0,732,20933,21665,35,1194,28961,8309,20652,28961,2390,0.025275370325610304,0.7227996270847001,0.001208521805186285,0.28690307655122405,0.713096923448776,0.04122785815406926
11611,,249,2164,2413,32,98,3366,902,2464,3366,206,0.07397504456327986,0.6428995840760546,0.009506833036244802,0.2679738562091503,0.7320261437908496,0.029114676173499703
11612,15.0,303,8656,8959,134,918,12648,3361,9287,12648,905,0.023956356736242884,0.6843769765970904,0.010594560404807085,0.2657337128399747,0.7342662871600253,0.07258064516129033
11613,16.0,86,4023,4109,25,164,5453,1578,3875,5453,433,0.01577113515496057,0.7377590317256556,0.0045846323124885385,0.2893819915642765,0.7106180084357234,0.03007518796992481
11614,,123,2918,3041,23,94,4003,1177,2826,4003,369,0.030726954783912065,0.7289532850362228,0.005745690731951037,0.2940294778915813,0.7059705221084187,0.023482388208843366
11615,37.0,114,4112,4226,0,953,5899,993,4906,5899,282,0.01932530937447025,0.6970672995422953,0.0,0.1683336158670961,0.8316663841329038,0.16155280556026444
11616,16.0,3241,257576,260817,709,18507,348830,100120,248710,348830,27712,0.009291058681879426,0.7383997935957343,0.0020325086718458846,0.28701659834303245,0.7129834016569676,0.053054496459593495
11617,17.0,5636,102340,107976,528,7633,148435,40842,107593,148435,11096,0.03796948159126891,0.6894600330110823,0.003557112540842793,0.2751507393808738,0.7248492606191262,0.051423181864115604
11618,26.0,49,2777,2826,0,98,3625,1076,2549,3625,265,0.013517241379310345,0.7660689655172414,0.0,0.29682758620689653,0.7031724137931035,0.02703448275862069
11619,15.0,280,7885,8165,31,562,10946,3062,7884,10946,777,0.025580120591997078,0.7203544673853463,0.002832084779828248,0.2797368901881966,0.7202631098118034,0.051342956331079846
11620,24.0,189,3684,3873,9,152,5397,1490,3907,5397,432,0.03501945525291829,0.6826014452473597,0.0016675931072818232,0.2760793033166574,0.7239206966833426,0.028163794700759682
11621,23.0,427,6730,7157,54,401,10036,2698,7338,10036,749,0.042546831406935035,0.6705858907931447,0.005380629732961339,0.2688322040653647,0.7311677959346353,0.0399561578318055
11622,33.0,77,1921,1998,0,85,2588,760,1828,2588,182,0.029752704791344668,0.7422720247295209,0.0,0.2936630602782071,0.7063369397217929,0.03284389489953632
11623,27.0,346,10304,10650,42,607,14266,4036,10230,14266,1091,0.024253469788307863,0.7222767419038273,0.002944062806673209,0.28291041637459696,0.7170895836254031,0.04254871722977709
11624,24.0,519,11163,11682,29,1105,15563,3957,11606,15563,957,0.03334832615819572,0.7172781597378397,0.0018633939471824198,0.2542568913448564,0.7457431086551436,0.07100173488401978
11625,,1123,20694,21817,64,1275,29063,8323,20740,29063,2015,0.03864019543749785,0.7120393627636514,0.002202112651825345,0.28637786876784915,0.7136221312321508,0.043870212985583044
11626,16.0,424,8911,9335,24,504,12378,3557,8821,12378,901,0.03425432218452092,0.7199062853449669,0.0019389238972370335,0.287364679269672,0.712635320730328,0.0407174018419777
11627,16.0,61,1410,1471,4,86,1958,566,1392,1958,150,0.03115423901940756,0.7201225740551583,0.0020429009193054137,0.28907048008171604,0.710929519918284,0.043922369765066395
11628,17.0,108,1726,1834,0,59,2433,711,1722,2433,162,0.04438964241676942,0.7094122482531854,0.0,0.2922318125770654,0.7077681874229347,0.02424989724619811
11629,15.0,160,4098,4258,6,231,5690,1608,4082,5690,455,0.028119507908611598,0.7202108963093146,0.001054481546572935,0.2826010544815466,0.7173989455184534,0.040597539543057996
11630,,429,7468,7897,67,460,10980,2942,8038,10980,626,0.03907103825136612,0.6801457194899818,0.006102003642987249,0.2679417122040073,0.7320582877959927,0.04189435336976321
11631,25.0,2423,43962,46385,465,3036,63704,17367,46337,63704,4425,0.03803528820796182,0.6900979530327765,0.007299384654024865,0.27262024362677384,0.7273797563732262,0.04765791787014944
11632,16.0,1101,32849,33950,42,885,45318,12934,32384,45318,3667,0.024294982126307426,0.7248554658193213,0.0009267840593141798,0.2854053576945143,0.7145946423054856,0.01952866410697736
11633,13.0,4516,93115,97631,33,10069,133659,37349,96310,133659,8925,0.03378747409452412,0.6966609057377355,0.0002468969541893924,0.27943498006120054,0.7205650199387995,0.0753334979313028
11634,,2541,28454,31046,351,3682,44892,11404,33488,44892,2818,0.056602512697139805,0.6338323086518756,0.007818765036086608,0.2540318987792925,0.7459681012207074,0.08201906798538715
11635,24.0,410,19966,20376,31,973,26743,7592,19151,26743,2088,0.01533111468421643,0.7465878921586957,0.0011591818419773399,0.28388737239651496,0.716112627603485,0.0363833526530307
11636,14.0,139,4176,4315,10,233,5715,1669,4046,5715,427,0.024321959755030622,0.7307086614173228,0.0017497812773403325,0.2920384951881015,0.7079615048118986,0.04076990376202975
11637,24.0,232,5697,5929,13,445,8057,2265,5792,8057,565,0.02879483678788631,0.7070870050887427,0.0016135037855281122,0.2811220057093211,0.7188779942906789,0.05523147573538538
11638,25.0,70,1660,1730,6,132,2315,603,1712,2315,178,0.03023758099352052,0.7170626349892009,0.002591792656587473,0.260475161987041,0.739524838012959,0.05701943844492441
11639,,175,3895,4070,10,321,5580,1545,4035,5580,418,0.03136200716845878,0.6980286738351255,0.0017921146953405018,0.2768817204301075,0.7231182795698925,0.057526881720430106
11640,,5234,94499,99733,396,6280,135002,37674,97328,135002,9123,0.038769796003022175,0.6999822224855928,0.002933289877187005,0.2790625324069273,0.7209374675930726,0.046517829365490884
11641,,1529,27751,29280,94,1813,39269,10884,28385,39269,2888,0.03893656573887799,0.7066897552777,0.0023937457027171562,0.2771651939188673,0.7228348060811327,0.046168733606661745
11642,,235,7840,8075,89,246,10357,3090,7267,10357,716,0.02268996813749155,0.7569759582890798,0.008593221975475523,0.29834894274403784,0.7016510572559621,0.023752051752437966
11643,23.0,388,9708,10096,40,254,13474,3870,9604,13474,1232,0.028796200089060413,0.7204987383108208,0.0029686804215526197,0.28721983078521596,0.712780169214784,0.018851120676859137
11644,17.0,379,10560,10939,30,734,14586,4135,10451,14586,1134,0.02598382010146716,0.7239819004524887,0.0020567667626491155,0.28349101878513644,0.7165089812148636,0.05032222679281503
11645,16.0,16,2551,2567,3,125,3483,959,2524,3483,285,0.004593741027849555,0.7324145851277635,0.0008613264427217916,0.2753373528567327,0.7246626471432673,0.03588860178007465
11646,13.0,204,4084,4288,21,520,6194,1612,4582,6194,361,0.03293509848240232,0.6593477558927995,0.0033903777849531806,0.26025185663545364,0.7397481433645463,0.08395221181788828
11647,,111,5587,5698,35,480,7673,1993,5680,7673,569,0.014466310439202398,0.728137625439854,0.004561449237586342,0.2597419523002737,0.7402580476997264,0.06255701811546983
11648,,1211,6058,7269,35,384,10106,2756,7350,10106,560,0.11982980407678606,0.5994458737383732,0.0034632891351672273,0.2727092816148822,0.7272907183851177,0.03799722936869187
11649,,251,4389,4640,0,101,6147,1872,4275,6147,446,0.04083292663087685,0.714006832601269,0.0,0.30453879941434847,0.6954612005856515,0.016430779241906623
11650,15.0,4423,64859,69282,306,4075,94794,26365,68429,94794,7097,0.046659071249235184,0.684209971095217,0.0032280524083802774,0.27812941747367975,0.7218705825263202,0.0429879528240184
11651,14.0,203,7640,7843,21,1155,11174,2962,8212,11174,846,0.018167173796312868,0.6837300877035977,0.0018793628065151243,0.26507964918560945,0.7349203508143906,0.10336495435833185
11652,37.0,99,2566,2665,5,284,3736,1020,2716,3736,323,0.026498929336188436,0.686830835117773,0.0013383297644539614,0.27301927194860814,0.7269807280513919,0.07601713062098502
11653,36.0,107,2358,2465,0,143,3229,937,2292,3229,243,0.033137194177764014,0.7302570455249303,0.0,0.290182719108083,0.709817280891917,0.04428615670486219
11654,,555,13748,14303,29,693,19028,5483,13545,19028,1571,0.029167542568845913,0.7225141896153038,0.0015240697918856422,0.28815429892789574,0.7118457010721043,0.03642001261299138
11655,,14777,319016,333793,2711,16804,453037,126105,326932,453037,32245,0.03261764491641963,0.7041720654162905,0.005984058697192503,0.27835474806693494,0.7216452519330651,0.03709189315662959
11656,17.0,34,3263,3297,21,156,4457,1248,3209,4457,414,0.007628449629795826,0.7321067982948172,0.004711689477226834,0.2800089746466233,0.7199910253533767,0.03500112183082791
11657,,68,4457,4525,12,204,6099,1712,4387,6099,504,0.011149368748975241,0.7307755369732744,0.001967535661583866,0.2807017543859649,0.7192982456140351,0.03344810624692573
11658,27.0,203,4454,4657,2,238,6237,1748,4489,6237,431,0.03254769921436588,0.7141253807920475,0.000320666987333654,0.2802629469296136,0.7197370530703864,0.038159371492704826
11659,17.0,452,18488,18940,80,1019,25006,7199,17807,25006,2028,0.018075661841158122,0.7393425577861313,0.0031992321842757737,0.28789090618251617,0.7121090938174838,0.04075021994721267
11660,33.0,10872,98717,109589,1870,7765,157183,41671,115512,157183,8461,0.06916778532029545,0.6280386555798019,0.011896960867269362,0.2651113670053377,0.7348886329946622,0.049401016649383206
11661,,98,1886,1984,15,131,2709,734,1975,2709,177,0.03617571059431524,0.6961978589885567,0.005537098560354375,0.2709486895533407,0.7290513104466593,0.04835732742709487
11662,14.0,203,2394,2597,0,180,3607,1006,2601,3607,252,0.05627945661214306,0.663709453839756,0.0,0.2789021347380094,0.7210978652619906,0.049902966454116994
11663,23.0,7713,238534,246247,665,10816,319279,94550,224729,319279,21214,0.0241575549910893,0.7471020643387132,0.0020828178489659516,0.2961359813830537,0.7038640186169463,0.03387632760062516
11664,33.0,156,3929,4085,5,169,5417,1583,3834,5417,470,0.02879822780136607,0.725309211740816,0.0009230201218386561,0.29222817057411854,0.7077718294258815,0.031198080118146575
11665,,139,38935,39074,140,5355,55265,14179,41086,55265,3541,0.00251515425676287,0.7045146114177147,0.00253324889170361,0.2565638288247535,0.7434361711752465,0.09689677010766308
11666,44.0,3460,51238,54698,401,5766,76307,20849,55458,76307,4894,0.04534315331489903,0.6714718177886695,0.00525508799979032,0.2732252611162803,0.7267747388837197,0.07556318555309474
11667,,1474,34181,35655,117,2021,48213,13631,34582,48213,3460,0.03057266712297513,0.7089581648103209,0.0024267313795034535,0.2827245763590733,0.7172754236409267,0.041918154854499824
11668,16.0,1984,48678,50662,174,2556,66686,19118,47568,66686,4927,0.029751372102090393,0.729958312089494,0.002609243319437363,0.286686860810365,0.713313139189635,0.038328884623459195
11669,17.0,371,7370,7741,6,367,10341,2948,7393,10341,825,0.03587660767817426,0.7126970312348903,0.0005802146794313896,0.2850788124939561,0.7149211875060439,0.035489797891886665
11670,17.0,546,9458,10004,57,672,13668,3824,9844,13668,918,0.03994732221246708,0.6919812701199883,0.004170324846356453,0.27977758267486097,0.720222417325139,0.04916593503072871
11671,,187,3234,3421,35,285,4665,1287,3378,4665,260,0.040085744908896034,0.6932475884244373,0.007502679528403001,0.27588424437299036,0.7241157556270097,0.06109324758842444
11672,23.0,359,7495,7854,42,235,10220,2982,7238,10220,761,0.03512720156555773,0.7333659491193738,0.00410958904109589,0.29178082191780824,0.7082191780821918,0.02299412915851272
11673,37.0,516,5816,6332,290,450,10057,2290,7767,10057,441,0.051307546982201455,0.5783036690862086,0.0288356368698419,0.22770209804116537,0.7722979019588346,0.04474495376354778
11674,17.0,62,1853,1915,22,91,2554,691,1863,2554,179,0.02427564604541895,0.7255285826155051,0.008613938919342208,0.27055599060297575,0.7294440093970243,0.03563038371182459
11675,14.0,293,2172,2465,31,214,3689,945,2744,3689,286,0.07942531851450257,0.588777446462456,0.008403361344537815,0.25616698292220114,0.7438330170777988,0.05801030089455137
11676,,580,14417,14997,99,1656,20774,5345,15429,20774,1123,0.027919514778087996,0.6939924906132666,0.004765572350052951,0.25729276980841437,0.7427072301915857,0.07971502840088572
11677,,119,3788,3907,0,190,5232,1501,3731,5232,474,0.022744648318042814,0.7240061162079511,0.0,0.28688837920489296,0.713111620795107,0.03631498470948012
11678,,1601,34945,36546,548,1375,47161,13995,33166,47161,3131,0.03394754140073366,0.7409724136468693,0.011619770573143062,0.2967494327940459,0.703250567205954,0.02915544623735714
11679,26.0,224,927,1193,41,281,1888,390,1501,1891,59,0.11845584346906399,0.4902168164992068,0.02168164992067689,0.20624008461131677,0.7937599153886833,0.14859862506610258
11680,23.0,374,7374,7748,11,481,10587,2883,7704,10587,749,0.035326343628978935,0.6965145933692264,0.0010390101067346746,0.27231510342873333,0.7276848965712667,0.045433078303579864
11681,23.0,2283,145336,147619,508,41845,226821,55528,171293,226821,13998,0.010065205602655839,0.6407519585928992,0.0022396515313837786,0.24480978392653238,0.7551902160734676,0.18448468175345317
11682,24.0,1440,55711,57151,82,2255,73550,21610,51940,73550,5471,0.019578518014955814,0.7574575118966689,0.001114887831407206,0.2938137321549966,0.7061862678450034,0.030659415363698164
11683,34.0,54,4055,4109,4,93,5335,1564,3771,5335,349,0.010121836925960637,0.7600749765698219,0.0007497656982193065,0.2931583880037488,0.7068416119962512,0.017432052483598876
11684,24.0,184,8392,8576,74,324,11187,3207,7980,11187,717,0.01644766246536158,0.7501564315723608,0.00661482077411281,0.2866720300348619,0.7133279699651381,0.028962188254223652
11685,,70,2717,2787,3,133,3668,1073,2595,3668,335,0.019083969465648856,0.7407306434023991,0.0008178844056706652,0.2925299890948746,0.7074700109051254,0.03625954198473282
11686,15.0,600,8782,9382,42,720,12965,3653,9312,12965,905,0.04627844195912071,0.6773621288083301,0.0032394909371384496,0.2817585807944466,0.7182414192055534,0.05553413035094485
11687,17.0,105,36836,36941,156,3476,51451,13651,37800,51451,4263,0.002040776661289382,0.7159433247167207,0.0030320110396299393,0.26532040193582246,0.7346795980641776,0.06755942547277993
11688,23.0,71,2426,2497,4,144,3263,947,2316,3263,234,0.021759117376647256,0.7434875881091021,0.001225865767698437,0.290223720502605,0.7097762794973951,0.04413116763714373
11689,17.0,387,17315,17702,147,1014,23733,6465,17268,23733,1533,0.016306408797876374,0.7295748535794042,0.006193907217798003,0.27240551131336116,0.7275944886866389,0.04272531917583112
11690,17.0,3025,233660,236685,1556,17166,323607,87635,235972,323607,24595,0.00934775823761538,0.7220486577855239,0.004808301427348605,0.27080687376972684,0.7291931262302731,0.0530458241014564
11691,35.0,3402,70872,74274,230,4101,100187,28198,71989,100187,7029,0.033956501342489544,0.7073971672971543,0.0022957070278579058,0.28145368161537926,0.7185463183846208,0.04093345444019683
11692,14.0,91,1717,1808,10,97,2417,712,1705,2417,205,0.03764997931319818,0.7103847745138602,0.004137360364087712,0.2945800579230451,0.7054199420769549,0.04013239553165081
11693,14.0,91,1967,2058,0,93,2758,813,1945,2758,218,0.03299492385786802,0.7131979695431472,0.0,0.29477882523567805,0.705221174764322,0.0337200870195794
11694,25.0,33,2894,2927,4,105,4256,1076,3180,4256,325,0.00775375939849624,0.6799812030075187,0.0009398496240601503,0.25281954887218044,0.7471804511278195,0.024671052631578948
11695,23.0,25,5140,5165,22,486,7073,1921,5152,7073,536,0.0035345680757811397,0.7267071963806023,0.003110419906687403,0.2715962109430228,0.7284037890569772,0.06871200339318535
11696,27.0,323,10139,10462,18,383,13823,3926,9897,13823,1004,0.023366852347536715,0.7334876654850612,0.0013021775302032843,0.2840193879765608,0.7159806120234392,0.027707444114880995
11697,23.0,142,2109,2251,6,137,3128,915,2213,3128,224,0.04539641943734015,0.6742327365728901,0.0019181585677749361,0.29251918158567775,0.7074808184143222,0.04379795396419437
11698,15.0,926,4203,5129,47,212,7763,1861,5902,7763,57,0.1192837820430246,0.5414144016488471,0.0060543604276697156,0.2397269096998583,0.7602730903001417,0.02730903001416978
11699,,172,3711,3883,28,168,5174,1490,3684,5174,374,0.03324313877077696,0.717240046385775,0.005411673753382296,0.28797835330498645,0.7120216466950136,0.03247004252029378
11700,17.0,3654,62512,66166,233,4668,89612,24996,64616,89612,5953,0.04077578895683614,0.6975851448466723,0.0026000982011337766,0.2789358568048922,0.7210641431951078,0.05209123778065438
11701,25.0,129,3186,3315,58,181,4519,1289,3230,4519,322,0.028546138526222616,0.705023235229033,0.012834697942022572,0.28524009736667405,0.714759902633326,0.04005310909493251
11702,,85,1772,1857,0,87,2431,697,1734,2431,172,0.03496503496503497,0.7289181406828465,0.0,0.2867132867132867,0.7132867132867133,0.03578774167009461
11703,33.0,628,9243,9871,179,490,13222,3860,9362,13222,726,0.04749659658145515,0.699062169112086,0.013538042656179096,0.29193767962486766,0.7080623203751324,0.03705944637725004
11704,16.0,392,7676,8068,37,795,11058,3038,8020,11058,812,0.035449448363175984,0.6941580756013745,0.0033459938506058963,0.2747332248146139,0.7252667751853862,0.07189365165491048
11705,,428,22865,23293,100,1573,31225,8834,22391,31225,2372,0.013706965572457966,0.7322658126501201,0.0032025620496397116,0.28291433146517214,0.7170856685348279,0.05037630104083267
11706,47.0,819,30359,31178,82,1031,40623,11888,28735,40623,3084,0.020160992541171256,0.7473352534278611,0.0020185609137680625,0.29264209930335033,0.7073579006966497,0.02537971100115698
11707,26.0,80,2159,2239,9,89,3050,850,2200,3050,213,0.02622950819672131,0.7078688524590164,0.0029508196721311475,0.2786885245901639,0.7213114754098361,0.029180327868852458
11708,26.0,5261,72115,77376,279,3149,100317,29037,71280,100317,5259,0.052443753302032554,0.7188711783645843,0.0027811836478363588,0.2894524357785819,0.7105475642214181,0.031390492139916466
11709,,774,27778,28552,49,1224,37743,10861,26882,37743,3191,0.020507113901915588,0.7359775322576372,0.001298253980870625,0.28776196910685425,0.7122380308931457,0.03242985454256418
11710,16.0,46,3004,3050,34,158,4068,1141,2927,4068,334,0.011307767944936086,0.7384464110127827,0.008357915437561455,0.2804818092428712,0.7195181907571289,0.03883972468043265
11711,15.0,294,5593,5887,124,400,8242,2248,5994,8242,592,0.03567095365202621,0.6785974278087843,0.01504489201650085,0.2727493326862412,0.7272506673137588,0.0485319097306479
11712,,106,2290,2396,33,88,3205,901,2304,3205,256,0.033073322932917315,0.7145085803432137,0.01029641185647426,0.2811232449297972,0.7188767550702028,0.027457098283931357
11713,46.0,101,1840,1941,3,79,2655,753,1902,2655,216,0.038041431261770245,0.6930320150659134,0.0011299435028248588,0.28361581920903955,0.7163841807909604,0.02975517890772128
11714,27.0,3934,67044,70978,535,4182,97320,26935,70385,97320,6825,0.04042334566378956,0.6889025893958076,0.005497328401150843,0.2767673653925195,0.7232326346074804,0.042971639950678174
11715,,547,10292,10839,59,585,14785,4051,10734,14785,1126,0.03699695637470409,0.6961109232330064,0.0039905309435238415,0.2739939127494082,0.7260060872505918,0.039567128846804196
11716,33.0,15640,283996,299636,2317,14878,400496,112224,288272,400496,27718,0.03905157604570333,0.7091107027286165,0.005785326195517558,0.28021253645479605,0.719787463545204,0.03714893532020295
11717,16.0,225,3633,3858,83,240,5365,1476,3889,5365,391,0.04193849021435228,0.6771668219944083,0.015470643056849953,0.275116495806151,0.7248835041938491,0.04473438956197577
11718,13.0,67,2183,2250,0,243,3264,807,2457,3264,244,0.020526960784313725,0.6688112745098039,0.0,0.24724264705882354,0.7527573529411765,0.0744485294117647
11719,16.0,294,9578,9872,31,2035,15010,3756,11254,15010,942,0.019586942038640906,0.638107928047968,0.0020652898067954695,0.2502331778814124,0.7497668221185876,0.13557628247834777
11720,15.0,2482,66760,69242,684,5426,94524,25718,68806,94524,6946,0.02625788159620837,0.7062756548601413,0.007236257458423258,0.2720790487072066,0.7279209512927933,0.057403410773983324
11721,34.0,352,8573,8925,93,502,12137,3428,8709,12137,916,0.0290022246024553,0.70635247590014,0.007662519568262339,0.28244211913982037,0.7175578808601796,0.04136112713191069
11722,,289,13759,14048,27,489,17981,5420,12561,17981,1417,0.01607252099438296,0.7651965964073189,0.0015015850063956398,0.30142928646905065,0.6985707135309493,0.02719537289360992
11723,17.0,882,20331,21213,68,1163,28342,7936,20406,28342,2180,0.031119892738691694,0.7173452826194341,0.0023992661068379085,0.28000846799802415,0.7199915320019759,0.04103450709194834
11724,34.0,405,10236,10641,14,528,13998,3984,10014,13998,1107,0.028932704672096014,0.7312473210458637,0.0010001428775539363,0.28461208744106303,0.715387912558937,0.03771967423917703
11725,33.0,168,3768,3936,18,211,5176,1511,3665,5176,390,0.03245749613601236,0.7279752704791345,0.0034775888717156105,0.2919242658423493,0.7080757341576507,0.04076506955177744
11726,17.0,551,8671,9222,86,579,12888,3428,9460,12888,1002,0.04275294847920546,0.672796399751707,0.006672873991309745,0.265983860955928,0.734016139044072,0.044925512104283055
11727,26.0,3552,58966,62518,158,3434,82370,23545,58825,82370,5924,0.04312249605438873,0.7158674274614544,0.0019181740925094087,0.28584436081097486,0.7141556391890251,0.041689935656185506
11728,23.0,70,1656,1726,4,100,2360,649,1711,2360,184,0.029661016949152543,0.7016949152542373,0.001694915254237288,0.275,0.725,0.0423728813559322
11729,15.0,7923,142635,150558,1138,9932,201175,56754,144421,201175,13134,0.039383621225301355,0.7090095687833975,0.005656766496831118,0.2821125885423139,0.7178874114576861,0.04936995153473344
11730,15.0,358,7763,8121,46,840,11317,3059,8258,11317,824,0.03163382521869754,0.6859591764601927,0.004064681452681806,0.2703013166033401,0.7296986833966599,0.07422461783158081
11731,,139,5829,5968,1,180,8125,2264,5861,8125,840,0.017107692307692306,0.7174153846153846,0.00012307692307692307,0.2786461538461538,0.7213538461538461,0.022153846153846152
11732,33.0,1241,21896,23137,460,1110,33050,8570,24480,33050,1841,0.037549167927382755,0.6625113464447806,0.013918305597579426,0.259304084720121,0.740695915279879,0.03358547655068079
11733,17.0,298,8042,8340,41,515,11109,3188,7921,11109,709,0.026825096768385993,0.7239175443334234,0.0036907012332343145,0.28697452515978034,0.7130254748402196,0.04635880817355297
11734,,406,6746,7152,14,297,9594,2659,6935,9594,684,0.042318115488847195,0.7031478007087764,0.001459245361684386,0.2771523869084845,0.7228476130915156,0.03095684803001876
11735,16.0,194,4470,4664,16,205,6273,1772,4501,6273,471,0.030926191614857323,0.7125777140124342,0.002550613741431532,0.28248047186354214,0.7175195281364578,0.032679738562091505
11736,,312,6332,6644,3,186,8939,2639,6300,8939,728,0.03490323302382817,0.7083566394451281,0.0003356080098445016,0.29522317932654657,0.7047768206734534,0.0208076966103591
11737,24.0,25181,625238,650419,3443,32221,875447,245223,630230,875453,64079,0.02876339449405051,0.7141879689714925,0.0039328210652085265,0.2801098402769766,0.7198901597230234,0.03680494555390181
11738,38.0,165,2797,2962,13,151,3811,1134,2677,3811,255,0.04329572290737339,0.7339281028601417,0.003411178168459722,0.29755969561794804,0.702440304382052,0.03962214641826292
11739,24.0,1044,20485,21529,145,1115,29468,8363,21105,29468,2273,0.03542826116465318,0.6951608524501154,0.0049205918284240535,0.28379937559386453,0.7162006244061355,0.037837654404778064
11740,15.0,1998,41934,43932,207,2396,58261,17001,41260,58261,4535,0.03429395307323939,0.719761075161772,0.0035529771202004773,0.29180755565472616,0.7081924443452738,0.04112528106280359
11741,,232,4563,4795,46,265,6520,1804,4716,6520,430,0.03558282208588957,0.6998466257668712,0.00705521472392638,0.2766871165644172,0.7233128834355829,0.040644171779141106
11742,16.0,468,12006,12474,34,604,16761,4840,11921,16761,1335,0.027921961696796133,0.7163057096831932,0.0020285185848099756,0.2887655867788318,0.7112344132211682,0.036036036036036036
11743,15.0,838,20595,21433,46,1242,28737,8260,20477,28737,2170,0.029161011935831854,0.7166718864182064,0.001600723805546856,0.2874343181264572,0.7125656818735429,0.04321954274976511
11744,17.0,599,11541,12140,36,622,16697,4605,12092,16697,1361,0.03587470803138288,0.6912020123375456,0.0021560759417859495,0.2757980475534527,0.7242019524465473,0.037252200994190576
11745,,400,12752,13152,50,326,17083,5093,11991,17084,1592,0.023413720440177945,0.7464294076328729,0.002926715055022243,0.29811519550456567,0.7018848044954343,0.019082182158745024
11746,27.0,8386,186312,194698,1269,7720,259567,73164,186403,259567,19024,0.032307650818478466,0.717779995145762,0.004888911148181394,0.28186942099727624,0.7181305790027238,0.029741839293900996
11747,16.0,428,11261,11689,64,1168,15749,4331,11418,15749,755,0.02717632865578767,0.7150295256841704,0.004063750079370119,0.27500158740237474,0.7249984125976252,0.07416343894850466
11748,25.0,603,4179,4782,100,308,6481,1874,4607,6481,154,0.09304119734608857,0.6448079000154298,0.015429717636167259,0.28915290850177444,0.7108470914982256,0.04752353031939516
11749,25.0,486,18608,19094,103,1243,25600,7206,18394,25600,2011,0.018984375,0.726875,0.0040234375,0.281484375,0.718515625,0.0485546875
11750,,53,1514,1567,8,72,2101,603,1498,2101,163,0.025226082817705855,0.7206092336982389,0.0038077106139933364,0.2870061875297477,0.7129938124702523,0.03426939552594003
11751,,98,1538,1636,0,138,2339,641,1698,2339,154,0.04189824711415135,0.6575459598118855,0.0,0.2740487387772552,0.7259512612227448,0.058999572466866185
11752,14.0,2210,16621,18831,168,1472,25391,6871,18520,25391,1369,0.08703871450513961,0.6546020243393328,0.00661651766373912,0.2706076956401875,0.7293923043598125,0.057973297625142764
11753,38.0,3272,69809,73081,1615,3177,98486,27793,70693,98486,5309,0.03322299616189103,0.7088215583940864,0.016398269804845357,0.2822025465548403,0.7177974534451598,0.03225839205572366
11754,16.0,117,3959,4076,17,132,5531,1540,3991,5531,387,0.021153498463207375,0.7157837642379317,0.0030735852467908154,0.27843066353281504,0.7215693364671849,0.02386548544566986
11755,,1108,84480,85588,502,4272,113130,32416,80714,113130,9960,0.009794042252276142,0.7467515247944843,0.0044373729337929815,0.2865376115972775,0.7134623884027226,0.03776186687881199
11756,17.0,909,21265,22174,20,1142,29362,8416,20946,29362,2365,0.030958381581636128,0.7242354063074723,0.0006811525100469995,0.2866289762277774,0.7133710237722226,0.03889380832368367
11757,25.0,58,1992,2050,37,141,2791,778,2013,2791,198,0.020781082049444642,0.7137226800429953,0.013256897169473307,0.2787531350770333,0.7212468649229666,0.050519527051236114
11758,,2565,65801,68366,268,2881,91391,25946,65445,91391,6658,0.02806622096267685,0.7199943101618321,0.002932455055749472,0.28390104058386495,0.7160989594161351,0.031523891849306825
11759,,103,2403,2506,9,156,3329,949,2380,3329,248,0.03094022228897567,0.721838389906879,0.0027035145689396217,0.2850705917693001,0.7149294082307,0.046860919194953436
11760,35.0,702,8740,9442,231,689,12804,3549,9255,12804,778,0.054826616682286784,0.6825991877538269,0.01804123711340206,0.27717900656044986,0.7228209934395501,0.05381130896594814
11761,,88,1753,1841,10,78,2512,696,1816,2512,185,0.03503184713375796,0.6978503184713376,0.003980891719745223,0.2770700636942675,0.7229299363057324,0.03105095541401274
11762,46.0,193,5213,5406,29,163,6908,2079,4829,6908,528,0.027938621887666475,0.7546323103647944,0.0041980312680949625,0.30095541401273884,0.6990445859872612,0.023595830920671686
11763,17.0,165,3243,3408,4,139,4618,1314,3304,4618,393,0.035729753139887396,0.702252057167605,0.0008661758336942399,0.2845387613685578,0.7154612386314422,0.030099610220874838
11764,,177,7984,8161,28,445,11023,3106,7917,11023,1070,0.016057334663884607,0.7243037285675406,0.0025401433366597113,0.28177447155946655,0.7182255284405334,0.04037013517191327
11765,,5056,180864,185920,342,7856,243727,68514,175213,243727,20390,0.02074452153433965,0.7420761753929601,0.0014032093284699686,0.281109602136817,0.718890397863183,0.032232785042280915
11766,17.0,630,10485,11115,26,610,14722,4150,10572,14722,1014,0.04279309876375492,0.7121994294253499,0.0017660643934248063,0.2818910474120364,0.7181089525879636,0.041434587691889686
11767,,181,6361,6542,8,296,8475,2503,5972,8475,671,0.02135693215339233,0.7505604719764012,0.0009439528023598821,0.2953392330383481,0.7046607669616519,0.03492625368731563
11768,27.0,1850,63085,64935,379,3052,89650,24327,65323,89650,6330,0.02063580591187953,0.7036809815950921,0.004227551589514779,0.2713552704963748,0.7286447295036252,0.03404350250976018
11769,,840,16686,17526,101,994,23972,6870,17102,23972,1659,0.035040881027865844,0.6960620724178208,0.004213248790255298,0.28658434840647423,0.7134156515935258,0.04146504254964125
11770,,194,5872,6066,14,267,8003,2286,5717,8003,605,0.024240909658877922,0.7337248531800574,0.0017493439960014994,0.28564288391853054,0.7143571160814695,0.033362489066600026
11771,,13,1537,1550,12,29,2117,578,1539,2117,199,0.006140765233821445,0.726027397260274,0.005668398677373642,0.2730278696268304,0.7269721303731695,0.0136986301369863
11772,17.0,655,14523,15178,82,862,20221,5790,14431,20221,1609,0.03239206765244053,0.7182137381929677,0.004055190148855151,0.2863359873398942,0.7136640126601058,0.04262895010137975
11773,41.0,22706,504691,527397,1384,28400,698895,200403,498492,698895,48629,0.03248842816159795,0.7221270720208329,0.0019802688529750533,0.28674264374476854,0.7132573562552315,0.04063557472867884
11774,26.0,94,3928,4022,12,164,5164,1563,3601,5164,382,0.01820294345468629,0.7606506584043378,0.0023237800154918666,0.30267234701781565,0.6973276529821844,0.031758326878388844
11775,13.0,1,5529,5530,40,386,7483,2069,5414,7483,595,0.00013363624214887077,0.7388747828411065,0.005345449685954831,0.2764933850060136,0.7235066149939864,0.05158358946946412
11776,24.0,343,7079,9857,209,394,12969,2820,10149,12969,755,0.026447682936232553,0.5458400801912252,0.016115351993214587,0.217441591487393,0.7825584085126069,0.030380137250366257
11777,,86,2134,2220,5,111,2948,879,2069,2948,229,0.029172320217096336,0.7238805970149254,0.0016960651289009499,0.298168249660787,0.7018317503392131,0.03765264586160109
11778,,107,2759,2866,6,132,3864,1065,2799,3864,254,0.02769151138716356,0.7140269151138716,0.0015527950310559005,0.27562111801242234,0.7243788819875776,0.034161490683229816
11779,17.0,145,13422,13567,13,535,18123,5120,13003,18123,1958,0.008000882856039287,0.7406058599569608,0.0007173205319207636,0.28251393257187,0.71748606742813,0.029520498813662196
11780,,1251,29406,30657,109,1333,40033,11786,28247,40033,2747,0.03124921939399995,0.7345440011990109,0.002722753728174256,0.29440711413084203,0.7055928858691579,0.03329752953813104
11781,,640,18882,19522,105,649,25628,7406,18222,25628,2255,0.024972686124551273,0.7367722803184017,0.0040970813173091935,0.28898080224754175,0.7110191977524583,0.025323864523177773
11782,16.0,1442,12711,14153,23,1722,19553,5206,14347,19553,1100,0.07374827392216028,0.6500792717230093,0.0011762900833631668,0.26625070321689764,0.7337492967831023,0.08806832711092927
11783,,59,3049,3108,0,112,4082,1196,2886,4082,286,0.014453699167074964,0.746937775600196,0.0,0.2929936305732484,0.7070063694267515,0.027437530622243998
11784,15.0,199,3235,3434,5,135,4774,1325,3449,4774,352,0.04168412232928362,0.6776288227901132,0.0010473397570171764,0.27754503560955174,0.7224549643904482,0.02827817343946376
11785,24.0,44,7281,7325,72,663,9980,2723,7257,9980,708,0.004408817635270541,0.7295591182364729,0.007214428857715431,0.27284569138276554,0.7271543086172345,0.06643286573146293
11786,,1216,21442,22658,178,992,29502,8614,20888,29502,1784,0.04121754457324927,0.7267981831740221,0.006033489254965765,0.2919802047318826,0.7080197952681174,0.03362483899396651
11787,,173,2490,2663,7,257,3702,1015,2687,3702,266,0.046731496488384656,0.6726094003241491,0.0018908698001080498,0.2741761210156672,0.7258238789843328,0.06942193408968125
11788,16.0,56,1838,1894,7,101,2575,727,1848,2575,165,0.02174757281553398,0.7137864077669903,0.0027184466019417475,0.28233009708737866,0.7176699029126213,0.03922330097087379
11789,,295,7379,7674,37,368,10103,2971,7132,10103,810,0.029199247748193605,0.7303771157082055,0.0036622785311293676,0.2940710679996041,0.705928932000396,0.036424824309611005
11790,35.0,123,2286,2409,6,106,3244,880,2364,3244,237,0.037916152897657214,0.7046855733662145,0.0018495684340320592,0.2712700369913687,0.7287299630086314,0.032675709001233046
11791,26.0,1159,29132,30291,220,2057,40753,11283,29470,40753,3149,0.028439624076755085,0.7148430790371261,0.005398375579711923,0.27686305302677106,0.723136946973229,0.05047481167030648
11792,,96,2470,2566,5,194,3541,976,2565,3541,230,0.027110985597288903,0.6975430669302457,0.001412030499858797,0.27562835357243715,0.7243716464275628,0.054786783394521324
11793,13.0,235,4949,5184,44,272,7029,1954,5075,7029,550,0.033432920756864416,0.7040830843647745,0.006259780907668232,0.2779911793996301,0.7220088206003699,0.03869682742922179
11794,25.0,2042,35360,37402,217,2466,50483,14252,36231,50483,3276,0.04044926014698017,0.7004338094011846,0.00429847671493374,0.28231285779371273,0.7176871422062873,0.048848127092288494
11795,24.0,305,9906,10211,52,362,13407,4002,9405,13407,860,0.02274931006190796,0.7388677556500336,0.003878570895800701,0.29850078317296935,0.7014992168270306,0.027000820466920265
11796,24.0,6099,118691,124790,597,5494,166432,47954,118478,166432,12227,0.03664559700057681,0.7131501153624303,0.003587050567198616,0.288129686598731,0.7118703134012689,0.033010478754085755
11797,,2170,25690,27860,80,1649,37418,10474,26944,37418,2474,0.05799347907424234,0.6865679619434497,0.0021380084451333584,0.2799187556790849,0.720081244320915,0.044069699075311344
11798,,3505,78512,82017,396,3375,107521,31327,76194,107521,7879,0.032598283126086994,0.7302015420243487,0.0036830014601798716,0.2913570372299365,0.7086429627700636,0.03138921699016936
11799,25.0,95,4417,4512,9,228,6051,1710,4341,6051,569,0.015699884316641877,0.7299619897537597,0.001487357461576599,0.2825979176995538,0.7174020823004462,0.03767972235994051
11800,14.0,140,5719,5859,29,177,7937,2207,5730,7937,695,0.017638906387803955,0.7205493259417917,0.003653773466045105,0.27806475998488095,0.7219352400151191,0.022300617361723573
11801,23.0,1450,38101,39551,200,2484,52839,14695,38144,52839,3711,0.027441851662597702,0.721077234618369,0.003785082987944511,0.2781089725392229,0.721891027460777,0.04701073071027082
11802,25.0,62,2172,2234,3,88,2911,831,2080,2911,218,0.021298522844383373,0.7461353486774305,0.0010305736860185502,0.28546891102713845,0.7145310889728615,0.03023016145654414
11803,13.0,318,10114,10432,88,1043,14582,3953,10629,14582,1142,0.021807708133315045,0.6935948429570704,0.006034837470854478,0.27108764229872445,0.7289123577012755,0.07152653956933205
11804,,277,4688,4965,3,204,6639,1849,4790,6639,488,0.041723151076969424,0.7061304413315258,0.00045187528242205153,0.27850579906612444,0.7214942009338756,0.030727519204699502
11805,26.0,239,4639,4878,17,297,6712,1818,4894,6712,473,0.03560786650774732,0.691150178784267,0.002532777115613826,0.2708581644815256,0.7291418355184743,0.04424910607866508
11806,16.0,258,3963,4221,41,535,5816,1314,4502,5816,287,0.04436038514442916,0.6813961485557084,0.007049518569463549,0.22592847317744155,0.7740715268225584,0.09198762035763411
11807,15.0,209,4104,4313,16,382,6218,1605,4613,6218,418,0.03361209392087488,0.6600192988099067,0.002573174654229656,0.25812158250241235,0.7418784174975876,0.061434544869733036
11808,24.0,33,9366,9399,17,618,12848,3474,9374,12848,925,0.0025684931506849314,0.7289850560398505,0.0013231631382316315,0.2703922789539228,0.7296077210460772,0.048100871731008715
11809,17.0,1625,13904,15529,73,1373,21268,5804,15464,21268,1444,0.07640586797066015,0.6537521158548053,0.003432386684220425,0.2728982508933609,0.727101749106639,0.06455708106074855
11810,16.0,256,2989,3245,36,187,4514,1211,3303,4514,311,0.056712450155073105,0.6621621621621622,0.007975188303057155,0.268276473194506,0.731723526805494,0.041426672574213556
11811,16.0,2891,61108,63999,304,3146,84605,24417,60188,84605,6617,0.034170557295668105,0.7222740972755747,0.003593168252467348,0.28859996454110276,0.7114000354588972,0.03718456356007328
11812,25.0,419,9118,9537,48,441,13025,3608,9417,13025,947,0.03216890595009597,0.7000383877159309,0.0036852207293666026,0.27700575815738965,0.7229942418426104,0.03385796545105566
11813,15.0,93,1797,1890,21,42,2643,704,1939,2643,202,0.03518728717366629,0.6799091940976163,0.007945516458569807,0.26636398032538783,0.7336360196746122,0.015891032917139614
11814,15.0,775,15023,15798,34,830,20840,6116,14724,20840,1474,0.03718809980806142,0.720873320537428,0.0016314779270633398,0.29347408829174665,0.7065259117082534,0.03982725527831094
11815,26.0,336,7940,8276,15,312,10956,3176,7781,10957,793,0.030665328100757505,0.7246509080952815,0.00136898786164096,0.2898603632381126,0.7101396367618874,0.02847494752213197
11816,15.0,1419,70244,71663,43,8873,99452,27321,72131,99452,7289,0.01426818967944335,0.7063105819893014,0.00043236938422555604,0.2747154406145678,0.7252845593854321,0.08921891967984555
11817,,295,8723,9018,23,359,11564,3516,8048,11564,832,0.025510204081632654,0.7543237634036666,0.0019889311656866135,0.30404704254583187,0.6959529574541681,0.03104462123832584
11818,,1449,37221,38670,163,2044,51654,14505,37149,51654,3712,0.028052038564293183,0.7205831106981067,0.0031556123436713517,0.2808107794168893,0.7191892205831107,0.03957099159794014
11819,,69,2108,2177,0,136,2927,844,2083,2927,199,0.023573624871882474,0.7201913221728733,0.0,0.2883498462589682,0.7116501537410318,0.04646395626921763
11820,,46,6431,6477,9,428,8798,2493,6305,8798,705,0.005228461013866788,0.7309615821777676,0.0010229597635826324,0.28335985451238915,0.7166401454876108,0.04864741986815185
11821,25.0,168,5649,5817,9,297,7620,2231,5389,7620,539,0.02204724409448819,0.7413385826771653,0.0011811023622047244,0.29278215223097115,0.7072178477690289,0.03897637795275591
11822,39.0,398,12006,12404,42,892,16853,4578,12275,16853,1283,0.023615973417195752,0.7123954192131965,0.002492137898297039,0.27164303091437725,0.7283569690856228,0.052928262030499024
11823,36.0,2518,52514,55032,178,2936,74953,20995,53958,74953,5517,0.0335943858151108,0.7006257254546182,0.002374821554841034,0.2801088682240871,0.7198911317759129,0.039171213960748734
11824,16.0,7,2873,2880,3,209,3959,1096,2863,3959,362,0.0017681232634503663,0.7256883051275574,0.0007577671129072998,0.2768375852488002,0.7231624147511998,0.05279110886587522
11825,13.0,252,3621,3873,36,570,5572,1490,4082,5572,264,0.04522613065326633,0.6498564249820531,0.006460875807609476,0.26740847092605885,0.7325915290739411,0.10229720028715003
11826,24.0,142,3402,3544,21,185,4836,1321,3515,4836,390,0.029363110008271298,0.7034739454094293,0.004342431761786601,0.27315963606286187,0.7268403639371381,0.03825475599669148
11827,24.0,189,3991,4180,3,182,5663,1585,4078,5663,332,0.03337453646477132,0.7047501324386367,0.0005297545470598623,0.27988698569662723,0.7201130143033728,0.032138442521631644
11828,13.0,64,4232,4296,66,355,6098,1594,4504,6098,356,0.010495244342407346,0.6939980321416858,0.010823220728107576,0.261397179403083,0.7386028205969171,0.05821580846179075
11829,25.0,56,1760,1816,12,75,2423,687,1736,2423,194,0.02311184482047049,0.7263722657862154,0.004952538175815105,0.2835328105654148,0.7164671894345852,0.03095336359884441
11830,26.0,104,2775,2879,8,171,3867,1108,2759,3867,291,0.026894233255753814,0.7176105508145849,0.002068787173519524,0.2865270235324541,0.7134729764675459,0.04422032583397983
11831,24.0,838,16459,17297,24,779,23150,6564,16586,23150,1878,0.03619870410367171,0.7109719222462203,0.0010367170626349891,0.2835421166306695,0.7164578833693305,0.033650107991360693
11832,23.0,111,2290,2401,34,119,3290,880,2410,3290,206,0.033738601823708206,0.6960486322188449,0.01033434650455927,0.2674772036474164,0.7325227963525835,0.036170212765957444
11833,27.0,210,2942,3152,7,96,3979,1207,2772,3979,232,0.052777079668258356,0.7393817542096004,0.0017592359889419453,0.3033425483789897,0.6966574516210103,0.02412666499120382
11834,,1043,27870,28913,89,1329,38696,11095,27601,38696,2987,0.02695369030390738,0.7202294810833161,0.00229997932602853,0.2867221418234443,0.7132778581765558,0.034344635104403554
11835,,299,4014,4313,19,269,5917,1622,4295,5917,457,0.050532364373838096,0.6783843163765422,0.0032110866993408822,0.2741254013858374,0.7258745986141626,0.04546222748014196
11836,15.0,120,2180,2300,5,142,3192,832,2360,3192,237,0.03759398496240601,0.6829573934837093,0.0015664160401002505,0.2606516290726817,0.7393483709273183,0.044486215538847115
11837,,1544,26990,28534,609,1446,38626,10618,28008,38626,2595,0.03997307513074095,0.6987521358670326,0.015766582094961942,0.27489255941593743,0.7251074405840625,0.037435923989022936
11838,,2834,74348,77182,201,4919,105292,29466,75826,105292,7642,0.026915625118717472,0.706112525168104,0.0019089769403183529,0.2798503210120427,0.7201496789879573,0.046717699350378
11839,,108,3673,3781,8,147,5045,1430,3615,5045,434,0.021407333994053517,0.7280475718533201,0.0015857284440039642,0.28344895936570863,0.7165510406342914,0.029137760158572844
11840,17.0,4845,174424,179269,513,8046,235345,68170,167175,235345,19867,0.020586798104909813,0.7411417281012981,0.002179778622872804,0.2896598610550468,0.7103401389449532,0.034188106821899766
11841,,689,19948,20637,48,614,27193,7935,19258,27193,2287,0.02533740300812709,0.7335711396315229,0.0017651601515095796,0.2918030375464274,0.7081969624535727,0.022579340271393373
11842,23.0,66,2019,2085,4,141,2842,770,2072,2842,200,0.02322308233638283,0.7104152005629838,0.0014074595355383533,0.270935960591133,0.729064039408867,0.04961294862772695
11843,38.0,198,7109,7307,15,391,9416,2733,6683,9416,677,0.02102803738317757,0.7549915038232795,0.0015930331350892098,0.29025063721325406,0.7097493627867459,0.0415250637213254
11844,,94,3756,3850,17,417,5490,1450,4040,5490,332,0.017122040072859744,0.6841530054644809,0.0030965391621129326,0.2641165755919854,0.7358834244080146,0.07595628415300547
11845,26.0,923,10037,10960,95,700,16386,4171,12215,16386,1006,0.05632857317222019,0.6125350909312828,0.005797632124984743,0.2545465641401196,0.7454534358598803,0.042719394605150736
11846,17.0,4,1964,1968,6,104,2656,757,1899,2656,222,0.0015060240963855422,0.7394578313253012,0.002259036144578313,0.28501506024096385,0.7149849397590361,0.0391566265060241
11847,,173,3199,3372,8,126,4605,1286,3319,4605,408,0.03756786102062975,0.6946796959826276,0.001737242128121607,0.2792616720955483,0.7207383279044517,0.02736156351791531
11848,16.0,196,6149,6345,5,374,8409,2373,6036,8409,577,0.023308360090379357,0.7312403377333809,0.0005946010227137591,0.28219764537995007,0.7178023546200499,0.04447615649898918
11849,17.0,468,5279,5747,31,562,7994,2110,5884,7994,342,0.058543907930948214,0.6603702777082812,0.0038779084313234928,0.26394796097072803,0.736052039029272,0.07030272704528397
11850,,97,3230,3327,11,168,4295,1272,3023,4295,325,0.022584400465657743,0.7520372526193247,0.002561117578579744,0.2961583236321304,0.7038416763678697,0.03911525029103609
11851,17.0,207,5104,5311,18,268,7120,2037,5083,7120,570,0.029073033707865167,0.7168539325842697,0.0025280898876404493,0.28609550561797753,0.7139044943820225,0.037640449438202245
11852,25.0,138,3751,3889,0,36,5082,1550,3532,5082,388,0.02715466351829988,0.7380952380952381,0.0,0.30499803227075956,0.6950019677292405,0.0070838252656434475
11853,44.0,393,5651,6044,134,248,8371,2362,6009,8371,670,0.04694779596225063,0.6750686895233544,0.01600764544259945,0.2821646159359694,0.7178353840640306,0.029626090072870623
11854,23.0,617,14735,15352,25,1007,20358,5761,14597,20358,1405,0.030307495824737202,0.7237940858630514,0.0012280184693977798,0.28298457608802435,0.7170154239119756,0.049464583947342565
11855,,1624,48167,49791,148,2068,64927,18956,45971,64927,4880,0.025012706578157008,0.741863939501286,0.002279483111802486,0.2919586612657292,0.7080413387342708,0.031851155913564466
11856,27.0,4004,104156,108160,427,4817,145452,41208,104244,145452,11024,0.027527981739680445,0.716085031488051,0.002935676374336551,0.28330995792426367,0.7166900420757363,0.03311745455545472
11857,15.0,396,9181,9577,46,339,12559,3579,8980,12559,1051,0.03153117286408153,0.7310295405685167,0.0036627119993630068,0.28497491838522176,0.7150250816147783,0.026992594951827376
11858,17.0,796,47698,48494,247,4680,67899,18364,49535,67899,4759,0.011723294893886509,0.7024845726741189,0.0036377560788818687,0.27046053697403494,0.7295394630259651,0.06892590465249857
11859,17.0,685,16083,16768,308,2024,23705,6255,17450,23705,1615,0.028896857203121705,0.6784644589748998,0.012993039443155453,0.26386838219784853,0.7361316178021514,0.08538283062645012
11860,,373,6007,6380,39,710,9015,2336,6679,9015,497,0.04137548530227399,0.6663338879645037,0.004326123128119801,0.2591236827509706,0.7408763172490294,0.07875762617859124
11861,23.0,105,2209,2314,4,110,3063,902,2161,3063,217,0.034280117531831536,0.7211883774077702,0.001305909239307868,0.2944825334639243,0.7055174665360757,0.03591250408096637
11862,17.0,198,1821,2019,0,143,3261,841,2420,3261,201,0.06071757129714812,0.5584176632934683,0.0,0.2578963508126342,0.7421036491873658,0.043851579270162526
11863,23.0,899,19681,20580,141,945,27268,7862,19406,27268,1859,0.032969047968314506,0.721761772040487,0.005170896288690039,0.28832330937362477,0.7116766906263753,0.03465600704122048
11864,26.0,207,6413,6620,29,457,8832,2501,6331,8832,656,0.0234375,0.7261096014492754,0.003283514492753623,0.2831748188405797,0.7168251811594203,0.051743659420289856
11865,,122,3451,3573,4,311,5191,1377,3814,5191,368,0.023502215372760548,0.664804469273743,0.0007705644384511655,0.26526680793681373,0.7347331920631863,0.05991138508957811
11866,,17747,385693,403440,6314,24170,545508,152840,392668,545508,38400,0.032532978434780056,0.7070345439480265,0.011574532362495142,0.28017920910417443,0.7198207908958255,0.044307324548860876
11867,16.0,1710,5879,7589,80,469,10500,2909,7591,10500,586,0.16285714285714287,0.5599047619047619,0.007619047619047619,0.27704761904761904,0.7229523809523809,0.04466666666666667
11868,13.0,701,9586,10287,68,679,14736,3878,10858,14736,835,0.04757057546145494,0.6505157437567861,0.004614549402823019,0.26316503800217156,0.7368349619978285,0.046077633007600434
11869,15.0,730,19489,20219,206,905,25851,7945,17906,25851,1730,0.028238752852887704,0.7538973347259293,0.007968743955746392,0.3073382074194422,0.6926617925805578,0.03500831689296352
11870,,198,4420,4618,9,326,6202,1733,4469,6202,502,0.03192518542405676,0.7126733311834892,0.0014511447920025798,0.2794259916156079,0.7205740083843921,0.052563689132537894
11871,,122,10571,10693,11,776,14892,4083,10809,14892,1418,0.008192318023099651,0.7098442116572656,0.000738651625033575,0.274174053182917,0.725825946817083,0.05210851463873221
11872,14.0,569,1014,1583,89,330,2995,556,2439,2995,31,0.18998330550918197,0.33856427378964943,0.02971619365609349,0.18564273789649416,0.8143572621035059,0.11018363939899833
11873,26.0,440,11728,12168,20,375,15741,4713,11028,15741,1177,0.027952480782669462,0.7450606695889714,0.0012705673083031573,0.29940918620163903,0.700590813798361,0.0238231370306842
11874,13.0,86,18127,18213,88,867,24292,6835,17457,24292,2379,0.003540260167956529,0.7462127449366046,0.0036225917997694712,0.2813683517207311,0.7186316482792688,0.03569076239091059
11875,15.0,926,15563,16489,121,344,20852,6389,14463,20852,1559,0.04440821024362172,0.746355265681949,0.005802800690581239,0.3063974678687896,0.6936025321312105,0.016497218492230962
11876,,727,16699,17426,704,1250,25469,6554,18915,25469,1629,0.028544505084612665,0.655659821744081,0.027641446464329183,0.25733244336251915,0.7426675566374809,0.04907927284149358
11877,42.0,82,2369,2451,6,152,3452,904,2548,3452,223,0.023754345307068367,0.686268829663963,0.0017381228273464658,0.26187717265353416,0.7381228273464658,0.0440324449594438
11878,46.0,354,6288,6642,96,250,8952,2531,6421,8952,683,0.039544235924932974,0.7024128686327078,0.010723860589812333,0.28273011617515637,0.7172698838248436,0.027926720285969615
11879,25.0,447,11231,11678,43,502,15926,4414,11512,15926,1368,0.028067311314831093,0.7051990455858345,0.002699987441918875,0.2771568504332538,0.7228431495667462,0.031520783624262215
11880,,2984,18554,21538,1346,2101,31136,7998,23138,31136,1618,0.09583761562178829,0.5959018499486125,0.043229701952723534,0.2568730729701953,0.7431269270298048,0.06747816032887975
11881,,100,2895,2995,1,138,4058,1145,2913,4058,324,0.02464268112370626,0.7134056185312962,0.0002464268112370626,0.2821586988664367,0.7178413011335634,0.03400689995071464
11882,23.0,733,16131,16864,98,868,22490,6375,16115,22490,1608,0.03259226322810138,0.7172521120497999,0.004357492218763895,0.28345931525122275,0.7165406847487772,0.03859493108048021
11883,17.0,1814,29483,31297,244,1603,41141,11429,29712,41141,3084,0.044092268053766315,0.7166330424637223,0.005930823266327994,0.2778007340609125,0.7221992659390876,0.03896356432755645
11884,,1511,22123,23634,410,1545,31527,8806,22721,31527,1814,0.04792717353379643,0.7017159894693438,0.013004726107780633,0.27931614171979574,0.7206838582802043,0.04900561423541726
11885,36.0,488,10024,10512,73,430,14165,4018,10147,14165,1070,0.03445111189551712,0.707659724673491,0.005153547476173668,0.28365690081186024,0.7163430991881398,0.030356512530885987
11886,,647,16093,16740,119,1089,22659,6383,16276,22659,1661,0.02855377554172735,0.7102255174544331,0.005251776336113685,0.2816982214572576,0.7183017785427424,0.04806037336157818
11887,24.0,3175,50732,53907,651,2265,76500,20761,55739,76500,6077,0.04150326797385621,0.6631633986928105,0.008509803921568627,0.27138562091503265,0.7286143790849673,0.029607843137254904
11888,,1736,45867,47603,258,2291,64510,18154,46356,64510,4200,0.026910556502867774,0.7110060455743296,0.003999379941094404,0.28141373430475897,0.7185862656952411,0.035513873818012714
11889,,203,3626,3829,5,274,5188,1461,3727,5188,351,0.03912875867386276,0.6989205859676175,0.0009637625289128759,0.28161141094834236,0.7183885890516577,0.0528141865844256
11890,14.0,177,3251,3428,14,180,4662,1284,3378,4662,353,0.03796653796653797,0.6973401973401974,0.003003003003003003,0.2754182754182754,0.7245817245817245,0.03861003861003861
11891,26.0,478,12286,12764,124,767,16946,4798,12149,16947,1104,0.028205582108927835,0.7249660706909777,0.007316929250014752,0.2831179559804095,0.7168820440195904,0.045258747860978346
11892,,78,2170,2248,10,211,3156,832,2324,3156,206,0.024714828897338403,0.6875792141951838,0.0031685678073510772,0.26362484157160965,0.7363751584283904,0.06685678073510773
11893,44.0,131,3789,3920,9,205,5251,1501,3750,5251,371,0.02494762902304323,0.7215768425061893,0.0017139592458579318,0.28585031422586177,0.7141496857741383,0.03904018282231956
11894,,90,2449,2539,2,117,3367,944,2423,3367,276,0.02673002673002673,0.7273537273537274,0.000594000594000594,0.2803682803682804,0.7196317196317197,0.03474903474903475
11895,,473,8554,9027,22,496,11940,3445,8495,11940,873,0.03961474036850921,0.7164154103852596,0.0018425460636515912,0.28852596314907875,0.7114740368509213,0.04154103852596315
11896,34.0,380,10568,10948,92,606,14687,4116,10571,14687,1032,0.0258732212160414,0.7195478995029618,0.006264043031252128,0.28024783822427995,0.71975216177572,0.041260979097160755
11897,,4426,68154,72580,220,4880,98263,27700,70563,98263,6926,0.04504238624914769,0.6935876169056512,0.002238889510802642,0.2818965429510599,0.7181034570489401,0.049662640057804054
11898,17.0,193,4959,5152,48,227,6808,2024,4784,6808,503,0.02834900117508813,0.7284077555816686,0.007050528789659225,0.2972972972972973,0.7027027027027027,0.03334312573443008
11899,17.0,106,10492,10598,11,653,14234,4026,10208,14234,1187,0.007446957987916257,0.737108332162428,0.0007727975270479134,0.2828438948995363,0.7171561051004637,0.04587607137838977
11900,,708,13134,13842,392,570,19483,5257,14227,19484,1205,0.03633750769862451,0.6740915623075344,0.020119072059125435,0.26981112707862864,0.7301888729213714,0.0292547731471977
11901,,897,21819,22716,94,925,29808,8560,21248,29808,2000,0.03009259259259259,0.7319847020933977,0.003153515834675255,0.2871712292002147,0.7128287707997852,0.031031937734836285
11902,23.0,2710,53482,56192,293,4842,76994,20964,56030,76994,4941,0.03519754786087228,0.6946255552380705,0.0038054913369872977,0.272280956957685,0.7277190430423149,0.06288801724809726
11903,17.0,138,5655,5793,0,193,7675,2223,5452,7675,579,0.017980456026058633,0.7368078175895766,0.0,0.2896416938110749,0.710358306188925,0.02514657980456026
11904,,1434,33653,35087,115,1890,46613,13532,33081,46613,3493,0.030763949971038124,0.721965975157145,0.0024671229056271856,0.29030527964301805,0.709694720356982,0.04054662862291635
11905,23.0,241,5689,5930,4,155,7472,2223,5249,7472,479,0.03225374732334047,0.7613758029978587,0.0005353319057815846,0.29751070663811563,0.7024892933618844,0.020744111349036403
11906,23.0,542,8485,9027,18,521,12165,3419,8746,12165,974,0.04455404849979449,0.6974928072338676,0.0014796547472256474,0.28105219893136046,0.7189478010686395,0.04282778462803124
11907,,7819,36656,44475,2959,9550,74475,13829,60646,74475,1030,0.10498825109097012,0.4921920107418597,0.03973145350788855,0.1856864719704599,0.8143135280295402,0.12823094998321585
11908,25.0,80,1793,1873,4,112,2483,699,1784,2483,184,0.03221908981071285,0.7221103503826017,0.0016109544905356424,0.2815142972211035,0.7184857027788965,0.045106725734997986
11909,17.0,181,2836,3017,12,198,4152,1157,2995,4152,240,0.04359344894026975,0.6830443159922929,0.002890173410404624,0.27866088631984587,0.7213391136801541,0.0476878612716763
11910,,3698,93687,97385,287,4089,129418,37107,92311,129418,10889,0.02857407779443354,0.7239101206941847,0.0022176204237432198,0.28672209429909284,0.7132779057009071,0.03159529586301751
11911,,458,8444,8902,55,486,11914,3370,8544,11914,885,0.03844216887695148,0.7087460130938392,0.004616417659895921,0.2828605002518046,0.7171394997481954,0.04079234514017123
11912,13.0,320,5148,5468,13,971,8537,2071,6466,8537,523,0.0374838936394518,0.6030221389246808,0.0015227831791027294,0.2425910741478271,0.7574089258521729,0.11374018976221155
11913,17.0,1371,24540,25911,51,1738,34908,9840,25068,34908,2405,0.03927466483327604,0.7029907184599519,0.0014609831557236164,0.28188380886902714,0.7181161911309728,0.049788014208777355
11914,15.0,215,3956,4171,19,493,6029,1612,4417,6029,252,0.03566097196881738,0.6561618842262399,0.0031514347321280477,0.26737435727317965,0.7326256427268204,0.08177143804942777
11915,23.0,140,3591,3731,7,110,4893,1452,3441,4893,395,0.02861230329041488,0.7339055793991416,0.001430615164520744,0.2967504598405886,0.7032495401594114,0.022481095442468832
11916,17.0,842,23506,24348,417,1937,33855,9195,24660,33855,2176,0.024870772411756017,0.6943139861172648,0.01231723526805494,0.2715994683207798,0.7284005316792203,0.05721459164082115
11917,25.0,36,1730,1766,3,33,2300,675,1625,2300,214,0.01565217391304348,0.7521739130434782,0.0013043478260869566,0.29347826086956524,0.7065217391304348,0.014347826086956521
11918,24.0,119,25237,25356,41,479,32719,9736,22983,32719,2995,0.0036370304715914303,0.771325529508848,0.00125309453222898,0.29756410648247195,0.702435893517528,0.014639811730187352
11919,,343,9733,10076,73,814,13997,3927,10070,13997,886,0.024505251125241122,0.6953632921340287,0.0052154033007072945,0.2805601200257198,0.7194398799742802,0.05815531899692791
11920,23.0,328,12572,12900,43,465,16357,4917,11440,16357,1060,0.020052576878400685,0.7686005991318702,0.002628843920034236,0.30060524546065903,0.699394754539341,0.028428195879439996
11921,23.0,293,6146,6439,20,353,8742,2478,6264,8742,657,0.03351635781285747,0.7030427819720888,0.0022878059940517046,0.2834591626630062,0.7165408373369938,0.04037977579501258
11922,,1286,25355,26641,85,1074,35562,10281,25281,35562,3320,0.03616219560204713,0.7129801473482931,0.0023901917777402848,0.2891007254935043,0.7108992745064957,0.030200776109330182
11923,,294,6998,7292,14,321,9688,2795,6893,9688,901,0.030346820809248554,0.7223369116432701,0.001445086705202312,0.28850123864574734,0.7114987613542527,0.03313377374071016
11924,,1068,18435,19503,82,1209,26397,7460,18937,26397,2110,0.040459143084441415,0.6983748153199227,0.003106413607606925,0.2826078721066788,0.7173921278933212,0.0458006591658143
11925,26.0,394,14837,15231,70,1196,20389,5743,14646,20389,1484,0.01932414537250478,0.7276963068321154,0.0034332237971455197,0.28167148952866744,0.7183285104713326,0.05865908087694345
11926,15.0,2304,37737,40041,337,2575,54429,15221,39208,54429,3969,0.04233037535137519,0.693325249407485,0.006191552297488471,0.27964871667677155,0.7203512833232284,0.04730933877161072
11927,,3002,61408,64410,246,2991,87455,24532,62924,87456,6979,0.03432583241858763,0.7021587998536407,0.0028128430296377608,0.2805067691181851,0.7194932308818148,0.034200054884742044
11928,16.0,229,7428,7657,7,313,10155,2927,7228,10155,789,0.022550467749876908,0.7314623338257016,0.00068931560807484,0.2882323978335795,0.7117676021664204,0.030822255046774986
11929,,184,88101,88285,367,4285,121842,33544,88298,121842,10542,0.0015101524925723478,0.7230757866745458,0.003012097634641585,0.2753073652763415,0.7246926347236585,0.035168496905828864
11930,24.0,2053,42650,44703,174,2237,61147,17157,43990,61147,4340,0.03357482787381229,0.6974994684939572,0.002845601583070306,0.28058612850998416,0.7194138714900159,0.03658396977774871
11931,,3771,71901,75672,350,6394,104000,28512,75488,104000,6252,0.03625961538461538,0.6913557692307692,0.0033653846153846156,0.27415384615384614,0.7258461538461538,0.06148076923076923
11932,26.0,5474,95596,101100,135,5789,134739,38194,96545,134739,8998,0.04062669308811851,0.7094901995710226,0.0010019370783514794,0.2834665538559734,0.7165334461440266,0.04296454627093863
11933,,1931,50261,52192,408,1749,67535,19904,47631,67535,4271,0.028592581624342934,0.7442215147701192,0.006041311912341749,0.294721255645221,0.705278744354779,0.02589768268305323
11934,25.0,939,19551,20490,91,1357,27800,7753,20047,27800,1977,0.033776978417266186,0.7032733812949641,0.0032733812949640286,0.27888489208633094,0.7211151079136691,0.04881294964028777
11935,,97,3444,3541,7,183,5064,1359,3705,5064,450,0.01915481832543444,0.6800947867298578,0.001382306477093207,0.2683649289099526,0.7316350710900474,0.03613744075829384
11936,25.0,10916,229311,240227,1881,14994,322333,90604,231729,322333,23061,0.03386559862006062,0.7114102496486553,0.005835579974746613,0.2810881914045413,0.7189118085954588,0.04651711118625769
11937,25.0,1216,22064,23280,109,1161,30857,8867,21990,30857,2323,0.03940758984995301,0.7150403474090158,0.0035324237612211168,0.2873578118417215,0.7126421881582785,0.03762517419062125
11938,17.0,619,9107,9726,56,640,13486,3693,9793,13486,891,0.0458994512828118,0.675292896336942,0.004152454397152602,0.2738395372979386,0.7261604627020614,0.047456621681744034
11939,23.0,119,2583,2702,4,235,3856,1054,2802,3856,275,0.030860995850622408,0.6698651452282157,0.001037344398340249,0.2733402489626556,0.7266597510373444,0.060943983402489625
11940,17.0,149,2496,2645,4,146,3667,1009,2658,3667,244,0.04063266975729479,0.6806653940550859,0.00109080992637033,0.2751568039269157,0.7248431960730842,0.039814562312517045
11941,15.0,128,9089,10454,114,3690,16233,3518,12715,16233,65,0.007885172180126902,0.5599088276966673,0.0070227314729255225,0.2167190291381753,0.7832809708618247,0.22731472925522084
11942,23.0,1865,60977,62842,164,2534,80804,24253,56551,80804,5423,0.02308054056729865,0.7546284837384288,0.0020296024949259936,0.30014603237463494,0.6998539676253651,0.03135983367160042
11943,23.0,557,6679,7236,379,357,10035,2640,7395,10035,660,0.05550572994519183,0.6655705032386646,0.03776781265570503,0.26307922272047835,0.7369207772795217,0.035575485799701045
11944,25.0,262,10779,11041,13,321,14362,4267,10095,14362,1359,0.01824258459824537,0.7505222113911711,0.0009051664113633198,0.29710346748363736,0.7028965325163626,0.02235064754212505
11945,,56,2119,2175,9,107,2913,802,2111,2913,217,0.01922416752488843,0.7274287675935461,0.003089598352214212,0.27531754205286646,0.7246824579471335,0.036731891520768965
11946,17.0,915,15294,16209,48,1059,22443,6209,16234,22443,1508,0.040769950541371475,0.6814596979013501,0.002138751503809651,0.2766564184823776,0.7233435815176225,0.047186205052800426
11947,34.0,133,2910,3043,3,95,3874,1121,2753,3874,271,0.03433144037170883,0.7511615900877646,0.0007743933918430562,0.2893649974186887,0.7106350025813113,0.024522457408363448
11948,13.0,1588,9345,10933,31,647,14713,4320,10393,14713,715,0.10793176102766261,0.6351525861483042,0.002106980221572759,0.29361788894175217,0.7063821110582478,0.04397471623734113
11949,25.0,99,2712,2811,14,129,3681,1084,2597,3681,272,0.02689486552567237,0.7367563162184189,0.0038033143167617496,0.29448519424069547,0.7055148057593046,0.03504482477587612
11950,34.0,73,3664,3737,16,139,4825,1436,3389,4825,318,0.015129533678756477,0.7593782383419689,0.003316062176165803,0.29761658031088084,0.7023834196891192,0.028808290155440414
11951,16.0,177,5435,5612,23,389,7565,2158,5407,7565,556,0.02339722405816259,0.7184401850627892,0.003040317250495704,0.285261070720423,0.714738929279577,0.05142101784534038
11952,41.0,288,6527,6815,12,272,9309,2567,6742,9309,786,0.030937802126973897,0.7011494252873564,0.0012890750886239124,0.27575464604146527,0.7242453539585347,0.029219035342142013
11953,16.0,442,4892,5334,172,712,8068,2004,6064,8068,289,0.054784333168071395,0.6063460585027268,0.021318790282597918,0.248388696083292,0.7516113039167079,0.08824987605354487
11954,24.0,1590,27686,29276,205,1792,40597,11225,29372,40597,2831,0.039165455575535135,0.6819715742542553,0.0050496342094243415,0.2764982634184792,0.7235017365815208,0.04414119269896791
11955,24.0,114,2079,2193,29,121,2900,850,2050,2900,173,0.039310344827586205,0.7168965517241379,0.01,0.29310344827586204,0.7068965517241379,0.04172413793103448
11956,16.0,85,2919,3004,11,139,4025,1149,2876,4025,300,0.02111801242236025,0.7252173913043478,0.002732919254658385,0.2854658385093168,0.7145341614906833,0.03453416149068323
11957,,384,8124,8508,55,423,11679,3223,8456,11679,991,0.032879527356794246,0.6956075006421782,0.004709307303707509,0.27596540799726005,0.72403459200274,0.03621885435396866
11958,,932,23591,24523,57,1150,32295,9417,22878,32295,2352,0.02885895649481344,0.7304845951385663,0.0017649790989317231,0.2915931258708778,0.7084068741291222,0.035609227434587394
11959,,209,17847,18056,65,680,23577,6840,16737,23577,2267,0.008864571404334732,0.7569665351825932,0.0027569241209653476,0.2901132459600458,0.7098867540399542,0.028841667727022097
11960,15.0,74,2274,2348,3,409,3372,899,2473,3372,253,0.021945432977461446,0.6743772241992882,0.0008896797153024911,0.2666073546856465,0.7333926453143536,0.12129300118623962
11961,15.0,4294,50747,55041,82,4020,75068,20869,54199,75068,4813,0.05720147066659562,0.6760137475355678,0.0010923429423988916,0.27800127884051795,0.721998721159482,0.05355144668833591
11962,,1145,20796,21941,179,4252,31468,8339,23129,31468,1724,0.03638617007753909,0.6608618278886488,0.005688318291597814,0.2649993644337104,0.7350006355662896,0.13512139316130672
11963,27.0,5568,83900,89468,596,4697,119430,33871,85559,119430,7752,0.04662145189650842,0.7025035585698736,0.0049903709285774095,0.2836054592648413,0.7163945407351586,0.03932847693209411
11964,23.0,372,11560,11932,32,593,15801,4512,11289,15801,1272,0.023542813745965445,0.7315992658692487,0.002025188279222834,0.2855515473704196,0.7144484526295805,0.03752927029934814
11965,35.0,390,11625,12015,36,359,15157,4525,10632,15157,921,0.02573068549185195,0.7669723560071254,0.002375140199247872,0.2985419278221284,0.7014580721778716,0.023685425875832947
11966,,101,4061,4162,4,312,5528,1582,3946,5528,430,0.018270622286541246,0.7346237337192475,0.000723589001447178,0.2861794500723589,0.7138205499276411,0.056439942112879886
11967,26.0,3432,52735,56167,210,2960,74090,21288,52802,74090,5568,0.04632204076123633,0.7117694695640437,0.0028343906060197058,0.28732622486165477,0.7126737751383453,0.039951410446753946
11968,,87,2279,2366,6,135,3176,909,2267,3176,256,0.02739294710327456,0.7175692695214105,0.001889168765743073,0.28620906801007556,0.7137909319899244,0.04250629722921914
11969,17.0,687,16449,17136,20,933,23270,6561,16709,23270,1698,0.029522990975504943,0.7068758057584873,0.0008594757198109154,0.28195100988397076,0.7180489901160292,0.0400945423291792
11970,,866,33372,34238,220,880,47164,13061,34103,47164,3716,0.01836146213213468,0.7075735730642015,0.004664574675600034,0.2769273174455093,0.7230726825544908,0.018658298702400135
11971,,38,2355,2393,29,294,3453,904,2549,3453,231,0.011004923255140457,0.682015638575152,0.008398494063133507,0.26180133217492035,0.7381986678250796,0.08514335360556038
11972,,185,7645,7830,69,933,11135,2786,8349,11135,664,0.01661427929950606,0.6865738661876964,0.0061966771441400986,0.25020206555904806,0.749797934440952,0.08378985181859003
11973,17.0,418,5554,5972,25,277,7952,2294,5658,7952,563,0.052565392354124746,0.6984406438631791,0.003143863179074447,0.2884808853118712,0.7115191146881288,0.03483400402414487
11974,,90,1957,2047,63,123,3095,769,2326,3095,201,0.029079159935379646,0.6323101777059774,0.020355411954765753,0.24846526655896609,0.7515347334410339,0.03974151857835218
11975,,1152,20443,21595,203,1221,29243,8301,20943,29244,2143,0.03939269593762823,0.6990493776501162,0.006941594857064697,0.28385309807139925,0.7161469019286008,0.04175215428805909
11976,16.0,72,17435,17507,54,1009,23031,6702,16329,23031,1871,0.0031262211801484957,0.7570231427206808,0.0023446658851113715,0.29099908818548914,0.7090009118145109,0.04381051626069211
11977,25.0,245,8535,8780,9,362,11359,3358,8001,11359,899,0.021568800070428735,0.7513865657188132,0.0007923232678933005,0.2956246148428559,0.7043753851571442,0.03186900255304164
11978,16.0,292,6153,6445,23,345,8658,2459,6199,8658,686,0.03372603372603373,0.7106722106722106,0.0026565026565026563,0.284014784014784,0.715985215985216,0.039847539847539845
11979,26.0,169,2866,3035,4,136,4233,1128,3105,4233,331,0.039924403496338294,0.6770611859201512,0.0009449562957713206,0.2664776754075124,0.7335223245924876,0.0321285140562249
11980,34.0,2491,67857,70348,307,2676,89689,26613,63076,89689,6756,0.027773751519138357,0.7565810746022367,0.003422939267914683,0.29672535093489727,0.7032746490651027,0.0298364347913345
11981,25.0,76,2892,2968,6,162,3937,1111,2826,3937,310,0.019304038608077216,0.7345694691389383,0.001524003048006096,0.28219456438912877,0.7178054356108712,0.041148082296164595
11982,17.0,15485,151422,166907,4161,15567,241593,64329,177264,241593,16537,0.06409540011506956,0.6267648483192808,0.01722318113521501,0.2662701319988576,0.7337298680011424,0.06443481392258882
11983,25.0,105,2496,2601,36,130,3467,995,2472,3467,252,0.03028554946639746,0.719930775886934,0.010383616959907702,0.2869916354196712,0.7130083645803288,0.037496394577444477
11984,23.0,200,5961,6161,30,345,8152,2272,5880,8152,591,0.02453385672227674,0.7312315996074583,0.0036800785083415115,0.2787046123650638,0.7212953876349362,0.04232090284592738
11985,25.0,2365,201179,203544,811,9803,272120,77524,194596,272120,22136,0.008691018668234603,0.7393025135969425,0.002980302807584889,0.28488901955019846,0.7151109804498016,0.03602454799353227
11986,26.0,92,11666,11758,20,576,16277,4658,11619,16277,730,0.005652147201572771,0.7167168397124777,0.0012287276525158198,0.28617067027093446,0.7138293297290655,0.03538735639245561
11987,25.0,67,1608,1675,3,72,2236,630,1606,2236,170,0.02996422182468694,0.7191413237924866,0.0013416815742397137,0.2817531305903399,0.7182468694096601,0.03220035778175313
11988,17.0,5705,103365,109070,1295,6201,147950,42510,105440,147950,10574,0.038560324433930385,0.6986481919567421,0.008752957080094626,0.28732679959445756,0.7126732004055424,0.041912808381209865
11989,23.0,747,9207,9954,703,1416,14921,3920,11009,14929,810,0.05003684104762543,0.6167191372496483,0.04708955723759126,0.2625761939848617,0.7374238060151384,0.09484895170473574
11990,15.0,65,7144,7209,10,390,9446,2701,6745,9446,729,0.006881219563836544,0.7562989625238196,0.0010586491636671606,0.2859411391065001,0.7140588608934999,0.041287317383019266
11991,,156,2177,2333,5,231,3171,826,2345,3171,185,0.04919583727530748,0.6865342163355408,0.001576789656259855,0.26048565121412803,0.739514348785872,0.0728476821192053
11992,26.0,133,3168,3301,6,172,4642,1265,3377,4642,321,0.02865144334338647,0.6824644549763034,0.0012925463162429987,0.2725118483412322,0.7274881516587678,0.03705299439896596
11993,17.0,448,6428,6876,56,366,9006,2609,6397,9006,513,0.04974461470131024,0.7137463912946924,0.00621807683766378,0.28969575838330003,0.7103042416167,0.04063957361758828
11994,27.0,342,9144,9486,7,363,12562,3656,8906,12562,1072,0.027224964177678713,0.7279095685400414,0.0005572361088998567,0.2910364591625537,0.7089635408374463,0.028896672504378284
11995,,275,4388,4663,25,198,5974,1740,4234,5974,319,0.0460328088382993,0.7345162370271175,0.004184800803481754,0.2912621359223301,0.7087378640776699,0.033143622363575494
11996,,10329,201610,211939,1501,12744,292403,80837,211566,292403,17812,0.03532453497399138,0.6894936098466842,0.005133326265462393,0.27645749188619817,0.7235425081138018,0.043583684161927205
11997,,630,9361,9991,71,462,13407,3664,9743,13407,789,0.046990378160662344,0.6982173491459686,0.005295741030804804,0.2732900723502648,0.7267099276497352,0.034459610651152384
11998,26.0,9,527,710,8,32,907,216,691,907,45,0.009922822491730982,0.5810363836824697,0.008820286659316428,0.23814773980154355,0.7618522601984564,0.03528114663726571
11999,27.0,163,1709,1872,8,162,3338,658,2680,3338,126,0.04883163571000599,0.511983223487118,0.002396644697423607,0.19712402636309168,0.8028759736369083,0.048532055122828044
12000,25.0,255,6093,6348,5,511,8622,2376,6246,8622,597,0.029575504523312455,0.7066805845511482,0.0005799118533982835,0.2755741127348643,0.7244258872651357,0.05926699141730457
12001,13.0,12,2366,2378,0,316,3273,870,2403,3273,199,0.0036663611365719525,0.7228842040941033,0.0,0.26581118240146656,0.7341888175985335,0.09654750992972808
12002,,137,4571,4708,5,211,6293,1733,4560,6293,559,0.02177022088034324,0.7263626251390434,0.0007945336087716511,0.2753853488002542,0.7246146511997458,0.03352931829016367
12003,24.0,707,10811,11518,73,949,16445,4372,12073,16445,988,0.042991790817877774,0.6574034660991183,0.0044390392216479176,0.2658558832471876,0.7341441167528124,0.057707509881422925
12004,26.0,3865,107017,110882,469,4618,142240,42585,99655,142240,10090,0.027172384701912262,0.752369235095613,0.003297244094488189,0.2993883577052868,0.7006116422947132,0.032466254218222725
12005,24.0,4322,120428,124750,878,5485,166080,47872,118215,166087,11956,0.026022506276830816,0.7250898625419208,0.00528638605068428,0.28823447951976977,0.7117655204802302,0.033024860464696215
12006,,83,4138,4221,11,181,5610,1629,3981,5610,477,0.014795008912655972,0.7376114081996435,0.00196078431372549,0.2903743315508021,0.7096256684491978,0.032263814616755794
12007,23.0,2032,49268,51300,132,2928,67446,19497,47949,67446,4892,0.030127805948462472,0.7304806808409691,0.0019571212525576016,0.2890757050084512,0.7109242949915487,0.04341250778400498
12008,,74,1830,1904,6,81,2550,724,1826,2550,184,0.029019607843137254,0.7176470588235294,0.002352941176470588,0.283921568627451,0.716078431372549,0.03176470588235294
12009,25.0,615,21167,21782,58,1025,28396,8245,20151,28396,2260,0.021657979997182702,0.7454218904070996,0.0020425412029863362,0.290357796872799,0.709642203127201,0.036096633328637835
12010,16.0,25,2659,2684,11,259,3801,1012,2789,3801,296,0.006577216521967903,0.6995527492765062,0.0028939752696658773,0.26624572480926073,0.7337542751907393,0.06813996316758748
12011,,4268,89703,93971,442,5269,124773,35677,89096,124773,8572,0.03420611831085251,0.7189295761102161,0.0035424330584341163,0.2859352584293076,0.7140647415706923,0.042228687296129774
12012,35.0,418,4369,4787,42,266,6512,1793,4719,6512,390,0.06418918918918919,0.6709152334152334,0.006449631449631449,0.27533783783783783,0.7246621621621622,0.040847665847665846
12013,26.0,5710,121287,126997,359,6477,169562,48495,121067,169562,12008,0.03367499793585827,0.7152958799731072,0.002117219660065345,0.2860015805428103,0.7139984194571897,0.03819841709817058
12014,17.0,153,3114,3267,118,318,5042,1260,3782,5042,290,0.03034510115033717,0.6176120587068623,0.023403411344704483,0.24990083300277668,0.7500991669972233,0.06307021023403411
12015,26.0,344,8182,8526,30,316,11467,3278,8189,11467,1072,0.02999912793232755,0.7135257695997209,0.002616203017354147,0.2858637830295631,0.7141362169704369,0.02755733844946368
12016,,5958,126509,132467,693,7055,176123,50281,125842,176123,10847,0.03382863112711003,0.7182991432124141,0.003934750146204641,0.2854879828301812,0.7145120171698188,0.04005723272939934
12017,24.0,328,5376,5704,55,393,7930,2114,5816,7930,504,0.04136191677175284,0.6779319041614124,0.0069356872635561164,0.2665825977301387,0.7334174022698613,0.049558638083228246
12018,17.0,355,6035,6390,24,299,8398,2404,5994,8398,663,0.04227196951655156,0.7186234817813765,0.0028578232912598238,0.28625863300785903,0.713741366992141,0.03560371517027864
12019,17.0,178,4405,4583,38,204,6102,1717,4385,6102,419,0.02917076368403802,0.721894460832514,0.006227466404457555,0.281383153064569,0.718616846935431,0.03343166175024582
12020,,5817,122331,128148,329,10749,173000,48765,124235,173000,12157,0.0336242774566474,0.7071156069364162,0.0019017341040462427,0.281878612716763,0.718121387283237,0.062132947976878614
12021,,380,29261,29641,70,1314,40042,11108,28934,40042,3389,0.009490035462764097,0.7307577044103691,0.001748164427351281,0.27740872084311474,0.7225912791568853,0.03281554367913691
12022,,1314,38846,40160,61,2071,51788,15312,36476,51788,3419,0.025372673206148142,0.7500965474627327,0.0011778790453386885,0.29566694987255737,0.7043330501274426,0.0399899590638758
12023,23.0,1343,22367,23710,203,1153,31834,9001,22833,31834,2414,0.042187598165483446,0.7026135578312496,0.006376829804611421,0.28274800527737637,0.7172519947226236,0.03621913677200477
12024,,1234,30838,32072,184,1614,42573,12147,30426,42573,3248,0.028985507246376812,0.7243558123693421,0.004321988114532685,0.28532168275667674,0.7146783172433232,0.0379113522655204
12025,24.0,5376,132310,137686,413,7970,183711,52484,131227,183711,14251,0.02926335385469569,0.7202072820898041,0.002248096194566466,0.28568784667221886,0.7143121533277811,0.04338335755616158
12026,16.0,1134,18913,20047,44,1003,26365,7551,18814,26365,1854,0.043011568367153426,0.7173525507301346,0.0016688791959036601,0.2864024274606486,0.7135975725393514,0.038042859852076616
12027,,813,14604,15417,55,507,20261,5814,14447,20261,1531,0.040126351117911255,0.7207936429593801,0.0027145747988746856,0.2869552341937713,0.7130447658062287,0.025023444055081192
12028,27.0,1063,23636,24699,151,1619,34104,9464,24640,34104,2179,0.031169364297443117,0.6930565329580108,0.004427633122214403,0.277504105090312,0.722495894909688,0.047472437250762375
12029,,66,2904,2970,28,304,4166,1104,3062,4166,278,0.01584253480556889,0.6970715314450312,0.00672107537205953,0.2650024003840615,0.7349975996159386,0.0729716754680749
12030,14.0,23,2602,2625,13,450,4094,980,3114,4094,231,0.0056179775280898875,0.6355642403517342,0.0031753786028334147,0.23937469467513434,0.7606253053248656,0.10991695163654128
12031,17.0,989,23074,24063,37,1104,31832,9155,22677,31832,2598,0.03106936416184971,0.7248680573008294,0.0011623523498366425,0.28760366926363407,0.7123963307363659,0.03468208092485549
12032,24.0,206,5339,5545,24,264,7556,2100,5456,7556,550,0.02726310217046056,0.7065907887771308,0.0031762837480148226,0.27792482795129697,0.722075172048703,0.03493912122816305
12033,34.0,3055,59774,62829,912,3453,82430,23918,58512,82430,4852,0.03706174936309596,0.725148610942618,0.011063933034089531,0.2901613490234138,0.7098386509765862,0.041890088559990296
12034,,487,5026,5513,4,491,7500,2102,5398,7500,540,0.06493333333333333,0.6701333333333334,0.0005333333333333334,0.28026666666666666,0.7197333333333333,0.06546666666666667
12035,24.0,16,1944,1960,1,119,2610,727,1883,2610,238,0.006130268199233717,0.7448275862068966,0.0003831417624521073,0.278544061302682,0.721455938697318,0.04559386973180077
12036,,299,11075,11374,14,602,15677,4265,11412,15677,1375,0.0190725266313708,0.7064489379345538,0.0008930280028066594,0.2720546022836002,0.7279453977163998,0.03840020412068636
12037,23.0,174,11435,11609,28,670,15561,4386,11175,15561,1280,0.011181800655484866,0.7348499453762611,0.001799370220422852,0.2818584923848082,0.7181415076151918,0.04305635884583253
12038,27.0,1948,46063,48022,187,2475,64085,18351,45734,64085,4379,0.030397128813294844,0.7187797456503082,0.002917999531871733,0.2863540610127175,0.7136459389872826,0.03862058203947882
12039,,2549,59441,61990,212,3257,83805,23776,60029,83805,6236,0.030415846309886044,0.7092774894099397,0.0025296819998806754,0.2837062227790705,0.7162937772209296,0.03886402959250641
12040,23.0,1368,38522,39890,84,1712,53296,15147,38149,53296,3924,0.025667967577304114,0.7227934554187931,0.0015761032722906034,0.28420519363554486,0.7157948063644551,0.03212248574001801
12041,,331,6667,6998,34,195,9161,2627,6534,9161,729,0.036131426700141904,0.7277589782774806,0.0037113852199541536,0.2867590874358694,0.7132409125641306,0.02128588582032529
12042,13.0,401,2402,2803,35,349,3904,1007,2897,3904,132,0.10271516393442623,0.6152663934426229,0.008965163934426229,0.2579405737704918,0.7420594262295082,0.08939549180327869
12043,,171,4376,4547,18,246,5952,1732,4220,5952,408,0.028729838709677418,0.7352150537634409,0.0030241935483870967,0.290994623655914,0.709005376344086,0.04133064516129032
12044,,39,3240,3279,23,480,4660,1202,3458,4660,299,0.008369098712446352,0.6952789699570815,0.004935622317596567,0.25793991416309014,0.7420600858369099,0.10300429184549356
12045,34.0,1630,61050,62680,151,2650,82107,23812,58295,82107,6407,0.019852144153360857,0.7435419635353867,0.0018390636608328157,0.2900118138526557,0.7099881861473443,0.03227495828613882
12046,48.0,2689,46677,49366,221,2319,64781,19041,45740,64781,3588,0.041509084453775026,0.7205353421527917,0.0034114941109275867,0.2939287754125438,0.7060712245874562,0.03579753322733518
12047,24.0,84,1898,1982,26,122,2771,769,2002,2771,199,0.030313966077228437,0.6849512811259473,0.009382894261999277,0.2775171418260556,0.7224828581739444,0.04402742692168892
12048,16.0,293,9652,9945,26,471,12977,3739,9238,12977,1037,0.022578407952531403,0.7437774524158126,0.0020035447329891346,0.28812514448639903,0.711874855513601,0.036294983432226244
12049,27.0,486,5762,6248,73,374,8233,2431,5802,8233,383,0.05903072998906839,0.6998663913518766,0.00886675573909875,0.29527511235272685,0.7047248876472731,0.045426940361957976
12050,35.0,404,13877,14281,37,604,19013,5369,13644,19013,1696,0.021248619365697153,0.7298690369747015,0.0019460369221059276,0.28238573607531686,0.7176142639246831,0.031767737863567035
12051,,148,3279,3427,55,198,4728,1269,3459,4728,336,0.031302876480541454,0.6935279187817259,0.011632825719120136,0.2684010152284264,0.7315989847715736,0.04187817258883249
12052,26.0,9062,260144,269206,308,11543,349876,102053,247823,349876,26175,0.025900604785695502,0.7435319941922282,0.0008803118819238816,0.29168333924018797,0.708316660759812,0.03299168848392002
12053,23.0,64,2169,2233,0,57,2992,848,2144,2992,259,0.0213903743315508,0.7249331550802139,0.0,0.28342245989304815,0.7165775401069518,0.019050802139037433
12054,34.0,5135,88199,93334,910,4356,125754,35339,90415,125754,8586,0.0408336911748334,0.7013613881069389,0.007236350334780603,0.28101690602287005,0.71898309397713,0.03463905720692781
12055,,87,1733,1820,4,119,2409,699,1710,2409,154,0.0361145703611457,0.7193856371938564,0.0016604400166044002,0.2901618929016189,0.709838107098381,0.0493980904939809
12056,16.0,761,7531,8292,67,386,11305,3201,8104,11305,757,0.06731534719150818,0.6661654135338346,0.0059265811587793015,0.28314904909332156,0.7168509509066785,0.03414418398938523
12057,17.0,374,9442,9816,62,778,13581,3645,9936,13581,776,0.027538472866504675,0.6952359914586554,0.004565201384286871,0.268389662027833,0.731610337972167,0.057285914144761065
12058,,477,8656,9133,68,355,12366,3405,8961,12366,754,0.03857350800582242,0.6999838266213813,0.005498948730389778,0.2753517709849588,0.7246482290150412,0.028707747048358403
12059,,418,8934,9352,75,228,11975,3483,8492,11975,736,0.03490605427974948,0.7460542797494781,0.006263048016701462,0.29085594989561586,0.7091440501043841,0.019039665970772442
12060,,103,2967,3070,18,286,4361,1083,3278,4361,249,0.023618436138500343,0.6803485439119468,0.0041274936941068565,0.24833753726209584,0.7516624627379042,0.06558128869525338
12061,,151,3646,3797,11,169,5303,1457,3846,5303,346,0.028474448425419574,0.6875353573448991,0.002074297567414671,0.2747501414293796,0.7252498585706204,0.03186875353573449
12062,46.0,266,6025,6291,14,403,8332,2325,6007,8332,568,0.031925108017282766,0.7231156985117618,0.0016802688430148825,0.279044647143543,0.7209553528564571,0.04836773883821412
12063,24.0,310,2859,3169,29,287,4392,1201,3191,4392,321,0.07058287795992714,0.6509562841530054,0.006602914389799636,0.27345173041894355,0.7265482695810564,0.06534608378870674
12064,25.0,2324,51145,53469,491,3502,73082,20011,53071,73082,4868,0.031799896007224764,0.699830327577242,0.006718480610820722,0.273815713855669,0.7261842861443311,0.04791877616923456
12065,33.0,1643,46501,48144,125,2677,63557,17870,45687,63557,4907,0.025850811082964897,0.731642462671303,0.001966738518180531,0.2811649385590887,0.7188350614409114,0.04211967210535425
12066,,581,3141,3722,22,177,5410,1440,3970,5410,408,0.10739371534195934,0.5805914972273567,0.004066543438077634,0.266173752310536,0.7338262476894639,0.03271719038817006
12067,,3843,101513,105411,735,7521,143496,39242,104254,143496,9743,0.02678123432012042,0.707427384735463,0.005122093995651447,0.2734710375202096,0.7265289624797904,0.052412610804482354
12068,27.0,556,13988,14544,50,931,19484,5266,14218,19484,1493,0.028536234859371793,0.7179223978649149,0.0025662081708068157,0.27027304454937384,0.7297269554506262,0.04778279614042291
12069,17.0,821,18119,18940,178,1475,26354,7178,19178,26356,1660,0.031150402185460616,0.6874715434815601,0.006753680376384884,0.2723478524814084,0.7276521475185916,0.0559644862649871
12070,16.0,281,4054,4335,24,404,5957,1639,4318,5957,424,0.04717139499748196,0.6805438979352023,0.004028873594090985,0.2751384925297969,0.7248615074702032,0.06781937216719826
12071,24.0,261,5632,5893,50,232,7922,2233,5689,7922,692,0.03294622570058066,0.7109315829336026,0.006311537490532693,0.2818732643271901,0.7181267356728099,0.0292855339560717
12072,16.0,284,6886,7170,20,577,10056,2681,7375,10056,708,0.028241845664280032,0.6847653142402546,0.001988862370723946,0.26660700079554495,0.733392999204455,0.05737867939538584
12073,23.0,580,14190,14770,49,877,19767,5456,14311,19767,1559,0.029341832346840693,0.7178631051752922,0.0024788789396468862,0.2760155815247635,0.7239844184752365,0.04436687408306774
12074,27.0,1378,43365,44743,346,1934,57858,16727,41131,57858,4564,0.023816931107193472,0.7495074147049673,0.005980158318642193,0.2891043589477687,0.7108956410522314,0.033426665283971105
12075,23.0,231,3109,3340,4,272,4560,1212,3348,4560,233,0.0506578947368421,0.6817982456140351,0.0008771929824561404,0.2657894736842105,0.7342105263157894,0.05964912280701754
12076,,46,2897,2943,7,107,3922,1116,2806,3922,326,0.011728709841917389,0.7386537480877103,0.0017848036715961244,0.28454869964303925,0.7154513003569607,0.027281998980112188
12077,,70,2171,2241,5,103,2967,895,2072,2967,247,0.023592854735422986,0.7317155375800471,0.0016852039096730705,0.3016514998314796,0.6983485001685203,0.03471520053926525
12078,24.0,276,5500,5776,102,320,8289,2249,6040,8289,567,0.03329714078899747,0.6635299794908915,0.012305465074194716,0.27132344070454817,0.7286765592954518,0.0386053806249246
12079,,368,10955,11323,41,646,14760,4192,10568,14760,1114,0.024932249322493227,0.7422086720867209,0.002777777777777778,0.2840108401084011,0.715989159891599,0.04376693766937669
12080,27.0,1474,37718,39192,323,1811,52930,14827,38103,52930,4212,0.027848101265822784,0.7126015492159455,0.006102399395427924,0.2801246929907425,0.7198753070092575,0.03421500094464387
12081,,194,5637,5831,4,155,7697,2243,5454,7697,767,0.02520462517864103,0.7323632584123685,0.0005196829933740418,0.29141223853449394,0.7085877614655061,0.02013771599324412
12082,,669,9416,10085,32,592,13723,3819,9904,13723,921,0.04875027326386359,0.6861473438752459,0.002331851635939663,0.2782919186766742,0.7217080813233258,0.04313925526488377
12083,23.0,2751,92819,95570,212,4471,122373,36339,86034,122373,8108,0.02248044911867814,0.7584924779158801,0.0017324082926789407,0.2969527591870756,0.7030472408129245,0.036535837153620486
12084,,2280,60957,63237,217,3408,83487,23348,60139,83487,6790,0.027309641021955513,0.7301376262172554,0.002599207062177345,0.2796603063950076,0.7203396936049924,0.04082072658018614
12085,16.0,346,7349,7695,21,485,10247,2905,7342,10247,731,0.033765980286913244,0.7171855177125013,0.0020493803064311504,0.28349760905630916,0.7165023909436908,0.04733092612471943
12086,25.0,867,19911,20778,51,438,28155,8546,19609,28155,1135,0.030793819925412892,0.7071923281832712,0.0018114011720831112,0.3035340081690641,0.6964659918309359,0.01555673947789025
12087,,326,10298,10624,36,411,13839,4082,9757,13839,1042,0.023556615362381676,0.7441289110484861,0.00260134402774767,0.2949635089240552,0.7050364910759448,0.02969867765011923
12088,15.0,601,12184,12785,4,787,17249,4790,12459,17249,1264,0.034842599570989626,0.7063597889732738,0.00023189750130442343,0.27769725781204707,0.7223027421879529,0.04562583338164531
12089,43.0,3364,88155,91519,338,3803,118147,35087,83063,118150,7819,0.028472280998730427,0.7461278036394414,0.0028607702073635208,0.2969699534490055,0.7030300465509945,0.03218789674143038
12090,15.0,172,4141,4313,9,364,6031,1596,4435,6031,399,0.028519316862875146,0.6866191344718952,0.001492289835848118,0.2646327308903996,0.7353672691096004,0.06035483336096833
12091,,358,8228,8586,64,647,11815,3394,8421,11815,673,0.030300465509944984,0.6964028776978417,0.005416842996191282,0.28726195514176894,0.7127380448582311,0.05476089716462124
12092,46.0,371,7011,7382,60,401,10003,2818,7185,10003,651,0.0370888733379986,0.700889733080076,0.005998200539838049,0.28171548535439367,0.7182845146456063,0.040087973607917625
12093,27.0,101,2785,2886,25,139,4022,1104,2918,4022,325,0.025111884634510195,0.6924415713575336,0.006215813028344107,0.2744903033316758,0.7255096966683242,0.03455992043759324
12094,17.0,47,2790,2837,28,287,4233,1057,3176,4233,283,0.011103236475313017,0.6591070163004961,0.006614694070399244,0.24970470115757146,0.7502952988424285,0.06780061422159225
12095,,342,5122,5464,17,517,7472,2142,5330,7472,281,0.04577087794432548,0.6854925053533191,0.0022751605995717343,0.28667023554603854,0.7133297644539615,0.0691916488222698
12096,,93,2107,2200,6,106,2898,872,2026,2898,222,0.032091097308488616,0.7270531400966184,0.002070393374741201,0.30089717046238784,0.6991028295376122,0.03657694962042788
12097,,95,3401,3496,8,115,4571,1295,3276,4571,368,0.02078319842485233,0.7440385036097135,0.0017501640778823015,0.2833078101071976,0.7166921898928025,0.025158608619558084
12098,16.0,242,22752,22994,88,1650,31285,8763,22522,31285,2579,0.007735336423206009,0.7272494805817484,0.0028128496084385488,0.28010228544030685,0.7198977145596931,0.05274093015822279
12099,34.0,3460,52320,55780,537,3502,75957,21038,54919,75957,4138,0.04555208868175415,0.688810774517161,0.007069789486156641,0.2769724975973248,0.7230275024026752,0.04610503311083903
12100,42.0,195,4887,5082,57,173,6587,1901,4686,6587,457,0.02960376499165022,0.7419158949445879,0.008653408228328526,0.28859875512372857,0.7114012448762714,0.026263853043874297
12101,26.0,213,5929,6142,11,308,8107,2342,5765,8107,631,0.026273590724065623,0.7313432835820896,0.0013568521031207597,0.28888614777352906,0.7111138522264709,0.037991858887381276
12102,17.0,5,2706,2711,6,33,3624,1016,2608,3624,309,0.0013796909492273732,0.7466887417218543,0.0016556291390728477,0.2803532008830022,0.7196467991169978,0.009105960264900662
12103,16.0,155,3270,3425,7,318,4983,1309,3674,4983,281,0.031105759582580775,0.6562311860325105,0.0014047762392133253,0.26269315673289184,0.7373068432671082,0.0638169777242625
12104,,145,7532,7677,70,501,10489,2903,7586,10489,797,0.013824006101630279,0.718085613499857,0.006673658118028411,0.27676613595194965,0.7232338640480503,0.047764324530460485
12105,27.0,232,6286,6518,44,326,8581,2521,6060,8581,607,0.027036475935205688,0.7325486540030299,0.005127607504952803,0.2937886027269549,0.706211397273045,0.03799091015033213
12106,15.0,671,11219,11890,21,747,15947,4544,11403,15947,1209,0.042076879663886624,0.703517903053866,0.0013168621057252148,0.2849438765912084,0.7150561234087917,0.046842666332225495
12107,,54,4400,4454,13,298,6013,1693,4320,6013,533,0.008980542158656245,0.7317478795942125,0.002161982371528355,0.2815566273075004,0.7184433726924996,0.04955928820888076
12108,,2425,34020,36445,76,2119,50790,13804,36986,50790,3255,0.04774561921638118,0.6698168930891908,0.0014963575506989565,0.27178578460326835,0.7282142153967316,0.0417208111833038
12109,16.0,39,8998,9037,34,394,12046,3435,8611,12046,1079,0.003237589241241906,0.7469699485306326,0.0028225136974929436,0.2851568985555371,0.714843101444463,0.03270795284741823
12110,23.0,1403,33826,35229,177,1088,45393,13626,31767,45393,3095,0.030907849227854514,0.7451809750402044,0.003899279624611724,0.30017844160993984,0.6998215583900601,0.023968453285748904
12111,,26,3976,4002,57,383,5652,1474,4178,5652,348,0.0046001415428167025,0.7034677990092003,0.010084925690021231,0.2607926397735315,0.7392073602264685,0.06776362349610757
12112,,881,18392,19273,205,1636,26651,7018,19633,26651,1778,0.03305692094105287,0.6901054369442047,0.007692019061198454,0.26332970620239393,0.7366702937976061,0.06138606431278376
12113,23.0,2665,94233,96898,680,10604,133880,36474,97406,133880,9120,0.01990588586794144,0.7038616671646251,0.005079175380938153,0.2724380041828503,0.7275619958171496,0.07920525844039439
12114,23.0,603,11953,12556,83,1161,17489,4656,12833,17489,1143,0.03447881525530334,0.6834581737091886,0.004745840242438104,0.2662244839613471,0.7337755160386529,0.06638458459603179
12115,,72,1538,1610,9,131,2192,640,1552,2192,143,0.032846715328467155,0.7016423357664233,0.004105839416058394,0.291970802919708,0.708029197080292,0.05976277372262774
12116,24.0,986,23488,24474,36,1084,31287,9427,21860,31287,2012,0.031514686611052514,0.7507271390673442,0.0011506376450282866,0.30130725221337934,0.6986927477866206,0.03464697797807396
12117,15.0,1,6334,6335,45,1672,9758,2356,7402,9758,336,0.00010248001639680262,0.6491084238573478,0.004611600737856118,0.24144291863086698,0.758557081369133,0.171346587415454
12118,16.0,5547,102786,108333,1204,6228,146106,40296,105810,146106,9641,0.037965586628885876,0.7035029362243851,0.00824059244657988,0.2757997618167632,0.7242002381832369,0.04262658617715905
12119,13.0,66,9912,9978,13,1653,14542,3695,10847,14542,1274,0.0045385779122541605,0.6816118828221702,0.0008939623160500619,0.25409159675422915,0.7459084032457709,0.11367074680236557
12120,,146,1755,1901,5,112,2507,729,1778,2507,166,0.05823693657758277,0.7000398883127243,0.001994415636218588,0.29078579976067015,0.7092142002393299,0.04467491025129637
12121,25.0,336,11242,11578,42,372,14874,4419,10455,14874,1071,0.022589753933037516,0.7558155170095469,0.0028237192416296895,0.29709560306575233,0.7029043969342477,0.02501008471157725
12122,,334,10536,10870,17,570,14194,3982,10212,14194,955,0.023531069465971537,0.7422854727349585,0.0011976891644356771,0.28054107369310977,0.7194589263068902,0.04015781316049035
12123,,1731,19525,21256,26,1917,35166,7159,28007,35166,1162,0.04922368196553489,0.555223795711767,0.0007393505090143889,0.20357731900130807,0.796422680998692,0.05451288176079167
12124,41.0,565,13926,14491,18,453,19159,5529,13630,19159,1609,0.029490056892322147,0.7268646589070411,0.0009395062372775197,0.28858499921707814,0.7114150007829219,0.023644240304817578
12125,35.0,9041,101644,110685,2882,7666,149920,43206,106729,149935,7557,0.06029946310067696,0.6779204321872812,0.019221662720512223,0.28816487144429254,0.7118351285557075,0.051128822489745554
12126,,264,4400,4664,20,68,6170,1854,4316,6170,484,0.04278768233387358,0.713128038897893,0.0032414910858995136,0.3004862236628849,0.6995137763371151,0.011021069692058346
12127,,39,3209,3248,31,184,4338,1201,3137,4338,326,0.008990318118948824,0.739741816505302,0.00714615029967727,0.276855693868142,0.723144306131858,0.04241585984324574
12128,14.0,2515,33737,36252,138,2469,49386,13434,35952,49386,3437,0.05092536346332969,0.6831288219333415,0.0027943141781071558,0.2720204106426923,0.7279795893573078,0.04999392540396064
12129,,843,6545,7388,26,652,10361,2860,7501,10361,705,0.08136280281826079,0.6316957822603996,0.002509410288582183,0.27603513174404015,0.7239648682559598,0.06292828877521475
12130,42.0,266,5459,5725,158,535,7960,2201,5759,7960,554,0.03341708542713568,0.6858040201005026,0.01984924623115578,0.2765075376884422,0.7234924623115578,0.06721105527638191
12131,23.0,240,5865,6105,17,174,7919,2306,5613,7919,672,0.030306856926379595,0.7406238161384013,0.002146735698951888,0.2911983836342973,0.7088016163657027,0.021972471271625205
12132,,46,1782,1828,0,98,2379,712,1667,2379,182,0.019335855401429174,0.7490542244640606,0.0,0.2992854140395124,0.7007145859604876,0.04119377889869693
12133,24.0,171,4091,4262,31,241,5745,1618,4127,5745,406,0.029765013054830286,0.7120974760661445,0.005395996518711923,0.28163620539599654,0.7183637946040035,0.04194952132288947
12134,25.0,730,32130,32860,88,1331,43102,13527,29575,43102,2170,0.016936569068720708,0.7454410468191731,0.002041668600064962,0.31383694492134934,0.6861630550786506,0.030880237575982555
12135,42.0,1437,33888,35325,569,1530,46340,13372,32968,46340,2962,0.031009926629261976,0.731290461804057,0.012278808804488563,0.28856279671989643,0.7114372032801036,0.0330168321104877
12136,39.0,745,24239,24984,146,1099,32256,9474,22782,32256,2232,0.023096478174603176,0.7514570932539683,0.004526289682539683,0.2937127976190476,0.7062872023809523,0.03407118055555555
12137,14.0,306,7917,8223,38,463,11297,2993,8304,11297,949,0.027086837213419493,0.7008055235903338,0.0033637248827122243,0.2649375940515181,0.7350624059484819,0.04098433212357263
12138,34.0,421,10479,10900,29,438,14387,4187,10201,14388,1016,0.029260494856825133,0.7283152627189324,0.002015568529329997,0.2910063942174034,0.7089936057825966,0.030442035029190993
12139,16.0,1234,20618,21852,50,1388,29366,8395,20971,29366,2273,0.04202138527548866,0.7021044745624191,0.0017026493223455698,0.2858748212218212,0.7141251787781788,0.04726554518831302
12140,,1781,61779,63560,65,2843,82847,24374,58473,82847,6539,0.021497459171726196,0.7456999046434994,0.0007845788018878173,0.2942049802648255,0.7057950197351744,0.03431626975026253
12141,17.0,3475,73445,76920,655,6371,104337,28740,75597,104337,7209,0.03330553878298207,0.7039209484650699,0.0062777346483030945,0.27545357830874956,0.7245464216912505,0.061061751823418345
12142,17.0,1251,22378,23629,112,1598,32694,9081,23613,32694,2180,0.03826390163332721,0.6844680981219796,0.003425705022328256,0.2777573866764544,0.7222426133235456,0.04887746987214779
12143,41.0,536,9083,9619,111,493,13209,3629,9580,13209,840,0.04057839351956999,0.6876372170489817,0.008403361344537815,0.2747369217957453,0.7252630782042547,0.03732303732303732
12144,36.0,1121,2877,3998,37,200,5512,1536,3976,5512,260,0.2033744557329463,0.5219521044992743,0.006712626995645864,0.27866473149492016,0.7213352685050798,0.036284470246734396
12145,16.0,1716,39219,40935,263,1643,53872,15634,38238,53872,4058,0.03185328185328185,0.7280034155034155,0.004881942381942382,0.2902064152064152,0.7097935847935848,0.030498217998218
12146,16.0,348,17985,18333,48,1382,25250,6857,18393,25250,2029,0.013782178217821782,0.7122772277227722,0.001900990099009901,0.2715643564356436,0.7284356435643564,0.05473267326732673
12147,,407,10456,10863,37,646,14258,4097,10161,14258,1064,0.028545378033384767,0.7333426848085286,0.0025950343666713426,0.2873474540608781,0.7126525459391219,0.04530789732080236
12148,,576,9481,10057,104,518,13641,3793,9848,13641,810,0.042225643281284364,0.6950370207462796,0.00762407448134301,0.2780587933435965,0.7219412066564035,0.037973755589766144
12149,26.0,872,31330,32202,62,1136,41760,12270,29490,41760,3523,0.020881226053639845,0.7502394636015326,0.0014846743295019156,0.2938218390804598,0.7061781609195402,0.027203065134099615
12150,,367,8454,8821,51,258,11696,3330,8366,11696,817,0.031378248974008205,0.7228112175102599,0.00436046511627907,0.2847127222982216,0.7152872777017784,0.022058823529411766
12151,26.0,388,6878,7266,11,568,10173,2770,7403,10173,799,0.03814017497296766,0.6761034109898751,0.0010812936203676397,0.2722893934925784,0.7277106065074216,0.05583407057898358
12152,,404,6660,7064,20,428,9771,2746,7025,9771,761,0.04134684269777914,0.6816088424930918,0.0020468734008801557,0.28103571794084536,0.7189642820591546,0.04380309077883533
12153,16.0,316,3822,4138,12,302,5520,1542,3978,5520,347,0.0572463768115942,0.6923913043478261,0.002173913043478261,0.2793478260869565,0.7206521739130435,0.05471014492753623
12154,,207,2580,2787,88,305,4194,984,3210,4194,173,0.04935622317596566,0.6151645207439199,0.020982355746304245,0.23462088698140202,0.765379113018598,0.07272293752980448
12155,14.0,1722,48598,50320,898,5228,69975,18548,51427,69975,3531,0.024608788853161843,0.6945051804215792,0.012833154698106466,0.2650660950339407,0.7349339049660593,0.07471239728474455
12156,15.0,105,2284,2389,2,85,3321,891,2430,3321,319,0.031616982836495035,0.68774465522433,0.0006022282445046673,0.2682926829268293,0.7317073170731707,0.025594700391448358
12157,35.0,23275,571087,594362,2704,27723,783235,229573,553662,783235,56826,0.02971649632613456,0.7291387642278498,0.0034523482735066744,0.2931087093911789,0.706891290608821,0.03539550709557157
12158,25.0,352,7550,7902,15,346,10508,2971,7537,10508,881,0.03349828701941378,0.7185001903311763,0.001427483821850019,0.2827369623144271,0.7172630376855729,0.032927293490673776
12159,25.0,359,9235,9594,92,404,12764,3674,9090,12764,948,0.02812597931682858,0.7235192729551865,0.007207771858351614,0.28784080225634595,0.712159197743654,0.031651519899717956
12160,38.0,207,3515,3722,16,142,4913,1435,3478,4913,389,0.04213311622226745,0.7154488092814981,0.003256665988194586,0.29208223081620194,0.7079177691837981,0.02890291064522695
12161,14.0,150,2863,3013,18,238,4197,1161,3036,4197,323,0.035739814152966405,0.6821539194662855,0.004288777698355968,0.27662616154395997,0.72337383845604,0.05670717178937336
12162,,415,8082,8497,162,467,11533,3184,8349,11533,655,0.03598369895083673,0.7007716986040059,0.014046648747073615,0.27607734327581723,0.7239226567241828,0.04049249978323073
12163,24.0,77,2877,2954,8,178,3846,1134,2712,3846,243,0.02002080083203328,0.7480499219968799,0.0020800832033281333,0.2948517940717629,0.7051482059282371,0.04628185127405096
12164,27.0,907,20672,21579,55,812,27680,8117,19563,27680,1833,0.03276734104046243,0.7468208092485549,0.001986994219653179,0.2932442196531792,0.7067557803468208,0.029335260115606936
12165,15.0,9325,169397,178722,836,13505,242596,68141,174455,242596,16280,0.038438391399693315,0.6982679021912974,0.0034460584675757226,0.2808826196639681,0.7191173803360319,0.05566868373757193
12166,,1815,54240,56055,348,3127,74843,21046,53797,74843,5168,0.024250764934596422,0.7247170744090964,0.0046497334420052645,0.28120198281736436,0.7187980171826357,0.04178079446307604
12167,14.0,112,1997,2109,14,312,3120,824,2296,3120,152,0.035897435897435895,0.6400641025641025,0.004487179487179487,0.2641025641025641,0.735897435897436,0.1
12168,,126,2433,2559,0,81,3279,955,2324,3279,277,0.0384263494967978,0.7419945105215004,0.0,0.2912473315035072,0.7087526684964929,0.024702653247941447
12169,23.0,55,3174,3229,18,342,4813,1169,3644,4813,286,0.011427384167878661,0.6594639517972158,0.003739871182214835,0.2428838562227301,0.7571161437772699,0.07105755246208185
12170,24.0,381,21458,21839,1,850,28604,8390,20214,28604,2529,0.013319815410432107,0.750174800727171,3.496014543420501e-05,0.29331562019298,0.70668437980702,0.029716123619074254
12171,,326,8632,8958,21,387,12010,3370,8640,12010,916,0.02714404662781016,0.7187343880099917,0.0017485428809325561,0.28059950041631976,0.7194004995836802,0.03222314737718568
12172,,350,12962,13312,49,457,17253,5077,12176,17253,1282,0.02028632701559149,0.7512896307888484,0.002840085782182809,0.29426766359473716,0.7057323364052629,0.026488146988929463
12173,16.0,85,4637,4722,9,244,6249,1803,4446,6249,541,0.013602176348215714,0.7420387261961914,0.0014402304368698992,0.2885261641862698,0.7114738358137302,0.039046247399583935
12174,15.0,275,6641,6916,14,390,9504,2639,6865,9504,719,0.028935185185185185,0.6987584175084175,0.001473063973063973,0.27767255892255893,0.7223274410774411,0.041035353535353536
12175,,0,1999,1999,0,282,2852,766,2086,2852,212,0.0,0.7009116409537167,0.0,0.26858345021037866,0.7314165497896213,0.09887798036465638
12176,,52,1687,1739,4,66,2296,662,1634,2296,185,0.02264808362369338,0.7347560975609756,0.0017421602787456446,0.2883275261324042,0.7116724738675958,0.028745644599303136
12177,,831,27850,28681,89,1331,37142,11066,26076,37142,2815,0.022373593236767002,0.7498249959614453,0.002396209143287922,0.29793764471487805,0.702062355285122,0.03583544235636207
12178,27.0,112,5271,5383,14,202,6803,2083,4720,6803,521,0.01646332500367485,0.7748052329854476,0.002057915625459356,0.3061884462737028,0.6938115537262972,0.029692782595913566
12179,,895,14673,15568,47,1632,21925,5918,16007,21925,1390,0.04082098061573546,0.669236031927024,0.0021436716077537056,0.2699201824401368,0.7300798175598632,0.07443557582668187
12180,,244,5826,6070,33,382,8401,2354,6047,8401,680,0.02904416140935603,0.6934888703725747,0.003928103797167004,0.2802047375312463,0.7197952624687537,0.04547077728841804
12181,,122,2757,2879,5,133,3781,1074,2707,3781,262,0.03226659613858768,0.7291721766728378,0.0013224014810896587,0.28405183813805873,0.7159481618619413,0.035175879396984924
12182,,266,6917,7183,1,217,9391,2806,6585,9391,696,0.028324992013630073,0.7365562772867639,0.00010648493238206793,0.2987967202640826,0.7012032797359173,0.023107230326908743
12183,25.0,1998,42667,44665,320,2062,62252,16865,45387,62252,4473,0.03209535436612478,0.6853916340037268,0.005140397095675641,0.27091499068303027,0.7290850093169697,0.03312343378525991
12184,25.0,325,13307,13632,19,589,17462,5242,12222,17464,1242,0.018609711406321575,0.7619674759505268,0.0010879523591387997,0.30016032982134677,0.6998396701786532,0.033726523133302794
12185,24.0,13259,361480,374739,611,15950,496490,143020,353470,496490,39148,0.02670547241636287,0.7280710588330077,0.0012306390863864327,0.2880621966202743,0.7119378033797257,0.0321255211585329
12186,14.0,91,3785,3876,9,180,5191,1492,3699,5191,487,0.017530340974764014,0.7291465998844153,0.0017337699865151224,0.28742053554228475,0.7125794644577153,0.034675399730302446
12187,,2185,50726,52911,361,3098,71093,19742,51351,71093,5389,0.030734390164995146,0.7135160986313702,0.005077855766390502,0.2776925998340202,0.7223074001659797,0.04357672344675285
12188,24.0,768,17548,18316,81,972,24782,6973,17809,24782,1843,0.030990234847873457,0.7080945847792752,0.0032685013316116535,0.2813735775966427,0.7186264224033573,0.039222015979339844
12189,16.0,95,3648,3743,2,155,4952,1382,3570,4952,335,0.01918416801292407,0.7366720516962844,0.0004038772213247173,0.27907915993537963,0.7209208400646203,0.03130048465266559
12190,37.0,11293,303073,314366,1014,15071,415280,119515,295765,415280,28063,0.027193700635715662,0.729803987670969,0.0024417260643421305,0.2877937776921595,0.7122062223078405,0.03629117703717973
12191,,85,2328,2413,4,21,3172,951,2221,3172,257,0.026796973518284993,0.733921815889029,0.0012610340479192938,0.2998108448928121,0.7001891551071879,0.006620428751576293
12192,17.0,131,3017,3148,30,171,4328,1162,3166,4328,347,0.030268022181146027,0.6970887245841035,0.006931608133086876,0.26848428835489835,0.7315157116451017,0.039510166358595195
12193,17.0,59,5622,5681,32,208,7413,2169,5244,7413,624,0.007958990961823823,0.7583974099554837,0.004316740860650209,0.292594091460947,0.707405908539053,0.02805881559422636
12194,35.0,179,4007,4186,6,156,5609,1605,4004,5609,457,0.03191299696915671,0.7143875913710108,0.0010697093956141914,0.28614726332679624,0.7138527366732038,0.02781244428596898
12195,,108,2436,2544,3,118,3562,947,2615,3562,277,0.030320044918585063,0.6838854576080854,0.0008422234699606962,0.2658618753509264,0.7341381246490736,0.03312745648512072
12196,25.0,36,59649,59685,143,2964,77882,22898,54984,77882,6455,0.0004622377442798079,0.7658894224596184,0.001836111039778126,0.29400888523664004,0.70599111476336,0.03805757427903752
12197,,491,17648,18139,85,1118,25119,6926,18193,25119,2135,0.019546956487121302,0.7025757394800748,0.0033838926708865797,0.2757275369242406,0.7242724630757594,0.044508141247661136
12198,,213,26927,27140,102,2014,36542,10329,26213,36542,3042,0.005828909200372175,0.7368781128564391,0.0027913086311641398,0.2826610475617098,0.7173389524382902,0.05511466258004488
12199,27.0,357,10590,10947,27,600,14435,4149,10286,14435,1128,0.02473155524766193,0.7336335296155179,0.0018704537582265328,0.2874263941808105,0.7125736058191895,0.04156563907170073
12200,,3073,66047,69120,584,3405,90621,26020,64601,90621,5896,0.03391046225488573,0.7288266516591078,0.006444422374504806,0.2871299146996833,0.7128700853003167,0.03757407223491244
12201,,300,9263,9563,44,679,12923,3644,9279,12923,990,0.02321442389538033,0.71678402847636,0.0034047821713224483,0.2819778689158864,0.7180221310841136,0.05254197941654415
12202,14.0,8,2812,2820,26,79,3718,1040,2678,3718,323,0.002151694459386767,0.7563206024744487,0.006993006993006993,0.27972027972027974,0.7202797202797203,0.021247982786444325
12203,,2605,70116,72721,235,2802,94455,28136,66319,94455,6961,0.027579270552114763,0.7423217405113546,0.002487957228309777,0.29787729606691016,0.7021227039330898,0.029664919803080832
12204,24.0,410,9688,10098,4,645,13727,3705,10022,13727,1023,0.029868143075690246,0.7057623661397247,0.00029139651781161214,0.2699060246230058,0.7300939753769943,0.04698768849712246
12205,,52,2950,3002,0,129,3873,1133,2740,3873,302,0.013426284533953009,0.7616834495223341,0.0,0.2925380841724761,0.7074619158275239,0.033307513555383424
12206,,3285,49230,52515,201,3073,71088,20135,50953,71088,4528,0.046210330857528695,0.6925219446320054,0.002827481431465226,0.28324049065946433,0.7167595093405357,0.04322811163628179
12207,24.0,2072,36430,38502,127,1712,50704,14597,36107,50704,3785,0.04086462606500473,0.7184837488166614,0.002504733354370464,0.28788655727358786,0.7121134427264121,0.03376459450930893
12208,24.0,165,4832,4997,28,235,6660,1897,4763,6660,518,0.024774774774774775,0.7255255255255255,0.004204204204204204,0.28483483483483485,0.7151651651651652,0.03528528528528529
12209,14.0,52,2321,2373,29,102,3172,871,2301,3172,287,0.01639344262295082,0.7317150063051703,0.00914249684741488,0.27459016393442626,0.7254098360655737,0.03215636822194199
12210,15.0,198,8786,8984,56,1258,13010,3266,9744,13010,877,0.015219062259800154,0.6753266717909301,0.004304381245196003,0.25103766333589544,0.7489623366641045,0.09669485011529592
12211,24.0,1436,32255,33691,133,2300,45389,13450,31946,45396,1886,0.03163274297294916,0.7105251564014451,0.0029297735483302494,0.2962816107146004,0.7037183892853996,0.05066525685082386
12212,26.0,3468,82652,86120,321,3772,112774,32765,80073,112838,8458,0.03073432708839221,0.7324837377479217,0.0028447863308459914,0.2903720377886882,0.7096279622113117,0.03342845495311863
12213,17.0,150,2978,3128,0,132,4209,1162,3047,4209,325,0.03563791874554526,0.7075314801615585,0.0,0.2760750772154906,0.7239249227845094,0.03136136849607983
12214,14.0,281,5302,5583,0,309,7401,2127,5274,7401,476,0.03796784218348872,0.7163896770706661,0.0,0.287393595460073,0.7126064045399271,0.04175111471422781
12215,,410,11131,11541,119,411,15435,4379,11056,15435,1266,0.02656300615484289,0.7211532231940395,0.007709750566893424,0.28370586329770003,0.7162941367023,0.02662779397473275
12216,23.0,1862,35507,37369,89,2712,51524,14400,37124,51524,3566,0.03613849856377611,0.6891351603136402,0.001727350360996817,0.2794814067230805,0.7205185932769195,0.052635664932846826
12217,34.0,432,11348,11780,123,624,16029,4475,11642,16117,1052,0.026803995780852515,0.7041012595396166,0.007631693243159397,0.2776571322206366,0.7223428677793634,0.03871688279456475
12218,,185,4953,5138,14,192,6685,1951,4734,6685,512,0.027673896783844427,0.7409124906507105,0.0020942408376963353,0.2918474195961107,0.7081525804038893,0.028721017202692597
12219,24.0,30173,499236,529409,2274,32580,710038,200959,509079,710038,47535,0.0424949087231951,0.7031116644461283,0.003202645492213093,0.28302569721620535,0.7169743027837947,0.04588486813381819
12220,13.0,5885,127217,133102,996,6157,181197,50771,130427,181198,12828,0.03247828342476186,0.7020883232706763,0.005496749412245168,0.2801962494067263,0.7198037505932736,0.033979403746178215
12221,27.0,1366,36615,37981,598,1328,48888,14536,34353,48889,2928,0.0279408455889873,0.7489414796784553,0.012231790382294586,0.29732659698500685,0.7026734030149931,0.02716357462823948
12222,15.0,2711,47391,50102,255,3122,67709,18516,49193,67709,4611,0.040038990385325435,0.6999217238476421,0.0037661167643887813,0.27346438435067716,0.7265356156493228,0.04610908446439912
12223,,266,18390,18656,50,836,23877,7092,16785,23877,1776,0.011140428026971563,0.7701972609624325,0.0020940654186036773,0.29702223897474556,0.7029777610252544,0.03501277379905348
12224,42.0,2220,70879,73099,209,3165,94384,28273,66111,94384,6207,0.023520935751822344,0.7509641464655026,0.002214358365824716,0.2995528903203933,0.7004471096796067,0.033533225970503476
12225,,71,1776,1847,4,86,2477,708,1769,2477,199,0.02866370609608397,0.7169963665724667,0.0016148566814695195,0.28582963262010497,0.714170367379895,0.03471941865159467
12226,,7951,221293,229244,928,7877,293071,87914,205157,293071,19616,0.027129944620928034,0.7550832392150707,0.003166468193714151,0.2999750913601141,0.7000249086398859,0.026877446079618932
12227,,670,20523,21193,99,1975,28723,7962,20761,28723,1473,0.02332625422135571,0.7145145005744525,0.003446715175991366,0.277199456881245,0.722800543118755,0.06876022699578735
12228,34.0,72,2014,2086,13,91,2793,779,2014,2793,246,0.02577873254564984,0.7210884353741497,0.004654493376297888,0.2789115646258503,0.7210884353741497,0.03258145363408521
12229,17.0,201,3255,3456,10,227,4710,1333,3377,4710,346,0.04267515923566879,0.6910828025477707,0.0021231422505307855,0.2830148619957537,0.7169851380042462,0.048195329087048835
12230,,1100,29439,30539,138,1386,41133,11634,29499,41133,3143,0.026742518172756666,0.7157027204434395,0.003354970461673109,0.28283859674713735,0.7171614032528627,0.0336955728976734
12231,,666,8560,9226,90,946,12954,3463,9491,12954,766,0.05141269106067624,0.660799752972055,0.006947660954145438,0.2673305542689517,0.7326694457310483,0.07302763625135093
12232,16.0,12,12443,12455,104,639,16385,4780,11605,16385,1314,0.000732377174244736,0.7594140982606042,0.006347268843454379,0.2917302410741532,0.7082697589258468,0.038999084528532194
12233,13.0,117,1603,1720,0,85,2481,645,1836,2481,141,0.0471584038694075,0.6461104393389763,0.0,0.2599758162031439,0.7400241837968561,0.03426037887948408
12234,15.0,193,2844,3037,20,204,4277,1156,3121,4277,288,0.04512508767827917,0.6649520692073884,0.004676174888940846,0.2702829085807809,0.729717091419219,0.04769698386719663
12235,,560,17856,18416,3,992,24221,7119,17102,24221,1935,0.023120432682383056,0.7372115106725569,0.00012385946079848065,0.2939185004747946,0.7060814995252054,0.04095619503736427
12236,,140,3045,3185,2,143,4220,1225,2995,4220,362,0.03317535545023697,0.7215639810426541,0.00047393364928909954,0.2902843601895735,0.7097156398104265,0.03388625592417062
12237,,148,1996,2144,150,199,3320,836,2484,3320,227,0.04457831325301205,0.6012048192771084,0.045180722891566265,0.25180722891566265,0.7481927710843373,0.059939759036144576
12238,,1182,9360,10542,79,1215,14930,4055,10875,14930,882,0.07916945746818486,0.6269256530475552,0.005291359678499665,0.2716008037508372,0.7283991962491627,0.08137977227059612
12239,,173,2954,3127,4,358,4307,1095,3212,4307,285,0.0401671697237056,0.6858602275365684,0.0009287206872533086,0.2542372881355932,0.7457627118644068,0.08312050150917112
12240,27.0,68,1454,1522,29,143,2219,599,1620,2219,133,0.03064443442992339,0.6552501126633619,0.013068949977467327,0.2699414150518252,0.7300585849481749,0.0644434429923389
12241,,180,5316,5496,15,119,7046,2152,4894,7046,620,0.02554640931024695,0.7544706216292932,0.002128867442520579,0.3054215157536191,0.6945784842463809,0.016889015043996595
12242,,448,13373,13821,72,314,17941,5288,12653,17941,1471,0.02497073741708935,0.7453876595507497,0.004013154227746503,0.29474388272671537,0.7052561172732846,0.0175018114932278
12243,15.0,2725,54891,57616,335,1964,77359,21767,55592,77359,5877,0.03522537778409752,0.709561912641063,0.004330459287219328,0.2813764397161287,0.7186235602838713,0.02538812549283212
12244,,522,11065,11587,47,602,15457,4411,11046,15457,1158,0.03377110694183865,0.7158568933169438,0.003040693536908844,0.28537232321925343,0.7146276767807466,0.03894675551530051
12245,,61,2434,2495,3,260,3476,931,2545,3476,243,0.017548906789413118,0.7002301495972382,0.0008630609896432681,0.26783659378596086,0.7321634062140391,0.07479861910241657
12246,27.0,188,3754,3942,62,152,5411,1475,3936,5411,338,0.03474403991868416,0.6937719460358529,0.011458140824246904,0.2725928663832933,0.7274071336167067,0.02809092589170209
12247,23.0,6107,104683,110790,1432,5482,148631,41837,106794,148631,10201,0.041088332851154874,0.7043147122740209,0.009634598435050561,0.28148232872011897,0.7185176712798811,0.03688328814311954
12248,25.0,394,9179,9573,65,537,13039,3665,9374,13039,1032,0.030217041184139887,0.7039650279929442,0.004985044865403789,0.2810798374108444,0.7189201625891556,0.04118413988802822
12249,24.0,176,3074,3250,56,270,4611,1204,3407,4611,217,0.03816959444805899,0.6666666666666666,0.012144870960746042,0.2611147256560399,0.7388852743439601,0.05855562784645413
12250,25.0,396,9124,9520,178,564,12888,3570,9318,12888,932,0.030726256983240222,0.7079453755431409,0.013811297330850403,0.2770018621973929,0.722998137802607,0.043761638733705775
12251,,281,7058,7339,123,307,9496,2784,6712,9496,634,0.02959140690817186,0.7432603201347936,0.012952822240943556,0.2931760741364785,0.7068239258635215,0.03232940185341196
12252,24.0,135,2884,3019,22,125,3955,1171,2784,3955,305,0.03413400758533502,0.7292035398230089,0.005562579013906448,0.2960809102402023,0.7039190897597978,0.0316055625790139
12253,16.0,587,11553,12140,42,1566,17138,4399,12739,17138,1059,0.03425137122184619,0.6741159995332011,0.002450694363402964,0.25668105963356286,0.7433189403664372,0.09137588983545337
12254,,38,9906,9944,27,1305,13785,3813,9972,13785,1054,0.002756619513964454,0.7186071817192601,0.001958650707290533,0.2766050054406964,0.7233949945593036,0.09466811751904244
12255,26.0,10315,198424,208739,703,10505,284318,79985,204333,284318,22656,0.03627979937956795,0.69789461096378,0.002472583515640937,0.28132232218853537,0.7186776778114646,0.03694806519460604
12256,,1371,23997,25368,168,976,33052,9733,23319,33052,2241,0.041480091976279804,0.7260377586832869,0.0050828996732421635,0.29447537214086894,0.7055246278591311,0.02952922667312114
12257,33.0,13352,254276,267628,1934,11703,345765,101313,244454,345767,20812,0.038615599522221614,0.7353969580671377,0.005593362003892795,0.2930094543435319,0.7069905456564681,0.03384649200183939
12258,,126,5120,5246,10,239,6878,1964,4914,6878,625,0.01831927886013376,0.7444024425705147,0.0014539110206455365,0.2855481244547834,0.7144518755452166,0.03474847339342832
12259,14.0,1862,31399,33261,539,2346,47224,12670,34554,47224,3368,0.039429103845502286,0.6648949686600034,0.011413687955276978,0.26829578180586144,0.7317042181941386,0.04967812976452651
12260,24.0,545,11798,12343,30,678,16687,4624,12063,16687,1307,0.03266015461137412,0.7070174387247558,0.0017978066758554563,0.277101935638521,0.722898064361479,0.040630430874333316
12261,14.0,85,5959,6065,8,653,8529,2289,6240,8529,618,0.009965998358541447,0.6986751084535116,0.0009379763160980185,0.26837847344354554,0.7316215265564544,0.07656231680150076
12262,,216,6403,6619,15,288,8683,2484,6199,8683,704,0.02487619486352643,0.737417943107221,0.0017275135321893355,0.28607624093055395,0.713923759069446,0.03316825981803524
12263,17.0,62,3856,3918,4,161,5124,1536,3588,5124,434,0.01209992193598751,0.7525370804059328,0.00078064012490242,0.2997658079625293,0.7002341920374707,0.031420765027322405
12264,,355,7402,7757,18,297,10146,2958,7188,10146,790,0.03498915828898088,0.7295485905775675,0.0017740981667652277,0.29154346540508574,0.7084565345949142,0.029272619751626257
12265,16.0,103,1922,2025,1,170,3007,746,2261,3007,190,0.034253408713002996,0.6391752577319587,0.0003325573661456601,0.24808779514466245,0.7519122048553375,0.05653475224476222
12266,,411,9885,10296,31,284,13572,3919,9653,13572,1247,0.03028293545534925,0.7283377541998232,0.0022841143530798703,0.2887562628941939,0.711243737105806,0.020925434718538166
12267,,2951,97488,100439,328,6039,135849,38562,97304,135866,10041,0.021719929930961387,0.71753050800053,0.0024141433471214285,0.28382376753566013,0.7161762324643398,0.04444820632093386
12268,,27,1463,1490,6,81,2098,552,1546,2098,157,0.012869399428026692,0.6973307912297426,0.002859866539561487,0.2631077216396568,0.7368922783603432,0.038608198284080075
12269,24.0,85,2227,2312,19,177,3498,805,2693,3498,205,0.024299599771297885,0.6366495140080046,0.005431675242995998,0.23013150371640936,0.7698684962835907,0.05060034305317324
12270,,4526,109100,113626,267,4760,148012,43593,104419,148012,11281,0.03057860173499446,0.7371023971029376,0.001803907791260168,0.2945234170202416,0.7054765829797583,0.03215955463070562
12271,,3,1930,1933,2,89,2613,768,1845,2613,242,0.001148105625717566,0.7386146192116342,0.0007654037504783774,0.2939150401836969,0.7060849598163031,0.03406046689628779
12272,17.0,88,2842,2930,11,279,4083,1075,3008,4083,275,0.021552779818760717,0.6960568209649768,0.0026940974773450896,0.263286798922361,0.736713201077639,0.0683321087435709
12273,25.0,4001,107265,111266,1026,4968,146178,42951,103227,146178,11346,0.02737073978300428,0.7337971514181341,0.007018840044329516,0.293826704428847,0.7061732955711529,0.03398596231991134
12274,16.0,100,3746,3846,3,120,4976,1539,3437,4976,420,0.02009646302250804,0.7528135048231511,0.0006028938906752412,0.3092845659163987,0.6907154340836013,0.024115755627009645
12275,42.0,4902,104066,108968,669,4540,141400,41738,99662,141400,8622,0.03466760961810467,0.735968882602546,0.004731258840169731,0.29517680339462515,0.7048231966053748,0.03210749646393211
12276,,50,1619,1669,8,66,2219,623,1596,2219,179,0.02253267237494367,0.7296079315006759,0.003605227579990987,0.2807570977917981,0.7192429022082019,0.029743127534925643
12277,,236,6496,6732,0,422,8819,2546,6273,8819,656,0.02676040367388593,0.7365914502778093,0.0,0.2886948633631931,0.711305136636807,0.047851230298219756
12278,16.0,8,1670,1678,2,93,2260,642,1618,2260,243,0.0035398230088495575,0.7389380530973452,0.0008849557522123894,0.28407079646017697,0.715929203539823,0.04115044247787611
12279,33.0,3332,63755,67087,600,3111,91276,25510,65766,91276,6323,0.036504667163328806,0.6984859108637539,0.006573469477190061,0.27948201060519745,0.7205179893948026,0.03408343923923047
12280,43.0,63,1729,1792,46,71,2398,691,1707,2398,164,0.02627189324437031,0.7210175145954962,0.019182652210175146,0.28815679733110927,0.7118432026688908,0.029608006672226857
12281,43.0,256,3608,3864,55,195,5245,1440,3805,5245,336,0.04880838894184938,0.6878932316491897,0.010486177311725452,0.27454718779790277,0.7254528122020972,0.037178265014299335
12282,15.0,78,3204,3282,12,140,4486,1238,3248,4486,431,0.017387427552385197,0.7142220240748997,0.0026749888542131075,0.2759696834596522,0.7240303165403478,0.03120820329915292
12283,27.0,182,3882,4064,24,282,5575,1527,4048,5575,369,0.0326457399103139,0.6963228699551569,0.004304932735426009,0.2739013452914798,0.7260986547085202,0.05058295964125561
12284,23.0,230,5564,5794,15,331,7788,2227,5561,7788,579,0.02953261427837699,0.714432460195172,0.001926040061633282,0.2859527478171546,0.7140472521828454,0.042501284026707754
12285,13.0,659,4967,5626,12,333,7553,2133,5420,7553,607,0.08725009929829207,0.6576194889447902,0.0015887726731100226,0.2824043426453065,0.7175956573546936,0.044088441678803124
12286,,522,13386,13908,124,666,18361,5200,13161,18361,1187,0.028429824083655575,0.7290452589728228,0.006753444801481401,0.2832089755459942,0.7167910244540058,0.03627253417569849
12287,27.0,1120,34674,35794,225,2165,49547,13488,36059,49547,3452,0.02260479948331887,0.6998203725755343,0.004541142753345309,0.2722263709205401,0.7277736290794599,0.04369588471552264
12288,25.0,481,17704,18185,9,1003,22843,5521,17322,22843,1418,0.021056778881933195,0.775029549533774,0.00039399378365363567,0.2416932977279692,0.7583067022720308,0.04390841833384407
12289,39.0,440,40450,40890,70,2267,54497,15734,38763,54497,4321,0.008073838926913409,0.7422426922582894,0.0012844743747362241,0.28871314017285354,0.7112868598271465,0.04159862010752886
12290,,1419,87815,89234,712,5022,119140,33239,85902,119141,9541,0.011910257593943312,0.7370678439831796,0.005976112337482479,0.27898876121570243,0.7210112387842976,0.042151736178141865
12291,,323,8457,8780,8,527,11658,3368,8290,11658,879,0.027706296105678502,0.7254246011322697,0.0006862240521530279,0.2889003259564248,0.7110996740435752,0.045205009435580715
12292,,1386,29171,30557,20,1447,41068,11522,29546,41068,3326,0.033748904256355315,0.7103097302035648,0.00048699717541638256,0.280559072757378,0.719440927242622,0.03523424564137528
12293,26.0,70,2487,2557,40,122,3487,931,2556,3487,280,0.02007456266131345,0.7132205334098078,0.011471178663607686,0.26699168339546886,0.7330083166045311,0.03498709492400344
12294,46.0,440,11664,12104,83,504,15923,4552,11371,15923,1189,0.027632983734220937,0.7325252778998932,0.0052125855680462225,0.28587577717766754,0.7141242228223325,0.03165232682283489
12295,17.0,109,2313,2422,2,113,3167,929,2238,3167,249,0.03441742974423745,0.7303441742974424,0.0006315124723713293,0.2933375434164825,0.7066624565835176,0.03568045468898011
12296,13.0,53,7954,8007,17,869,11319,2949,8370,11319,568,0.004682392437494479,0.7027122537326619,0.0015018994610831345,0.2605353829843626,0.7394646170156374,0.07677356656948493
12297,16.0,120,1842,1962,3,113,2604,749,1855,2604,152,0.04608294930875576,0.7073732718894009,0.001152073732718894,0.28763440860215056,0.7123655913978495,0.043394777265745005
12298,,10960,122613,133573,779,8362,183215,50498,132725,183223,11099,0.059817817632065846,0.6692009190985848,0.004251649629140446,0.2756095031737282,0.7243904968262718,0.0456383750948298
12299,15.0,510,7873,8383,100,590,11244,3101,8143,11244,655,0.04535752401280683,0.7001956599075062,0.008893632159373888,0.27579153326218425,0.7242084667378157,0.05247242974030594
12300,,576,8341,8917,102,469,12465,3405,9060,12465,848,0.046209386281588445,0.6691536301644605,0.008182912154031288,0.273164861612515,0.7268351383874849,0.0376253509827517
12301,27.0,339,9971,10310,131,530,13786,3756,10030,13786,852,0.02459016393442623,0.7232699840417816,0.009502393732772377,0.27245031191063396,0.727549688089366,0.03844479907152183
12302,33.0,213,3971,4184,47,101,6029,1621,4408,6029,448,0.035329241997014434,0.658649859014762,0.0077956543373693815,0.2688671421462929,0.7311328578537071,0.016752363576049097
12303,,2079,50848,52927,122,2714,70069,20121,49948,70069,5326,0.02967075311478685,0.7256846822417903,0.0017411408754227976,0.28715979962608285,0.7128402003739172,0.038733248654897315
12304,48.0,433,6203,6636,111,256,9241,2529,6712,9241,388,0.04685640082242182,0.6712477004653176,0.0120116870468564,0.2736716805540526,0.7263283194459474,0.02770262958554269
12305,23.0,89,1534,1623,4,94,2161,625,1536,2161,152,0.04118463674224896,0.7098565478944933,0.0018509949097639982,0.2892179546506247,0.7107820453493753,0.04349838037945396
12306,42.0,69,2109,2178,24,490,3170,531,2639,3170,132,0.021766561514195582,0.6652996845425867,0.007570977917981073,0.16750788643533124,0.8324921135646688,0.15457413249211358
12307,27.0,21,1616,1637,3,130,2236,603,1633,2236,186,0.009391771019677997,0.7227191413237924,0.0013416815742397137,0.2696779964221825,0.7303220035778175,0.05813953488372093
12308,43.0,956,50939,51895,138,1577,64733,20318,44415,64733,4100,0.014768356170732085,0.7869093043733489,0.002131833840545008,0.3138739128419817,0.6861260871580184,0.024361608453184618
12309,,265,6491,6756,13,267,8895,2586,6309,8895,639,0.029792017987633503,0.7297358066329398,0.001461495222034851,0.29072512647554805,0.709274873524452,0.030016863406408096
12310,23.0,2342,60434,62776,151,2940,84414,23715,60699,84414,6258,0.027744213045229463,0.7159238988793328,0.0017888028052218826,0.28093681142938376,0.7190631885706162,0.03482834600895586
12311,16.0,135,2660,2795,1,189,3745,1053,2692,3745,284,0.036048064085447265,0.7102803738317757,0.000267022696929239,0.28117489986648864,0.7188251001335113,0.05046728971962617
12312,,1882,68861,70743,148,2414,91938,26772,65166,91938,7624,0.020470316952729013,0.7489938871848419,0.0016097805042528661,0.29119624094498464,0.7088037590550154,0.026256825251800127
12313,24.0,107,1756,1863,12,82,2695,709,1986,2695,198,0.03970315398886828,0.6515769944341373,0.0044526901669758815,0.26307977736549165,0.7369202226345084,0.030426716141001856
12314,15.0,130,3048,3178,11,128,4190,1226,2964,4190,318,0.031026252983293555,0.7274463007159905,0.0026252983293556086,0.29260143198090693,0.7073985680190931,0.03054892601431981
12315,16.0,3866,9887,13753,59,583,18574,5112,13462,18574,1142,0.2081404113276623,0.5323032195542156,0.003176483256164531,0.2752234306019167,0.7247765693980833,0.031387961666846126
12316,,249,9620,9869,16,357,12912,3768,9144,12912,1025,0.01928438661710037,0.7450433705080545,0.0012391573729863693,0.29182156133828996,0.70817843866171,0.027648698884758363
12317,34.0,265,6275,6540,10,247,8721,2522,6199,8721,726,0.030386423575278064,0.7195275771127164,0.0011466574934067195,0.28918701983717465,0.7108129801628253,0.02832244008714597
12318,24.0,1269,35584,36853,219,2134,50012,13998,36014,50012,3912,0.025373910261537232,0.7115092377829321,0.0043789490522274654,0.2798928257218268,0.7201071742781733,0.042669759257778134
12319,26.0,78,2243,2321,1,118,3062,877,2185,3062,226,0.025473546701502287,0.732527759634226,0.00032658393207054214,0.28641410842586545,0.7135858915741345,0.038536903984323974
12320,17.0,554,12353,12907,75,1350,18024,4923,13101,18024,1234,0.030736795383932536,0.685363959165557,0.004161118508655127,0.2731358189081225,0.7268641810918774,0.07490013315579228
12321,36.0,85,2509,2594,0,106,3416,975,2441,3416,260,0.024882903981264637,0.7344847775175644,0.0,0.2854215456674473,0.7145784543325527,0.031030444964871194
12322,15.0,13,2451,2464,2,117,3255,937,2318,3255,319,0.0039938556067588326,0.7529953917050691,0.0006144393241167435,0.28786482334869434,0.7121351766513057,0.035944700460829496
12323,,27,11765,11792,31,1021,16246,4376,11870,16246,1442,0.001661947556321556,0.7241782592638187,0.0019081620091099347,0.2693586113504863,0.7306413886495138,0.06284623907423366
12324,36.0,212,7975,8187,43,375,10887,3019,7868,10887,792,0.019472765683843117,0.7325250298521172,0.0039496647377606315,0.2773032056581244,0.7226967943418756,0.03444475062000551
12325,,30631,361058,391689,8229,28107,560316,148771,411545,560316,34622,0.05466736627188944,0.6443828125557721,0.014686355556507399,0.26551267499054104,0.7344873250094589,0.05016276529672542
12326,,171,4407,4578,41,264,6259,1688,4571,6259,436,0.02732065825211695,0.7041060872343825,0.006550567183256111,0.26969164403259305,0.730308355967407,0.0421792618629174
12327,24.0,1713,32735,34448,138,1980,45612,12861,32751,45612,3434,0.03755590634043673,0.7176839428220644,0.0030255196001052354,0.281965272296764,0.718034727703236,0.043409629044988164
12328,44.0,1574,28788,30362,121,1664,39995,11425,28570,39995,2612,0.03935491936492062,0.7197899737467184,0.003025378172271534,0.2856607075884486,0.7143392924115515,0.04160520065008126
12329,23.0,89,2632,2721,7,189,3987,1063,3022,4085,279,0.021787025703794368,0.6443084455324357,0.0017135862913096695,0.2602203182374541,0.7397796817625459,0.04626682986536108
12330,,4,3734,3738,22,441,5157,1506,3651,5157,214,0.0007756447547023463,0.7240643785146403,0.0042660461508629045,0.2920302501454334,0.7079697498545666,0.08551483420593368
12331,25.0,134,2005,2139,5,99,3359,730,2629,3359,105,0.03989282524560881,0.596903840428699,0.0014885382554331646,0.21732658529324203,0.782673414706758,0.02947305745757666
12332,13.0,212,1939,2151,29,112,3379,820,2559,3379,148,0.06274045575614087,0.5738384137318734,0.00858242083456644,0.24267534773601657,0.7573246522639834,0.033145901154187626
12333,,6825,143370,150195,236,6572,199409,56946,142463,199409,13787,0.034226138238494755,0.7189745698539183,0.0011834972343274376,0.2855738707881791,0.7144261292118209,0.03295738908474542
12334,,841,15841,16682,355,1635,23379,6372,17007,23379,1755,0.03597245391163009,0.6775738910988494,0.01518456734676419,0.27255229051713076,0.7274477094828692,0.0699345566534069
12335,17.0,149,17138,17287,239,616,23213,6504,16709,23213,2139,0.006418817042174643,0.7382931977771077,0.01029595485288416,0.28018782578727436,0.7198121742127256,0.026536854348856245
12336,24.0,1208,36863,38071,318,1798,49841,14627,35214,49841,3962,0.024237073894986055,0.7396119660520455,0.00638028932003772,0.2934732449188419,0.706526755081158,0.036074717601974275
12337,24.0,202,4679,4881,10,210,6675,1853,4822,6675,445,0.030262172284644194,0.7009737827715355,0.00149812734082397,0.27760299625468166,0.7223970037453183,0.03146067415730337
12338,15.0,74,1851,1925,12,156,2623,711,1912,2623,161,0.02821197102554327,0.7056805184902784,0.004574914220358368,0.27106366755623335,0.7289363324437667,0.05947388486465879
12339,25.0,4577,78155,82732,244,4656,110427,31247,79180,110427,9205,0.04144819654613455,0.7077526329611418,0.002209604535122751,0.2829652168400844,0.7170347831599156,0.042163601293162
12340,15.0,295,12194,12489,377,792,17128,4688,12440,17128,1361,0.017223260158804297,0.7119336758524054,0.022010742643624473,0.27370387669313406,0.726296123306866,0.04624007473143391
12341,17.0,196,4537,4733,7,256,6446,1808,4638,6446,525,0.03040645361464474,0.7038473471920571,0.0010859447719515978,0.2804840210983556,0.7195159789016444,0.03971455165994415
12342,,444,11309,11753,14,444,14907,4480,10427,14907,949,0.029784664922519622,0.7586368820017442,0.0009391561011605286,0.30052995237136915,0.6994700476286309,0.029784664922519622
12343,26.0,413,10374,10787,25,608,14441,4065,10376,14441,1056,0.028599127484246242,0.7183713039263209,0.001731182051104494,0.28149020150959075,0.7185097984904093,0.0421023474828613
12344,25.0,1226,32958,34184,267,1486,45047,12879,32168,45047,3373,0.027216018824783004,0.73163584700424,0.005927142762004129,0.2859013918795924,0.7140986081204076,0.03298776833085444
12345,41.0,104,1727,1831,12,126,2487,681,1806,2487,179,0.04181745074386811,0.694410936871733,0.0048250904704463205,0.2738238841978287,0.7261761158021713,0.05066344993968637
12346,45.0,3616,70802,74418,635,2797,94032,28097,65935,94032,4641,0.03845499404458057,0.7529564403607283,0.006753020248426068,0.29880253530712947,0.7011974646928705,0.02974519312574443
12347,,3209,71236,74445,308,3767,99206,28199,71007,99206,8396,0.03234683386085519,0.7180614075761547,0.003104650928371268,0.28424692054916034,0.7157530794508397,0.037971493659657685
12348,16.0,527,6232,6759,8,730,9467,2595,6872,9467,757,0.05566705397697264,0.6582866800464773,0.0008450406675821274,0.2741100665469526,0.7258899334530474,0.07710996091686913
12349,38.0,143,3424,3567,7,110,4727,1380,3347,4727,413,0.03025174529299767,0.7243494817008673,0.0014808546646921938,0.2919399196107468,0.7080600803892533,0.023270573302305902
12350,33.0,188,4942,5130,0,277,6670,1901,4769,6670,452,0.028185907046476763,0.7409295352323838,0.0,0.28500749625187405,0.714992503748126,0.04152923538230885
12351,25.0,978,82767,83745,470,5953,112104,31529,80575,112104,8466,0.008724041961036181,0.7383055020338257,0.0041925355027474485,0.28124776992792405,0.7187522300720759,0.053102476272033114
12352,15.0,2229,52342,54571,597,3024,72714,20775,51939,72714,5151,0.03065434441785626,0.7198338696812169,0.008210248370327584,0.28570839178150015,0.7142916082184999,0.04158758973512666
12353,24.0,2111,41962,44073,44,1494,58312,16935,41377,58312,5609,0.03620181094800384,0.7196117437234189,0.000754561668267252,0.29042049663877073,0.7095795033612292,0.02562079846343806
12354,,196,8486,8682,12,339,11124,3361,7763,11124,695,0.017619561308881697,0.7628550880978066,0.0010787486515641855,0.30213951815893564,0.6978604818410644,0.03047464940668824
12355,26.0,309,7487,7796,25,321,10214,3032,7182,10214,736,0.030252594478167222,0.7330135108674368,0.002447620912473076,0.2968474642647347,0.7031525357352654,0.0314274525161543
12356,,1303,5104,6407,17,589,9240,2558,6682,9240,318,0.141017316017316,0.5523809523809524,0.00183982683982684,0.27683982683982683,0.7231601731601731,0.06374458874458874
12357,,436,11801,12237,13,367,16152,4746,11524,16270,1288,0.02679778733866011,0.7253226797787339,0.0007990165949600492,0.29170251997541485,0.7082974800245851,0.022556853103872156
12358,41.0,98,2780,2878,4,166,3923,1114,2809,3923,266,0.024980881978078,0.7086413459087433,0.0010196278358399185,0.28396635228141726,0.7160336477185827,0.04231455518735661
12359,25.0,1027,28695,29722,167,1480,39972,11348,28624,39972,2647,0.025692985089562696,0.717877514259982,0.0041779245471830284,0.2838987291103773,0.7161012708896227,0.03702591814269989
12360,,15,1631,1646,0,91,2299,601,1698,2299,184,0.006524575902566333,0.7094388864723793,0.0,0.2614180078294911,0.7385819921705089,0.039582427142235754
12361,16.0,1086,17976,19062,43,1590,26878,7267,19611,26878,1954,0.040404792023216014,0.6687997618870452,0.0015998214152838752,0.2703698191829749,0.7296301808170251,0.05915618721631074
12362,23.0,875,22712,23587,66,931,31388,8901,22487,31388,2551,0.027876895628902765,0.7235886325984453,0.002102714413151523,0.283579711991844,0.7164202880081559,0.029661016949152543
12363,23.0,112,2564,2676,62,358,3941,972,2969,3941,182,0.028419182948490232,0.6505962953565085,0.01573204770362852,0.24663790916011163,0.7533620908398884,0.09083988835320984
12364,,792,15022,15814,61,573,20979,6095,14884,20979,1442,0.037752037752037754,0.7160493827160493,0.002907669574336241,0.2905286238619572,0.7094713761380428,0.027313027313027313
12365,27.0,339,5838,6177,68,430,8483,2273,6210,8483,525,0.039962277496168805,0.6881999292703053,0.008016032064128256,0.26794766002593423,0.7320523399740658,0.05068961452316398
12366,17.0,300,6669,6969,40,354,9312,2626,6686,9312,684,0.03221649484536082,0.7161726804123711,0.00429553264604811,0.2820017182130584,0.7179982817869416,0.03801546391752577
12367,27.0,1100,37871,38971,29,2165,51785,14536,37249,51785,4464,0.02124167229892826,0.7313121560297383,0.0005600077242444723,0.28069904412474656,0.7193009558752534,0.04180747320652699
12368,17.0,129,3097,3226,10,248,4610,1236,3374,4610,343,0.027982646420824295,0.6718004338394794,0.0021691973969631237,0.26811279826464207,0.7318872017353579,0.053796095444685464
12369,36.0,105,2469,2574,6,131,3385,989,2396,3385,271,0.0310192023633678,0.7293943870014771,0.0017725258493353029,0.2921713441654357,0.7078286558345642,0.038700147710487444
12370,,61,1493,1554,4,92,2294,606,1688,2294,202,0.02659110723626853,0.6508282476024412,0.0017436791630340018,0.26416739319965127,0.7358326068003488,0.04010462074978204
12371,45.0,539,6043,6582,0,299,8836,2531,6305,8836,798,0.06100045269352648,0.6839067451335445,0.0,0.286441828881847,0.713558171118153,0.033838841104572207
12372,,50,3537,3587,32,970,5139,689,4450,5139,192,0.00972951936174353,0.6882661996497373,0.006226892391515859,0.13407277680482585,0.8659272231951741,0.18875267561782447
12373,,3414,120675,124089,1013,5372,165710,48020,117690,165710,11169,0.02060225695492125,0.7282300404320802,0.006113089131615473,0.2897833564661155,0.7102166435338845,0.03241807977792529
12374,15.0,64,2127,2191,4,140,3023,785,2238,3023,232,0.02117102216341383,0.7036056897122064,0.0013231888852133643,0.25967581872312273,0.7403241812768773,0.04631161098246775
12375,25.0,117,6198,6315,35,404,8616,2417,6199,8616,643,0.013579387186629526,0.7193593314763231,0.004062209842154132,0.28052460538532964,0.7194753946146704,0.04688950789229341
12376,24.0,1114,25927,27041,161,999,34920,10316,24604,34920,2490,0.03190148911798396,0.7424684994272623,0.0046105383734249715,0.295418098510882,0.704581901489118,0.02860824742268041
12377,23.0,492,12078,12570,54,551,16206,4776,11430,16206,1356,0.030359126249537207,0.7452795261014439,0.0033320992225101815,0.29470566456867825,0.7052943354313217,0.03399975317783537
12378,,889,28360,29249,65,752,37197,11182,26015,37197,2814,0.023899776863725568,0.7624270774524827,0.0017474527515659866,0.30061564104632094,0.699384358953679,0.020216684141194183
12379,26.0,107,4264,4371,0,133,5682,1674,4008,5682,479,0.01883139739528335,0.7504399859204506,0.0,0.2946145723336853,0.7053854276663146,0.023407250967969025
12380,16.0,1627,25483,27110,59,1773,35638,9930,25708,35638,2368,0.045653515909983726,0.7150513496829227,0.0016555362253774062,0.2786351647118245,0.7213648352881755,0.04975026656939222
12381,,466,9601,10067,60,340,13131,3761,9370,13131,940,0.03548853857284289,0.7311705125276065,0.004569339730408956,0.28642144543446807,0.713578554565532,0.025892925138984082
12382,25.0,270,7845,8115,13,304,10788,3121,7667,10788,939,0.02502780867630701,0.7271968854282537,0.0012050426399703375,0.289302929180571,0.710697070819429,0.02817945865776789
12383,,73,2572,2645,53,108,3579,1033,2546,3579,216,0.02039675887119307,0.7186364906398436,0.014808605755797708,0.28862810841017045,0.7113718915898296,0.030176026823134954
12384,15.0,1224,33299,34523,118,1942,46482,13003,33479,46482,3885,0.026332773977023365,0.716384837141259,0.0025386170990921216,0.27974269609741403,0.7202573039025859,0.04177961361387204
12385,27.0,2607,91856,94463,190,4383,123453,35890,87563,123453,9445,0.02111734830259289,0.7440564425327858,0.0015390472487505366,0.29071792504029875,0.7092820749597013,0.03550338995407159
12386,17.0,1166,27003,28169,98,1722,38162,10659,27504,38163,3061,0.030553153578073002,0.7075701595786494,0.0025679322904383827,0.2793019416712523,0.7206980583287478,0.04512223881770301
12387,41.0,2457,62463,64920,395,2778,85342,24865,60482,85347,6215,0.028788358114520723,0.7318710675243418,0.0046281650204459445,0.29134005881870484,0.7086599411812952,0.032549474498224894
12388,23.0,632,13897,14529,222,534,18795,5643,13152,18795,1260,0.03362596435222134,0.7393987762702846,0.011811652035115722,0.3002394253790902,0.6997605746209098,0.028411811652035115
12389,38.0,400,11165,11565,36,511,14994,4428,10566,14994,1182,0.02667733760170735,0.7446311858076564,0.0024009603841536613,0.29531812725090034,0.7046818727490997,0.034080298786181136
12390,17.0,283,10263,10546,2,506,14079,4026,10053,14079,1175,0.02010085943603949,0.7289580225868314,0.00014205554371759358,0.28595780950351585,0.7140421904964841,0.035940052560551175
12391,17.0,29,1836,1865,10,73,2456,698,1758,2456,237,0.011807817589576547,0.747557003257329,0.004071661237785016,0.28420195439739415,0.7157980456026058,0.029723127035830618
12392,27.0,250,6942,7192,11,226,9054,2767,6287,9054,528,0.0276121051468964,0.7667329357190192,0.0012149326264634416,0.3056107797658493,0.6943892202341506,0.024961343052794346
12393,,502,17754,18256,49,942,24584,6962,17622,24584,2192,0.020419785226163358,0.7221770257077774,0.0019931662870159455,0.2831923202082655,0.7168076797917344,0.03831760494630654
12394,15.0,706,10495,11201,31,1067,16425,4370,12055,16425,1172,0.042983257229832574,0.6389649923896499,0.0018873668188736682,0.26605783866057836,0.7339421613394216,0.06496194824961948
12395,25.0,71,2927,2998,20,115,3814,1141,2673,3814,259,0.018615626638699527,0.7674357629785002,0.005243838489774515,0.2991609858416361,0.7008390141583639,0.030152071316203462
12396,44.0,368,2359,2727,40,560,4079,1028,3051,4079,149,0.0902181907330228,0.5783280215739152,0.009806325079676392,0.25202255454768324,0.7479774454523167,0.13728855111546948
12397,,752,26456,27208,166,1922,36970,10122,26848,36970,2704,0.020340816878550175,0.7156072491209089,0.004490127130105491,0.27378955910197456,0.7262104408980254,0.051988098458209356
12398,15.0,482,8502,8984,29,679,12176,3382,8794,12176,763,0.03958607095926413,0.6982588699080158,0.0023817345597897505,0.27775952693823913,0.7222404730617609,0.05576544021024967
12399,,790,20459,21249,7,864,28780,7956,20824,28780,2219,0.027449617790132035,0.7108756080611536,0.00024322446143154968,0.2764419735927728,0.7235580264072272,0.030020847810979846
12400,16.0,1537,28418,29962,203,2280,40821,11251,29570,40821,3227,0.03765218882437961,0.6961612895323486,0.004972930599446364,0.2756179417456701,0.7243820582543299,0.05585360476225472
12401,,342,9734,10076,40,334,13402,3865,9537,13402,1056,0.02551857931651992,0.726309506043874,0.0029846291598268917,0.2883897925682734,0.7116102074317266,0.024921653484554544
12402,25.0,4377,81536,85913,352,4823,114038,32835,81203,114038,9401,0.03838194286115155,0.7149897402620179,0.0030866904014451324,0.28793033900980375,0.7120696609901962,0.04229291990389168
12403,,3623,71540,75163,850,2462,95130,29085,66045,95130,5942,0.038084726164196364,0.7520235467255335,0.008935141385472512,0.3057395143487859,0.6942604856512141,0.025880374224745085
12404,,279,5384,5663,9,382,7798,2138,5660,7798,546,0.03577840471915876,0.6904334444729417,0.0011541420877147987,0.2741728648371377,0.7258271351628622,0.0489869197230059
12405,25.0,338,8244,8582,341,430,12045,3240,8805,12045,845,0.028061436280614364,0.6844333748443338,0.028310502283105023,0.26899128268991285,0.7310087173100872,0.0356994603569946
12406,,439,8419,8858,38,648,12388,3332,9056,12388,893,0.03543752018082015,0.6796092993219245,0.003067484662576687,0.268969970939619,0.7310300290603811,0.05230868582499193
12407,16.0,115,6768,6883,4,237,8694,2706,5988,8694,590,0.013227513227513227,0.7784679089026915,0.00046008741660915573,0.3112491373360939,0.6887508626639062,0.027260179434092476
12408,,4542,105200,109742,675,4218,145681,41619,104062,145681,11539,0.031177710202428596,0.7221257404877781,0.004633411357692492,0.28568584784563533,0.7143141521543647,0.0289536727507362
12409,,1125,27717,29048,174,1506,38958,10850,28108,38958,2934,0.028877252425689205,0.7114584937625135,0.004466348375173263,0.2785050567277581,0.721494943272242,0.03865701524718928
12410,13.0,1186,13586,14772,48,1050,19896,5604,14292,19896,1277,0.05960997185363892,0.6828508242862887,0.0024125452352231603,0.28166465621230397,0.718335343787696,0.05277442702050664
12411,,749,21588,22337,25,1040,28996,9181,19815,28996,1631,0.025831149124017107,0.7445164850324183,0.0008621878879845495,0.316629879983446,0.6833701200165541,0.03586701614015726
12412,,567,14543,15110,48,971,20924,5705,15219,20924,1597,0.027098069202829287,0.6950391894475244,0.0022940164404511567,0.27265341234945517,0.7273465876505448,0.04640604090995985
12413,14.0,406,6719,7125,15,859,10090,2721,7369,10090,733,0.0402378592666006,0.6659068384539147,0.0014866204162537165,0.2696729435084242,0.7303270564915758,0.08513379583746283
12414,,4691,85669,90360,1677,4940,120579,34548,86031,120579,7829,0.03890395508338931,0.7104802660496438,0.013907894409474287,0.28651755280770286,0.7134824471922971,0.0409689912837227
12415,23.0,9981,104659,114640,297,9860,159033,43987,115046,159033,10062,0.06276055912923732,0.6580961184156747,0.0018675369262983155,0.27659039318883505,0.723409606811165,0.061999710751856535
12416,34.0,19124,533097,552221,9328,22940,742767,211914,530853,742767,62362,0.025746970449683413,0.717717669201782,0.012558446996164343,0.28530346663220096,0.714696533367799,0.030884516948114282
12417,16.0,1174,10538,11712,50,995,16087,4425,11662,16087,1103,0.07297818114005097,0.6550630944240691,0.0031080997078386276,0.2750668241437185,0.7249331758562815,0.061851184185988686
12418,17.0,258,5667,5925,54,248,7891,2276,5615,7891,654,0.032695475858573055,0.7181599290330757,0.00684323913318971,0.28842985679888483,0.7115701432011152,0.031428209352426816
12419,36.0,109,2665,2774,0,99,3605,1060,2545,3605,314,0.030235783633841887,0.739251040221914,0.0,0.29403606102635227,0.7059639389736477,0.027461858529819694
12420,26.0,69,1946,2015,4,108,2720,764,1956,2720,174,0.02536764705882353,0.7154411764705882,0.0014705882352941176,0.28088235294117647,0.7191176470588235,0.039705882352941174
12421,27.0,135,7102,7237,8,180,9233,2736,6497,9233,708,0.014621466478934258,0.7691974439510452,0.0008664572728257337,0.29632838730640093,0.703671612693599,0.01949528863857901
12422,23.0,12910,236411,249330,10371,14397,343558,94065,249493,343558,23970,0.037577352295682244,0.6881254402458974,0.03018704265364218,0.2737965641900349,0.7262034358099652,0.04190558799387585
12423,25.0,115,2796,2911,8,150,3849,1083,2766,3849,329,0.029877890361132763,0.7264224473889321,0.0020784619381657575,0.2813717848791894,0.7186282151208107,0.03897116134060795
12424,24.0,82,1847,1929,6,91,2633,719,1914,2633,194,0.03114318268135207,0.701481200151918,0.002278769464489176,0.2730725408279529,0.726927459172047,0.03456133687808583
12425,24.0,1556,34229,35785,699,2197,48747,13552,35195,48747,3411,0.031919913020288425,0.7021765441975917,0.014339343959628284,0.2780068517036946,0.7219931482963055,0.04506944017067717
12426,,1630,46687,48317,398,1678,60425,18513,41912,60425,3736,0.026975589573851884,0.7726437732726521,0.006586677699627638,0.30637980968142325,0.6936201903185768,0.027769962763756723
12427,27.0,362,5050,5412,126,149,7441,2025,5416,7441,537,0.048649375083994084,0.6786722214756081,0.016933207902163686,0.27214084128477356,0.7278591587152264,0.02002419029700309
12428,35.0,2769,53505,56274,323,2981,72857,21306,51551,72857,4523,0.03800595687442524,0.7343837929093978,0.0044333420261608355,0.29243586752130885,0.7075641324786911,0.04091576650150294
12429,27.0,689,21636,22325,60,606,33939,8576,25363,33939,2600,0.020301128495241464,0.6374966852293821,0.0017678776628657297,0.25268864727894164,0.7473113527210584,0.01785556439494387
12430,,233,5015,5248,10,561,7248,2027,5221,7248,603,0.03214679911699779,0.6919150110375276,0.0013796909492273732,0.27966335540838855,0.7203366445916115,0.07740066225165564
12431,24.0,700,12876,13576,67,1169,18915,5109,13806,18915,1370,0.037007665873645255,0.6807295796986519,0.003542162305048903,0.27010309278350514,0.7298969072164948,0.06180280200898758
12432,17.0,364,11012,11376,60,489,15023,4462,10561,15023,1263,0.02422951474405911,0.7330093856087333,0.00399387605671304,0.29701124941755974,0.7029887505824403,0.03255008986221128
12433,24.0,189,1997,2186,89,102,3003,816,2187,3003,133,0.06293706293706294,0.665001665001665,0.029637029637029636,0.27172827172827174,0.7282717282717283,0.03396603396603397
12434,23.0,1756,47642,49398,74,2200,64621,18714,45907,64621,4839,0.027173828941056313,0.7372525959053559,0.001145138577242692,0.28959626127729376,0.7104037387227062,0.03404466040451246
12435,16.0,3920,166063,169983,1809,10908,232583,64986,167597,232583,19004,0.016854198286203204,0.7139945739800415,0.007777868545852449,0.2794099310783677,0.7205900689216322,0.046899386455587895
12436,23.0,4824,76625,81449,350,4211,107186,30477,76709,107186,6230,0.045005877633273,0.7148788087996567,0.003265351818334484,0.28433750676394304,0.7156624932360569,0.03928684716287575
12437,17.0,1849,20946,22795,151,1011,30336,8827,21509,30336,1584,0.06095068565400844,0.6904667721518988,0.004977584388185654,0.29097441983122363,0.7090255801687764,0.03332674050632911
12438,44.0,109,2513,2622,2,151,3431,979,2452,3431,237,0.031769163509181,0.7324395220052463,0.0005829204313611193,0.28533955115126786,0.7146604488487321,0.0440104925677645
12439,14.0,5183,96850,102033,523,11111,151877,39282,112595,151877,8635,0.03412629957136367,0.6376870757257518,0.0034435760516733937,0.2586435075752089,0.7413564924247911,0.07315788434061773
12440,,242,4329,4571,7,239,6177,1726,4451,6177,384,0.03917759430144083,0.7008256435162701,0.0011332361988020075,0.2794236684474664,0.7205763315525336,0.038691921644811396
12441,,2556,31476,34032,112,2380,45907,12920,32987,45907,3327,0.05567778334458797,0.6856470690744331,0.0024397150761321803,0.28143856056810507,0.7185614394318949,0.05184394536780883
12442,16.0,53,1672,1725,4,125,2336,674,1662,2336,183,0.022688356164383562,0.7157534246575342,0.0017123287671232876,0.288527397260274,0.711472602739726,0.05351027397260274
12443,16.0,701,15508,16209,56,927,21378,6231,15147,21378,1402,0.03279071943119095,0.7254186546917392,0.0026195153896529143,0.2914678641594162,0.7085321358405838,0.043362335110861634
12444,27.0,563,15932,16495,150,716,21722,6145,15577,21722,1616,0.0259184237178897,0.7334499585673511,0.006905441487892459,0.2828929196206611,0.7171070803793389,0.032961974035540006
12445,,60,1639,1699,4,76,2309,661,1648,2309,169,0.0259852750108272,0.7098310957124296,0.0017323516673884798,0.2862711130359463,0.7137288869640537,0.03291468168038112
12446,34.0,395,10473,10868,51,696,14324,3956,10368,14324,1001,0.02757609606255236,0.7311505166154706,0.0035604579726333427,0.2761798380340687,0.7238201619659314,0.0485897793912315
12447,16.0,359,7454,7813,28,533,10663,2904,7759,10663,848,0.03366782331426428,0.6990527993997937,0.0026259026540373254,0.2723436181187283,0.7276563818812717,0.049985932664353375
12448,,168,5322,5490,61,451,8012,2042,5970,8012,541,0.020968547179231155,0.664253619570644,0.0076135796305541684,0.25486769845232154,0.7451323015476785,0.056290564153769346
12449,,365,7502,7867,16,504,10644,2896,7748,10644,795,0.034291619691845174,0.7048102217211575,0.001503194287861706,0.2720781661029688,0.7279218338970312,0.04735062006764374
12450,25.0,263,20009,20272,121,1366,27669,7685,19984,27669,2350,0.00950522245111858,0.7231558784198923,0.004373125158119195,0.2777476598359174,0.7222523401640826,0.049369330297444794
12451,24.0,309,11130,11444,23,453,14924,4399,10525,14924,1014,0.020704904851246316,0.7457786116322702,0.001541141785044224,0.29476011793084966,0.7052398820691503,0.0303537925489145
12452,23.0,178,5325,5503,12,243,7201,2103,5098,7201,476,0.024718789057075405,0.7394806276905985,0.0016664352173309262,0.2920427718372448,0.7079572281627552,0.03374531315095126
12453,17.0,68,8008,8076,83,648,11309,2978,8331,11309,791,0.00601291007162437,0.7081085860818817,0.007339287293306216,0.26333009107790256,0.7366699089220975,0.05729949597665576
12454,15.0,2499,57477,59976,158,3368,78472,22656,55816,78472,5372,0.03184575389948007,0.7324523396880416,0.002013457029258844,0.288714445917015,0.711285554082985,0.042919767560403714
12455,,250,4585,4835,27,326,6487,1801,4686,6487,430,0.03853861569292431,0.7067982118082319,0.004162170494835826,0.2776321874518267,0.7223678125481733,0.0502543548635733
12456,25.0,203,4378,4581,0,306,6146,1743,4403,6146,361,0.03302961275626424,0.7123332248616987,0.0,0.2835990888382688,0.7164009111617312,0.049788480312398305
12457,13.0,637,10444,11081,122,699,15159,4211,10948,15159,904,0.04202124150669569,0.6889636519559338,0.008048024276007652,0.2777887723464608,0.7222112276535392,0.04611122105679794
12458,,1402,36017,37419,318,1904,50046,14275,35771,50046,3921,0.028014226911241658,0.7196778963353715,0.0063541541781560965,0.2852375814250889,0.7147624185749111,0.038044998601286815
12459,26.0,4331,104661,108992,1536,3899,134917,42253,92664,134917,5929,0.03210121778574976,0.77574360532772,0.011384777307529815,0.3131777314941779,0.6868222685058221,0.028899249168006996
12460,13.0,373,2755,3128,19,281,4395,1160,3235,4395,215,0.08486916951080774,0.626848691695108,0.004323094425483504,0.26393629124004553,0.7360637087599545,0.0639362912400455
12461,13.0,701,25610,26311,107,1363,35807,9996,25811,35807,3076,0.01957717764682883,0.7152232803641746,0.002988242522411819,0.2791632920937247,0.7208367079062753,0.03806518278548887
12462,26.0,571,15321,15892,78,842,21039,6077,14962,21039,1696,0.027140073197395313,0.7282190218166262,0.0037074005418508485,0.28884452683112316,0.7111554731688768,0.040020913541518134
12463,17.0,310,13219,13529,41,588,18171,4999,13172,18171,1331,0.017060150789719883,0.7274778493203456,0.002256342523801662,0.27510868967035385,0.7248913103296462,0.032359253755984814
12464,,218,4598,4816,21,211,6331,1822,4509,6331,435,0.03443373874585374,0.7262675722634655,0.003317011530563892,0.2877902385089243,0.7122097614910756,0.033328068235665774
12465,16.0,223,3229,3452,30,202,4631,1308,3323,4631,326,0.04815374649103865,0.6972576117469229,0.006478082487583675,0.2824443964586482,0.7175556035413517,0.04361908874973008
12466,44.0,68,1672,1740,1,83,2337,663,1674,2337,162,0.029097133076593923,0.7154471544715447,0.0004278990158322636,0.28369704749679076,0.7163029525032092,0.03551561831407788
12467,,1024,23858,24882,65,712,32178,9522,22656,32178,2490,0.031822984647896076,0.7414382497358444,0.002020013673938716,0.29591646466529925,0.7040835353347007,0.022126919012990243
12468,,57,2653,2710,0,55,3421,1001,2420,3421,301,0.01666179479684303,0.7755042385267465,0.0,0.29260450160771706,0.707395498392283,0.01607717041800643
12469,36.0,259,6863,7122,36,339,9278,2728,6550,9278,686,0.027915499029963355,0.7397068333692606,0.0038801465833153696,0.2940288855356758,0.7059711144643243,0.036538046992886396
12470,24.0,7907,152293,160200,711,11127,217304,60281,157023,217304,13786,0.03638681294407834,0.700829253028016,0.003271914000662666,0.2774040054485882,0.7225959945514119,0.05120476383315539
12471,17.0,2461,22412,24873,191,2319,34016,9412,24604,34016,2414,0.07234830667920979,0.6588664158043274,0.005615004703668862,0.27669332079021636,0.7233066792097836,0.06817380056444027
12472,15.0,1103,13617,14720,544,849,20353,5506,14854,20360,1338,0.05417485265225933,0.668811394891945,0.026719056974459726,0.27043222003929274,0.7295677799607073,0.04169941060903733
12473,24.0,1876,29168,31044,371,1675,41199,11595,29604,41199,2102,0.045535085803053474,0.7079783489890531,0.00900507293866356,0.2814388698754824,0.7185611301245176,0.04065632660986917
12474,,89,2874,2963,3,115,3861,1128,2733,3861,278,0.02305102305102305,0.7443667443667443,0.000777000777000777,0.29215229215229216,0.7078477078477079,0.029785029785029785
12475,25.0,499,9835,10334,46,430,14125,3902,10223,14125,1004,0.03532743362831858,0.6962831858407079,0.003256637168141593,0.27624778761061947,0.7237522123893805,0.030442477876106194
12476,25.0,616,10701,11317,48,648,15129,4185,10944,15129,1155,0.04071650472602287,0.7073170731707317,0.003172714653975808,0.2766210588935158,0.7233789411064843,0.04283164782867341
12477,35.0,199,2275,2474,5,169,3278,927,2351,3278,271,0.06070774862721171,0.6940207443563148,0.001525320317266626,0.2827943868212325,0.7172056131787675,0.05155582672361196
12478,26.0,2543,43469,46012,176,3303,62692,17495,45197,62692,4243,0.04056338926816819,0.6933739552095961,0.0028073757417214316,0.27906271932622984,0.7209372806737702,0.05268614815287437
12479,26.0,749,30401,31150,51,1073,40572,12087,28485,40572,3071,0.018461007591442376,0.7493098688750862,0.0012570245489500148,0.2979148181011535,0.7020851818988465,0.026446810608301292
12480,14.0,216,5239,5455,28,492,7455,2027,5428,7455,479,0.0289738430583501,0.7027498323272972,0.003755868544600939,0.27189805499664654,0.7281019450033535,0.06599597585513078
12481,,87,9386,9473,21,546,12663,3634,9029,12663,912,0.006870409855484482,0.7412145621100845,0.001658374792703151,0.2869778093658691,0.713022190634131,0.04311774461028192
12482,,1062,35554,36616,104,1062,46781,14211,32570,46781,3490,0.022701524123041404,0.7600094055278852,0.002223124772877878,0.30377717449391844,0.6962228255060815,0.022701524123041404
12483,,1272,22864,24136,119,903,31958,9103,22855,31958,1755,0.03980224044057826,0.7154390137054885,0.0037236372739220228,0.28484260592027033,0.7151573940797297,0.028255835784467113
12484,45.0,3411,82170,85581,633,3665,112099,32805,79294,112099,7985,0.03042846055718606,0.7330127833432948,0.005646794351421511,0.2926431101080295,0.7073568898919705,0.032694314846698005
12485,,3333,79852,83185,311,3477,107370,31605,75766,107371,7513,0.031041901444524126,0.743701744418884,0.002896499054679569,0.2943532238686424,0.7056467761313576,0.03238304570135325
12486,42.0,227,6051,6278,22,371,8265,2402,5863,8265,724,0.02746521476104053,0.7321234119782214,0.002661826981246219,0.2906231094978826,0.7093768905021174,0.04488808227465215
12487,,65,9005,9070,12,1069,13088,3415,9673,13088,938,0.00496638141809291,0.6880348410757946,0.0009168704156479218,0.2609260391198044,0.7390739608801956,0.0816778728606357
12488,24.0,208,5605,5813,6,325,7820,2213,5607,7820,569,0.02659846547314578,0.7167519181585678,0.0007672634271099745,0.2829923273657289,0.7170076726342711,0.04156010230179028
12489,,70,1711,1781,16,110,2433,671,1762,2433,180,0.02877106452938759,0.7032470201397452,0.006576243321002877,0.27579120427455817,0.7242087957254418,0.04521167283189478
12490,17.0,9907,202197,212104,455,14072,283704,80265,203439,283704,19193,0.03492019851676395,0.7127040859487354,0.001603784225812819,0.28291811183487015,0.7170818881651299,0.04960099258381975
12491,23.0,111,2844,2955,5,116,3872,1131,2741,3872,314,0.028667355371900828,0.734504132231405,0.0012913223140495868,0.29209710743801653,0.7079028925619835,0.029958677685950414
12492,,720,17391,18111,34,997,24574,6746,17828,24574,1522,0.029299259379832344,0.7076991942703671,0.0013835761373809717,0.2745177830227069,0.7254822169772931,0.04057133555790673
12493,,80,2962,3042,20,138,4013,1161,2852,4013,301,0.0199352105656616,0.7381011711936207,0.0049838026414154,0.289309743334164,0.7106902566658361,0.03438823822576626
12494,,3048,64321,67369,319,2983,89595,25565,64030,89595,5871,0.034019755566716894,0.7179083654221776,0.0035604665438919584,0.28533958368212514,0.7146604163178749,0.033294268653384675
12495,,217,5537,5754,20,331,7691,2148,5543,7691,572,0.02821479651540762,0.719932388506046,0.002600442075152776,0.27928747887140815,0.7207125211285919,0.04303731634377844
12496,16.0,131,1630,1761,0,102,2425,721,1704,2425,205,0.05402061855670103,0.6721649484536083,0.0,0.29731958762886596,0.702680412371134,0.04206185567010309
12497,14.0,360,7322,7682,10,502,10434,3018,7416,10434,838,0.034502587694077054,0.7017442974889784,0.0009584052137243627,0.28924669350201265,0.7107533064979874,0.048111941728963006
12498,13.0,205,2880,3085,1,237,4489,1142,3347,4489,262,0.0456671864557808,0.6415682780129205,0.00022276676319893073,0.2543996435731789,0.7456003564268211,0.05279572287814658
12499,,35,2166,2201,32,65,2980,837,2143,2980,283,0.01174496644295302,0.7268456375838926,0.010738255033557046,0.2808724832214765,0.7191275167785235,0.02181208053691275
12500,,69,2875,2944,17,319,3949,1015,2934,3949,249,0.01747277791846037,0.7280324132691821,0.004304887313243859,0.25702709546720687,0.7429729045327931,0.0807799442896936
12501,27.0,1903,54913,56816,182,2304,74983,21740,53243,74983,6131,0.02537908592614326,0.7323393302481895,0.0024272168358161184,0.2899323846738594,0.7100676153261406,0.03072696477868317
12502,25.0,401,4279,4680,132,330,6722,1769,4953,6722,401,0.05965486462362392,0.6365664980660518,0.019637012793811366,0.2631657244867599,0.7368342755132401,0.04909253198452841
12503,16.0,554,10911,11465,45,487,15500,4388,11112,15500,1198,0.03574193548387097,0.7039354838709677,0.002903225806451613,0.2830967741935484,0.7169032258064516,0.031419354838709675
12504,17.0,810,14285,15095,90,1037,20928,5785,15143,20928,1510,0.03870412844036697,0.6825783639143731,0.0043004587155963305,0.27642392966360857,0.7235760703363915,0.049550840978593275
12505,,132,2127,2259,15,74,3010,860,2150,3010,240,0.043853820598006646,0.7066445182724252,0.0049833887043189366,0.2857142857142857,0.7142857142857143,0.02458471760797342
12506,27.0,180,4482,4662,4,181,6140,1789,4351,6140,471,0.029315960912052116,0.7299674267100977,0.0006514657980456026,0.2913680781758958,0.7086319218241043,0.029478827361563518
12507,13.0,123,1704,1827,8,219,2719,713,2006,2719,140,0.045237219566016916,0.6267009930121368,0.002942258183155572,0.26222876057374034,0.7377712394262597,0.08054431776388378
12508,36.0,247,5766,6013,5,185,7984,2262,5722,7984,660,0.03093687374749499,0.7221943887775552,0.00062625250501002,0.28331663326653306,0.7166833667334669,0.02317134268537074
12509,,160,5389,5549,4,203,7147,2156,4991,7147,559,0.022387015530992024,0.7540226668532252,0.0005596753882748006,0.30166503428011754,0.6983349657198825,0.02840352595494613
12510,33.0,161,3560,3721,23,264,4993,1406,3587,4993,344,0.03224514320048067,0.7129981974764671,0.004606449028640096,0.28159423192469457,0.7184057680753054,0.05287402363308632
12511,,352,1093,1445,0,14,3431,499,2932,3431,1,0.10259399591955698,0.3185660157388516,0.0,0.14543864762459924,0.8545613523754008,0.004080443019527835
12512,17.0,816,13608,14424,145,513,19264,5480,13784,19264,1203,0.04235880398671096,0.7063953488372093,0.0075269933554817274,0.28446843853820597,0.715531561461794,0.026629983388704318
12513,16.0,221,7528,7749,6,237,10242,2948,7294,10242,876,0.021577816832649872,0.735012692833431,0.0005858230814294083,0.28783440734231597,0.7121655926576841,0.023140011716461628
12514,,238,3732,3970,25,152,5136,1567,3569,5136,396,0.04633956386292835,0.7266355140186916,0.004867601246105919,0.305101246105919,0.694898753894081,0.029595015576323987
12515,,1630,22265,23895,145,1524,32626,9027,23599,32626,2121,0.04996015447802366,0.682431189848587,0.004444308220437687,0.27668117452338625,0.7233188254766137,0.04671121191687611
12516,17.0,1667,29677,31344,312,1586,43695,11612,32083,43695,2861,0.038150818171415496,0.6791852614715642,0.007140405080672846,0.26575123011786245,0.7342487698821375,0.036297059160086964
12517,,90,1712,1802,1,123,2410,683,1727,2410,207,0.03734439834024896,0.7103734439834025,0.0004149377593360996,0.283402489626556,0.716597510373444,0.05103734439834025
12518,25.0,40,14384,14424,40,612,19014,5516,13498,19014,1723,0.002103713053539497,0.7564952140528032,0.002103713053539497,0.29010203008309665,0.7098979699169033,0.03218680971915431
12519,16.0,1029,24406,25435,192,2289,35700,9706,25994,35700,2510,0.028823529411764706,0.6836414565826331,0.005378151260504202,0.2718767507002801,0.7281232492997198,0.06411764705882353
12520,,93,2916,3009,13,254,4149,1161,2988,4149,280,0.022415039768618944,0.702819956616052,0.0031332851289467343,0.279826464208243,0.720173535791757,0.061219570980959266
12521,24.0,812,17015,17827,78,926,24053,6846,17207,24053,1606,0.03375878268823016,0.7073961667983204,0.0032428387311354092,0.28462146094042323,0.7153785390595768,0.03849831621835114
12522,,297,13581,13878,20,307,17907,5206,12710,17916,1752,0.016577361018084394,0.7580375083724046,0.0011163206072784104,0.2905782540745702,0.7094217459254298,0.0171355213217236
12523,,1239,25174,26413,228,1381,35178,9700,25479,35179,2169,0.03521987549390261,0.715597373433014,0.006481139316069246,0.2757326814292618,0.7242673185707382,0.03925637454162995
12524,17.0,1724,25768,27492,126,1772,37787,10751,27036,37787,2855,0.04562415645592399,0.6819276470743907,0.003334480112207902,0.284515838780533,0.715484161219467,0.046894434593907956
12525,,501,13912,14413,276,1024,19529,5439,14090,19529,1058,0.025654155358697323,0.7123764657688566,0.014132828101797328,0.27850888422346254,0.7214911157765375,0.05243484049362487
12526,,125,1633,1758,0,110,2337,658,1679,2337,151,0.05348737697903295,0.6987590928540864,0.0,0.2815575524176294,0.7184424475823705,0.047068891741549
12527,39.0,342,7636,7978,8,743,10532,3103,7429,10532,676,0.032472464868970756,0.7250284846183062,0.0007595898214963919,0.29462590201291305,0.705374097987087,0.07054690467147741
12528,24.0,1276,21361,22637,88,1529,30331,8372,21959,30331,1693,0.042069170155946065,0.7042629652830438,0.002901322079720418,0.2760212324024925,0.7239787675975075,0.050410471135142264
12529,,130,2851,2981,0,157,4013,1163,2850,4013,317,0.0323947171692001,0.7104410665337653,0.0,0.2898081235983055,0.7101918764016945,0.03912285073511089
12530,,58,1542,1600,3,114,2162,590,1572,2162,195,0.02682701202590194,0.7132284921369103,0.0013876040703052729,0.272895467160037,0.727104532839963,0.05272895467160037
12531,24.0,437,10874,11311,28,511,15189,4336,10853,15189,1264,0.028770820988873527,0.7159128316544868,0.0018434393310948712,0.28546974784383433,0.7145302521561656,0.033642767792481404
12532,,2,4688,4690,0,779,7462,1824,5638,7462,493,0.0002680246582685607,0.6282497989815063,0.0,0.24443848834092738,0.7555615116590726,0.1043956043956044
12533,14.0,157,2760,2917,0,337,4168,1155,3013,4168,229,0.037667946257197694,0.6621880998080614,0.0,0.2771113243761996,0.7228886756238004,0.08085412667946257
12534,15.0,74,2046,2120,3,87,2830,803,2027,2830,234,0.026148409893992933,0.7229681978798587,0.0010600706713780918,0.28374558303886926,0.7162544169611308,0.030742049469964665
12535,17.0,169,2051,2220,23,142,3143,848,2295,3143,225,0.053770283168946865,0.6525612472160356,0.007317849188673242,0.26980591791282216,0.7301940820871778,0.04517976455615654
12536,17.0,109,4389,4498,24,174,5818,1692,4126,5818,417,0.01873496046751461,0.7543829494671709,0.004125128910278446,0.29082158817463044,0.7091784118253696,0.029907184599518737
12537,,235,5385,5620,19,273,7466,2137,5329,7466,656,0.031476024645057596,0.7212697562282346,0.0025448700776855076,0.28623091347441737,0.7137690865255827,0.03656576480042861
12538,16.0,205,12128,12333,64,635,16869,4594,12275,16869,1451,0.012152469026024067,0.7189519236469263,0.0037939415495880017,0.27233386685636374,0.7276661331436363,0.03764301381231845
12539,25.0,625,16219,16844,81,811,22791,6425,16366,22791,1742,0.027423105611864333,0.7116405598701242,0.0035540344872976174,0.28190952568996536,0.7180904743100347,0.03558422184195516
12540,,953,9945,10898,108,526,14848,4199,10649,14848,1158,0.06418372844827586,0.6697871767241379,0.007273706896551724,0.2827990301724138,0.7172009698275862,0.03542564655172414
12541,,778,7418,8196,438,724,11987,2989,8998,11987,482,0.0649036456160841,0.6188370734962877,0.03653958454992909,0.2493534662551097,0.7506465337448903,0.060398765329106534
12542,16.0,6935,231268,238203,1611,19477,329122,90365,238757,329122,25387,0.021071213714063477,0.702681680349536,0.004894841426583456,0.2745638395488603,0.7254361604511397,0.059178663231263785
12543,,6419,83429,89848,783,7800,123085,32833,90253,123086,7407,0.05215052889849374,0.6778106364655606,0.006361405846318834,0.26674845230164274,0.7332515476983572,0.06337032643842516
12544,25.0,844,24334,25178,93,1222,33084,9635,23449,33084,2718,0.025510820940635958,0.7355217023334543,0.002811026478055858,0.29122838834481923,0.7087716116551808,0.03693628339983073
12545,27.0,21,6080,6101,9,444,8419,2359,6060,8419,702,0.002494357999762442,0.7221760304074119,0.0010690105713267609,0.280199548639981,0.719800451360019,0.0527378548521202
12546,,66,2153,2219,16,135,2924,856,2068,2924,195,0.022571819425444596,0.7363201094391245,0.005471956224350205,0.292749658002736,0.707250341997264,0.04616963064295486
12547,,482,9434,9916,35,521,13245,3664,9581,13245,892,0.03639109097772744,0.7122687806719517,0.0026425066062665155,0.27663269158172893,0.723367308418271,0.039335598338995845
12548,,383,9466,9849,36,260,12814,3850,8964,12814,870,0.029889183705322304,0.7387232714218823,0.002809427189012018,0.30045262993600746,0.6995473700639925,0.020290307476197908
12549,14.0,553,14619,15172,32,421,20397,5927,14470,20397,1735,0.027111830171103593,0.7167230475069863,0.0015688581654164828,0.2905819483257342,0.7094180516742659,0.020640290238760604
12550,14.0,44,2663,2707,3,101,3526,1070,2456,3526,261,0.012478729438457176,0.7552467385138968,0.0008508224617129892,0.3034600113442995,0.6965399886557005,0.02864435621100397
12551,14.0,9,1687,1696,0,127,2312,643,1669,2312,209,0.0038927335640138406,0.7296712802768166,0.0,0.2781141868512111,0.721885813148789,0.05493079584775087
12552,14.0,467,10084,10551,35,433,13721,4062,9659,13721,966,0.03403542015888055,0.7349318562786968,0.002550834487282268,0.2960425624954449,0.7039574375045551,0.0315574666569492
12553,23.0,332,7674,8006,5,387,10502,3086,7416,10502,788,0.03161302609026852,0.7307179584840983,0.00047609979051609216,0.2938487907065321,0.7061512092934679,0.036850123785945536
12554,25.0,1592,52416,54008,73,1974,71670,20494,51176,71670,5437,0.02221292032928701,0.7313520301381331,0.0010185572764057486,0.2859494907213618,0.7140505092786382,0.027542904981163668
12555,23.0,557,36316,36873,99,1801,48545,14138,34407,48545,3974,0.011473890204964466,0.7480894015861572,0.0020393449376866824,0.29123493665671024,0.7087650633432897,0.037099598310845604
12556,15.0,691,22701,23392,41,850,30540,8742,21798,30540,2123,0.022626064178127046,0.7433202357563851,0.0013425016371971185,0.2862475442043222,0.7137524557956778,0.027832351015062214
12557,23.0,276,5510,5786,11,269,7484,2233,5251,7484,527,0.03687867450561197,0.7362373062533405,0.001469802244788883,0.29836985569214325,0.7016301443078568,0.03594334580438268
12558,,216,8431,8647,61,401,11570,3336,8234,11570,809,0.01866897147796024,0.728694900605013,0.005272255834053587,0.28833189282627486,0.7116681071737252,0.034658599827139154
12559,14.0,67,6331,6398,73,348,9172,2233,6939,9172,581,0.007304840819886612,0.6902529437418229,0.007959005669428696,0.24345835150457915,0.7565416484954208,0.03794156127344091
12560,25.0,896,25703,26599,98,1679,35615,10089,25526,35615,2714,0.025157939070616312,0.721690299031307,0.002751649585848659,0.2832795170574196,0.7167204829425804,0.04714305770040713
12561,14.0,73,1867,1940,19,258,2845,693,2152,2845,149,0.025659050966608084,0.6562390158172232,0.006678383128295255,0.243585237258348,0.756414762741652,0.09068541300527241
12562,,415,17557,17972,219,618,23698,6939,16759,23698,1654,0.017512026331335976,0.7408642079500379,0.009241286184488143,0.29280951979069963,0.7071904802093003,0.02607815005485695
12563,17.0,52,1467,1519,5,77,2025,598,1427,2025,169,0.02567901234567901,0.7244444444444444,0.0024691358024691358,0.29530864197530865,0.7046913580246914,0.03802469135802469
12564,16.0,4107,69506,73613,483,4834,99649,27936,71713,99649,6903,0.0412146634687754,0.6975082539714398,0.004847013015685055,0.28034400746620636,0.7196559925337936,0.04851027105139038
12565,,77,1813,1890,1,103,2615,728,1887,2615,169,0.029445506692160613,0.6933078393881453,0.0003824091778202677,0.27839388145315486,0.7216061185468451,0.03938814531548757
12566,16.0,51,1851,1902,2,97,2495,742,1753,2495,197,0.020440881763527055,0.7418837675350701,0.0008016032064128256,0.2973947895791583,0.7026052104208417,0.038877755511022044
12567,16.0,188,4833,5021,21,395,6750,1870,4880,6750,482,0.027851851851851853,0.716,0.003111111111111111,0.277037037037037,0.7229629629629629,0.05851851851851852
12568,17.0,8622,147535,156157,918,10264,215372,59730,155642,215372,16056,0.040033059079174635,0.6850240514087254,0.004262392511561392,0.2773341009973441,0.7226658990026559,0.0476570770573705
12569,15.0,174,1809,1983,5,82,2654,764,1890,2654,216,0.06556141672946496,0.6816126601356444,0.0018839487565938207,0.2878673700075358,0.7121326299924642,0.03089675960813866
12570,23.0,142,2936,3078,16,155,4090,1167,2923,4090,252,0.03471882640586797,0.7178484107579463,0.003911980440097799,0.28533007334963323,0.7146699266503668,0.037897310513447434
12571,15.0,96,2435,2531,4,120,3385,958,2427,3385,257,0.028360413589364846,0.7193500738552437,0.0011816838995568684,0.28301329394387004,0.71698670605613,0.03545051698670606
12572,33.0,352,7304,7656,64,830,10683,2625,8058,10683,725,0.032949546007675745,0.6837030796592718,0.005990826546850136,0.2457174950856501,0.7542825049143499,0.0776935317794627
12573,15.0,3538,40470,44008,110,3344,59512,16536,42976,59512,4240,0.059450194918671866,0.6800309181341578,0.0018483667159564458,0.2778599274095981,0.7221400725904019,0.056190348165075954
12574,,3720,64524,68244,610,8945,93840,21754,72086,93840,4796,0.03964194373401535,0.6875959079283888,0.006500426257459505,0.23182011935208865,0.7681798806479113,0.09532182438192668
12575,25.0,457,44065,44522,169,2873,59593,16806,42787,59593,4824,0.007668685919487188,0.7394324836809693,0.002835903545718457,0.2820129881026295,0.7179870118973705,0.04821036027721377
12576,,231,5753,5984,22,242,7681,2308,5373,7681,501,0.030074209087358417,0.7489910167946882,0.00286421038927223,0.30048170811092306,0.699518291889077,0.03150631428199453
12577,26.0,195,3862,4060,47,308,7385,1422,5966,7388,250,0.026394152680021658,0.5227395776935572,0.006361667569030861,0.19247428262046562,0.8075257173795344,0.041689225771521385
12578,16.0,600,22983,23583,182,872,30520,9408,21112,30520,1488,0.019659239842726082,0.7530471821756225,0.005963302752293578,0.30825688073394497,0.691743119266055,0.02857142857142857
12579,17.0,100,2940,3040,3,127,4078,1110,2968,4078,312,0.024521824423737126,0.7209416380578715,0.0007356547327121138,0.2721922511034821,0.7278077488965179,0.03114271701814615
12580,15.0,102,1870,1972,7,138,2815,743,2072,2815,192,0.036234458259325045,0.6642984014209592,0.002486678507992895,0.26394316163410303,0.736056838365897,0.04902309058614565
12581,15.0,89,1655,1744,14,95,2344,627,1717,2344,147,0.037969283276450515,0.7060580204778157,0.005972696245733789,0.2674914675767918,0.7325085324232082,0.04052901023890785
12582,,685,5540,6225,36,398,8581,2335,6246,8581,580,0.07982752592937886,0.6456123994872393,0.004195315231325021,0.27211280736510896,0.727887192634891,0.04638154061298217
12583,,292,6534,6826,148,376,9402,2583,6819,9402,674,0.031057221867687727,0.6949585194639438,0.01574133163156775,0.27472878111040205,0.725271218889598,0.03999149117209105
12584,17.0,107,3566,3673,16,139,4800,1365,3435,4800,333,0.022291666666666668,0.7429166666666667,0.0033333333333333335,0.284375,0.715625,0.028958333333333332
12585,25.0,13917,390631,404548,1918,13753,531465,152226,379239,531465,42634,0.026186108210324292,0.7350079497238765,0.003608892401192929,0.2864271400750755,0.7135728599249245,0.025877527212516346
12586,26.0,33,5364,5397,1,302,7198,1982,5216,7198,599,0.004584606835232009,0.7452070019449847,0.0001389274798555154,0.2753542650736316,0.7246457349263684,0.041956098916365654
12587,15.0,46,1793,1839,3,65,2949,675,2274,2949,221,0.015598507968802983,0.6080027127839945,0.001017293997965412,0.2288911495422177,0.7711088504577823,0.02204136995591726
12588,26.0,473,8992,9465,5,795,13290,3816,9474,13290,817,0.03559066967644846,0.6765989465763732,0.0003762227238525207,0.2871331828442438,0.7128668171557562,0.05981941309255079
12589,38.0,4378,87359,91737,381,4001,121406,34593,86813,121406,10031,0.036060820717262736,0.7195608124804376,0.003138230400474441,0.2849364940777227,0.7150635059222773,0.03295553761758068
12590,33.0,5069,83177,88246,575,4734,122463,33532,88949,122481,8163,0.04138601089148521,0.679101248356888,0.0046946056939443665,0.2737730750075522,0.7262269249924478,0.03865089279153501
12591,,342,5034,5376,65,376,7448,2046,5402,7448,493,0.04591836734693878,0.6758861439312567,0.00872717508055854,0.27470461868958107,0.7252953813104189,0.050483351235230935
12592,13.0,54,2445,2499,2,234,3382,943,2439,3382,237,0.01596688350088705,0.7229450029568303,0.0005913660555884093,0.27882909520993493,0.7211709047900651,0.06918982850384388
12593,36.0,1044,21939,22983,74,2090,30928,8682,22246,30928,2115,0.03375581996896017,0.7093572167615106,0.0023926539058458356,0.2807165028453182,0.7192834971546819,0.06757630625969994
12594,24.0,623,10846,11469,25,782,15039,4396,10643,15039,933,0.041425626703903186,0.721191568588337,0.0016623445707826317,0.29230666932641797,0.707693330673582,0.05199813817408072
12595,40.0,24917,230919,255836,2277,17107,354084,96226,257858,354084,19887,0.07037030761062346,0.6521588097739519,0.006430677466363914,0.27176037324476676,0.7282396267552332,0.04831339456174241
12596,24.0,137,4425,4562,6,192,5982,1811,4171,5982,481,0.022902039451688398,0.7397191574724172,0.0010030090270812437,0.3027415580073554,0.6972584419926446,0.0320962888665998
12597,24.0,243,3981,4224,29,119,5405,1581,3824,5405,318,0.04495837187789084,0.7365402405180389,0.005365402405180388,0.29250693802035155,0.7074930619796485,0.022016651248843663
12598,15.0,54,1995,2049,9,158,2759,784,1975,2759,243,0.019572308807538963,0.7230880753896339,0.0032620514679231605,0.28416092787241753,0.7158390721275825,0.057267125770206595
12599,17.0,1502,31135,32637,94,1944,43806,12397,31409,43806,3368,0.03428754051956353,0.7107473862028033,0.002145824772862165,0.2829977628635347,0.7170022371364653,0.04437748253663882
12600,34.0,6238,140310,146548,790,6684,193423,55678,137795,193473,12677,0.03224222501330935,0.725217472205424,0.004083257095305288,0.28778175766127573,0.7122182423387242,0.034547456234203223
12601,25.0,1129,5291,6420,38,354,8634,2358,6276,8634,612,0.13076210331248553,0.612809821635395,0.004401204540189946,0.2731063238359972,0.7268936761640028,0.04100069492703266
12602,15.0,2080,49234,51314,189,2958,67722,19631,48091,67722,5275,0.03071380053749151,0.7270015652225273,0.0027908212988393727,0.2898762588228345,0.7101237411771655,0.043678568264374946
12603,17.0,501,8307,8808,34,489,11754,3356,8398,11754,913,0.04262378764675855,0.7067381316998469,0.0028926322953888037,0.28551982303896545,0.7144801769610345,0.04160285860132721
12604,25.0,445,14574,15019,48,746,19777,5878,13899,19777,1601,0.022500884866258786,0.7369166203165293,0.00242706173838297,0.2972139353794812,0.7027860646205187,0.03772058451736866
12605,24.0,4190,69823,74013,484,3316,99233,28308,70925,99233,6736,0.04222385698306007,0.7036268176916953,0.004877409732649421,0.28526800560297483,0.7147319943970252,0.033416303044350164
12606,26.0,5555,123516,129071,2381,5978,170687,49445,121242,170687,11996,0.0325449506992331,0.7236403475367192,0.013949509921669488,0.2896822839466392,0.7103177160533608,0.03502317106750954
12607,40.0,46,1911,1957,0,59,2577,773,1804,2577,249,0.01785021342646488,0.7415599534342259,0.0,0.29996119518820336,0.7000388048117967,0.022894838960031045
12608,,71,2432,2503,6,118,3473,955,2518,3473,286,0.020443420673769076,0.7002591419522027,0.0017276130146847107,0.27497840483731645,0.7250215951626836,0.03397638928879931
12609,17.0,41,1749,1790,3,117,2423,656,1767,2423,167,0.01692117210070161,0.7218324391250516,0.0012381345439537762,0.27073875361122574,0.7292612463887742,0.048287247214197276
12610,15.0,911,13627,14538,44,632,19148,5493,13655,19148,1546,0.04757677041988719,0.7116670148318363,0.002297890119072488,0.2868706914560267,0.7131293085439733,0.03300605807395028
12611,,48,3267,3315,32,169,4527,1238,3289,4527,303,0.010603048376408217,0.7216699801192843,0.007068698917605479,0.27347028937486195,0.726529710625138,0.03733156615860393
12612,,378,7793,8171,67,409,11105,3177,7928,11105,798,0.03403872129671319,0.7017559657811796,0.006033318325078793,0.2860873480414228,0.7139126519585772,0.03683025664115264
12613,,2450,50005,52455,371,2283,68796,20191,48605,68796,4914,0.03561253561253561,0.7268591197162626,0.005392755392755392,0.29349090063375777,0.7065090993662422,0.03318506889935462
12614,27.0,333,8538,8871,16,538,11867,3325,8542,11867,927,0.028061009522204434,0.7194741720738181,0.0013482767337996125,0.28018875874273197,0.719811241257268,0.045335805174011964
12615,15.0,1485,16704,18189,131,799,24400,6925,17475,24400,1659,0.06086065573770492,0.6845901639344262,0.005368852459016394,0.2838114754098361,0.7161885245901639,0.03274590163934426
12616,15.0,107,1283,1390,37,148,2245,557,1688,2245,150,0.047661469933184854,0.5714922048997773,0.01648106904231626,0.24810690423162585,0.7518930957683742,0.06592427616926504
12617,,4197,120449,124646,431,4897,158571,47862,110709,158571,10640,0.0264676391017273,0.7595903412351565,0.0027180253640325153,0.3018332481979681,0.6981667518020319,0.03088206544702373
12618,,21,3398,3419,10,511,4967,1252,3715,4967,384,0.0042279041675055366,0.6841151600563721,0.0020132876988121604,0.25206361989128245,0.7479363801087175,0.1028790014093014
12619,,542,14616,15158,37,704,19985,5820,14165,19985,1452,0.027120340255191392,0.7313485113835376,0.0018513885414060546,0.2912184138103578,0.7087815861896423,0.035226419814861146
12620,17.0,900,12495,13395,51,1050,18431,4985,13446,18431,1281,0.04883077423905377,0.6779339156855299,0.0027670772068797136,0.2704682328685367,0.7295317671314633,0.0569692366122294
12621,,96,3209,3305,13,201,4725,1269,3456,4725,387,0.020317460317460317,0.6791534391534392,0.0027513227513227515,0.26857142857142857,0.7314285714285714,0.04253968253968254
12622,,466,6914,7380,60,349,9772,2759,7013,9772,589,0.047687269750307,0.7075317232910356,0.006139991813344249,0.28233729021694637,0.7176627097830536,0.03571428571428571
12623,24.0,1888,17169,19057,290,1080,25800,7316,18484,25800,1502,0.07317829457364342,0.6654651162790698,0.01124031007751938,0.2835658914728682,0.7164341085271317,0.04186046511627907
12624,16.0,44,1593,1637,6,63,2138,626,1512,2138,194,0.0205799812909261,0.745088868101029,0.002806361085126286,0.29279700654817586,0.7072029934518241,0.029466791393826006
12625,,1290,3180,4659,81,478,7215,1527,5696,7223,231,0.1785961511837187,0.4402602796621902,0.011214176934791638,0.21140800221514605,0.7885919977848539,0.06617748857815312
12626,26.0,3770,74851,78621,598,3753,106027,29688,76342,106030,7226,0.03555597472413468,0.705941714609073,0.005639913232104121,0.2799962274827879,0.7200037725172121,0.03539564274262001
12627,25.0,2898,57457,60355,261,3797,81933,22838,59095,81933,5899,0.035370363589762366,0.7012681093088255,0.003185529640071766,0.27873994605348273,0.7212600539465173,0.046342743461120675
12628,24.0,2479,60832,63311,164,3636,85543,24362,61181,85543,6820,0.028979577522415628,0.7111277369276271,0.001917164466993208,0.2847924435663935,0.7152075564336065,0.042504939036507955
12629,26.0,5043,31683,36726,442,2375,49455,13877,35578,49455,3261,0.10197148923263573,0.640643008795875,0.008937417854615307,0.28059852391062584,0.7194014760893742,0.048023455666767766
12630,15.0,2149,47209,49358,198,2411,64443,19002,45441,64443,4696,0.03334729916360194,0.732569867945316,0.003072482659094083,0.2948652297379079,0.705134770262092,0.03741290753068603
12631,,129,1867,1996,8,123,2880,738,2142,2880,163,0.04479166666666667,0.6482638888888889,0.002777777777777778,0.25625,0.74375,0.042708333333333334
12632,27.0,205,4831,5036,15,244,6583,1879,4704,6583,471,0.031140817256569954,0.7338599422755583,0.0022785963846270697,0.2854321737809509,0.714567826219049,0.037065167856600335
12633,26.0,127,5884,6011,15,264,7766,2256,5510,7766,591,0.016353335050218902,0.7576616018542364,0.0019314962657738862,0.2904970383723925,0.7095029616276075,0.0339943342776204
12634,27.0,726,16152,16878,148,703,22158,6458,15704,22162,1544,0.032758776283728905,0.7288150888908943,0.006678097644616912,0.2913996931684866,0.7086003068315134,0.03172096381193033
12635,25.0,743,17982,18725,120,1244,24709,7092,17617,24709,1739,0.03007001497430086,0.7277510218948561,0.004856530009308349,0.28702092355012343,0.7129790764498766,0.05034602776316322
12636,,1590,20414,22004,62,1066,28864,8501,20363,28864,2087,0.05508592017738359,0.7072477827050998,0.0021480044345898006,0.2945191241685144,0.7054808758314856,0.036931818181818184
12637,36.0,409,5029,5438,26,653,10045,1821,8224,10045,323,0.040716774514683925,0.5006470881035341,0.002588352414136386,0.18128422100547537,0.8187157789945246,0.06500746640119462
12638,25.0,277,9035,9312,40,370,12235,3510,8725,12235,940,0.022639967306906417,0.7384552513281569,0.0032693093583980384,0.2868818961994279,0.7131181038005722,0.030241111565181854
12639,45.0,67,2894,2961,14,165,3883,1145,2738,3883,282,0.017254699974246716,0.7453000257532836,0.0036054596961112542,0.2948750965748133,0.7051249034251867,0.042492917847025496
12640,27.0,984,27724,28708,310,1565,37733,10864,26869,37733,2341,0.026077968886650944,0.7347414729812101,0.00821562027933109,0.2879177377892031,0.712082262210797,0.041475631410171465
12641,25.0,513,9439,9952,20,553,13840,3759,10081,13840,1092,0.037066473988439305,0.6820086705202312,0.001445086705202312,0.27160404624277457,0.7283959537572254,0.03995664739884393
12642,26.0,105,1632,1737,7,169,2613,665,1948,2613,145,0.040183696900114814,0.6245694603903559,0.0026789131266743206,0.25449674703406044,0.7455032529659396,0.06467661691542288
12643,,468,12541,13009,70,982,17852,4871,12981,17852,1509,0.026215550078422585,0.7024983195160206,0.003921129285234148,0.27285458211965047,0.7271454178803496,0.055007842258570465
12644,35.0,316,33950,34266,4,942,43329,12484,30845,43329,3220,0.007293036996007293,0.7835398924507836,9.231692400009232e-05,0.2881211198042881,0.7118788801957119,0.02174063560202174
12645,24.0,109,2277,2386,13,93,3055,877,2178,3055,215,0.03567921440261866,0.7453355155482815,0.00425531914893617,0.28707037643207856,0.7129296235679214,0.03044189852700491
12646,40.0,74,1897,1971,13,101,2641,769,1872,2641,190,0.028019689511548655,0.7182885270730783,0.004922377887163953,0.29117758424839074,0.7088224157516092,0.03824308973873533
12647,16.0,285,3979,4264,24,380,5974,1629,4345,5974,308,0.047706729159692,0.666052895882156,0.004017408771342484,0.2726816203548711,0.7273183796451289,0.06360897221292267
12648,,706,6983,7689,152,590,10958,2831,8127,10958,744,0.06442781529476181,0.6372513232341668,0.013871144369410476,0.2583500638802701,0.7416499361197298,0.05384194196021172
12649,24.0,773,30835,31608,81,1440,40989,12096,28893,40989,3167,0.018858718192685843,0.7522750006099197,0.001976139939983898,0.2951035643709288,0.7048964356290712,0.035131376710824856
12650,27.0,51,1929,1980,9,88,2594,777,1817,2594,244,0.01966075558982267,0.743639167309175,0.003469545104086353,0.29953739398612184,0.7004626060138782,0.03392444101773323
12651,33.0,114,4095,4209,10,109,5453,1625,3828,5453,450,0.020905923344947737,0.7509627727856226,0.0018338529249954153,0.298001100311755,0.701998899688245,0.019988996882450028
12652,40.0,115,4795,4910,8,295,6360,1893,4467,6360,434,0.018081761006289308,0.7539308176100629,0.0012578616352201257,0.2976415094339623,0.7023584905660377,0.046383647798742135
12653,,3682,88196,91878,248,3336,119165,34946,84219,119165,7982,0.030898334242436955,0.7401166449880417,0.0020811479880837496,0.29325724835312383,0.7067427516468762,0.02799479713002979
12654,26.0,123,3390,3513,6,152,4637,1312,3325,4637,404,0.026525770972611603,0.7310761268061247,0.0012939400474444684,0.28294155704119045,0.7170584429588096,0.03277981453525987
12655,23.0,107,2071,2178,19,63,2809,844,1965,2809,206,0.03809184763260947,0.7372730509077964,0.006763972944108224,0.3004627981488074,0.6995372018511926,0.022427910288358846
12656,27.0,72,1963,2035,8,106,2630,742,1888,2630,183,0.02737642585551331,0.7463878326996197,0.003041825095057034,0.28212927756653994,0.7178707224334601,0.0403041825095057
12657,15.0,48,1743,1791,1,433,3015,530,2485,3015,115,0.015920398009950248,0.5781094527363184,0.0003316749585406302,0.175787728026534,0.824212271973466,0.14361525704809286
12658,,1412,28483,29895,255,1214,38876,11390,27486,38876,2522,0.036320609116164214,0.732662825393559,0.006559316802140138,0.2929828171622595,0.7070171828377405,0.031227492540384812
12659,,9133,116759,125892,1436,12106,175650,47567,128083,175650,9991,0.051995445488186735,0.6647253060062625,0.008175348704810704,0.27080557927697124,0.7291944207230288,0.06892115001423285
12660,,248,6121,6369,41,240,8582,2402,6180,8582,700,0.028897692845490562,0.713237007690515,0.004777441155907714,0.27988813796317874,0.7201118620368212,0.027965509205313446
12661,25.0,347,15473,15820,72,536,21093,5989,15104,21093,1688,0.01645095529322524,0.7335608969800408,0.0034134547006115772,0.28393305836059357,0.7160669416394064,0.02541127388233063
12662,26.0,252,5060,5312,23,268,7271,1985,5286,7271,512,0.034658231329940864,0.6959152798789713,0.003163251272177142,0.2730023380552881,0.7269976619447118,0.03685875395406409
12663,,146,3782,3928,18,216,5201,1512,3689,5201,404,0.028071524706787157,0.7271678523360892,0.003460872909055951,0.29071332436069985,0.7092866756393001,0.04153047490867141
12664,,113,5228,5341,13,206,6870,2038,4832,6870,508,0.016448326055312955,0.7609898107714702,0.0018922852983988354,0.29665211062590974,0.7033478893740902,0.029985443959243085
12665,23.0,154,5682,5836,47,235,7582,2254,5328,7582,603,0.020311263518860458,0.7494064890530203,0.0061988921128989715,0.29728303877604856,0.7027169612239514,0.030994460564494855
12666,15.0,2025,32172,34197,357,2314,47182,12900,34282,47182,3297,0.04291890975371964,0.6818702047390954,0.007566444830655759,0.27340935102369546,0.7265906489763045,0.04904412699758382
12667,36.0,678,10032,10710,30,463,16423,4162,12261,16423,1268,0.04128356573098703,0.6108506363027462,0.0018267064482737625,0.2534250745905133,0.7465749254094867,0.0281921695183584
12668,34.0,4509,139150,143659,477,4468,182796,55490,127306,182796,13162,0.024666841725201866,0.7612310991487778,0.002609466290290816,0.30356244119127335,0.6964375588087267,0.0244425479769798
12669,35.0,637,30522,31159,91,837,39344,12116,27228,39344,3244,0.016190524603497358,0.7757726718178121,0.002312932086213908,0.30795038633590893,0.6920496136640911,0.021273891825945506
12670,26.0,121,1680,1801,54,132,2566,684,1882,2566,177,0.04715510522213562,0.6547155105222136,0.021044427123928292,0.2665627435697584,0.7334372564302416,0.05144193296960249
12671,,389,9530,9919,25,319,13201,3777,9424,13201,1012,0.02946746458601621,0.7219150064389062,0.0018937959245511704,0.2861146882811908,0.7138853117188092,0.024164835997272933
12672,,52,1613,1665,0,76,2188,644,1544,2188,169,0.02376599634369287,0.7372029250457038,0.0,0.2943327239488117,0.7056672760511883,0.03473491773308958
12673,16.0,32,2035,2067,8,182,2789,766,2023,2789,153,0.011473646468268197,0.7296522050914306,0.0028684116170670493,0.27465041233417,0.72534958766583,0.06525636428827537
12674,,3857,80065,83922,575,4025,111955,32223,79732,111955,7748,0.034451342057076506,0.7151534098521728,0.005135992139698987,0.2878209995087312,0.7121790004912688,0.035951944977892905
12675,27.0,338,5073,5411,44,115,6950,2094,4856,6950,482,0.04863309352517985,0.7299280575539568,0.006330935251798561,0.301294964028777,0.698705035971223,0.016546762589928057
12676,,320,8792,9112,5,384,12047,3562,8485,12047,954,0.026562629700340335,0.7298082510168507,0.00041504108906781774,0.29567527185191333,0.7043247281480867,0.0318751556404084
12677,,102,1746,1848,21,61,2569,673,1896,2569,189,0.0397041650447645,0.679641884001557,0.008174386920980926,0.26196963799143635,0.7380303620085636,0.023744647722849357
12678,24.0,1529,51078,52607,604,2591,69707,20056,49660,69716,4199,0.021931837741694875,0.7326582133226233,0.008663721383900395,0.2876814504561363,0.7123185495438636,0.03716506971140054
12679,44.0,25371,228821,254192,1528,8751,328594,99039,229566,328605,24228,0.07720819829278312,0.696340591287412,0.004649959678032897,0.30139224905281414,0.6986077509471859,0.02663075729218971
12680,,786,22099,22885,258,825,30221,8835,21386,30221,2209,0.02600840475166275,0.7312464842328182,0.00853710995665266,0.2923463816551405,0.7076536183448595,0.02729889811720327
12681,26.0,285,10211,10496,52,519,13498,3944,9554,13498,903,0.021114239146540228,0.756482441843236,0.0038524225811231295,0.29219143576826195,0.707808564231738,0.03845014076159431
12682,14.0,228,8526,8754,55,334,11603,3288,8315,11603,1075,0.0196500904938378,0.7348099629406188,0.004740153408601224,0.28337498922692406,0.7166250107730759,0.028785658881323794
12683,33.0,85,3546,3631,4,122,4700,1356,3344,4700,397,0.018085106382978722,0.754468085106383,0.000851063829787234,0.2885106382978723,0.7114893617021276,0.02595744680851064
12684,17.0,122,4831,4953,22,210,6480,1893,4587,6480,586,0.018827160493827162,0.7455246913580247,0.0033950617283950617,0.29212962962962963,0.7078703703703704,0.032407407407407406
12685,,272,3508,3780,26,336,5203,1422,3781,5203,321,0.052277532192965596,0.6742264078416298,0.004997117047857005,0.27330386315587163,0.7266961368441284,0.06457812800307515
12686,23.0,302,7914,8216,1,362,10860,3140,7720,10860,818,0.027808471454880294,0.7287292817679558,9.208103130755064e-05,0.289134438305709,0.7108655616942909,0.03333333333333333
12687,17.0,2044,10479,12523,10,1334,16970,4808,12162,16970,802,0.12044784914555097,0.6175014731879788,0.0005892751915144372,0.28332351208014145,0.7166764879198586,0.07860931054802593
12688,,295,6824,7119,58,265,9460,2732,6728,9460,767,0.031183932346723044,0.721353065539112,0.00613107822410148,0.28879492600422835,0.7112050739957717,0.028012684989429177
12689,13.0,30,1827,1857,2,74,2455,695,1760,2455,234,0.012219959266802444,0.7441955193482689,0.000814663951120163,0.2830957230142566,0.7169042769857433,0.03014256619144603
12690,,150,2754,2904,11,232,4220,1091,3129,4220,264,0.035545023696682464,0.6526066350710901,0.0026066350710900474,0.25853080568720377,0.7414691943127962,0.054976303317535544
12691,,1527,38477,40004,56,2226,53276,15283,37994,53277,4265,0.028661523734444506,0.7222065807008653,0.001051110235185915,0.28685924507761323,0.7131407549223868,0.04178163184864012
12692,37.0,2589,45893,48482,563,3598,67509,18957,48552,67509,5060,0.03835044216326712,0.679805655542224,0.008339628790235375,0.280807003510643,0.719192996489357,0.05329659749070494
12693,33.0,2595,35157,37752,177,2826,52145,14424,37788,52212,3180,0.049701218110779134,0.6733509538037232,0.0033900252815444727,0.27625833141806483,0.7237416685819352,0.05412548839347277
12694,17.0,1198,17204,18402,47,1592,25544,7005,18539,25544,1839,0.04689946758534294,0.6735045411838396,0.0018399624177889132,0.27423269652364546,0.7257673034763545,0.062323833385530845
12695,,677,17390,18067,25,2279,26488,6895,19593,26488,1854,0.025558743581999395,0.6565237088492902,0.0009438236182422229,0.26030655391120505,0.739693446088795,0.08603896103896104
12696,17.0,205,2760,2965,3,144,3878,1121,2757,3878,248,0.052862300154718926,0.7117070654976793,0.0007735946364105209,0.2890665291387313,0.7109334708612687,0.037132542547705004
12697,17.0,1648,28580,30228,171,1987,41037,11492,29545,41037,2807,0.04015888100982041,0.6964446718814729,0.004166971269829666,0.2800399639349855,0.7199600360650145,0.04841971879035992
12698,33.0,699,17573,18272,162,1540,24558,6665,17893,24558,1520,0.028463229904715368,0.7155713005945109,0.006596628389934034,0.27139832233895267,0.7286016776610473,0.06270868963270625
12699,,253,7153,7406,35,351,9857,2831,7026,9857,787,0.0256670386527341,0.7256771837273004,0.0035507760982043217,0.28720706097189813,0.7127929390281018,0.035609211727706196
12700,17.0,152,2154,2306,9,91,3736,902,2834,3736,230,0.04068522483940043,0.5765524625267666,0.0024089935760171306,0.24143468950749464,0.7585653104925053,0.0243576017130621
12701,27.0,257,6877,7134,3,391,9312,2633,6679,9312,679,0.027598797250859106,0.7385094501718213,0.00032216494845360824,0.28275343642611683,0.7172465635738832,0.04198883161512027
12702,16.0,39,4655,4694,21,287,6530,1739,4791,6530,555,0.005972434915773353,0.7128637059724349,0.003215926493108729,0.2663093415007657,0.7336906584992343,0.043950995405819294
12703,25.0,63,3989,4052,0,164,5237,1540,3697,5237,413,0.01202978804659156,0.7616956272675196,0.0,0.29406148558334927,0.7059385144166508,0.03131563872446057
12704,27.0,411,9995,10406,51,533,13853,3891,9962,13853,1038,0.02966866382732982,0.7215043672850646,0.0036815130296686638,0.280877788204721,0.719122211795279,0.03847542048653721
12705,,41,6654,6695,9,563,9386,2529,6857,9386,815,0.004368207969316002,0.7089281909226508,0.0009588749200937567,0.2694438525463456,0.7305561474536544,0.05998295333475389
12706,17.0,40,3229,3269,11,136,4099,1264,2835,4099,286,0.009758477677482313,0.7877531105147597,0.002683581361307636,0.3083678946084411,0.691632105391559,0.03317882410343986
12707,15.0,39,1941,1980,4,165,2690,717,1973,2690,169,0.01449814126394052,0.7215613382899628,0.001486988847583643,0.266542750929368,0.7334572490706319,0.06133828996282528
12708,,7019,156231,163250,637,9068,225261,62535,162726,225261,16039,0.031159410639214066,0.693555475648248,0.0028278308273513835,0.2776113042204376,0.7223886957795623,0.04025552581227998
12709,,614,2883,3497,19,216,5342,1280,4062,5342,15,0.11493822538375141,0.5396855110445526,0.00355672032946462,0.23961063272182703,0.760389367278173,0.040434294271808315
12710,14.0,12,5200,5212,23,366,6993,1921,5072,6993,557,0.001716001716001716,0.7436007436007436,0.003289003289003289,0.2747032747032747,0.7252967252967253,0.05233805233805234
12711,26.0,836,19999,20835,98,1289,27940,7960,19980,27940,2115,0.029921259842519685,0.7157838224767359,0.0035075161059413026,0.28489620615604866,0.7151037938439513,0.046134574087329995
12712,,427,8749,9176,53,695,13047,3310,9737,13047,777,0.032727830152525485,0.6705756112516287,0.004062236529470377,0.2536981681612631,0.7463018318387369,0.05326895071663984
12713,15.0,126,4788,4914,121,913,7241,1805,5436,7241,260,0.017400911476315426,0.6612346360999862,0.01671039911614418,0.2492749620218202,0.7507250379781798,0.12608755696726973
12714,44.0,384,8832,9216,30,455,12269,3456,8813,12269,764,0.03129839432716603,0.7198630695248186,0.002445187056809846,0.28168554894449427,0.7183144510555057,0.037085337028282664
12715,24.0,1587,37330,38917,319,2044,52620,14763,37857,52620,3844,0.03015963511972634,0.709426073736222,0.006062333713416952,0.2805587229190422,0.7194412770809578,0.038844545800076014
12716,,95,2147,2242,15,116,2980,848,2132,2980,221,0.031879194630872486,0.7204697986577181,0.0050335570469798654,0.28456375838926173,0.7154362416107383,0.038926174496644296
12717,38.0,120,2396,2516,7,93,3395,966,2429,3395,244,0.035346097201767304,0.7057437407952872,0.002061855670103093,0.2845360824742268,0.7154639175257732,0.02739322533136966
12718,17.0,100,2601,2701,12,98,3586,1001,2585,3586,291,0.02788622420524261,0.7253206915783603,0.0033463469046291134,0.2791411042944785,0.7208588957055214,0.027328499721137756
12719,15.0,119,1681,1800,35,294,2680,694,1986,2680,186,0.044402985074626866,0.6272388059701492,0.013059701492537313,0.258955223880597,0.741044776119403,0.10970149253731343
12720,,152,4719,4871,18,273,6510,1835,4675,6510,469,0.023348694316436252,0.7248847926267281,0.0027649769585253456,0.2818740399385561,0.7181259600614439,0.041935483870967745
12721,,77,1568,1645,9,79,2204,639,1565,2204,164,0.034936479128856626,0.7114337568058077,0.004083484573502722,0.28992740471869327,0.7100725952813067,0.03584392014519056
12722,17.0,235,5432,5667,13,373,7806,2115,5691,7806,532,0.03010504739943633,0.6958749679733538,0.001665385600819882,0.270945426594927,0.7290545734050731,0.04778375608506277
12723,25.0,176,4006,4182,0,413,5948,1664,4284,5948,431,0.029589778076664425,0.6735036987222596,0.0,0.2797579018157364,0.7202420981842637,0.06943510423671823
12724,24.0,809,15460,16269,10,773,22381,6274,16107,22381,1701,0.03614673160269872,0.6907644877351324,0.00044680755998391494,0.2803270631339082,0.7196729368660918,0.034538224386756626
12725,,348,12067,12415,45,549,16195,4606,11589,16195,1226,0.02148811361531337,0.7451065143562828,0.002778635381290522,0.2844087681383143,0.7155912318616857,0.03389935165174437
12726,,5580,145345,150925,563,8077,198411,57807,140604,198411,15135,0.028123440736652707,0.7325450705858042,0.002837544289379117,0.29134977395406503,0.708650226045935,0.040708428464147656
12727,15.0,29,5052,5081,38,589,7093,1918,5175,7093,576,0.004088537995206542,0.7122515155787396,0.0053573946144085715,0.27040744395883265,0.7295925560411674,0.08303961652333286
12728,,56,1792,1848,4,142,2529,700,1829,2529,164,0.022143139580862,0.708580466587584,0.0015816528272044287,0.276789244760775,0.723210755239225,0.05614867536575722
12729,,2041,41659,43700,1242,3275,61058,16531,44527,61058,4564,0.03342723312260474,0.6822856955681483,0.020341314815421403,0.27074257263585444,0.7292574273641456,0.053637524976252085
12730,24.0,139,3181,3320,11,186,4509,1271,3238,4509,351,0.030827234420048793,0.7054779330228432,0.002439565313816811,0.28188068307828784,0.7181193169217122,0.04125083166999335
12731,,113,2882,2995,39,127,3985,1120,2866,3986,307,0.028349222277972905,0.7230306071249373,0.009784244856999498,0.2809834420471651,0.7190165579528349,0.03186151530356247
12732,,5594,58313,63907,995,4019,85017,23449,61568,85017,3838,0.06579860498488538,0.6858981144947481,0.011703541644612254,0.2758154251502641,0.724184574849736,0.04727289836150417
12733,17.0,659,18005,18664,137,980,24299,7128,17171,24299,1619,0.027120457632001316,0.7409769949380633,0.005638092102555661,0.29334540516070623,0.7066545948392938,0.04033087781390181
12734,,164,5353,5517,5,233,7182,2079,5103,7182,550,0.022834864940128097,0.7453355611250349,0.0006961849067112225,0.2894736842105263,0.7105263157894737,0.03244221665274297
12735,,46,2192,2238,0,103,2952,876,2076,2952,236,0.015582655826558265,0.7425474254742548,0.0,0.2967479674796748,0.7032520325203252,0.03489159891598916
12736,17.0,242,6705,6947,0,229,9300,2711,6589,9300,669,0.026021505376344085,0.7209677419354839,0.0,0.291505376344086,0.708494623655914,0.024623655913978495
12737,25.0,766,21549,22315,36,1359,30359,8665,21694,30359,2564,0.025231397608616885,0.7098059883395369,0.0011858098092822557,0.2854178332619651,0.7145821667380349,0.04476432030040515
12738,,112,3812,3924,0,147,5171,1529,3642,5171,377,0.021659253529298008,0.7371881647650358,0.0,0.29568748791336297,0.704312512086637,0.028427770257203635
12739,40.0,4628,47067,51695,811,2476,71605,19321,52284,71605,3305,0.06463235807555338,0.6573144333496265,0.011326024718944208,0.26982752601075344,0.7301724739892466,0.034578590880525104
12740,24.0,1199,21011,22210,94,1286,31311,8164,23147,31311,2181,0.03829325157292964,0.671042125770496,0.0030021398230653763,0.2607390373989972,0.7392609626010028,0.041071827792149726
12741,17.0,202,1548,1750,36,111,2379,661,1718,2379,153,0.08490962589323245,0.6506935687263556,0.015132408575031526,0.27784783522488443,0.7221521647751156,0.04665825977301387
12742,26.0,1180,29162,30342,416,1057,39320,11328,27992,39320,2481,0.030010172939979655,0.7416581892166836,0.010579857578840285,0.2880976602238047,0.7119023397761953,0.026881993896236012
12743,,5267,113720,118987,306,5970,156837,44988,111849,156837,10659,0.033582636750256634,0.7250840044122242,0.001951070219399759,0.28684557853057635,0.7131544214694236,0.03806499741770118
12744,27.0,243,5989,6232,18,273,8073,2460,5613,8073,612,0.030100334448160536,0.7418555679425245,0.002229654403567447,0.3047194351542178,0.6952805648457823,0.033816425120772944
12745,26.0,494,12073,12567,26,647,16902,4833,12069,16902,1239,0.02922731037747012,0.7142941663708436,0.001538279493551059,0.28594249201277955,0.7140575079872205,0.03827949355105904
12746,,171,9897,10068,56,750,14149,3959,10190,14149,818,0.012085659763940914,0.6994840624779136,0.003957876881758428,0.27980776026574317,0.7201922397342568,0.05300727966640752
12747,27.0,669,18561,19230,68,989,25184,7249,17935,25184,1897,0.02656448538754765,0.7370155654383735,0.0027001270648030497,0.2878414866581957,0.7121585133418044,0.03927096569250318
12748,23.0,285,9143,9428,11,439,12559,3530,9029,12559,909,0.0226928895612708,0.7280038219603472,0.0008758659128911537,0.28107333386416117,0.7189266661358389,0.03495501234174696
12749,,71,2375,2446,11,188,3324,904,2420,3324,302,0.021359807460890494,0.7145006016847172,0.003309265944645006,0.2719614921780987,0.7280385078219013,0.056558363417569195
12750,15.0,1507,27885,29392,100,2016,39901,10947,28954,39901,3006,0.0377684769805268,0.6988546652966091,0.0025062028520588457,0.2743540262148818,0.7256459737851182,0.05052504949750633
12751,26.0,319,7758,8077,13,508,11039,2924,8115,11039,810,0.028897545067487998,0.7027810490080624,0.001177642902436815,0.2648790651327113,0.7351209348672887,0.046018661110607845
12752,,77,2407,2484,9,188,3434,980,2454,3434,253,0.02242283051834595,0.7009318578916716,0.0026208503203261502,0.28538147932440305,0.714618520675597,0.054746651135701804
12753,25.0,9455,102545,112000,769,12530,153964,41868,112096,153964,11654,0.06141045958795563,0.6660323192434595,0.004994674079654984,0.27193369878672935,0.7280663012132707,0.08138266088176457
12754,38.0,997,12518,13515,263,673,18398,5033,13365,18398,1137,0.05419067289922818,0.6804000434829873,0.01429503206870312,0.27356234373301447,0.7264376562669855,0.036580063050331554
12755,,5968,113956,119924,1491,5179,153064,45351,107713,153064,9236,0.038990226310562905,0.7444990330842001,0.009741023362776356,0.2962878273140647,0.7037121726859353,0.03383551978257461
12756,24.0,107,2111,2218,13,92,3013,835,2178,3013,231,0.035512777962163955,0.7006306007301693,0.00431463657484235,0.27713242615333555,0.7228675738466644,0.030534351145038167
12757,27.0,410,16145,16555,104,1010,21630,6097,15533,21630,1643,0.018955154877484975,0.7464170134073047,0.004808136846971798,0.28187702265372166,0.7181229773462783,0.04669440591770689
12758,14.0,75,2043,2118,12,126,2851,797,2054,2851,220,0.02630655910206945,0.7165906699403718,0.004209049456331112,0.27955103472465803,0.720448965275342,0.04419501929147668
12759,24.0,405,9761,10166,170,541,13533,3804,9729,13533,830,0.029926845488805143,0.7212739230030296,0.012561885760733024,0.28109066725781423,0.7189093327421857,0.03997635409739156
12760,,105,2448,2553,8,141,3314,965,2349,3314,227,0.03168376584188292,0.7386843693421846,0.0024140012070006035,0.29118889559444777,0.7088111044055522,0.04254677127338564
12761,25.0,1148,18850,19998,324,1651,29767,7476,22291,29767,1536,0.03856619746699365,0.6332515873282494,0.010884536567339672,0.2511506030167635,0.7488493969832365,0.055464104545301846
12762,25.0,716,23060,23776,10,898,30979,9039,21940,30979,2491,0.023112431001646276,0.7443752219245295,0.0003227993156654508,0.29177830143000094,0.7082216985699991,0.02898737854675748
12763,17.0,160,10169,10329,11,561,13033,3787,9246,13033,774,0.012276528811478555,0.7802501342745338,0.0008440113557891506,0.29057009130668304,0.709429908693317,0.04304457914524668
12764,27.0,1449,29670,31119,197,1390,40730,11970,28760,40730,2687,0.03557574269580162,0.7284556837711761,0.004836729683280138,0.29388657009575253,0.7061134299042475,0.03412717898355021
12765,23.0,429,15310,15739,32,465,20539,5978,14561,20539,1844,0.020887092847753055,0.7454111689955694,0.0015580115877111835,0.2910560397292955,0.7089439602707045,0.022639855883928136
12766,,4344,106969,111313,131,5697,148899,43398,105501,148899,9975,0.02917413817419862,0.718399720615988,0.0008797909992679601,0.2914593113452743,0.7085406886547256,0.03826083452541656
12767,23.0,299,7637,7936,26,617,11306,2986,8329,11315,803,0.026425099425541318,0.6749447635881574,0.0022978347326557667,0.26389748121962,0.73610251878038,0.05452938577110031
12768,24.0,162,5184,5346,14,150,6877,2053,4824,6877,562,0.023556783481169113,0.7538170713974116,0.0020357714119528863,0.2985313363385197,0.7014686636614803,0.02181183655663807
12769,16.0,72,2415,2487,21,194,3328,898,2430,3328,243,0.021634615384615384,0.7256610576923077,0.006310096153846154,0.2698317307692308,0.7301682692307693,0.05829326923076923
12770,16.0,251,2947,3198,2,198,4373,1222,3151,4373,311,0.05739766750514521,0.6739080722616053,0.000457351932311914,0.27944203064257944,0.7205579693574206,0.04527784129887949
12771,24.0,378,8873,9251,47,519,12284,3528,8756,12284,994,0.0307717355910127,0.7223217193096712,0.0038261152718984046,0.2872028655161185,0.7127971344838815,0.04225008140670791
12772,17.0,411,7834,8245,133,1335,12198,3034,9164,12198,711,0.03369404820462371,0.6422364322020003,0.010903426791277258,0.24872929988522707,0.7512707001147729,0.10944417117560255
12773,15.0,293,3749,4042,9,319,5584,1518,4066,5584,393,0.05247134670487106,0.6713825214899714,0.0016117478510028654,0.2718481375358166,0.7281518624641834,0.05712750716332378
12774,16.0,1294,21919,23213,706,1987,32386,8864,23522,32386,1381,0.0399555363428642,0.676804792194158,0.02179954301241277,0.2736985117025875,0.7263014882974125,0.06135367133946767
12775,41.0,106,2241,2347,5,117,3402,868,2534,3402,209,0.03115814226925338,0.6587301587301587,0.0014697236919459142,0.2551440329218107,0.7448559670781894,0.03439153439153439
12776,,1,2099,2100,0,64,2767,803,1964,2767,283,0.0003614022406938923,0.7585833032164799,0.0,0.29020599927719554,0.7097940007228045,0.023129743404409108
12777,39.0,63,2748,2811,1,106,3658,1081,2577,3658,293,0.01722252597047567,0.7512301804264625,0.0002733734281027884,0.2955166757791143,0.7044833242208858,0.028977583378895572
12778,34.0,210,4703,4913,73,415,9315,1737,7578,9315,381,0.02254428341384863,0.5048845947396672,0.007836822329575954,0.18647342995169083,0.8135265700483092,0.04455179817498658
12779,25.0,397,9160,9557,34,520,12835,3530,9305,12835,848,0.030931047915855082,0.7136735488897545,0.0026490066225165563,0.27502921698480715,0.7249707830151928,0.04051421893260616
12780,14.0,551,2730,3295,682,3944,9345,1188,8157,9345,303,0.058962011771000536,0.29213483146067415,0.07298020331728197,0.12712680577849117,0.8728731942215088,0.422043873729267
12781,17.0,1,2524,2525,1,102,3439,937,2502,3439,320,0.0002907822041291073,0.7339342832218668,0.0002907822041291073,0.27246292526897353,0.7275370747310265,0.029659784821168943
12782,41.0,780,15806,16586,50,651,21622,6329,15323,21652,1679,0.03602438573803805,0.7300018474043968,0.0023092554960280807,0.29230556068723446,0.7076944393127655,0.03006650655828561
12783,40.0,348,5285,5633,54,356,7825,2092,5733,7825,515,0.044472843450479235,0.6753993610223642,0.006900958466453674,0.2673482428115016,0.7326517571884984,0.04549520766773163
12784,,1439,29987,31426,589,1609,43329,12100,31229,43329,3234,0.03321101340903321,0.6920768999976921,0.013593667059013593,0.2792586951002793,0.7207413048997208,0.037134482679037135
12785,,635,6901,7536,18,559,10544,2838,7706,10544,572,0.06022382397572079,0.6544954476479514,0.0017071320182094083,0.2691578148710167,0.7308421851289834,0.05301593323216995
12786,,52,1726,1778,0,58,2298,658,1640,2298,188,0.022628372497824196,0.7510879025239339,0.0,0.2863359442993908,0.7136640557006092,0.025239338555265448
12787,,354,10658,11012,39,384,13719,4227,9492,13719,813,0.02580363000218675,0.7768787812522778,0.0028427727968510824,0.3081128362125519,0.6918871637874481,0.027990378307456813
12788,,2,4240,4242,54,246,5782,1678,4104,5782,442,0.0003459010722933241,0.7333102732618471,0.00933932895191975,0.2902109996540989,0.7097890003459011,0.04254583189207887
12789,15.0,801,13462,14263,74,1020,20328,5333,14995,20328,1335,0.039403778040141675,0.6622392758756395,0.0036402990948445494,0.2623475009838646,0.7376524990161354,0.050177095631641085
12790,,1129,27743,28872,47,1241,38791,11145,27646,38791,3004,0.02910468923203836,0.7151916681704519,0.0012116212523523497,0.28730891186099866,0.7126910881390013,0.031991956897218427
12791,26.0,348,8923,9271,15,406,12359,3568,8791,12359,916,0.028157617930253256,0.72198397928635,0.0012136904280281575,0.28869649648029777,0.7113035035197023,0.032850554251962136
12792,23.0,860,22074,22934,65,1064,30793,8808,21985,30793,2413,0.027928425291462344,0.7168512324229532,0.0021108693534244794,0.2860390348455818,0.7139609651544182,0.03455330756990225
12793,25.0,805,14904,15709,210,760,20525,5882,14643,20525,1263,0.03922046285018271,0.7261388550548112,0.01023142509135201,0.2865773447015834,0.7134226552984165,0.03702801461632156
12794,,733,21807,22540,134,1211,30109,8684,21425,30109,2044,0.024344880268358297,0.724268491148826,0.004450496529276961,0.28841874522568,0.71158125477432,0.040220532066823876
12795,24.0,130,2715,2845,10,110,3768,1123,2645,3768,297,0.034501061571125265,0.7205414012738853,0.002653927813163482,0.29803609341825904,0.701963906581741,0.029193205944798302
12796,,112,4517,4629,16,158,6032,1739,4293,6032,489,0.01856763925729443,0.7488395225464191,0.002652519893899204,0.28829575596816975,0.7117042440318302,0.02619363395225464
12797,24.0,1413,35012,36425,123,1703,47414,14063,33351,47414,3178,0.029801324503311258,0.7384316868435483,0.002594170498165099,0.29660016029020964,0.7033998397097904,0.03591766145020458
12798,26.0,2379,54695,57074,235,2840,78920,21817,57103,78920,6115,0.030144450076026355,0.6930435884439939,0.002977698935631019,0.27644450076026356,0.7235554992397364,0.03598580841358338
12799,,61,3210,3271,16,169,4345,1246,3099,4345,325,0.014039125431530495,0.7387802071346375,0.003682393555811277,0.2867663981588032,0.7132336018411968,0.038895281933256615
12800,23.0,1714,29099,30813,372,2542,43930,11674,32256,43930,2684,0.039016617345777375,0.662394718870931,0.008468017300250399,0.2657409515137719,0.7342590484862281,0.05786478488504439
12801,,559,13464,14023,48,665,18609,5324,13285,18609,1393,0.030039228330377775,0.7235208769950024,0.0025793970659358373,0.2860981245633833,0.7139018754366167,0.03573539685098608
12802,16.0,24,2801,2825,2,246,3988,1084,2904,3988,304,0.006018054162487462,0.7023570712136409,0.0005015045135406219,0.27181544633901705,0.728184553660983,0.06168505516549649
12803,15.0,1306,42895,44201,442,4113,62743,17000,45743,62743,4826,0.020815071003936696,0.6836619224455318,0.007044610554165405,0.2709465597755925,0.7290534402244075,0.06555312943276541
12804,23.0,3210,56799,60009,134,4276,81122,22956,58166,81122,5864,0.03957003032469614,0.7001676487266093,0.0016518330415916768,0.2829811888267055,0.7170188111732946,0.052710731983925445
12805,,559,14427,14986,61,716,19895,5691,14204,19895,1500,0.028097511937672782,0.7251570746418698,0.003066097009298819,0.2860517718019603,0.7139482281980397,0.03598894194521236
12806,24.0,8,3192,3200,7,135,4274,1250,3024,4274,380,0.0018717828731867104,0.7468413664014975,0.0016378100140383716,0.2924660739354235,0.7075339260645765,0.031586335985025735
12807,16.0,4593,79780,84373,303,7697,115901,32120,83786,115906,9286,0.03962693907131641,0.6883163943195348,0.002614187358721723,0.2771211153866064,0.7228788846133936,0.06640726105637326
12808,,650,10319,10969,75,309,14009,4142,9867,14009,925,0.046398743664786926,0.7365979013491327,0.005353701192090799,0.2956670711685345,0.7043329288314655,0.02205724891141409
12809,,490,8911,9401,52,709,14209,3561,10648,14209,859,0.03448518544584418,0.627137729607995,0.0036596523330283625,0.2506158068829615,0.7493841931170385,0.0498979520022521
12810,26.0,667,14716,15383,35,946,20436,5869,14567,20436,1490,0.032638481111763554,0.7201017811704835,0.0017126639264043843,0.2871892738304952,0.7128107261695048,0.046290859267958506
12811,25.0,350,11129,11479,36,359,15000,4331,10669,15000,1487,0.023333333333333334,0.7419333333333333,0.0024,0.28873333333333334,0.7112666666666667,0.023933333333333334
12812,,3883,106816,110699,598,5396,149189,41931,107291,149222,10611,0.02602163219900551,0.7158193832008685,0.00400745198429186,0.28099744005575583,0.7190025599442441,0.03616088780474729
12813,25.0,673,22219,22892,130,1028,30634,8862,21772,30634,2359,0.02196905399229614,0.7253052164261932,0.004243650845465822,0.2892864137886009,0.7107135862113991,0.03355748514722204
12814,27.0,56,1297,1353,0,58,1835,499,1336,1835,142,0.030517711171662125,0.7068119891008174,0.0,0.27193460490463217,0.7280653950953678,0.03160762942779292
12815,40.0,434,11601,12035,27,505,15814,4530,11284,15814,1255,0.02744403692930315,0.7335904894397369,0.0017073479195649425,0.2864550398381181,0.7135449601618818,0.031933729606677626
12816,,3756,77576,81332,329,3620,109543,32077,77491,109568,7959,0.03428008177570094,0.7080169392523364,0.003002701518691589,0.2927588346962617,0.7072411653037384,0.033038843457943924
12817,,20229,413035,433265,3313,29206,589671,165467,424823,590290,41975,0.03426959630012367,0.6997153941283099,0.005612495553033255,0.2803147605414288,0.7196852394585712,0.0494773755272832
12818,,268,6063,6331,28,191,8634,2434,6200,8634,669,0.03104007412555015,0.702223766504517,0.0032429928190873293,0.28190873291637714,0.7180912670836229,0.022121843873059995
12819,13.0,953,24391,25344,26,1280,33552,9503,24049,33552,2297,0.028403671912255603,0.7269611349546972,0.0007749165474487363,0.2832319980925131,0.7167680019074869,0.03814973772055317
12820,,583,12111,12694,180,897,16702,4709,11993,16702,1093,0.03490599928152317,0.7251227397916418,0.010777152436833913,0.28194228236139385,0.7180577176386062,0.053706142976889
12821,25.0,1512,41847,43359,49,2747,56783,16056,40727,56783,3842,0.02662768786432559,0.7369635278164239,0.0008629343289364774,0.28276068541640986,0.7172393145835901,0.048377155134459254
12822,24.0,468,7379,7847,33,646,10814,2958,7856,10814,721,0.04327723321620122,0.6823562049195487,0.003051599778065471,0.2735343073793231,0.726465692620677,0.05973737747364528
12823,26.0,174,5360,5534,32,236,7234,2095,5139,7234,555,0.024053082665192148,0.7409455349737352,0.004423555432679016,0.2896046447332043,0.7103953552667956,0.03262372131600774
12824,25.0,59,12203,12262,101,618,16477,4641,11836,16477,1347,0.0035807489227407904,0.7406081204102689,0.006129756630454573,0.281665351702373,0.7183346482976269,0.037506827699217093
12825,35.0,928,22219,23147,144,1061,30946,8662,22284,30946,2457,0.029987720545466296,0.7179926323272797,0.004653266981193046,0.27990693466037614,0.7200930653396238,0.034285529632262654
12826,27.0,540,13333,13873,62,482,18162,5310,12852,18162,1282,0.02973240832507433,0.734115185552252,0.0034137209558418678,0.2923686818632309,0.707631318136769,0.02653892743089968
12827,17.0,281,12847,13128,5,584,17413,5061,12352,17413,1478,0.016137368632630794,0.7377821168092804,0.00028714179061620627,0.290644920461724,0.709355079538276,0.03353816114397289
12828,,21839,470867,492706,1897,21837,653809,188813,464996,653809,47297,0.033402721589944465,0.7201904531751627,0.002901458988787245,0.28878923355291836,0.7112107664470816,0.03339966259259203
12829,24.0,3335,75315,78650,318,5007,107304,30232,77072,107304,7745,0.03107992246328189,0.7018843659136659,0.0029635428315813016,0.28174159397599347,0.7182584060240066,0.04666182062178484
12830,15.0,900,13446,14346,50,996,20037,5483,14554,20037,1348,0.04491690372810301,0.671058541697859,0.002495383540450167,0.2736437590457653,0.7263562409542347,0.04970804012576733
12831,27.0,2918,61729,64647,311,3364,87105,24217,62888,87105,6399,0.03349979909304862,0.7086734401010275,0.003570403535962344,0.27802077951897136,0.7219792204810287,0.038620056253946385
12832,24.0,64,1421,1485,3,76,1986,555,1431,1986,159,0.032225579053373615,0.7155085599194361,0.0015105740181268882,0.2794561933534743,0.7205438066465257,0.038267875125881166
12833,25.0,1530,38324,39854,129,1629,52412,15124,37288,52412,4108,0.02919178814012058,0.7312065939097917,0.0024612684118140884,0.2885598717850874,0.7114401282149126,0.03108066854918721
12834,35.0,797,17792,18589,149,826,24605,7057,17548,24605,1788,0.03239179028652713,0.7231050599471652,0.006055679739890266,0.2868116236537289,0.7131883763462711,0.03357041251778094
12835,25.0,162,6762,6924,51,257,8977,2628,6349,8977,683,0.018046117856745016,0.7532583268352456,0.005681185251197505,0.29274813412053025,0.7072518658794698,0.028628717834465855
12836,,183,3807,3990,10,273,5543,1431,4113,5544,347,0.03300865800865801,0.6866883116883117,0.0018037518037518038,0.25811688311688313,0.7418831168831169,0.04924242424242424
12837,41.0,4559,105237,109796,126,4426,141626,41825,99801,141626,9932,0.03219041701382515,0.7430627144733312,0.0008896671515117281,0.29532006834903196,0.7046799316509681,0.03125132390945166
12838,,1140,36597,37737,101,4060,51778,14258,37520,51778,3477,0.022017072888099194,0.7068059793734791,0.0019506354049982617,0.27536791687589324,0.7246320831241068,0.07841168063656379
12839,34.0,403,8874,9277,27,644,12298,3502,8796,12298,897,0.03276955602536998,0.7215807448365588,0.0021954789396649863,0.28476174987802894,0.7152382501219711,0.05236623841275004
12840,27.0,157,2063,2220,14,120,3019,845,2174,3019,209,0.052003974826101355,0.6833388539251408,0.004637297118251077,0.27989400463729713,0.7201059953627029,0.03974826101358066
12841,24.0,532,10584,11116,58,273,14686,4281,10405,14686,1040,0.03622497616777884,0.7206863679694948,0.003949339507013482,0.29150211085387445,0.7084978891461255,0.018589132507149667
12842,,102,2033,2135,15,161,2959,802,2157,2959,181,0.03447110510307536,0.6870564379858061,0.005069280162216965,0.2710375126732004,0.7289624873267996,0.05441027374112876
12843,,1966,55874,58211,183,2155,75673,21917,53756,75673,5769,0.02598020430008061,0.738361106339117,0.002418299789885428,0.28962774040939304,0.7103722595906069,0.0284777926076672
12844,,550,15064,15614,99,619,20654,5899,14755,20654,1651,0.026629224363319454,0.729350246925535,0.004793260385397502,0.28561053548949356,0.7143894645105064,0.029969981601626804
12845,23.0,350,6476,6826,20,372,9235,2643,6592,9235,767,0.03789929615592853,0.7012452625879805,0.002165674066053059,0.28619382782891173,0.7138061721710882,0.0402815376285869
12846,13.0,42,2117,2159,45,415,3139,807,2332,3139,124,0.0133800573431029,0.6744186046511628,0.014335775724753107,0.25708824466390573,0.7429117553360943,0.13220770946161198
12847,33.0,367,21327,21694,6,1072,28106,8058,20048,28106,2241,0.01305771009748808,0.7588059489077066,0.0002134775492777343,0.28670034867999716,0.7132996513200028,0.03814132213762186
12848,35.0,508,14235,14743,42,673,19450,5621,13829,19450,1602,0.026118251928020565,0.7318766066838046,0.002159383033419023,0.2889974293059126,0.7110025706940875,0.03460154241645244
12849,15.0,3472,79022,82494,322,4803,109639,31031,78608,109639,7134,0.031667563549466884,0.7207471793796003,0.002936911135636042,0.2830288492233603,0.7169711507766398,0.04380740429956494
12850,26.0,136,2079,2215,7,105,2970,858,2112,2970,274,0.04579124579124579,0.7,0.0023569023569023568,0.28888888888888886,0.7111111111111111,0.03535353535353535
12851,16.0,2309,29889,32198,231,2627,45681,12086,33595,45681,2631,0.050546178936538164,0.6542982859394496,0.0050568069875878375,0.26457389286574284,0.7354261071342572,0.05750749764672402
12852,24.0,172,3743,3915,44,385,5417,1493,3924,5417,470,0.03175189219124977,0.690972863208418,0.008122577072180174,0.27561380838102273,0.7243861916189773,0.07107254938157652
12853,,140,2830,2970,7,133,3921,1111,2810,3921,321,0.03570517725070135,0.7217546544248916,0.0017852588625350675,0.28334608518235144,0.7166539148176485,0.033919918388166284
12854,14.0,432,8678,9110,26,462,12100,3470,8630,12100,803,0.03570247933884298,0.7171900826446281,0.0021487603305785125,0.28677685950413223,0.7132231404958678,0.038181818181818185
12855,24.0,104,3218,3322,8,213,4310,1236,3074,4310,267,0.024129930394431554,0.7466357308584687,0.0018561484918793504,0.28677494199535963,0.7132250580046404,0.0494199535962877
12856,26.0,184,5800,5984,28,210,7612,2243,5369,7612,543,0.02417235943247504,0.7619548081975828,0.0036784025223331584,0.2946663163426169,0.705333683657383,0.027588018917498687
12857,25.0,485,12783,13268,45,901,18327,5049,13278,18327,1376,0.026463687455666504,0.6974954984449173,0.002455393681453593,0.27549517105909316,0.7245048289409068,0.04916243793310417
12858,,32,1635,1667,5,82,2475,624,1851,2475,180,0.01292929292929293,0.6606060606060606,0.00202020202020202,0.25212121212121213,0.7478787878787879,0.03313131313131313
12859,,2279,40086,42431,615,4408,61533,16039,45494,61533,3905,0.037037037037037035,0.6514553166593535,0.009994637024035883,0.2606568832983927,0.7393431167016072,0.07163635772674824
12860,38.0,60,1513,1573,6,84,2253,563,1690,2253,152,0.02663115845539281,0.6715490457168221,0.002663115845539281,0.2498890368397692,0.7501109631602308,0.037283621837549935
12861,,101,2560,2661,46,116,3595,1013,2582,3595,318,0.028094575799721837,0.7121001390820584,0.012795549374130737,0.28178025034770515,0.7182197496522948,0.03226703755215577
12862,,37,1030,1216,3,93,1784,398,1386,1784,108,0.020739910313901346,0.577354260089686,0.0016816143497757848,0.22309417040358745,0.7769058295964125,0.052130044843049325
12863,,486,17204,17690,97,996,23502,6883,16619,23502,1659,0.020679091141179475,0.7320228065696537,0.004127308314186027,0.2928686920262105,0.7071313079737894,0.04237937196834312
12864,,403,10459,10862,19,434,14182,4147,10035,14182,1179,0.02841630235509801,0.7374841348187844,0.0013397264137639262,0.29241291778310535,0.7075870822168947,0.03060217176702863
12865,17.0,234,2549,2783,12,211,3772,1038,2734,3772,273,0.06203605514316013,0.6757688229056203,0.003181336161187699,0.27518557794273596,0.7248144220572641,0.05593849416755037
12866,35.0,487,12096,12583,0,505,17729,4791,12938,17729,1171,0.02746911839359242,0.682271983755429,0.0,0.27023520785154265,0.7297647921484574,0.028484404083704666
12867,23.0,249,8268,8517,10,251,11053,3242,7811,11053,924,0.022527820501221388,0.7480322084501945,0.0009047317470370035,0.2933140323893965,0.7066859676106034,0.022708766850628788
12868,,88,4116,4204,9,661,6284,1671,4613,6284,243,0.014003819223424571,0.6549968173138129,0.0014322087842138765,0.26591343093570974,0.7340865690642903,0.10518777848504138
12869,26.0,181,2778,2959,14,139,4368,1079,3289,4368,240,0.041437728937728936,0.635989010989011,0.003205128205128205,0.24702380952380953,0.7529761904761905,0.03182234432234432
12870,,766,22593,23359,45,1290,31126,8941,22185,31126,2491,0.024609651095547132,0.7258561973912485,0.001445736683158774,0.2872518152027244,0.7127481847972756,0.04144445158388486
12871,,219,3043,3262,28,128,4603,1283,3320,4603,360,0.04757766673908321,0.6610905930914621,0.006082989354768629,0.2787312622202911,0.7212687377797089,0.02780795133608516
12872,36.0,22,2196,2218,2,81,2913,805,2108,2913,306,0.007552351527634741,0.7538619979402678,0.0006865774116031583,0.2763474081702712,0.7236525918297289,0.027806385169927908
12873,,9171,245607,254778,2081,14323,355628,96862,258766,355628,26495,0.025788183157681624,0.6906289718469861,0.005851620232377653,0.27236887984073244,0.7276311201592676,0.04027523142159785
12874,,229,5159,5388,55,264,6979,2074,4905,6979,436,0.03281272388594354,0.7392176529588766,0.0078807852127812,0.29717724602378565,0.7028227539762144,0.037827769021349766
12875,27.0,29,1943,1972,3,112,3041,725,2316,3041,231,0.009536336731338375,0.6389345609996712,0.0009865175928970734,0.23840841828345938,0.7615915817165406,0.03682999013482407
12876,,344,10585,10929,55,439,14265,4092,10173,14265,1140,0.02411496670171749,0.7420259376095338,0.00385559060637925,0.2868559411146162,0.7131440588853838,0.030774623203645286
12877,17.0,548,10968,11516,54,1855,16939,4366,12573,16939,908,0.032351378475706946,0.6474998524115946,0.0031879095578251373,0.25774839128638055,0.7422516087136195,0.10951059684751166
12878,13.0,2672,27239,29911,848,2967,42244,11579,30665,42244,2325,0.06325158602405075,0.6448016286336521,0.020073856642363413,0.2740980967711391,0.725901903228861,0.07023482624751444
12879,26.0,63,3808,3871,18,247,5203,1447,3756,5203,448,0.01210839900057659,0.7318854507015183,0.0034595425715933117,0.27810878339419565,0.7218912166058044,0.04747261195464155
12880,13.0,457,7126,7583,99,265,9688,2800,6888,9688,536,0.04717175887696119,0.7355491329479769,0.010218827415359207,0.28901734104046245,0.7109826589595376,0.02735342691990091
12881,17.0,6,2041,2047,6,279,3084,778,2306,3084,148,0.0019455252918287938,0.6618028534370947,0.0019455252918287938,0.2522697795071336,0.7477302204928664,0.09046692607003891
12882,35.0,1404,33126,34530,146,1718,45367,13162,32205,45367,3401,0.030947605087398328,0.7301783234509666,0.003218198249829171,0.29012277646747636,0.7098772235325237,0.03786893556990764
12883,17.0,126,3251,3377,8,182,4496,1254,3242,4496,307,0.02802491103202847,0.7230871886120996,0.0017793594306049821,0.27891459074733094,0.7210854092526691,0.04048042704626335
12884,25.0,11307,308298,319605,638,15113,418621,122219,296402,418621,32321,0.027010111771745803,0.7364609037769247,0.0015240515884296297,0.29195620859918636,0.7080437914008136,0.03610186779927428
12885,25.0,89,2544,2633,10,88,3453,994,2459,3453,297,0.025774688676513176,0.736750651607298,0.0028960324355632784,0.2878656240949899,0.7121343759050102,0.02548508543295685
12886,14.0,140,3485,3625,29,490,5075,1370,3705,5075,325,0.027586206896551724,0.6866995073891625,0.005714285714285714,0.26995073891625615,0.7300492610837438,0.09655172413793103
12887,17.0,426,9705,10131,33,1028,14717,3889,10828,14717,1036,0.028946116735747776,0.6594414622545356,0.0022423048175579264,0.26425222531765985,0.7357477746823402,0.06985119249847116
12888,,897,23551,24448,100,1213,33714,9406,24308,33714,2270,0.026606157679302366,0.6985525301061873,0.0029661268315833186,0.2789938897787269,0.721006110221273,0.03597911846710565
12889,16.0,88,1976,2064,22,204,2841,788,2053,2841,174,0.030975008799718408,0.6955297430482225,0.007743752199929602,0.2773671242520239,0.7226328757479761,0.07180570221752904
12890,23.0,212,5582,5794,69,357,7824,2201,5623,7824,617,0.0270961145194274,0.7134458077709611,0.008819018404907975,0.28131390593047034,0.7186860940695297,0.04562883435582822
12891,24.0,806,14802,15608,85,589,21855,5968,15887,21855,1435,0.03687943262411347,0.6772820864790666,0.0038892701898878973,0.27307252345001143,0.7269274765499886,0.02695035460992908
12892,26.0,469,13610,14079,55,917,18825,5280,13545,18825,1291,0.0249136786188579,0.7229747675962815,0.0029216467463479417,0.2804780876494024,0.7195219123505976,0.04871181938911023
12893,27.0,2495,63779,66274,211,2768,89937,25175,64762,89937,6965,0.02774164137118205,0.7091519619289058,0.002346086705138041,0.27991816493767857,0.7200818350623214,0.03077709952522321
12894,16.0,110,5554,5664,53,710,8041,2038,6003,8041,472,0.013679890560875513,0.6907101106827509,0.0065912199975127475,0.2534510633005845,0.7465489366994155,0.0882974754383783
12895,25.0,66,1970,2036,0,108,2770,791,1979,2770,211,0.023826714801444042,0.7111913357400722,0.0,0.2855595667870036,0.7144404332129964,0.03898916967509025
12896,,146,2406,2552,8,139,3411,980,2431,3411,310,0.04280269715625916,0.7053649956024626,0.0023453532688361184,0.2873057754324245,0.7126942245675755,0.04075051304602756
12897,23.0,144,8141,8285,7,541,10638,3038,7600,10638,762,0.01353637901861252,0.765275427711976,0.0006580184245158864,0.2855799962398947,0.7144200037601053,0.050855423951870656
12898,26.0,170,4000,4170,32,196,5528,1616,3912,5528,476,0.030752532561505064,0.723589001447178,0.005788712011577424,0.29232995658465993,0.7076700434153401,0.03545586107091172
12899,,9756,162796,172552,1136,9357,231745,65551,166194,231745,16559,0.04209799564176142,0.7024790178860385,0.004901939631923019,0.282858314095234,0.717141685904766,0.040376275647802544
12900,,263,5786,6049,51,310,8202,2300,5902,8202,607,0.03206534991465496,0.7054376981224092,0.006217995610826628,0.2804194099000244,0.7195805900999757,0.03779565959522068
12901,25.0,160,4355,4515,8,352,6220,1659,4561,6220,493,0.02572347266881029,0.7001607717041801,0.0012861736334405145,0.2667202572347267,0.7332797427652733,0.05659163987138264
12902,,137,2180,2317,16,195,3184,869,2315,3184,195,0.04302763819095477,0.6846733668341709,0.005025125628140704,0.27292713567839194,0.727072864321608,0.061243718592964826
12903,43.0,461,11412,11873,22,669,15649,4468,11181,15649,1140,0.029458751357914245,0.7292478752635951,0.0014058406287941721,0.2855134513387437,0.7144865486612563,0.042750335484695506
12904,25.0,3481,92373,95854,351,4498,125266,36774,88492,125266,9212,0.02778886529465298,0.7374147813452973,0.002802037264700717,0.2935672888094136,0.7064327111905865,0.03590758865134993
12905,24.0,64,3426,3490,10,183,4734,1314,3420,4734,367,0.01351922264469793,0.7237008871989861,0.0021123785382340513,0.27756653992395436,0.7224334600760456,0.038656527249683145
12906,,306,5898,6204,28,411,8632,2375,6257,8632,579,0.03544949026876738,0.683271547729379,0.003243744207599629,0.27513901760889714,0.7248609823911029,0.04761353104726599
12907,15.0,115,13190,13305,112,754,18198,4949,13249,18198,1389,0.006319375755577536,0.72480492361798,0.006154522474997252,0.2719529618639411,0.7280470381360589,0.04143312451917793
12908,,225,5674,5899,10,260,7957,2234,5723,7957,637,0.02827698881487998,0.7130828201583511,0.0012567550584391101,0.2807590800552972,0.7192409199447027,0.03267563151941687
12909,24.0,74,1516,1590,4,74,2193,606,1587,2193,187,0.0337437300501596,0.6912904696762426,0.001823985408116735,0.2763337893296854,0.7236662106703147,0.0337437300501596
12910,23.0,4746,122598,133200,534,6345,177434,48910,128524,177434,12412,0.026747973894518526,0.6909498743194653,0.0030095697555147264,0.27565179165210724,0.7243482083478927,0.035759775465807005
12911,,747,21906,22653,81,932,29393,8507,21018,29525,2184,0.025300592718035562,0.7419475021168501,0.002743437764606266,0.28812870448772226,0.7118712955122777,0.03156646909398814
12912,,237,4903,5140,14,185,6824,1915,4909,6824,509,0.034730363423212195,0.7184935521688159,0.0020515826494724504,0.2806271981242673,0.7193728018757327,0.027110199296600235
12913,17.0,3253,47664,50917,237,3203,69453,19360,50093,69453,4823,0.04683742962866975,0.6862770506673578,0.0034123795948339166,0.2787496580421292,0.7212503419578707,0.04611751832174276
12914,17.0,10669,147368,158037,587,10133,214033,60347,153687,214034,14520,0.04984722053505518,0.6885261220179971,0.002742554921180747,0.28195053122401115,0.7180494687759889,0.04734294551332966
12915,,378,5882,6260,49,311,8466,2384,6082,8466,572,0.0446491849751949,0.6947791164658634,0.005787857311599339,0.2815969761398535,0.7184030238601464,0.03673517599811009
12916,,99,2242,2341,3,156,3169,881,2288,3169,225,0.031240138845061535,0.707478699905333,0.0009466708740927738,0.27800568002524456,0.7219943199747555,0.049226885452824234
12917,23.0,120,76981,77101,553,3532,103165,29343,73822,103165,9155,0.001163185188775263,0.7461929918092376,0.00536034507827267,0.2844278582852712,0.7155721417147288,0.03423641738961857
12918,24.0,430,14645,15075,24,698,20273,5637,14636,20273,1668,0.021210476989098802,0.7223893848961673,0.001183840576135747,0.2780545553198836,0.7219454446801165,0.03443003008928131
12919,15.0,643,9720,10363,41,1238,14537,3940,10597,14537,998,0.044231959826649236,0.6686386462131114,0.002820389351310449,0.27103253766251634,0.7289674623374837,0.0851620004127399
12920,15.0,170,6205,6375,18,402,8450,2368,6082,8450,620,0.020118343195266272,0.7343195266272189,0.0021301775147928993,0.28023668639053256,0.7197633136094674,0.04757396449704142
12921,,135,5360,5495,3,173,7185,2084,5101,7185,759,0.018789144050104383,0.7459986082115518,0.0004175365344467641,0.29004871259568543,0.7099512874043146,0.02407794015309673
12922,,322,9520,9842,0,523,12998,3712,9286,12998,1008,0.024773042006462534,0.7324203723649793,0.0,0.28558239729189105,0.714417602708109,0.04023695953223573
12923,15.0,1485,19529,21014,117,1432,28318,8054,20264,28318,1944,0.05244014407797161,0.6896320361607459,0.004131647715234127,0.2844127410127834,0.7155872589872166,0.05056854297619889
12924,17.0,110,3930,4040,19,104,5200,1690,3510,5200,304,0.021153846153846155,0.7557692307692307,0.003653846153846154,0.325,0.675,0.02
12925,14.0,47,1844,1891,15,158,2685,712,1973,2685,221,0.017504655493482308,0.6867783985102421,0.00558659217877095,0.26517690875232774,0.7348230912476722,0.05884543761638734
12926,,51,2244,2295,2,87,2997,884,2113,2997,241,0.01701701701701702,0.7487487487487487,0.000667334000667334,0.29496162829496164,0.7050383717050384,0.02902902902902903
12927,16.0,1122,28302,29424,74,1938,40510,11734,28776,40510,2091,0.02769686497161195,0.6986423105406072,0.00182670945445569,0.2896568748457171,0.7103431251542829,0.047840039496420635
12928,16.0,1151,26333,27484,94,1325,35700,10620,25080,35700,2588,0.032240896358543415,0.7376190476190476,0.0026330532212885155,0.29747899159663865,0.7025210084033613,0.03711484593837535
12929,,86,3178,3264,7,184,4758,1255,3503,4758,346,0.01807482135350988,0.667927700714586,0.0014712063892391761,0.26376628835645227,0.7362337116435477,0.03867171080285835
12930,,4870,118417,138934,1527,4529,176871,46933,129939,176872,9238,0.027534035912976616,0.6695067619521462,0.008633361979284455,0.2653500836763309,0.734649916323669,0.025606088018454022
12931,23.0,117,2199,2316,2,114,3113,881,2232,3113,206,0.037584323803405074,0.7063925473819467,0.00064246707356248,0.2830067459042724,0.7169932540957276,0.03662062319306136
12932,,396,4656,5052,22,473,6901,1903,4998,6901,438,0.05738298797275757,0.6746848282857557,0.0031879437762643097,0.2757571366468628,0.7242428633531373,0.06854079118968265
12933,14.0,1170,16016,17186,34,1494,23193,6504,16689,23193,1552,0.05044625533566162,0.6905531841503902,0.0014659595567628164,0.2804294399172164,0.7195705600827836,0.06441598758246023
12934,,125,1905,2030,0,489,3308,765,2543,3308,118,0.037787182587666265,0.5758766626360339,0.0,0.23125755743651755,0.7687424425634825,0.14782345828295043
12935,,729,15997,16726,58,948,22958,6343,16615,22958,1698,0.03175363707640038,0.6967941458315184,0.002526352469727328,0.2762871330255249,0.7237128669744751,0.041292795539681154
12936,23.0,511,12898,13409,25,877,17982,5136,12846,17982,1277,0.028417306195083973,0.7172728283839395,0.0013902791680569459,0.28561895228561895,0.714381047714381,0.04877099321543766
12937,27.0,1013,28027,29040,22,1408,38422,11118,27312,38430,2960,0.02635961488420505,0.7293000260213375,0.0005724694249284413,0.28930523028883687,0.7106947697111632,0.036638043195420245
12938,15.0,281,3312,3593,30,386,5040,1326,3714,5040,256,0.05575396825396826,0.6571428571428571,0.005952380952380952,0.2630952380952381,0.736904761904762,0.07658730158730159
12939,43.0,2203,57544,59747,29,3169,78467,22633,55835,78468,5807,0.028075138910128968,0.7333435285721568,0.0003695774073507672,0.2884360503644798,0.7115639496355202,0.04038588978946832
12940,17.0,1045,28509,29554,91,1513,38806,11046,27760,38806,2902,0.026928825439365048,0.734654434881204,0.0023449981961552336,0.2846467041179199,0.7153532958820801,0.038988816162449105
12941,17.0,2891,52733,55624,666,2413,73917,21011,52906,73917,5670,0.03911143579961308,0.7134082822625377,0.009010105929623768,0.28425125478577323,0.7157487452142268,0.032644723135408636
12942,37.0,3430,92386,95816,668,9269,135123,35745,99378,135123,9333,0.025384279508299846,0.6837177978582477,0.0049436439392257425,0.264536755400635,0.7354632445993651,0.06859675998904702
12943,,431,15190,15621,196,530,19733,5995,13738,19733,1135,0.02184158516191152,0.7697765164952111,0.009932600212841433,0.3038058075305326,0.6961941924694673,0.026858561800030406
12944,13.0,263,4063,4326,28,279,5932,1638,4294,5932,455,0.044335805799055966,0.6849291975724882,0.004720161834120027,0.27612946729602156,0.7238705327039784,0.04703304113283884
12945,13.0,474,2410,2884,351,139,3970,1028,2942,3970,195,0.11939546599496222,0.6070528967254408,0.08841309823677582,0.25894206549118387,0.7410579345088161,0.03501259445843829
12946,16.0,4393,78633,83026,304,6069,114176,31813,82363,114176,7450,0.03847568665919283,0.6886999019058296,0.002662556053811659,0.2786312359865471,0.721368764013453,0.05315477858744395
12947,16.0,46,1867,1913,25,108,2638,726,1912,2638,250,0.017437452615617893,0.7077331311599697,0.009476876421531463,0.27520849128127367,0.7247915087187263,0.04094010614101592
12948,23.0,9274,188168,197442,961,11529,270100,75597,194503,270100,19974,0.03433543132173269,0.6966604961125509,0.0035579415031469826,0.27988522769344687,0.7201147723065531,0.042684191040355424
12949,27.0,3910,79619,83529,671,4558,109599,31736,77866,109602,6733,0.0356745314866517,0.7264374737687268,0.006122151055637671,0.2895567599131403,0.7104432400868598,0.04158683235707378
12950,,115,3127,3242,10,150,4334,1247,3087,4334,289,0.0265343793262575,0.7215043839409322,0.0023073373327180432,0.28772496538994,0.71227503461006,0.03461005999077065
12951,,20236,383793,404029,3196,27772,542671,153626,389045,542671,35611,0.03728962852262236,0.7072296105743627,0.005889387861153443,0.2830923340292737,0.7169076659707263,0.05117649551938468
12952,,707,11342,12049,154,516,16643,4539,12104,16643,1161,0.0424803220573214,0.6814877125518236,0.009253139458030404,0.2727272727272727,0.7272727272727273,0.031004025716517454
12953,23.0,884,24744,25628,47,869,33005,9777,23228,33005,2425,0.02678382063323739,0.749704590213604,0.0014240266626268747,0.2962278442660203,0.7037721557339797,0.026329344038782003
12954,,2250,66213,68463,183,2797,88522,26364,62158,88522,7096,0.025417410361266126,0.7479835521113396,0.0020672827093829783,0.2978242696730756,0.7021757303269244,0.0315966652357606
12955,23.0,1424,32578,34002,151,1674,44846,12981,31865,44846,2959,0.031753110645319535,0.7264416001427106,0.0033670784462382377,0.2894572537127057,0.7105427462872943,0.037327743834455696
12956,,1272,39234,40506,386,1847,54239,15474,38765,54239,4837,0.02345175980383119,0.7233540441379819,0.0071166503807223586,0.2852928704437766,0.7147071295562234,0.034052987702575636
12957,17.0,978,17370,18348,188,1534,25379,6809,18570,25379,1674,0.03853579731273888,0.6844241301863746,0.0074076992789314,0.2682926829268293,0.7317073170731707,0.060443673903621105
12958,17.0,207,4012,4219,2,203,5558,1612,3946,5558,404,0.03724361281036344,0.7218423893486866,0.0003598416696653472,0.2900323857502699,0.7099676142497301,0.036523929471032744
12959,,141,1803,1944,22,218,2865,712,2153,2865,147,0.049214659685863874,0.6293193717277487,0.007678883071553229,0.24851657940663177,0.7514834205933683,0.07609075043630018
12960,,96,8658,8754,24,235,11237,3270,7967,11237,1129,0.008543205481890184,0.770490344397971,0.002135801370472546,0.2910029367268844,0.7089970632731156,0.020913055085877014
12961,,1879,33555,35434,149,2833,48824,13600,35224,48824,3685,0.03848517122726528,0.6872644601015894,0.003051777814189743,0.2785515320334262,0.7214484679665738,0.05802474193019826
12962,16.0,263,4085,4348,36,524,6422,1619,4803,6422,457,0.04095297415135472,0.636094674556213,0.005605730302086578,0.25210214886328247,0.7478978511367176,0.0815945188414824
12963,24.0,2105,39229,41334,252,2354,55392,15660,39732,55392,4011,0.03800187752744079,0.7082069612940497,0.004549393414211438,0.28271230502599654,0.7172876949740035,0.042497111496244945
12964,,5,1833,1838,6,167,2519,695,1824,2519,207,0.001984914648670107,0.7276697102024613,0.0023818975784041284,0.2759031361651449,0.724096863834855,0.06629614926558158
12965,15.0,102,1907,2009,3,107,2644,734,1910,2644,178,0.038577912254160365,0.7212556732223904,0.0011346444780635401,0.27760968229954613,0.7223903177004538,0.04046898638426626
12966,23.0,880,20887,21767,51,1171,29608,8338,21270,29608,2161,0.029721696838692246,0.7054512293974602,0.0017225074304242096,0.281613077546609,0.718386922453391,0.03955012158875979
12967,,2524,48855,51379,1669,2213,68580,19205,49375,68580,4371,0.036803732866724996,0.7123797025371829,0.024336541265675124,0.2800379119276757,0.7199620880723243,0.03226888305628463
12968,,527,15771,16298,26,889,21469,6260,15209,21469,1581,0.024547021286506127,0.7345940658624063,0.0012110484885183288,0.2915832130047976,0.7084167869952024,0.04140854254972286
12969,39.0,178,5960,6138,6,220,8021,2244,5777,8021,696,0.022191746665004362,0.7430494950754271,0.0007480364044383493,0.27976561525994265,0.7202343847400573,0.02742800149607281
12970,37.0,1972,56195,58167,369,2286,72360,22679,49681,72360,4095,0.027252625760088446,0.7766030956329464,0.005099502487562189,0.31341901603095634,0.6865809839690437,0.03159203980099502
12971,,83,2419,2502,4,145,3300,943,2357,3300,262,0.02515151515151515,0.733030303030303,0.0012121212121212121,0.28575757575757577,0.7142424242424242,0.04393939393939394
12972,,92,2111,2203,5,111,3232,838,2394,3232,196,0.028465346534653466,0.6531559405940595,0.001547029702970297,0.2592821782178218,0.7407178217821783,0.0343440594059406
12973,,115,3206,3321,0,97,4319,1292,3027,4319,337,0.026626533919888864,0.7423014586709886,0.0,0.29914332021301226,0.7008566797869877,0.022458902523732345
12974,17.0,151,2767,2918,3,201,3990,1145,2845,3990,283,0.037844611528822056,0.6934837092731829,0.0007518796992481203,0.2869674185463659,0.7130325814536341,0.05037593984962406
12975,,542,8424,8966,26,518,12337,3450,8887,12337,897,0.043932884818027075,0.6828240252897787,0.002107481559536354,0.27964659155386234,0.7203534084461376,0.0419875172246089
12976,,273,6584,6857,45,346,8969,2549,6420,8969,601,0.03043817593934664,0.7340840673430705,0.005017281748243951,0.2842011372505296,0.7157988627494704,0.038577321886497935
12977,,272,11146,11418,60,416,15418,4283,11135,15418,1166,0.01764171747308341,0.7229212608639253,0.0038915553249448697,0.27779219094564794,0.722207809054352,0.026981450252951095
12978,,75,1968,2043,11,160,2843,803,2040,2843,207,0.02638058389025677,0.6922265212803377,0.0038691523039043265,0.2824481181850158,0.7175518818149842,0.056278578965881114
12979,39.0,48,2298,2346,4,77,3005,911,2094,3005,213,0.015973377703826955,0.7647254575707155,0.0013311148086522463,0.30316139767054906,0.6968386023294509,0.02562396006655574
12980,,515,16617,17132,40,911,23631,6445,17186,23631,2092,0.02179340696542677,0.703186492319411,0.0016926918031399433,0.27273496678092335,0.7272650332190767,0.038551055816512206
12981,13.0,11,1788,1799,5,196,2543,708,1835,2543,192,0.004325599685410932,0.7031065670467951,0.001966181675186787,0.27841132520644907,0.7215886747935509,0.07707432166732206
12982,,308,4881,5189,21,429,7035,1986,5049,7035,531,0.04378109452736319,0.693816631130064,0.0029850746268656717,0.2823027718550107,0.7176972281449894,0.06098081023454158
12983,23.0,175,5166,5341,3,294,6919,1961,4958,6919,452,0.02529267235149588,0.7466396878161584,0.0004335886688827865,0.28342245989304815,0.7165775401069518,0.04249168955051308
12984,13.0,464,9747,10221,194,1979,14857,3627,11230,14857,413,0.031231069529514707,0.6560543851383186,0.013057817863633305,0.2441273473783402,0.7558726526216598,0.13320320387696036
12985,16.0,217,3807,4024,54,219,5455,1531,3924,5455,349,0.03978001833180568,0.6978918423464712,0.009899175068744272,0.28065994500458297,0.7193400549954171,0.04014665444546288
12986,,3130,73986,78668,897,7606,110441,29301,81140,110441,6875,0.02834092411332748,0.6699142528589925,0.008121983683595766,0.26530907905578544,0.7346909209442145,0.06886935105622007
12987,16.0,25,2556,2581,23,324,3742,895,2847,3742,222,0.006680919294494923,0.6830571886691609,0.006146445750935329,0.23917691074291822,0.7608230892570818,0.0865847140566542
12988,26.0,222,5993,6215,25,397,8425,2431,5994,8425,596,0.026350148367952523,0.7113353115727002,0.002967359050445104,0.2885459940652819,0.7114540059347181,0.04712166172106825
12989,25.0,770,17436,18206,360,646,23790,6685,17105,23790,1644,0.032366540563261874,0.7329129886506935,0.015132408575031526,0.28100042034468264,0.7189995796553174,0.027154266498528794
12990,23.0,5759,113593,119352,585,7008,161727,44467,117260,161727,11027,0.03560939113444261,0.7023749899522034,0.003617206774379046,0.2749509976689112,0.7250490023310888,0.04333228217922796
12991,,2185,50576,52761,368,3051,70723,19781,50942,70723,4891,0.030895182613859706,0.7151280347270337,0.005203399177071109,0.2796968454392489,0.7203031545607511,0.043140138285989
12992,16.0,2305,59768,62073,51,2292,81493,23638,57855,81493,6316,0.028284637944363318,0.7334126857521505,0.0006258206226301646,0.290061723092781,0.709938276907219,0.02812511504055563
12993,16.0,678,4871,5549,366,822,8707,2076,6632,8708,268,0.077859439595774,0.5593706936150666,0.0420303169499311,0.23840146991272393,0.7615985300872761,0.09439595774000918
12994,,1639,42417,44056,325,2538,57616,16243,41373,57616,4037,0.02844695917800611,0.7362017495140238,0.005640794223826715,0.28191821716189946,0.7180817828381005,0.044050263815606776
12995,,6,1670,1676,2,142,2287,653,1634,2287,149,0.0026235242675994755,0.730214254481854,0.0008745080891998251,0.2855268911237429,0.7144731088762571,0.062090074333187584
12996,15.0,457,13272,13729,147,1434,19825,5179,14646,19825,1450,0.023051702395964692,0.6694577553593947,0.007414880201765448,0.2612358133669609,0.7387641866330391,0.07233291298865069
12997,25.0,71,1936,2007,3,77,2631,809,1822,2631,233,0.026985936906119345,0.7358418852147472,0.0011402508551881414,0.30748764728240213,0.6925123527175979,0.029266438616495628
12998,15.0,332,4314,4646,65,402,6662,1749,4913,6662,378,0.04983488441909337,0.6475532873011107,0.009756829780846592,0.26253377364154906,0.7374662263584509,0.06034223956769739
12999,,5136,96493,101629,607,6727,136942,39508,97435,136943,6220,0.03750465522151552,0.7046216308975267,0.00443250111360201,0.2884995947218916,0.7115004052781084,0.04912262766260415
13000,25.0,4641,101185,105826,379,5295,141135,40110,101025,141135,11670,0.032883409501541075,0.7169376837779431,0.002685372161405746,0.2841959825698799,0.7158040174301201,0.037517270698267616
13001,,810,20310,21120,31,1260,27886,7817,20069,27886,2048,0.029046833536541635,0.728322455712544,0.00111166893781826,0.28031987377178513,0.7196801262282149,0.045183963279064765
13002,16.0,22,2782,2804,0,153,3801,1069,2732,3801,274,0.005787950539331755,0.7319126545645883,0.0,0.28124177847934756,0.7187582215206525,0.04025256511444357
13003,14.0,3004,43395,46399,180,2573,61325,17246,44079,61325,4403,0.048984916428862615,0.7076233183856502,0.0029351814105177333,0.2812229922543824,0.7187770077456176,0.041956787607011825
13004,,427,13842,14269,22,987,18746,5278,13468,18746,1233,0.022778192681105303,0.7383975248052917,0.0011735836978555424,0.2815533980582524,0.7184466019417476,0.05265123226288275
13005,23.0,905,19909,20814,134,1033,27706,7931,19775,27706,2264,0.032664404822060206,0.7185808128203277,0.0048364975095647154,0.286255684689237,0.713744315310763,0.03728434274164441
13006,,274,5093,5367,77,630,7785,1933,5852,7785,283,0.035195889531149646,0.6542068079640334,0.009890815671162493,0.2482980089916506,0.7517019910083493,0.08092485549132948
13007,,579,11614,12193,107,605,16133,4596,11537,16133,1125,0.03588917126386909,0.7198909068369181,0.006632368437364408,0.2848819190479142,0.7151180809520857,0.03750077480939689
13008,13.0,104,5221,5325,62,244,7135,2050,5085,7135,495,0.0145760336370007,0.7317449194113524,0.008689558514365802,0.28731604765241764,0.7126839523475823,0.03419761737911703
13009,24.0,113,2319,2432,11,157,3205,876,2329,3205,236,0.035257410296411856,0.7235569422776911,0.0034321372854914196,0.2733229329173167,0.7266770670826833,0.04898595943837754
13010,,46,2373,2419,45,240,3528,953,2575,3528,269,0.013038548752834467,0.6726190476190477,0.012755102040816327,0.27012471655328796,0.729875283446712,0.06802721088435375
13011,33.0,2699,35197,37896,264,3259,56224,14581,41643,56224,3864,0.0480044109277177,0.6260138019351167,0.004695503699487763,0.25933764940239046,0.7406623505976095,0.057964570290267504
13012,23.0,122,6516,6638,1,327,8966,2559,6407,8966,750,0.013606959625250948,0.7267454829355342,0.00011153245594467991,0.28541155476243585,0.7145884452375642,0.03647111309391033
13013,25.0,110,3351,3461,65,244,4589,1231,3358,4589,317,0.02397036391370669,0.7302244497711919,0.014164305949008499,0.2682501634342994,0.7317498365657006,0.05317062540858575
13014,,376,10936,11312,42,1058,15623,4250,11373,15623,1107,0.02406708058631505,0.6999935991806951,0.0026883441080458297,0.2720348204570185,0.7279651795429815,0.06772066824553542
13015,,578,7464,8042,56,659,11048,3043,8005,11048,788,0.05231716147719044,0.6755973931933381,0.005068790731354091,0.2754344677769732,0.7245655322230268,0.05964880521361332
13016,16.0,82,1664,1746,12,78,2341,643,1698,2341,184,0.03502776591200342,0.710807347287484,0.0051260145237078175,0.2746689448953439,0.7253310551046561,0.03331909440410081
13017,17.0,12,1349,1361,5,191,2019,514,1505,2019,139,0.005943536404160475,0.6681525507677067,0.0024764735017335313,0.254581475978207,0.745418524021793,0.0946012877662209
13018,27.0,1296,25365,26661,169,1007,33868,10341,23527,33868,2236,0.03826620999173261,0.7489370497224519,0.00498996102515649,0.3053324672256998,0.6946675327743003,0.029733081374749025
13019,,10878,226460,237338,651,10896,320094,89815,230279,320094,22223,0.03398376726836492,0.7074796778446332,0.0020337775778365105,0.2805894518485195,0.7194105481514805,0.03404000074977975
13020,48.0,64,1997,2061,10,105,2737,817,1920,2737,212,0.023383266350018268,0.7296309828279137,0.003653635367190354,0.29850200949945194,0.7014979905005481,0.03836317135549872
13021,14.0,105,7548,7653,108,574,10437,2894,7543,10437,708,0.01006036217303823,0.7231963207818338,0.010347801092267893,0.2772827440835489,0.7227172559164511,0.05499664654594232
13022,17.0,924,9374,10298,65,1076,14425,4089,10336,14425,510,0.06405545927209705,0.649844020797227,0.004506065857885615,0.28346620450606586,0.7165337954939341,0.07459272097053726
13023,23.0,2657,43181,45838,138,2289,61326,17391,43935,61326,5026,0.04332583243648697,0.7041222320060008,0.0022502690539086194,0.28358281968496235,0.7164171803150376,0.03732511495939732
13024,17.0,3126,52733,55859,731,4447,76639,21173,55466,76639,4892,0.04078863241952531,0.6880700426675713,0.009538224663682981,0.2762692623859915,0.7237307376140085,0.058025287386317674
13025,26.0,2861,54077,56938,1244,2305,75893,21367,54526,75893,5506,0.03769781139235503,0.7125426587432306,0.016391498557179186,0.2815411170990737,0.7184588829009263,0.030371707535609346
13026,34.0,1188,23528,24716,128,1374,32800,9589,23211,32800,2234,0.03621951219512195,0.7173170731707317,0.003902439024390244,0.29234756097560977,0.7076524390243902,0.04189024390243903
13027,16.0,157,10622,10779,7,892,14498,4110,10388,14498,950,0.010829079873085942,0.7326527796937509,0.00048282521727134776,0.2834873775693199,0.7165126224306801,0.06152572768657746
13028,16.0,280,5584,5864,29,280,7966,2227,5739,7966,641,0.0351493848857645,0.7009791614361034,0.003640472006025609,0.2795631433592769,0.7204368566407231,0.0351493848857645
13029,,160,12071,12231,40,541,16334,4606,11728,16334,1267,0.009795518550263255,0.7390106526264234,0.0024488796375658137,0.28198849026570344,0.7180115097342965,0.03312109709807763
13030,,44,1725,1769,3,33,2356,705,1651,2356,237,0.01867572156196944,0.7321731748726655,0.0012733446519524619,0.29923599320882854,0.7007640067911715,0.01400679117147708
13031,48.0,92,3563,3655,18,118,4742,1463,3279,4742,338,0.01940109658371995,0.7513707296499368,0.003795866722901729,0.3085196119780683,0.6914803880219317,0.02488401518346689
13032,,186,4373,4559,4,236,6076,1809,4267,6076,451,0.030612244897959183,0.7197169190256748,0.0006583278472679394,0.2977287689269256,0.7022712310730744,0.038841342988808425
13033,15.0,670,11819,12489,17,748,17445,4808,12637,17445,1320,0.03840642017770135,0.6775007165376898,0.0009744912582401834,0.2756090570364001,0.7243909429635998,0.042877615362568074
13034,17.0,742,44108,44850,213,1899,59124,17134,41990,59124,4709,0.012549895135647115,0.746025302753535,0.0036025979297747107,0.28979771328056286,0.7102022867194371,0.03211893647249848
13035,15.0,414,3631,4045,5,419,5682,1494,4188,5682,320,0.07286166842661035,0.6390355508623724,0.0008799718409010912,0.26293558606124606,0.737064413938754,0.07374164026751144
13036,23.0,366,7859,8225,25,475,11119,3072,8047,11119,826,0.032916629193272776,0.7068081662019966,0.0022484036334202715,0.27628383847468296,0.723716161525317,0.04271966903498516
13037,17.0,147,3695,3842,0,221,5222,1468,3754,5222,396,0.028150134048257374,0.7075833014170816,0.0,0.281118345461509,0.718881654538491,0.04232094982765224
13038,26.0,358,2165,2523,6,307,4577,932,3645,4577,147,0.07821717282062486,0.47301726021411405,0.0013109023377758358,0.2036268298011798,0.7963731701988201,0.06707450294953025
13039,,859,20011,20870,86,854,27228,7956,19272,27228,2118,0.03154840605259292,0.7349419714999266,0.0031585132951373585,0.29219920669898636,0.7078007933010136,0.03136477155868959
13040,,1577,31773,33350,151,1946,44960,12367,32593,44960,3435,0.03507562277580071,0.7066948398576512,0.003358540925266904,0.2750667259786477,0.7249332740213523,0.04328291814946619
13041,27.0,559,7764,8323,46,2300,13058,3092,9966,13058,420,0.04280900597334967,0.5945780364527493,0.0035227446775922804,0.23678970745902894,0.7632102925409711,0.17613723387961402
13042,23.0,343,6698,7041,46,381,9705,2599,7106,9705,747,0.03534260690365791,0.6901597114889232,0.004739824832560535,0.2678001030396703,0.7321998969603297,0.039258114374034
13043,27.0,535,77648,78183,155,4141,102970,29666,73304,102970,9825,0.005195688064484802,0.7540837137030203,0.0015052928037292415,0.2881033310673012,0.7118966689326989,0.04021559677575993
13044,45.0,4916,142491,147407,632,5119,186903,55779,131124,186903,12518,0.02630241355141437,0.7623794160607373,0.00338143314981568,0.2984382273157734,0.7015617726842266,0.02738853843972542
13045,,1161,25851,27012,37,1327,36060,10369,25691,36060,2353,0.03219633943427621,0.7168885191347754,0.0010260676650027732,0.2875485302273988,0.7124514697726012,0.036799778147531895
13046,17.0,862,23490,24352,55,1148,32041,8978,23063,32041,2541,0.02690303049218189,0.7331231859180425,0.001716550669454761,0.28020348927936084,0.7197965107206392,0.03582909397334665
13047,,1176,22722,23898,70,1369,33694,9107,24587,33694,1887,0.03490235650264142,0.6743633881403217,0.002077521220395323,0.2702855107734315,0.7297144892265686,0.040630379296017094
13048,15.0,26,5316,5342,9,612,7391,2020,5371,7391,525,0.003517791909078609,0.7192531457177649,0.0012176971992964416,0.27330537139764577,0.7266946286023542,0.08280340955215804
13049,14.0,349,2409,2758,6,323,3854,987,2867,3854,184,0.0905552672548002,0.6250648676699533,0.0015568240788790867,0.25609756097560976,0.7439024390243902,0.0838090295796575
13050,,2316,69289,71605,87,3209,92787,27040,65747,92787,6887,0.02496039315852436,0.7467533167361807,0.0009376313492191794,0.291420134286053,0.708579865713947,0.03458458620280858
13051,23.0,412,12172,12584,40,1018,17062,4531,12531,17062,1181,0.024147227757589967,0.7133981948188958,0.0023443910444262105,0.265560895557379,0.7344391044426211,0.05966475208064705
13052,15.0,168,4160,4328,10,373,5865,1636,4229,5865,425,0.02864450127877238,0.7092924126172208,0.0017050298380221654,0.27894288150042623,0.7210571184995738,0.06359761295822677
13053,17.0,171,1571,1742,14,115,2394,677,1717,2394,176,0.07142857142857142,0.6562238930659984,0.005847953216374269,0.2827903091060986,0.7172096908939014,0.04803675856307435
13054,43.0,24448,546560,571008,6547,28822,759364,219718,539646,759364,53010,0.03219536348839292,0.7197602203949621,0.008621688676313336,0.28934476746329824,0.7106552325367018,0.03795544692663861
13055,,464,7244,7708,182,309,10208,2961,7247,10208,552,0.045454545454545456,0.7096394984326019,0.017829153605015673,0.2900666144200627,0.7099333855799373,0.030270376175548588
13056,24.0,332,6002,6334,45,281,8400,2380,6020,8400,549,0.039523809523809524,0.7145238095238096,0.005357142857142857,0.2833333333333333,0.7166666666666667,0.033452380952380956
13057,16.0,953,19504,20457,41,716,27388,7800,19588,27388,2293,0.03479626113626406,0.7121367022053454,0.0014970059880239522,0.28479626113626405,0.7152037388637359,0.026142836278662186
13058,,338,8714,9052,16,548,12185,3450,8735,12185,868,0.02773902338941321,0.7151415675010259,0.0013130898645876078,0.2831350020517029,0.7168649979482971,0.044973327862125566
13059,17.0,50,3308,3358,41,281,4840,1227,3613,4840,399,0.010330578512396695,0.6834710743801653,0.008471074380165288,0.2535123966942149,0.7464876033057851,0.058057851239669424
13060,15.0,682,22370,23052,168,1245,30332,8631,21701,30332,2143,0.022484504813398393,0.7375049452723197,0.005538704998021891,0.28455096927337464,0.7154490307266254,0.04104576025319794
13061,17.0,1598,33374,34972,13,1496,46225,13369,32856,46225,3654,0.03457003785830178,0.7219902650081125,0.00028123309897241754,0.2892157923201731,0.710784207679827,0.03236343969713359
13062,26.0,15886,276368,292254,1136,14123,391727,111266,280461,391727,26176,0.04055375299634695,0.7055117467011465,0.0028999788117745266,0.28403965006241594,0.7159603499375841,0.03605316968194686
13063,,142,2831,2973,16,177,4040,1145,2895,4040,292,0.03514851485148515,0.7007425742574257,0.0039603960396039604,0.2834158415841584,0.7165841584158416,0.04381188118811881
13064,,65,1728,1793,5,79,2535,675,1860,2535,202,0.02564102564102564,0.6816568047337278,0.0019723865877712033,0.26627218934911245,0.7337278106508875,0.03116370808678501
13065,27.0,449,6515,6964,82,353,9423,2666,6757,9423,512,0.04764936856627401,0.6913933991297888,0.008702111853974319,0.2829247585694577,0.7170752414305422,0.037461530298206515
13066,14.0,117,2312,2429,18,105,3444,957,2487,3444,191,0.03397212543554007,0.6713124274099884,0.005226480836236934,0.2778745644599303,0.7221254355400697,0.03048780487804878
13067,,549,2891,3440,21,247,4828,1287,3541,4828,311,0.11371168185584093,0.5987986743993372,0.004349627174813587,0.26657000828500416,0.7334299917149959,0.05115990057995029
13068,,75,1751,1826,7,156,2503,708,1795,2503,195,0.02996404314822213,0.6995605273671595,0.002796644027167399,0.28286056731921694,0.7171394326807831,0.06232520974830204
13069,23.0,310,6683,6993,16,453,9371,2658,6713,9371,738,0.033080781133283534,0.7131576139152705,0.001707395155266247,0.28364102016860526,0.7163589798313947,0.04834062533347561
13070,15.0,129,3614,3743,0,91,4843,1439,3404,4843,438,0.026636382407598597,0.7462316745818708,0.0,0.2971298781746851,0.7028701218253149,0.018790006194507537
13071,13.0,53,1377,1430,1,77,2032,556,1476,2032,183,0.02608267716535433,0.6776574803149606,0.0004921259842519685,0.2736220472440945,0.7263779527559056,0.03789370078740158
13072,,244,7408,7652,5,382,10150,2874,7276,10150,873,0.024039408866995075,0.7298522167487684,0.0004926108374384236,0.2831527093596059,0.7168472906403941,0.037635467980295566
13073,,316,7432,7748,36,590,11179,2927,8252,11179,654,0.028267286877180428,0.6648179622506485,0.003220323821450935,0.26183021737185797,0.738169782628142,0.05277752929600143
13074,,193,2856,3049,6,97,4015,1149,2866,4015,367,0.048069738480697385,0.7113325031133251,0.0014943960149439602,0.28617683686176837,0.7138231631382317,0.024159402241594023
13075,,85,1848,1933,0,148,2728,735,1993,2728,176,0.031158357771260997,0.6774193548387096,0.0,0.2694281524926686,0.7305718475073314,0.054252199413489736
13076,26.0,163,4578,4784,2,187,6146,1803,4343,6146,402,0.02652131467621217,0.744874715261959,0.0003254149040026033,0.2933615359583469,0.7066384640416531,0.03042629352424341
13077,17.0,334,7611,7945,55,1533,12348,3079,9269,12348,577,0.027048914804016846,0.6163751214771623,0.004454162617427923,0.2493521218011014,0.7506478781988986,0.12414965986394558
13078,15.0,62,10805,10867,103,553,14558,4074,10484,14558,1210,0.004258826761917846,0.7422035993955214,0.007075147685121582,0.27984613271053715,0.7201538672894628,0.037985987086138207
13079,,5045,133314,138359,653,8023,199174,53064,146110,199174,13661,0.025329611294646892,0.6693343508690893,0.0032785403717352666,0.26642031590468634,0.7335796840953136,0.04028136202516393
13080,47.0,1001,12529,13530,79,796,18048,5162,12886,18048,1362,0.05546320921985816,0.6942043439716312,0.004377216312056738,0.2860150709219858,0.7139849290780141,0.04410460992907801
13081,,20,1489,1509,1,85,2040,573,1467,2040,218,0.00980392156862745,0.7299019607843137,0.0004901960784313725,0.28088235294117647,0.7191176470588235,0.041666666666666664
13082,,3051,14035,17086,117,1212,23657,6443,17214,23657,1741,0.12896817009764552,0.5932704907638331,0.004945682039142749,0.27235067844612587,0.7276493215538741,0.05123219343111975
13083,14.0,264,3794,4058,24,484,5589,1268,4321,5589,313,0.04723564143853999,0.6788334227947754,0.0042941492216854536,0.22687421721238146,0.7731257827876186,0.08659867597065665
13084,,1083,16617,17700,828,1175,24307,6722,17585,24307,1668,0.044555066441765746,0.6836302299749043,0.03406426132389846,0.2765458509894269,0.723454149010573,0.04833998436664336
13085,24.0,123,4624,4747,11,211,6300,1803,4497,6300,607,0.019523809523809523,0.7339682539682539,0.001746031746031746,0.2861904761904762,0.7138095238095238,0.03349206349206349
13086,36.0,50,1835,1885,10,77,2447,730,1717,2447,208,0.02043318348998774,0.7498978340825501,0.004086636697997548,0.298324478953821,0.701675521046179,0.03146710257458112
13087,,85,2105,2190,1,118,2940,837,2103,2940,223,0.02891156462585034,0.7159863945578231,0.0003401360544217687,0.28469387755102044,0.7153061224489796,0.04013605442176871
13088,13.0,1097,1708,2805,25,199,3859,1098,2761,3859,36,0.28427053640839595,0.4426017102876393,0.0064783622700181395,0.2845296708991967,0.7154703291008033,0.05156776366934439
13089,25.0,628,12960,13588,72,691,17690,5180,12511,17691,1088,0.035498275959527446,0.732575886043751,0.004069866033576394,0.2928042507489684,0.7071957492510316,0.03905940873890679
13090,,385,19163,19548,54,961,26006,7580,18426,26006,2199,0.014804275936322386,0.7368684149811582,0.002076443897562101,0.2914711989540875,0.7085288010459124,0.03695301084365146
13091,41.0,1137,20603,21740,164,1455,30564,8163,22401,30564,2306,0.037200628190027486,0.6740937050124329,0.005365789818086638,0.2670789163722026,0.7329210836277974,0.04760502552021987
13092,35.0,176,5750,5926,22,266,7681,2294,5387,7681,548,0.02291368311417784,0.7486004426506965,0.00286421038927223,0.2986590287722953,0.7013409712277048,0.034630907433927875
13093,38.0,675,12491,13166,43,721,17902,4876,13026,17902,1173,0.03770528432577366,0.6977432689085018,0.0024019662607529884,0.27237180203329237,0.7276281979667076,0.040274829627974525
13094,23.0,1646,32025,33671,70,1830,46719,12438,34283,46721,2875,0.03523041030799855,0.68545193810064,0.0014982556024057704,0.2662186168960425,0.7337813831039576,0.03916868217717943
13095,35.0,1498,67150,68648,156,3993,92010,26015,65995,92010,7230,0.016280839039234867,0.7298119769590262,0.0016954678839256603,0.2827410064123465,0.7172589935876535,0.04339745679817411
13096,27.0,144,3743,3887,41,225,5165,1456,3709,5165,394,0.027879961277831558,0.7246853823814133,0.007938044530493708,0.2818973862536302,0.7181026137463697,0.04356243949661181
13097,33.0,323,8808,9131,132,429,12206,3464,8742,12206,954,0.026462395543175487,0.7216123218089464,0.01081435359659184,0.2837948549893495,0.7162051450106505,0.03514664918892348
13098,17.0,3979,78846,82825,375,4496,110321,31169,79152,110321,8310,0.036067475820560004,0.7146962047117049,0.003399171508597638,0.2825300713372794,0.7174699286627206,0.040753800273746615
13099,48.0,50,1828,1878,10,55,2496,711,1785,2496,217,0.020032051282051284,0.7323717948717948,0.004006410256410256,0.2848557692307692,0.7151442307692307,0.022035256410256412
13100,16.0,1882,51072,52954,37,2564,69561,20576,48989,69565,5130,0.027053834543232947,0.7341622942571695,0.0005318766621145691,0.2957809243153885,0.7042190756846115,0.03685761518004744
13101,24.0,385,12684,13069,4,714,17613,5185,12428,17613,997,0.021858854255379548,0.7201498892863226,0.00022710497927667063,0.2943848293873843,0.7056151706126157,0.04053823880088571
13102,33.0,101,2129,2230,5,122,3002,851,2151,3002,254,0.03364423717521652,0.7091938707528315,0.0016655562958027982,0.28347768154563624,0.7165223184543638,0.04063957361758828
13103,23.0,748,22369,23117,88,949,30442,8802,21640,30442,2470,0.024571315945075882,0.7348071742986663,0.0028907430523618686,0.28914000394192235,0.7108599960580777,0.03117403587149333
13104,,18440,146322,164762,622,24945,244645,58848,185797,244645,11511,0.07537452226695825,0.5980992867215762,0.002542459482106726,0.24054446238427107,0.7594555376157289,0.10196407038770464
13105,16.0,167,3454,3621,2,171,4749,1410,3339,4749,350,0.03516529795746473,0.7273110128448095,0.0004211412929037692,0.2969046114971573,0.7030953885028427,0.036007580543272265
13106,,2620,44319,46939,171,2538,62470,17897,44573,62470,4855,0.04194013126300624,0.7094445333760205,0.002737313910677125,0.2864895149671842,0.7135104850328158,0.040627501200576274
13107,,120,3232,3352,5,115,4389,1317,3072,4389,366,0.02734107997265892,0.7363864205969469,0.001139211665527455,0.30006835269993165,0.6999316473000684,0.026201868307131466
13108,15.0,471,10885,11356,63,451,15569,4179,11390,15569,1435,0.03025242469008928,0.699145738326161,0.004046502665553343,0.26841801014837174,0.7315819898516283,0.028967820669278693
13109,,8819,82304,91123,2897,7439,127355,34594,92761,127355,9131,0.06924737937261984,0.6462565270307409,0.02274743826312277,0.27163440775784226,0.7283655922421578,0.05841152683443917
13110,16.0,2364,17614,19978,83,1278,26564,7709,18855,26564,1871,0.08899262159313356,0.6630778497214275,0.0031245294383375997,0.2902047884354766,0.7097952115645234,0.048110224363800635
13111,16.0,65,2070,2135,11,260,2985,800,2185,2985,231,0.021775544388609715,0.6934673366834171,0.0036850921273031824,0.26800670016750416,0.7319932998324958,0.08710217755443886
13112,23.0,44,3935,3979,13,166,5670,1497,4173,5670,488,0.007760141093474427,0.6940035273368607,0.002292768959435626,0.26402116402116405,0.735978835978836,0.02927689594356261
13113,,589,20695,21284,60,829,27586,8098,19488,27586,2226,0.021351410135576017,0.7501993764953238,0.0021750163126223448,0.29355470166026243,0.7064452983397376,0.030051475386065396
13114,23.0,232,7061,7293,40,214,9559,2883,6676,9559,845,0.0242703211633016,0.7386755936813474,0.004184538131603724,0.30160058583533844,0.6983994141646616,0.022387279004079923
13115,,16,1712,1728,0,199,2335,658,1677,2335,191,0.006852248394004282,0.7331905781584582,0.0,0.28179871520342614,0.7182012847965739,0.08522483940042827
13116,,252,6747,6999,46,428,9286,2652,6634,9286,636,0.027137626534568166,0.7265776437648073,0.004953693732500539,0.2855912125780745,0.7144087874219255,0.04609088951109196
13117,,564,6386,6950,54,532,9916,2639,7277,9916,565,0.05687777329568374,0.6440096813231142,0.005445744251714401,0.2661355385235982,0.7338644614764018,0.0536506655909641
13118,16.0,71,4214,4285,29,271,5913,1587,4326,5913,394,0.012007441231185523,0.7126670049044478,0.004904447826822256,0.26839167935058345,0.7316083206494165,0.04583121934720108
13119,,73,1758,1831,6,153,2496,700,1796,2496,152,0.029246794871794872,0.7043269230769231,0.002403846153846154,0.28044871794871795,0.719551282051282,0.06129807692307692
13120,,626,12336,12962,149,730,17155,4821,12334,17155,1128,0.03649081900320606,0.7190906441270767,0.008685514427280676,0.28102593995919556,0.7189740600408044,0.0425531914893617
13121,26.0,134,2851,2985,3,157,3900,1127,2773,3900,239,0.03435897435897436,0.731025641025641,0.0007692307692307692,0.28897435897435897,0.711025641025641,0.040256410256410254
13122,15.0,12,2549,2561,2,88,3341,969,2372,3341,302,0.0035917390002993114,0.7629452259802454,0.000598623166716552,0.29003292427416943,0.7099670757258306,0.026339419335528285
13123,27.0,239,9526,9765,13,374,12751,3696,9055,12751,1075,0.01874362795074896,0.7470786604972159,0.0010195278801662614,0.28985961885342326,0.7101403811465767,0.02933103286016783
13124,15.0,92,2046,2138,17,318,3007,797,2210,3007,160,0.030595277685400733,0.6804123711340206,0.005653475224476222,0.2650482208180911,0.7349517791819089,0.10575324243431992
13125,39.0,47,2251,2298,9,63,2909,875,2034,2909,216,0.01615675489859058,0.7738054314197319,0.0030938466827088347,0.3007906497078034,0.6992093502921967,0.021656926778961843
13126,23.0,61,1779,1840,51,136,2625,711,1914,2625,187,0.023238095238095238,0.6777142857142857,0.019428571428571427,0.27085714285714285,0.7291428571428571,0.05180952380952381
13127,26.0,92,1610,1702,15,61,2335,659,1676,2335,191,0.039400428265524624,0.6895074946466809,0.006423982869379015,0.2822269807280514,0.7177730192719486,0.026124197002141327
13128,16.0,250,11424,11674,55,734,15911,4517,11394,15911,1260,0.015712400226258562,0.7179938407391113,0.003456728049776884,0.28389164728803973,0.7161083527119603,0.046131607064295144
13129,17.0,372,7304,7676,10,364,10700,2909,7791,10700,723,0.034766355140186916,0.6826168224299065,0.0009345794392523365,0.27186915887850466,0.7281308411214953,0.034018691588785045
13130,25.0,471,6908,7379,45,699,10283,2856,7427,10283,528,0.04580375376835554,0.6717883886025479,0.004376154818632695,0.27773995915588834,0.7222600408441117,0.06797627151609452
13131,26.0,149,2428,2577,14,128,3512,942,2570,3512,247,0.04242596810933941,0.6913439635535308,0.003986332574031891,0.26822323462414577,0.7317767653758542,0.03644646924829157
13132,24.0,861,20176,21037,104,949,28057,7984,20073,28057,2148,0.030687528958905086,0.7191075310974089,0.003706739851017571,0.284563567024272,0.715436432975728,0.03382400114053534
13133,24.0,23180,444131,467311,5741,30685,619306,174732,444646,619378,39558,0.037424642140986605,0.7170596953718085,0.009268976295573947,0.282108825305387,0.7178911746946129,0.04954163693253554
13134,16.0,4920,143628,148548,1843,10314,203463,56385,147078,203463,15738,0.02418130077704546,0.7059170463425782,0.009058157994328207,0.2771265537222984,0.7228734462777016,0.05069226345822091
13135,,24084,410668,434752,3514,24403,593904,166312,427594,593906,45385,0.04055187184503945,0.6914696938572771,0.0059167612383104395,0.2800308466322953,0.7199691533677046,0.041088993881186586
13136,26.0,528,8160,8688,60,363,11829,3256,8573,11829,843,0.04463606391072787,0.6898300786203398,0.00507227998985544,0.27525572744948856,0.7247442725505114,0.03068729393862541
13137,,82,2797,2879,30,130,3868,1090,2778,3868,353,0.021199586349534644,0.7231127197518097,0.0077559462254395035,0.28179937952430195,0.718200620475698,0.03360910031023785
13138,,180,3607,3787,19,272,5086,1414,3672,5086,333,0.03539127015336217,0.7092017302398742,0.0037357451828548957,0.2780180888714117,0.7219819111285882,0.053480141565080616
13139,23.0,93,3357,3450,22,120,4833,1300,3533,4833,380,0.019242706393544383,0.6945996275605214,0.004552038071591144,0.26898406786674944,0.7310159321332506,0.024829298572315334
13140,,226,4790,5016,10,171,6519,1890,4629,6519,461,0.034667893848749805,0.7347752722810247,0.0015339776039269826,0.28992176714219975,0.7100782328578003,0.026231017027151405
13141,,111,2317,2428,14,158,3251,928,2323,3251,186,0.034143340510612116,0.7127037834512457,0.004306367271608736,0.28545063057520764,0.7145493694247924,0.048600430636727164
13142,26.0,519,11125,11644,32,640,15723,4418,11305,15723,1153,0.033008967754245375,0.7075621700693252,0.002035235006042104,0.28098963302168795,0.719010366978312,0.040704700120842076
13143,24.0,426,7819,8245,24,516,11131,3136,7995,11131,750,0.038271494025694006,0.7024526098284072,0.002156140508489803,0.2817356931093343,0.7182643068906657,0.04635702093253077
13144,23.0,419,24382,24801,84,1297,33522,9336,24186,33522,2603,0.012499254221108525,0.7273432372770121,0.002505817075353499,0.27850366923214603,0.7214963307678539,0.03869100888968439
13145,36.0,56,1841,1897,1,56,2477,722,1755,2477,223,0.022607993540573273,0.7432377876463464,0.0004037141703673799,0.29148163100524827,0.7085183689947517,0.022607993540573273
13146,35.0,1304,22251,23555,407,1302,33045,8766,24279,33045,2021,0.03946134059615675,0.6733545165683159,0.012316538054168559,0.2652746255106673,0.7347253744893327,0.03940081706763504
13147,24.0,5,4435,4440,1,84,5668,1704,3964,5668,489,0.0008821453775582216,0.7824629498941426,0.00017642907551164433,0.30063514467184194,0.6993648553281581,0.014820042342978124
13148,15.0,151,2542,2693,6,257,3802,1030,2772,3802,233,0.03971593897948448,0.6685954760652288,0.0015781167806417674,0.27091004734350344,0.7290899526564966,0.06759600210415571
13149,,34,1883,1917,4,89,2525,760,1765,2525,185,0.013465346534653465,0.7457425742574257,0.0015841584158415843,0.300990099009901,0.699009900990099,0.035247524752475244
13150,15.0,1783,44368,46151,170,2315,61811,17657,44154,61811,5099,0.028845998285094886,0.7178010386500785,0.002750319522415104,0.2856611282781382,0.7143388717218618,0.03745288055524098
13151,,518,18179,18697,76,795,24442,7089,17353,24442,1825,0.021193028393748467,0.7437607397103346,0.0031094018492758366,0.2900335488094264,0.7099664511905736,0.032525979870714344
13152,26.0,86,1935,2021,8,53,2671,767,1904,2671,190,0.03219767877199551,0.7244477723698989,0.002995132909022838,0.2871583676525646,0.7128416323474355,0.019842755522276302
13153,17.0,385,15357,15742,64,1640,21670,5895,15775,21670,1457,0.017766497461928935,0.7086755883710198,0.0029533917858790954,0.2720350715274573,0.7279649284725427,0.07568066451315182
13154,,452,13863,14315,122,641,19608,5382,14226,19608,1485,0.023051815585475317,0.7070073439412484,0.006221950224398204,0.2744798041615667,0.7255201958384333,0.03269073847409221
13155,15.0,869,17246,18115,58,1081,24474,6910,17564,24474,1824,0.035507068725994934,0.7046661763504127,0.002369861894255128,0.2823404429190161,0.717659557080984,0.04416932254637575
13156,43.0,2587,53506,56093,1195,2092,71997,22594,49403,71997,3174,0.03593205272441907,0.7431698542994847,0.01659791380196397,0.31381863133186105,0.686181368668139,0.029056766254149477
13157,14.0,94,1581,1675,19,70,2258,625,1633,2258,150,0.04162976085031001,0.7001771479185119,0.00841452612931798,0.27679362267493357,0.7232063773250664,0.03100088573959256
13158,23.0,321,5038,5359,31,373,7291,2066,5225,7291,581,0.04402688245782471,0.6909888904128377,0.00425181730901111,0.2833630503360307,0.7166369496639693,0.05115896310519819
13159,,151,3820,3971,23,180,5322,1500,3822,5322,400,0.028372792183389704,0.7177752724539647,0.004321683577602405,0.2818489289740699,0.7181510710259301,0.033821871476888386
13160,,53,2171,2224,20,171,3108,867,2241,3108,194,0.01705276705276705,0.6985199485199485,0.006435006435006435,0.27895752895752896,0.721042471042471,0.05501930501930502
13161,25.0,213,5858,6071,36,189,7801,2262,5539,7801,562,0.02730419177028586,0.7509293680297398,0.004614792975259582,0.2899628252788104,0.7100371747211895,0.024227663120112805
13162,14.0,1075,20579,21654,70,1641,29067,8058,21009,29067,1818,0.03698352083118313,0.7079850001720164,0.0024082292634258783,0.2772215914955104,0.7227784085044896,0.056455774589740944
13163,,468,20413,20881,133,2053,28694,8019,20675,28694,1608,0.016310029971422595,0.7114030807834391,0.004635115355126508,0.27946609047187565,0.7205339095281243,0.07154805882762946
13164,,88,1743,1831,2,1053,3438,717,2721,3438,183,0.025596276905177427,0.5069808027923212,0.0005817335660267597,0.20855148342059338,0.7914485165794066,0.306282722513089
13165,,206,3419,3625,42,159,5034,1372,3662,5034,309,0.04092173222089789,0.679181565355582,0.00834326579261025,0.2725466825586015,0.7274533174413985,0.03158522050059595
13166,24.0,199,1948,2147,15,192,3072,816,2256,3072,135,0.06477864583333333,0.6341145833333334,0.0048828125,0.265625,0.734375,0.0625
13167,,110,4667,4777,0,128,6317,1896,4421,6317,553,0.017413329111920214,0.7388000633211967,0.0,0.3001424726927339,0.6998575273072661,0.02026278296659807
13168,16.0,122,4138,4260,3,143,5521,1669,3852,5521,408,0.02209744611483427,0.7495019018293787,0.0005433798224959246,0.30230030791523277,0.6976996920847672,0.025901104872305743
13169,,534,10800,11334,41,857,15166,4259,10907,15166,1065,0.03521033891599631,0.712119214031386,0.0027034155347487802,0.2808255307925623,0.7191744692074377,0.056507978372675724
13170,24.0,288,8049,8337,112,266,11155,3176,7979,11155,824,0.025818018825638726,0.7215598386373824,0.01004034065441506,0.2847153742716271,0.7152846257283729,0.023845809054235768
13171,23.0,134,6215,6349,43,307,8445,2385,6060,8445,728,0.01586737714624038,0.7359384251036116,0.005091770278271166,0.2824156305506217,0.7175843694493783,0.03635287152161042
13172,,22,2586,2608,14,76,3471,971,2500,3471,288,0.006338231057332181,0.7450302506482281,0.004033419763756842,0.2797464707577067,0.7202535292422932,0.021895707288965716
13173,17.0,443,3601,4044,46,276,5697,1496,4201,5697,469,0.07776022467965596,0.6320870633666842,0.00807442513603651,0.26259434790240477,0.7374056520975952,0.04844655081621906
13174,43.0,206,9017,9223,88,446,12003,3304,8699,12003,963,0.017162376072648505,0.7512288594518037,0.007331500458218778,0.27526451720403233,0.7247354827959677,0.03715737732233608
13175,25.0,59,1953,2012,29,77,2675,763,1912,2675,223,0.02205607476635514,0.7300934579439252,0.010841121495327103,0.28523364485981306,0.7147663551401869,0.028785046728971964
13176,16.0,262,6495,6757,12,231,9241,2571,6670,9241,750,0.028351909966453846,0.7028460123363273,0.0012985607618223136,0.2782166432204307,0.7217833567795693,0.024997294665079536
13177,,799,15290,16089,70,713,20578,5957,14621,20578,1282,0.038827874429001846,0.7430265331907863,0.0034016911264457186,0.28948391486053066,0.7105160851394693,0.03464865390222568
13178,25.0,533,8716,9249,32,557,12332,3464,8868,12332,850,0.04322088874472916,0.7067791112552708,0.0025948751216347712,0.28089523191696397,0.719104768083036,0.04516704508595524
13179,15.0,272,6143,6415,18,358,8654,2461,6193,8654,674,0.03143055234573608,0.7098451583082968,0.0020799630228795934,0.2843771666281488,0.7156228333718512,0.04136815345504969
13180,15.0,9,2835,2844,2,62,3710,1021,2689,3710,264,0.002425876010781671,0.7641509433962265,0.0005390835579514825,0.2752021563342318,0.7247978436657682,0.016711590296495958
13181,,630,9292,9922,67,513,13186,3804,9382,13186,925,0.04777794630668891,0.7046867890186561,0.0050811466707113605,0.2884877900803883,0.7115122099196117,0.03890489913544669
13182,27.0,1241,35073,36314,132,1574,47873,13789,34084,47873,3492,0.025922753953167756,0.7326259060430723,0.002757295343930817,0.2880329204353185,0.7119670795646815,0.03287865811626595
13183,14.0,34,2371,2405,16,261,3532,879,2653,3532,269,0.009626274065685165,0.671291053227633,0.004530011325028313,0.24886749716874293,0.7511325028312571,0.07389580973952435
13184,37.0,222,8684,8906,12,472,12044,3327,8717,12044,888,0.018432414480239124,0.7210229159747592,0.0009963467286615742,0.27623713052142146,0.7237628694785786,0.03918963799402192
13185,34.0,60,1738,1798,11,85,2421,694,1727,2421,167,0.024783147459727387,0.7178851714167699,0.004543577034283354,0.28665840561751343,0.7133415943824866,0.03510945890128046
13186,24.0,4613,123333,127946,463,6591,170569,48643,121926,170569,12393,0.02704477366930685,0.7230680838839414,0.0027144440079967637,0.28518077728074853,0.7148192227192515,0.038641253686191514
13187,,727,21820,22547,127,663,29271,8655,20616,29271,2418,0.024836869256260462,0.745447712753237,0.004338765330873561,0.2956851491237061,0.704314850876294,0.022650404837552526
13188,,76,4149,4225,7,232,5807,1629,4193,5822,429,0.01305393335623497,0.7126417038818276,0.0012023359670216421,0.2798007557540364,0.7201992442459636,0.03984884919271728
13189,14.0,235,4673,4908,32,221,6280,1926,4354,6280,397,0.037420382165605094,0.744108280254777,0.005095541401273885,0.30668789808917196,0.693312101910828,0.03519108280254777
13190,39.0,231,4387,4618,17,169,6342,1733,4609,6342,466,0.03642384105960265,0.6917376222011984,0.0026805424156417534,0.2732576474298329,0.7267423525701672,0.02664774519079155
13191,25.0,3369,63925,67294,281,3627,90221,25547,64674,90221,5962,0.0373416388645659,0.7085379235432993,0.0031145742122122345,0.283160239855466,0.716839760144534,0.04020128351492446
13192,24.0,3725,76377,80102,446,4768,110104,30512,79592,110104,7192,0.033831650076291506,0.6936805202354138,0.004050715686986849,0.277119813994042,0.722880186005958,0.043304512097653125
13193,,565,7446,8011,61,351,10713,3158,7555,10713,750,0.05273966209278447,0.6950434052086251,0.0056940166153271726,0.29478204051152807,0.705217959488472,0.03276393167180062
13194,,8658,144769,153427,1044,11573,210003,58157,151846,210003,14038,0.04122798245739347,0.6893663423855849,0.004971357552034971,0.27693413903610903,0.723065860963891,0.055108736541858924
13195,16.0,303,7627,7930,18,394,10803,3049,7754,10803,907,0.028047764509858374,0.7060075904841248,0.0016662038322688142,0.282236415810423,0.717763584189577,0.036471350550772934
13196,,1030,19506,20536,212,904,26095,8019,18076,26095,1551,0.0394711630580571,0.7474995209810309,0.008124161716803985,0.307300249089864,0.692699750910136,0.034642651849013224
13197,17.0,328,7252,7580,86,378,10025,2874,7151,10025,604,0.032718204488778053,0.7233915211970074,0.0085785536159601,0.28668329177057356,0.7133167082294264,0.03770573566084788
13198,15.0,283,5301,5584,29,1205,9390,1938,7452,9390,198,0.030138445154419595,0.5645367412140575,0.00308839190628328,0.2063897763578275,0.7936102236421725,0.1283280085197018
13199,15.0,805,9149,9954,57,671,14136,3631,10505,14136,804,0.05694680249009621,0.6472127900396152,0.004032258064516129,0.25686191284663273,0.7431380871533673,0.047467458970005656
13200,,7249,165743,172992,464,5796,231359,66228,165131,231359,19808,0.03133225852463055,0.7163888156501368,0.0020055411719448993,0.28625642399906637,0.7137435760009336,0.025051975501277236
13201,24.0,1773,41590,43363,310,1677,57432,16449,40983,57432,4030,0.030871291266193063,0.7241607466220922,0.005397687700236802,0.2864082741328876,0.7135917258671124,0.029199749268700375
13202,23.0,309,7773,8082,277,493,10541,3168,7373,10541,646,0.029314106820984728,0.7374063181861303,0.026278341713309932,0.3005407456598046,0.6994592543401954,0.04676975619011479
13203,16.0,321,9037,9358,869,909,13938,3132,10806,13938,742,0.023030563925957814,0.648371358875018,0.06234753910173626,0.22470942746448558,0.7752905725355144,0.06521739130434782
13204,24.0,687,9934,10621,58,653,14386,4031,10355,14386,931,0.04775476157375226,0.6905324621159461,0.004031697483664674,0.28020297511469483,0.7197970248853052,0.0453913527040178
13205,26.0,1749,43352,45101,195,1622,58189,17068,41123,58191,3959,0.030056194256843843,0.7449949304875324,0.003351033664999742,0.29330996202161846,0.7066900379783816,0.0278737261775876
13206,27.0,2442,68772,71214,239,3019,91752,27021,64731,91752,6791,0.026615223646351032,0.7495422443107507,0.0026048478507280496,0.29450039236201936,0.7054996076379807,0.03290391490103758
13207,,590,19380,19970,7,830,26098,7661,18437,26098,2337,0.02260709632922063,0.742585638746264,0.0002682197869568549,0.29354739826806653,0.7064526017319335,0.031803203310598514
13208,45.0,1040,32912,33952,95,1039,44354,13107,31247,44354,3527,0.023447716102268115,0.7420300311133156,0.002141858682418722,0.295508860531181,0.704491139468819,0.02342517022140055
13209,,15160,264094,279254,1142,19976,381271,106715,274556,381271,23793,0.03976174427113523,0.692667420286358,0.0029952448520868358,0.27989277967639814,0.7201072203236019,0.05239317965436658
13210,17.0,116,2338,2454,0,84,3291,953,2338,3291,239,0.035247645092677,0.7104223640230933,0.0,0.2895776359769067,0.7104223640230933,0.02552415679124886
13211,,81,3313,3394,3,211,4430,1355,3075,4430,355,0.018284424379232507,0.7478555304740406,0.0006772009029345372,0.3058690744920993,0.6941309255079007,0.04762979683972912
13212,34.0,90,2458,2548,8,78,3359,991,2368,3359,296,0.026793688597796964,0.7317654063709438,0.0023816612086930635,0.29502828222685323,0.7049717177731468,0.02322119678475737
13213,26.0,6263,135047,141310,635,7131,189842,54388,135455,189843,13366,0.03299041839836075,0.7113614934445831,0.00334486918137619,0.2864893622625011,0.7135106377374989,0.037562617531328515
13214,23.0,5821,180903,186724,329,7829,243165,71081,172084,243165,19024,0.023938477988197315,0.7439516377768182,0.0013529907675857956,0.29231591717558036,0.7076840828244196,0.0321962453478091
13215,,341,7449,7790,77,471,10415,2910,7505,10415,690,0.03274123859817571,0.7152184349495919,0.007393182909265482,0.27940470475276047,0.7205952952472395,0.04522323571771483
13216,15.0,92,3161,3253,8,221,4439,1215,3224,4439,290,0.02072538860103627,0.7120973192160397,0.0018022077044379365,0.2737102951115116,0.7262897048884884,0.049785987835097995
13217,,1356,33163,34519,156,1348,45390,13105,32285,45390,3512,0.029874421678783875,0.7306234853491959,0.0034368803701255784,0.2887199823749725,0.7112800176250276,0.029698171403392818
13218,25.0,339,7974,8313,52,302,10908,3143,7765,10908,860,0.03107810781078108,0.731023102310231,0.004767143381004767,0.2881371470480381,0.7118628529519618,0.027686101943527688
13219,,83,1426,1509,1,101,2097,565,1532,2097,146,0.039580352885073916,0.6800190748688603,0.0004768717215069146,0.26943252265140677,0.7305674773485932,0.04816404387219838
13220,17.0,247,12902,13149,31,460,17400,5074,12326,17400,1569,0.014195402298850576,0.7414942528735632,0.001781609195402299,0.29160919540229885,0.7083908045977011,0.026436781609195402
13221,15.0,244,5823,6067,9,351,7990,2234,5756,7990,629,0.03053817271589487,0.7287859824780977,0.0011264080100125157,0.2795994993742178,0.7204005006257822,0.04392991239048811
13222,25.0,822,11399,12221,529,858,17665,4481,13184,17665,1033,0.0465326917633739,0.6452872912538918,0.029946221341636003,0.2536654401358619,0.7463345598641381,0.04857061986979904
13223,,150,4729,4879,30,363,6609,1881,4728,6609,464,0.022696323195642305,0.7155394159479498,0.004539264639128461,0.28461189287335453,0.7153881071266455,0.05492510213345438
13224,23.0,539,5380,5919,2,493,7984,2230,5754,7984,479,0.06751002004008017,0.6738476953907816,0.000250501002004008,0.2793086172344689,0.720691382765531,0.061748496993987975
13225,17.0,0,2182,2182,2,113,2947,816,2131,2947,260,0.0,0.7404139803189684,0.0006786562606040041,0.27689175432643365,0.7231082456735664,0.03834407872412623
13226,,5887,191882,197769,999,13049,263357,79051,184306,263357,12068,0.02235368720026428,0.728600340982013,0.0037933299665473103,0.30016669387941086,0.6998333061205891,0.049548711444920776
13227,16.0,12191,249232,261423,1233,13029,343937,99779,244160,343939,24964,0.03544523883595638,0.7246401251384693,0.003584938026801264,0.29010667589310896,0.7098933241068911,0.03788171739756178
13228,15.0,76,1752,1828,0,75,2635,707,1928,2635,195,0.028842504743833017,0.6648956356736243,0.0,0.2683111954459203,0.7316888045540797,0.028462998102466792
13229,13.0,388,6381,6769,26,345,9313,2647,6666,9313,637,0.04166219263395254,0.6851712659722968,0.0027917964136153764,0.28422635026307314,0.7157736497369269,0.03704499087297326
13230,17.0,7072,186136,193208,714,9020,271549,74304,197245,271549,20340,0.02604318189350725,0.685460082710671,0.002629359710402174,0.2736301735598363,0.7263698264401637,0.033216841159422424
13231,,101,2178,2279,1,191,3091,873,2218,3091,227,0.032675509543836946,0.7046263345195729,0.00032351989647363315,0.28243286962148173,0.7175671303785183,0.061792300226463925
13232,34.0,135,3036,3171,246,206,4514,1230,3284,4514,228,0.029906956136464335,0.6725742135578201,0.05449712007089056,0.2724856003544528,0.7275143996455472,0.04563579973416039
13233,26.0,169,4280,4449,29,146,5889,1697,4192,5889,537,0.02869757174392936,0.7267787400237732,0.004924435388011547,0.28816437425708946,0.7118356257429105,0.02479198505688572
13234,15.0,16,3006,3022,26,314,4193,1105,3088,4193,208,0.0038158836155497257,0.7169091342714047,0.006200810875268304,0.2635344621989029,0.736465537801097,0.07488671595516337
13235,23.0,239,5343,5582,13,347,7492,2092,5400,7492,609,0.03190069407367859,0.7131607047517352,0.0017351841964762414,0.2792311799252536,0.7207688200747464,0.04631607047517352
13236,,613,16973,17586,14,996,23584,6767,16817,23584,1817,0.025992198100407055,0.7196828358208955,0.0005936227951153324,0.2869318181818182,0.7130681818181818,0.04223202170963365
13237,24.0,3724,60297,64021,423,3523,86151,23831,62320,86151,5686,0.04322642801592553,0.6998990145210154,0.004909983633387889,0.2766189597334912,0.7233810402665088,0.040893315225592274
13238,15.0,3871,103348,107274,735,7555,145832,39934,105898,145832,9925,0.02654424269021888,0.7086784793460968,0.005040046080421307,0.2738356464973394,0.7261643535026606,0.05180618794228976
13239,,4320,81362,85682,3066,5766,117829,32459,85370,117829,5758,0.03666330020623106,0.6905091276341139,0.02602075889636677,0.27547547717454957,0.7245245228254504,0.048935321525261186
13240,17.0,317,5458,5775,42,353,8011,2213,5798,8011,608,0.03957059043814755,0.6813131943577581,0.005242791162152041,0.2762451629010111,0.7237548370989889,0.04406441143427787
13241,,161,3427,3588,0,129,4597,1409,3188,4597,337,0.035022840983249946,0.7454861866434631,0.0,0.3065042418968893,0.6934957581031107,0.028061779421361756
13242,14.0,35,5144,5179,33,636,7060,1960,5100,7060,445,0.004957507082152974,0.7286118980169972,0.004674220963172804,0.2776203966005666,0.7223796033994334,0.09008498583569405
13243,16.0,1284,23488,24772,21,1223,32161,9289,22872,32161,2416,0.039924131712322376,0.7303255495786822,0.0006529647709959267,0.2888280837038649,0.7111719162961351,0.03802742452038183
13244,,15,10613,10628,2,793,14041,3882,10159,14041,1327,0.0010682999786340004,0.7558578448828431,0.00014243999715120005,0.2764760344704793,0.7235239655295207,0.056477458870450824
13245,,304,6122,6426,35,337,8496,2453,6043,8496,580,0.035781544256120526,0.7205743879472694,0.004119585687382297,0.2887241054613936,0.7112758945386064,0.03966572504708098
13246,17.0,164,2078,2242,9,141,3129,875,2254,3129,200,0.05241291147331416,0.6641099392777245,0.0028763183125599234,0.2796420581655481,0.7203579418344519,0.045062320230105465
13247,27.0,302,5743,6045,23,270,8078,2305,5773,8078,664,0.03738549145828175,0.7109433027977222,0.002847239415696955,0.2853429066600644,0.7146570933399357,0.03342411487992077
13248,26.0,197,4531,4728,1,159,6219,1874,4345,6219,503,0.03167711850779868,0.7285737256793696,0.00016079755587715066,0.30133461971378034,0.6986653802862196,0.025566811384466957
13249,15.0,186,3891,4077,16,125,5550,1635,3915,5550,406,0.03351351351351351,0.701081081081081,0.002882882882882883,0.2945945945945946,0.7054054054054054,0.02252252252252252
13250,,717,14569,15286,254,340,19245,5862,13383,19245,1163,0.0372564302416212,0.757027799428423,0.013198233307352559,0.30459859703819175,0.6954014029618083,0.01766692647440894
13251,13.0,250,5101,5351,49,346,7320,2031,5290,7321,540,0.03414834039065701,0.6967627373309657,0.006693074716568775,0.27742111733369756,0.7225788826663024,0.04726130310066931
13252,26.0,334,7740,8074,33,512,10982,3001,7981,10982,771,0.030413403751593515,0.7047896558004006,0.0030049171371334914,0.2732653432890184,0.7267346567109816,0.046621744673101435
13253,36.0,123,3471,3594,16,159,4815,1390,3425,4815,409,0.02554517133956386,0.7208722741433021,0.0033229491173416407,0.28868120456905505,0.711318795430945,0.03302180685358255
13254,16.0,407,16774,17181,107,951,23308,6522,16786,23308,1939,0.01746181568560151,0.7196670671014244,0.004590698472627424,0.27981808821005666,0.7201819117899434,0.040801441565127855
13255,15.0,2848,59763,62611,47,6006,87953,23731,64222,87953,5736,0.03238093072436415,0.6794879083146681,0.0005343763146225825,0.26981456004911714,0.7301854399508828,0.06828647118347299
13256,23.0,167,4734,4901,11,186,6460,1889,4571,6460,530,0.025851393188854488,0.7328173374613003,0.0017027863777089784,0.29241486068111455,0.7075851393188854,0.028792569659442723
13257,,93,11296,11389,71,2060,16625,4239,12386,16625,831,0.005593984962406015,0.6794586466165413,0.004270676691729323,0.2549774436090226,0.7450225563909775,0.12390977443609022
13258,,644,4693,5337,37,448,7303,2131,5172,7303,254,0.08818293851841709,0.6426126249486512,0.005066411063946324,0.2917978912775572,0.7082021087224428,0.06134465288237711
13259,16.0,208,6021,6229,11,232,7979,2424,5555,7979,597,0.026068429627772904,0.7546058403308685,0.0013786188745456825,0.3037974683544304,0.6962025316455697,0.029076325354054394
13260,17.0,2553,26056,28609,102,1818,39986,10868,29118,39986,2483,0.06384734657129995,0.6516280698244385,0.0025508928124843696,0.2717951282949032,0.7282048717050967,0.04546591306957435
13261,23.0,430,11359,11789,10,539,15431,4562,10869,15431,1167,0.027865984058064935,0.7361156114315339,0.000648046140885231,0.2956386494718424,0.7043613505281576,0.03492968699371395
13262,13.0,76,2331,2407,6,74,3554,935,2619,3554,278,0.021384355655599326,0.6558806978052898,0.0016882386043894203,0.263083849184018,0.7369161508159819,0.020821609454136185
13263,15.0,232,2976,3208,3,308,4395,1264,3131,4395,320,0.0527872582480091,0.6771331058020478,0.0006825938566552901,0.2875995449374289,0.7124004550625711,0.07007963594994311
13264,17.0,85,1471,1556,9,116,2213,608,1605,2213,137,0.03840939900587438,0.6647085404428378,0.004066877541798464,0.27474017171260734,0.7252598282873927,0.05241753276095797
13265,,46,1583,1629,1,64,2208,612,1596,2208,188,0.020833333333333332,0.7169384057971014,0.0004528985507246377,0.27717391304347827,0.7228260869565217,0.028985507246376812
13266,24.0,6374,80951,87325,972,3807,121810,32708,89104,121812,5796,0.05232653597346731,0.6645568581092175,0.007979509407940105,0.2685121334515483,0.7314878665484517,0.03125307851443208
13267,,322,7295,7617,26,377,10093,3032,7061,10093,607,0.031903299316357873,0.7227781630833251,0.00257604280194194,0.30040622213415236,0.6995937778658476,0.03735262062815813
13268,25.0,3501,62070,65571,187,3321,89255,24626,64629,89255,6046,0.0392246932944933,0.6954232255896028,0.002095120721528206,0.2759061117024256,0.7240938882975744,0.03720799955184584
13269,,763,17558,18321,120,502,24041,6967,17074,24041,2132,0.03173744852543572,0.730335676552556,0.0049914729004617115,0.2897965974793062,0.7102034025206938,0.020880994966931493
13270,35.0,275,4614,4889,30,276,7103,1820,5283,7103,450,0.03871603547796706,0.6495846825285091,0.0042235675066873155,0.2562297620723638,0.7437702379276362,0.0388568210615233
13271,,42,2345,2387,10,183,3300,918,2382,3300,277,0.012727272727272728,0.7106060606060606,0.0030303030303030303,0.2781818181818182,0.7218181818181818,0.05545454545454546
13272,,1548,45986,47534,119,3220,62535,18534,44003,62537,3751,0.024753346019156658,0.7353406783184355,0.0019028734988886578,0.29636854981850747,0.7036314501814925,0.05148951820522251
13273,26.0,109,3032,3141,6,133,4102,1188,2914,4102,294,0.026572403705509506,0.7391516333495856,0.0014627011214041932,0.28961482203803024,0.7103851779619698,0.032423208191126277
13274,27.0,278,10549,10827,59,465,14024,4164,9860,14024,1115,0.01982316029663434,0.7522104962920707,0.0042070735881346265,0.29691956645750145,0.7030804335424986,0.03315744438106104
13275,16.0,65,2831,2896,13,229,4059,1092,2967,4059,321,0.01601379650160138,0.6974624291697462,0.003202759300320276,0.2690317812269032,0.7309682187730968,0.05641783690564178
13276,34.0,614,15417,16031,72,730,20978,6011,14967,20978,1377,0.029268757746210315,0.7349127657546001,0.003432167032128897,0.28653827819620553,0.7134617218037944,0.03479836018686243
13277,,91,7704,7795,14,577,10573,2961,7612,10573,903,0.008606828714650525,0.7286484441501939,0.0013241274945616191,0.28005296509978245,0.7199470349002175,0.05457296888300388
13278,14.0,115,5306,5421,5,322,7159,2032,5127,7159,571,0.016063696046933928,0.7411649671741863,0.0006984215672579969,0.28383852493364997,0.7161614750663501,0.044978348931415
13279,17.0,28814,485837,514651,2900,27012,710285,198716,511569,710285,51319,0.0405668147292988,0.6840029002442681,0.0040828681444772166,0.2797693883441154,0.7202306116558846,0.038029804937454684
13280,,349,8597,8946,28,413,12160,3416,8744,12160,951,0.02870065789473684,0.7069901315789474,0.002302631578947368,0.28092105263157896,0.719078947368421,0.03396381578947368
13281,,1031,20933,21964,59,1514,30121,8529,21592,30121,2107,0.03422861126788619,0.6949636466252781,0.0019587663092194814,0.2831579296836094,0.7168420703163906,0.050263935460310084
13282,,612,15252,15864,8,1080,21517,5969,15548,21517,1468,0.02844262676023609,0.7088348747501975,0.00037179904261746524,0.2774085606729563,0.7225914393270437,0.05019287075335781
13283,17.0,175,4787,4962,26,298,6757,1856,4901,6757,504,0.02589906763356519,0.7084504957821518,0.0038478614769868287,0.27467811158798283,0.7253218884120172,0.04410241231315672
13284,,37,4893,4930,9,249,6692,1816,4876,6692,601,0.00552898983861327,0.7311715481171548,0.0013448894202032278,0.27136879856545126,0.7286312014345487,0.0372086072922893
13285,,824,17020,17844,96,1003,24106,6780,17326,24106,1561,0.03418236123786609,0.7060482867335933,0.003982411018003816,0.28125777814651953,0.7187422218534805,0.04160789844851904
13286,17.0,2180,9980,12160,7,315,16025,4668,11357,16025,1292,0.1360374414976599,0.6227769110764431,0.00043681747269890795,0.2912948517940718,0.7087051482059282,0.019656786271450857
13287,17.0,71,2226,2297,1,120,3093,890,2203,3093,274,0.02295505981247979,0.7196896217264791,0.00032331070158422246,0.28774652440995796,0.712253475590042,0.038797284190106696
13288,,89,3379,3468,3,252,4700,1367,3333,4700,431,0.018936170212765956,0.718936170212766,0.0006382978723404255,0.29085106382978726,0.7091489361702128,0.05361702127659575
13289,,490,13468,13958,42,702,18561,5363,13200,18563,1384,0.026396595377902277,0.7255292786726284,0.0022625653181059095,0.28890804288099986,0.7110919571190002,0.037817163174055916
13290,27.0,14526,354299,368825,1404,28964,497976,140579,357397,497976,39472,0.029170080485806545,0.711478063199833,0.0028194129837582536,0.28230075344996547,0.7176992465500346,0.058163445627901746
13291,23.0,314,10159,10473,73,721,14443,3958,10485,14443,1050,0.02174063560202174,0.7033857231877034,0.005054351589005054,0.274042788894274,0.725957211105726,0.04992037665304992
13292,24.0,172,2818,2990,17,325,4285,1028,3257,4285,221,0.04014002333722287,0.6576429404900817,0.0039673278879813305,0.23990665110851808,0.760093348891482,0.07584597432905485
13293,17.0,11607,226674,238281,607,11528,311837,90564,221285,311849,21666,0.037219936571866515,0.7268710177040811,0.0019464548547534224,0.29040978165714815,0.7095902183428519,0.036966608839534516
13294,14.0,1020,15754,16774,48,1057,23419,6496,16923,23419,1469,0.04355437892309663,0.6727016525043767,0.0020496178316751355,0.277381613220035,0.722618386779965,0.04513429266834621
13295,,19668,225038,244706,1090,12287,325543,93382,232161,325543,20172,0.060415981913295634,0.6912696633010078,0.003348251997431983,0.28684997066439766,0.7131500293356023,0.037743093846281446
13296,24.0,89,1544,1633,8,209,2533,592,1941,2533,166,0.03513620213185945,0.6095538886695618,0.0031583103039873666,0.23371496249506515,0.7662850375049348,0.08251085669166995
13297,27.0,803,10543,11346,80,739,15550,4235,11315,15550,795,0.051639871382636655,0.6780064308681673,0.005144694533762058,0.27234726688102895,0.727652733118971,0.04752411575562701
13298,27.0,395,10655,11050,50,393,14404,4243,10162,14405,1113,0.027421034363068378,0.7396737244012496,0.003471017007983339,0.2945505032974662,0.7054494967025339,0.027282193682749045
13299,14.0,135,13678,13813,53,1364,18732,5305,13427,18732,846,0.007206918641896221,0.7301943198804185,0.0028293828742259235,0.2832052103352552,0.7167947896647449,0.07281657057441811
13300,,5237,104361,109598,511,6374,149979,41688,108291,149979,10722,0.03491822188439715,0.6958374172384134,0.003407143666780016,0.27795891424799474,0.7220410857520053,0.04249928323298595
13301,,287,6451,6738,7,202,9080,2585,6495,9080,731,0.0316079295154185,0.7104625550660792,0.0007709251101321586,0.28469162995594716,0.7153083700440529,0.02224669603524229
13302,16.0,1150,11360,12510,92,863,16875,4662,12213,16875,1322,0.06814814814814815,0.6731851851851852,0.005451851851851852,0.27626666666666666,0.7237333333333333,0.051140740740740744
13303,,2523,64984,67508,820,3013,88189,25920,62269,88189,6001,0.028609010194015128,0.7368719454807289,0.00929821179512184,0.293914206987266,0.706085793012734,0.034165258705734274
13304,17.0,725,16854,17579,54,673,22974,6662,16313,22975,1650,0.031556039173014146,0.7335799782372143,0.00235038084874864,0.28996735582154515,0.7100326441784548,0.029292709466811753
13305,,445,6146,6591,19,390,8996,2509,6487,8996,713,0.04946642952423299,0.6831925300133392,0.002112049799911072,0.27890173410404623,0.7210982658959537,0.04335260115606936
13306,26.0,42,4716,4758,47,651,6674,1750,4924,6674,501,0.006293077614623914,0.7066227150134852,0.007042253521126761,0.2622115672759964,0.7377884327240036,0.09754270302667066
13307,16.0,203,3495,3698,1,166,4817,1413,3404,4817,370,0.04214241228980693,0.725555324891011,0.00020759809009757111,0.29333610130786797,0.7066638986921321,0.034461282956196805
13308,35.0,3214,94444,97658,700,3263,128836,37685,91151,128836,10183,0.02494644354062529,0.7330559781427551,0.005433263994535689,0.29250364804868206,0.707496351951318,0.02532677202024279
13309,,462,11133,11595,99,541,15702,4475,11227,15702,1221,0.02942300343905235,0.7090179594956056,0.006304929308368361,0.2849955419691759,0.7150044580308241,0.034454209654821044
13310,15.0,173,2244,2417,3,204,3360,891,2469,3360,209,0.051488095238095236,0.6678571428571428,0.0008928571428571428,0.26517857142857143,0.7348214285714286,0.060714285714285714
13311,,96,5835,5931,12,277,8113,2271,5842,8113,787,0.011832860840626156,0.7192160729693086,0.0014791076050782695,0.2799211142610625,0.7200788857389375,0.03414273388389005
13312,,584,12104,12688,15,641,16855,4767,12088,16855,1232,0.03464847226342332,0.7181251854049243,0.0008899436369029962,0.2828240878077722,0.7171759121922279,0.0380302580836547
13313,16.0,441,8497,8938,39,549,12170,3357,8813,12170,891,0.03623664749383731,0.6981922760887428,0.0032046014790468366,0.2758422350041085,0.7241577649958916,0.04511092851273624
13314,,232,5384,5616,21,391,7594,2180,5414,7594,550,0.030550434553594942,0.7089807742954964,0.002765341058730577,0.2870687384777456,0.7129312615222544,0.05148801685541217
13315,,1283,17003,18286,33,1113,26036,6651,19385,26036,1467,0.04927792287601782,0.6530573052696267,0.001267475802734675,0.25545398678752496,0.744546013212475,0.042748502074051314
13316,24.0,3051,63111,66162,429,3033,87154,25171,61983,87154,6107,0.03500699910503247,0.7241319962365468,0.004922321408082245,0.2888106111021869,0.711189388897813,0.03480046813686119
13317,35.0,1176,24847,26023,44,1182,34459,10063,24396,34459,2542,0.03412751385704751,0.7210598102092342,0.0012768797701616414,0.29202820743492264,0.7079717925650774,0.03430163382570591
13318,,227,3495,3722,17,486,5301,1448,3853,5301,370,0.04282210903603094,0.6593095642331636,0.0032069420863987926,0.2731560083003207,0.7268439916996793,0.09168081494057725
13319,15.0,164,2539,2703,28,218,3910,1025,2885,3910,229,0.04194373401534527,0.6493606138107417,0.007161125319693095,0.26214833759590794,0.7378516624040921,0.055754475703324806
13320,15.0,858,32304,33162,152,2498,45041,12870,32171,45041,3614,0.019049310628094403,0.717213205745876,0.0033747030483337404,0.28573965942141605,0.714260340578584,0.05546058036011634
13321,23.0,81,2020,2101,0,115,2742,810,1932,2742,185,0.02954048140043764,0.7366885485047411,0.0,0.29540481400437635,0.7045951859956237,0.041940189642596645
13322,41.0,76,2178,2254,10,161,3030,862,2168,3030,210,0.025082508250825083,0.7188118811881188,0.0033003300330033004,0.2844884488448845,0.7155115511551156,0.05313531353135314
13323,,151,6258,6409,45,280,8529,2656,5873,8529,385,0.0177043029663501,0.733731973267675,0.005276116778051354,0.31140813694454217,0.6885918630554578,0.03282917106343065
13324,,314,5909,6223,38,231,8130,2403,5727,8130,563,0.038622386223862236,0.7268142681426815,0.004674046740467405,0.2955719557195572,0.7044280442804428,0.02841328413284133
13325,23.0,503,16921,17424,123,780,23392,6746,16646,23392,1861,0.021503077975376195,0.7233669630642955,0.005258207934336526,0.2883891928864569,0.7116108071135431,0.033344733242134064
13326,26.0,232,6185,6417,22,273,8515,2447,6068,8515,715,0.02724603640634175,0.7263652378156195,0.002583675866118614,0.2873752201996477,0.7126247798003523,0.03206106870229008
13327,17.0,590,15221,15811,28,734,21065,6039,15026,21065,1835,0.028008544979824353,0.722572988369333,0.0013292190837882745,0.28668407310704963,0.7133159268929504,0.03484452883930691
13328,27.0,505,12308,12813,42,647,16860,4917,11943,16860,1221,0.029952550415183868,0.7300118623962041,0.002491103202846975,0.2916370106761566,0.7083629893238435,0.03837485172004745
13329,,392,9563,9955,2,406,13256,3813,9443,13256,1048,0.029571514785757393,0.7214091732045866,0.00015087507543753772,0.28764333132166564,0.7123566686783344,0.03062764031382016
13330,36.0,1411,41239,42650,244,1328,56282,16305,39978,56283,4876,0.02506973686548336,0.732707922463266,0.004335234440239504,0.2896967112627259,0.7103032887372741,0.023595046461631398
13331,15.0,804,3203,4007,179,330,5401,1499,3902,5401,109,0.1488613219774116,0.5930383262358823,0.03314201073875208,0.277541196074801,0.722458803925199,0.06109979633401222
13332,40.0,4236,103864,108100,546,4779,142377,40891,101486,142377,10519,0.029751996460102403,0.7294998489924637,0.0038348890621378454,0.2872022868862246,0.7127977131137754,0.03356581470321751
13333,,122,3712,3834,19,173,5312,1476,3836,5312,477,0.02296686746987952,0.6987951807228916,0.0035768072289156625,0.27786144578313254,0.7221385542168675,0.03256777108433735
13334,17.0,77,1726,1803,2,144,2447,707,1740,2447,149,0.03146710257458112,0.7053534940743768,0.0008173273395995096,0.2889252145484266,0.7110747854515733,0.05884756845116469
13335,14.0,241,4306,4547,18,339,6201,1744,4457,6201,410,0.03886469924205773,0.6944041283663925,0.002902757619738752,0.2812449604902435,0.7187550395097565,0.05466860183841316
13336,,734,14340,15074,38,875,21846,5702,16144,21846,1211,0.03359882816076169,0.6564130733315023,0.001739448869358235,0.26100888034422776,0.7389911196557722,0.04005309896548567
13337,27.0,1354,27030,28384,130,1292,38998,10808,28190,38998,3189,0.03471972921688292,0.6931124673060157,0.0033335042822708856,0.27714241755987484,0.7228575824401251,0.03312990409764603
13338,26.0,287,9309,9596,203,248,12856,3599,9257,12856,1067,0.022324206596141878,0.7240976975731176,0.01579029247044182,0.27994710640945863,0.7200528935905414,0.019290603609209707
13339,,41296,916022,957318,12502,33299,1208150,370117,838041,1208158,62161,0.03418095977512875,0.758197189440454,0.010347984286823412,0.3063481763146873,0.6936518236853126,0.027561792414568295
13340,,315,6416,6731,0,462,9052,2598,6454,9052,665,0.034798939460892624,0.7087936367653557,0.0,0.2870083959346001,0.7129916040654,0.05103844454264251
13341,16.0,199,8699,8898,16,311,11811,3402,8409,11811,1037,0.016848700364067395,0.736516806366946,0.0013546693760054186,0.28803657607315214,0.7119634239268479,0.026331385996105326
13342,37.0,93,2687,2780,4,87,3486,1072,2414,3486,252,0.02667814113597246,0.7707974756167527,0.0011474469305794606,0.30751577739529545,0.6924842226047045,0.02495697074010327
13343,23.0,750,17360,18110,7,591,23864,6887,16977,23864,1635,0.03142809252430439,0.7274555816292323,0.0002933288635601743,0.28859369761984577,0.7114063023801542,0.02476533690915186
13344,,15976,183247,199224,1072,13126,268280,75917,192605,268522,19292,0.05949605618906458,0.6824282554129643,0.003992224100818555,0.28272171367709165,0.7172782863229084,0.04888240069714958
13345,,565,16650,17215,11,1048,22965,6323,16642,22965,1789,0.02460265621598084,0.7250163291966035,0.0004789897670367951,0.27533202699760506,0.7246679730023949,0.045634661441323755
13346,23.0,795,21441,22236,96,911,29903,8647,21256,29903,2181,0.026585961274788482,0.7170183593619369,0.0032103802294084207,0.2891683108718189,0.7108316891281811,0.03046517071865699
13347,23.0,91,2269,2360,0,151,3219,900,2319,3219,227,0.02826964895930413,0.7048772910841876,0.0,0.27958993476234856,0.7204100652376515,0.0469089779434607
13348,16.0,951,21504,22455,240,902,30370,8581,21789,30370,1856,0.03131379650971353,0.7080671715508726,0.007902535396773132,0.2825485676654593,0.7174514323345407,0.029700362199539018
13349,27.0,396,7433,7829,275,712,13220,2658,10562,13220,635,0.02995461422087746,0.5622541603630863,0.0208018154311649,0.2010590015128593,0.7989409984871407,0.053857791225416035
13350,25.0,106,3789,3895,15,111,5113,1511,3602,5113,530,0.020731468805006845,0.7410522198318013,0.0029336984158028555,0.29552122041854095,0.704478779581459,0.02170936827694113
13351,15.0,0,3854,3854,3,186,5180,1462,3718,5180,462,0.0,0.7440154440154441,0.0005791505791505791,0.2822393822393822,0.7177606177606177,0.035907335907335906
13352,,8142,156536,164678,651,8088,216630,62488,154142,216630,14748,0.03758482204680792,0.7225961316530489,0.00300512394405207,0.28845496930249737,0.7115450306975026,0.037335549092923415
13353,14.0,290,15742,16032,254,1078,22572,6017,16555,22572,1795,0.012847776005670743,0.6974127237285132,0.011252879673932306,0.2665692007797271,0.7334307992202729,0.04775828460038986
13354,15.0,162,2103,2265,0,221,3235,878,2357,3235,169,0.05007727975270479,0.6500772797527048,0.0,0.2714064914992272,0.7285935085007728,0.06831530139103555
13355,24.0,2137,82640,84777,211,3868,114816,32460,82356,114816,9077,0.01861238851727982,0.7197603121516165,0.0018377229654403567,0.2827132107023411,0.7172867892976589,0.033688684503901896
13356,,331,24429,26457,215,2412,35747,9210,26537,35747,1873,0.009259518281254372,0.6833860184071391,0.006014490726494531,0.25764399809774247,0.7423560019022575,0.06747419363862701
13357,,964,25757,26721,131,1327,35304,10243,25061,35304,2593,0.02730568774076592,0.7295773849988669,0.003710627690913211,0.2901370949467482,0.7098629050532518,0.03758780874688421
13358,17.0,283,12884,13167,17,546,17089,5026,12063,17089,1370,0.01656036046579671,0.7539352800046814,0.0009947919714436188,0.2941073204985663,0.7058926795014336,0.0319503774357774
13359,25.0,122,3108,3230,3,152,4339,1281,3058,4339,359,0.02811707766766536,0.7162940769762618,0.0006914035492048859,0.2952293155104863,0.7047706844895137,0.03503111315971422
13360,,319,9397,9716,27,263,12423,3772,8651,12423,984,0.025678177573854946,0.7564195443934637,0.0021733880705143687,0.30363036303630364,0.6963696369636964,0.02117040972389922
13361,24.0,648,11925,12573,61,652,17177,4729,12448,17177,1280,0.03772486464458287,0.6942423007510042,0.0035512604063573385,0.2753100075682599,0.7246899924317401,0.037957734179425974
13362,23.0,32056,75680,107736,792,10184,147881,41126,106755,147881,17,0.21676888849818435,0.5117628363346204,0.0053556575895483535,0.2781019874087949,0.7218980125912051,0.06886618294439448
13363,17.0,452,11061,11513,102,448,15313,4386,10927,15313,1188,0.029517403513354665,0.72232743420623,0.0066610069875269375,0.2864233004636583,0.7135766995363416,0.029256187553059494
13364,13.0,48,1716,1764,12,82,2361,660,1701,2361,212,0.020330368487928845,0.7268106734434562,0.005082592121982211,0.2795425667090216,0.7204574332909784,0.03473104616687844
13365,25.0,539,15659,16198,31,794,21213,6067,15146,21213,1627,0.02540894734361005,0.7381794182812427,0.001461368029038797,0.2860038655541413,0.7139961344458586,0.037429877905058216
13366,,50,2704,2754,0,209,3807,1046,2761,3807,315,0.013133701076963489,0.7102705542421854,0.0,0.27475702653007616,0.7252429734699238,0.05489887050170738
13367,,266,18578,18844,127,2845,26879,7166,19713,26879,1507,0.009896201495591353,0.6911715465605119,0.004724878157669556,0.26660218014063025,0.7333978198593698,0.10584471148480226
13368,47.0,96,2986,3082,0,91,3949,1203,2746,3949,338,0.02430995188655356,0.7561407951380096,0.0,0.30463408457837426,0.6953659154216257,0.023043808559128895
13369,17.0,80,2230,2310,22,134,3125,868,2257,3125,248,0.0256,0.7136,0.00704,0.27776,0.72224,0.04288
13370,,4347,102482,106829,484,5045,145013,40641,104372,145013,9829,0.029976622785543364,0.7067090536710502,0.0033376317985284077,0.28025763207436577,0.7197423679256343,0.034789984346231026
13371,35.0,1670,42929,44599,153,2001,58991,16837,42154,58991,4950,0.028309403129290908,0.7277211778067841,0.002593615975318269,0.28541641945381496,0.714583580546185,0.03392042853994677
13372,25.0,973,22953,23926,24,1174,31646,9151,22495,31646,2322,0.03074638184920685,0.7253049358528724,0.0007583896859002717,0.28916766731972443,0.7108323326802756,0.037097895468621626
13373,,2334,51024,53358,462,2480,69592,20154,49442,69596,4391,0.03353641013851371,0.7331455830794873,0.0066383125466980865,0.28958560836829705,0.710414391631703,0.03563423185240531
13374,16.0,168,9355,9523,84,1308,14945,2860,12085,14945,720,0.011241217798594848,0.6259618601538977,0.005620608899297424,0.1913683506189361,0.8086316493810639,0.0875209100033456
13375,,3209,91486,94695,735,3572,124029,35600,88429,124029,9332,0.0258729813188851,0.7376178151883833,0.005926033427666111,0.28702964629239935,0.7129703537076006,0.028799716195405913
13376,,456,1307,1763,2,134,2337,651,1686,2337,2,0.1951219512195122,0.5592640136927685,0.0008557980316645272,0.2785622593068036,0.7214377406931964,0.05733846812152332
13377,23.0,34,1676,1710,8,73,2232,650,1582,2232,180,0.015232974910394265,0.7508960573476703,0.0035842293906810036,0.29121863799283154,0.7087813620071685,0.03270609318996416
13378,24.0,3267,95589,98856,123,2198,128511,37555,90956,128511,10474,0.025421948315708383,0.7438195952097486,0.0009571165114270374,0.2922317933873365,0.7077682066126635,0.017103594244850636
13379,,2544,90399,92943,184,6294,123171,35396,87775,123171,9858,0.02065421243636895,0.7339308765862094,0.0014938581321902072,0.2873728393858944,0.7126271606141056,0.05109969067394111
13380,14.0,159,4350,4509,11,340,6194,1720,4474,6194,421,0.025670003228931225,0.7022925411688731,0.0017759121730707135,0.2776880852437843,0.7223119147562157,0.05489183080400387
13381,36.0,505,11021,11526,86,426,14917,4398,10519,14917,900,0.033853992089562246,0.7388214788496347,0.005765234296440303,0.29483140041563316,0.7051685995843668,0.02855802104980894
13382,23.0,606,15947,16553,124,617,21893,6366,15527,21893,1886,0.027680080390992554,0.7284063399260038,0.005663910839080985,0.29077787420636736,0.7092221257936326,0.028182524094459416
13383,24.0,1106,38590,39696,127,2481,53232,15193,38039,53232,3783,0.02077697625488428,0.7249398857829876,0.0023857829876765854,0.28541103095882175,0.7145889690411782,0.046607303877366994
13384,,181,4833,5014,2,228,6562,1935,4627,6562,513,0.02758305394696739,0.7365132581530022,0.00030478512648582747,0.2948796098750381,0.7051203901249619,0.034745504419384336
13385,,1074,31503,32577,54,1056,44417,12012,32405,44417,3126,0.024179931107458856,0.7092554652497918,0.0012157507260733503,0.2704369948443164,0.7295630051556836,0.023774680865434404
13386,23.0,99,5786,5885,30,562,7987,2188,5799,7987,600,0.012395142105922123,0.7244271941905597,0.0037561036684612497,0.27394516088644044,0.7260548391135595,0.07036434205584075
13387,27.0,2315,41234,43549,346,2320,62488,16382,46106,62488,4322,0.03704711304570477,0.6598706951734733,0.005537063116118295,0.2621623351683523,0.7378376648316477,0.03712712840865446
13388,24.0,861,21884,22745,131,1492,30284,8776,21533,30309,2106,0.02840740374146293,0.722029760137253,0.004322148536738263,0.28955095846118317,0.7104490415388168,0.04922630241842357
13389,14.0,212,3502,3714,9,279,5008,1416,3592,5008,332,0.04233226837060703,0.6992811501597445,0.0017971246006389776,0.2827476038338658,0.7172523961661342,0.05571086261980831
13390,16.0,1939,20980,22919,120,1637,31122,8782,22340,31122,2107,0.06230319388214125,0.6741212004369899,0.00385579332947754,0.282179808495598,0.717820191504402,0.05259944733628944
13391,15.0,358,18164,18522,74,1658,25358,7017,18341,25358,1763,0.014117832636643268,0.7163025475195205,0.002918211215395536,0.27671740673554696,0.723282593264453,0.06538370533953781
13392,17.0,504,11625,12129,33,542,15937,4592,11345,15937,1210,0.03162452155361737,0.7294346489301625,0.002070653196963042,0.288134529710736,0.711865470289264,0.0340089100834536
13393,26.0,467,11771,12238,93,561,16284,4733,11551,16284,1081,0.028678457381478752,0.7228567919430116,0.005711127487103906,0.29065340211250307,0.7093465978874969,0.03445099484156227
13394,17.0,344,7821,8165,55,547,11254,3084,8170,11254,824,0.030566909543273502,0.6949529056335525,0.004887151235116403,0.27403589834725434,0.7259641016527457,0.04860494046561223
13395,13.0,475,7748,8223,11,243,11155,3154,8001,11155,660,0.04258180188256387,0.6945764231286419,0.0009861048857014792,0.28274316450022413,0.7172568354997759,0.021783953384132675
13396,,571,16901,17472,35,617,22809,6726,16083,22809,1577,0.025033977815774475,0.7409794379411636,0.0015344820027182252,0.2948835985795081,0.7051164014204919,0.027050725590775572
13397,34.0,79,2336,2415,6,130,3215,910,2305,3215,246,0.024572317262830483,0.7265940902021772,0.0018662519440124418,0.28304821150855364,0.7169517884914464,0.04043545878693624
13398,16.0,469,6223,6692,30,456,9074,2547,6527,9074,656,0.05168613621335685,0.6858055984130482,0.0033061494379545957,0.2806920872823452,0.7193079127176548,0.05025347145690985
13399,25.0,75,2828,2903,38,84,3786,1131,2655,3786,301,0.019809825673534072,0.7469624933967248,0.010036978341257264,0.2987321711568938,0.7012678288431062,0.022187004754358162
13400,23.0,67,2528,2595,0,76,3380,1018,2362,3380,300,0.01982248520710059,0.7479289940828402,0.0,0.30118343195266273,0.6988165680473373,0.022485207100591716
13401,15.0,54,2497,2551,11,207,3470,932,2538,3470,163,0.015561959654178675,0.7195965417867435,0.003170028818443804,0.2685878962536023,0.7314121037463976,0.059654178674351584
13402,17.0,44,4432,4476,15,323,6040,1678,4362,6040,405,0.00728476821192053,0.7337748344370861,0.0024834437086092716,0.27781456953642386,0.7221854304635762,0.05347682119205298
13403,16.0,991,17182,18173,123,763,23579,6988,16591,23579,1463,0.04202892404258026,0.7286992662962806,0.005216506213155774,0.29636540989863863,0.7036345901013614,0.03235930276941346
13404,,1232,16526,17758,68,1326,25202,6754,18448,25202,1678,0.04888500912625982,0.655741607808904,0.002698198555670185,0.2679946036028887,0.7320053963971114,0.05261487183556861
13405,,125,2531,2656,3,176,3745,1025,2720,3745,241,0.03337783711615487,0.6758344459279039,0.0008010680907877169,0.27369826435246997,0.7263017356475301,0.04699599465954606
13406,17.0,750,13916,14666,36,1427,21341,5551,15790,21341,1442,0.035143620261468535,0.6520781594114615,0.0016868937725504896,0.2601096480952158,0.7398903519047842,0.06686659481748747
13407,16.0,201,3250,3451,194,156,5077,1256,3821,5077,359,0.03959030923773882,0.6401418160330904,0.03821154224935986,0.24739019105771123,0.7526098089422888,0.030726807169588338
13408,23.0,626,12615,13241,62,821,18248,4899,13349,18248,1327,0.03430512932924156,0.691308636562911,0.0033976326172731257,0.268467777290662,0.731532222709338,0.044991231915826393
13409,,4129,61326,66699,367,5995,92391,24302,68089,92391,5407,0.0446905001569417,0.6637659512290158,0.003972248379171131,0.2630342782305636,0.7369657217694364,0.06488727256983905
13410,17.0,814,12684,13498,77,973,18420,5026,13394,18420,1370,0.044191096634093374,0.6885993485342019,0.004180238870792617,0.27285559174809987,0.7271444082519001,0.05282301845819761
13411,,607,31162,31769,1147,2577,44639,12083,32556,44639,3400,0.013597974865028338,0.6980891148995273,0.025695020049732297,0.27068258697551467,0.7293174130244853,0.057729787853670556
13412,,156,3013,3169,206,278,4699,1259,3440,4699,254,0.033198552883592254,0.6412002553734837,0.043839114705256435,0.26792934666950413,0.7320706533304958,0.05916152372845286
13413,,154,1800,1954,24,82,2529,738,1791,2529,129,0.0608936338473705,0.7117437722419929,0.009489916963226572,0.2918149466192171,0.708185053380783,0.03242388295769079
13414,,1255,38860,40115,207,2342,53966,15426,38540,53966,4385,0.02325538301893785,0.7200830152318126,0.0038357484341993106,0.28584664418337474,0.7141533558166253,0.04339769484490234
13415,33.0,126,3504,3630,73,236,5033,1268,3765,5033,287,0.025034770514603615,0.6962050466918339,0.014504271806079872,0.2519372143850586,0.7480627856149414,0.04689052255116233
13416,,167,3016,3183,19,153,4048,1203,2845,4048,149,0.04125494071146245,0.7450592885375494,0.004693675889328063,0.29718379446640314,0.7028162055335968,0.03779644268774703
13417,13.0,5059,72194,77253,504,4066,103141,29024,74117,103141,7743,0.04904935961450829,0.6999544313124751,0.004886514577132275,0.28140118866406183,0.7185988113359382,0.03942176244170601
13418,,114,4412,4526,112,300,6361,1688,4673,6361,279,0.017921710422889484,0.6936016349630562,0.01760729445055809,0.26536708064769693,0.7346329193523031,0.04716239584970917
13419,,70,3338,3408,4,202,4440,1317,3123,4440,277,0.015765765765765764,0.7518018018018018,0.0009009009009009009,0.29662162162162165,0.7033783783783784,0.045495495495495496
13420,,307,5827,6134,27,221,8308,2320,5988,8308,584,0.03695233509870005,0.7013721714010592,0.0032498796340876264,0.27924891670678864,0.7207510832932114,0.02660086663456909
13421,15.0,651,3778,4429,28,435,6336,1734,4602,6336,326,0.10274621212121213,0.5962752525252525,0.004419191919191919,0.27367424242424243,0.7263257575757576,0.06865530303030302
13422,,103,2286,2389,18,110,3100,892,2208,3100,222,0.0332258064516129,0.7374193548387097,0.005806451612903226,0.28774193548387095,0.712258064516129,0.035483870967741936
13423,23.0,500,12286,12786,92,860,17527,4817,12710,17527,1253,0.028527414845666687,0.7009756375877219,0.00524904433160267,0.27483311462315285,0.7251668853768471,0.0490671535345467
13424,16.0,193,4088,4281,21,290,5932,1614,4318,5932,451,0.0325354012137559,0.6891436277815239,0.0035401213755900203,0.2720836142953473,0.7279163857046528,0.04888739042481457
13425,13.0,197,3364,3561,45,99,4694,1327,3367,4694,351,0.041968470387729016,0.7166595654026416,0.009586706433745207,0.2827013208351086,0.7172986791648913,0.021090754154239454
13426,,220,9504,9724,61,785,13182,3768,9414,13182,935,0.016689424973448642,0.7209831588529814,0.004627522379001669,0.2858443331816113,0.7141556668183887,0.05955090274616902
13427,26.0,27489,380429,407918,3534,26583,560033,153969,406064,560033,36220,0.04908460751420005,0.6792974699705195,0.006310342426249882,0.2749284417168274,0.7250715582831726,0.047466845703735314
13428,16.0,160,4179,4339,33,240,5763,1598,4165,5763,426,0.027763317716467117,0.7251431546069755,0.005726184279021343,0.27728613569321536,0.7227138643067846,0.041644976574700676
13429,14.0,31,2721,2752,7,220,3784,1050,2734,3784,328,0.008192389006342496,0.7190803382663847,0.0018498942917547568,0.2774841437632135,0.7225158562367865,0.05813953488372093
13430,14.0,277,7557,7834,19,437,10746,3036,7710,10746,878,0.025777033314721757,0.7032384142936907,0.0017680997580495068,0.2825237297599107,0.7174762702400893,0.04066629443513865
13431,16.0,388,1131,1519,5,139,2116,598,1518,2116,97,0.1833648393194707,0.5344990548204159,0.0023629489603024575,0.2826086956521739,0.717391304347826,0.06568998109640832
13432,14.0,105,4371,4476,4,261,6025,1666,4359,6025,521,0.017427385892116183,0.7254771784232366,0.0006639004149377593,0.27651452282157674,0.7234854771784233,0.0433195020746888
13433,23.0,922,23244,24166,37,997,31168,9404,21764,31168,2181,0.029581622176591375,0.7457648870636551,0.0011871149897330596,0.30171971252566737,0.6982802874743327,0.0319879363449692
13434,24.0,592,7619,8211,32,593,11387,3107,8280,11387,876,0.05198911038904013,0.6690963379292175,0.0028102221831913586,0.27285501009923596,0.727144989900764,0.05207692983226486
13435,,144,3094,3238,9,255,4502,1258,3244,4502,266,0.03198578409595735,0.6872501110617504,0.0019991115059973343,0.2794313638382941,0.7205686361617059,0.05664149266992448
13436,,600,18763,19363,12,785,25209,7508,17701,25209,2020,0.02380102344400809,0.7442976714665397,0.00047602046888016187,0.2978301400293546,0.7021698599706454,0.03113967233924392
13437,14.0,82,10974,11056,45,1003,15772,3949,11823,15772,869,0.005199086989601826,0.69579000760842,0.002853157494293685,0.2503804209992392,0.7496195790007608,0.06359371037281258
13438,17.0,1250,20658,21908,315,1344,30400,8366,22034,30400,2054,0.04111842105263158,0.6795394736842105,0.010361842105263157,0.27519736842105263,0.7248026315789474,0.04421052631578947
13439,15.0,1167,97251,98418,431,3517,131219,37934,93285,131219,12446,0.008893529138310763,0.7411350490401543,0.003284585311578354,0.28908923250443913,0.7109107674955608,0.02680252097638299
13440,16.0,119,5132,5251,2,193,6819,2054,4765,6819,521,0.01745123918463118,0.7526030209708169,0.0002932981375568265,0.30121718727086083,0.6987828127291392,0.02830327027423376
13441,14.0,552,7034,7586,15,389,10206,2908,7298,10206,773,0.05408583186360964,0.6892024299431707,0.0014697236919459142,0.28493043307858124,0.7150695669214188,0.038114834411130706
13442,33.0,2127,71422,73549,174,2508,95100,28315,66785,95100,8279,0.022365930599369085,0.7510199789695058,0.0018296529968454258,0.297739221871714,0.702260778128286,0.026372239747634068
13443,,274,6538,6812,22,363,9301,2600,6701,9301,635,0.02945919793570584,0.7029351682614773,0.0023653370605311256,0.2795398344264058,0.7204601655735943,0.039028061498763575
13444,27.0,950,22157,23107,273,1667,32030,8691,23339,32030,2117,0.02965969403684046,0.6917577271308148,0.008523259444270997,0.2713393693412426,0.7286606306587574,0.05204495785201374
13445,17.0,336,2917,3253,84,577,5193,1253,3940,5193,277,0.06470248411322935,0.5617176968996727,0.016175621028307337,0.24128634700558443,0.7587136529944155,0.1111111111111111
13446,16.0,219,6830,7049,31,633,9800,2650,7150,9800,835,0.022346938775510205,0.6969387755102041,0.003163265306122449,0.27040816326530615,0.7295918367346939,0.06459183673469387
13447,,274,5195,5469,44,319,7603,2056,5547,7603,473,0.03603840589241089,0.6832829146389583,0.005787189267394449,0.2704195712218861,0.7295804287781139,0.04195712218860976
13448,27.0,1239,38381,39620,269,1676,52507,14779,37728,52507,4249,0.023596853752832957,0.7309692041061192,0.0051231264402841524,0.28146723294036985,0.7185327670596301,0.03191955358333175
13449,23.0,1234,25820,27054,21,1041,35208,11018,24190,35208,2112,0.03504885253351511,0.733356055441945,0.0005964553510565781,0.3129402408543513,0.6870597591456488,0.029567143830947513
13450,37.0,2027,37781,39808,261,4258,54248,15155,39093,54248,3678,0.03736543282701667,0.6964496386963575,0.004811237280637074,0.2793651378852677,0.7206348621147324,0.07849137295384162
13451,,750,19901,20651,177,1501,29104,7639,21465,29104,1361,0.025769653655854867,0.6837891698735569,0.006081638262781748,0.26247251236943375,0.7375274876305662,0.051573666849917536
13452,16.0,387,5890,6277,3,257,8332,2378,5954,8332,555,0.04644743158905425,0.7069131060969756,0.0003600576092174748,0.285405664906385,0.714594335093615,0.03084493518963034
13453,24.0,95,2461,2556,7,135,3367,999,2368,3367,262,0.028215028215028214,0.7309177309177309,0.002079002079002079,0.2967032967032967,0.7032967032967034,0.04009504009504009
13454,26.0,6,3159,3165,0,184,4522,1213,3309,4522,475,0.0013268465280849183,0.6985846970367094,0.0,0.2682441397611676,0.7317558602388323,0.040689960194604156
13455,,711,22172,22883,21,966,30182,8682,21500,30182,2494,0.023557087005499966,0.7346100324696839,0.0006957789410907163,0.287654893645219,0.712345106354781,0.032005831290172954
13456,16.0,3199,46331,49530,273,3934,67655,18769,48886,67655,4848,0.04728401448525608,0.6848126524277585,0.0040351784790481115,0.2774222156529451,0.7225777843470549,0.058147956544231764
13457,,7323,98913,106236,104,3874,136246,39918,96328,136246,9503,0.05374836692453357,0.7259882858946318,0.0007633251618396137,0.29298474817609327,0.7070152518239068,0.02843386227852561
13458,15.0,23,3349,3372,9,257,4630,1172,3458,4630,375,0.004967602591792656,0.7233261339092872,0.0019438444924406047,0.2531317494600432,0.7468682505399568,0.05550755939524838
13459,25.0,1699,25485,27184,191,1296,36711,10190,26521,36711,2229,0.04628040641769497,0.6942060962654245,0.005202800250606085,0.27757347933861787,0.7224265206613821,0.03530277028683501
13460,,18997,311153,330150,3027,31439,462426,128139,334287,462426,32955,0.04108116758140762,0.6728709025876572,0.006545912210818596,0.2771016335586667,0.7228983664413333,0.06798709415128042
13461,,366,8074,8440,20,820,11702,3305,8397,11702,725,0.03127670483678004,0.6899675269184755,0.0017091095539224065,0.28243035378567766,0.7175696462143223,0.07007349171081867
13462,,253,1765,2018,8,45,2587,756,1831,2587,171,0.09779667568612292,0.682257441051411,0.0030923850019327404,0.292230382682644,0.707769617317356,0.017394665635871664
13463,15.0,235,5925,6160,12,249,8286,2324,5962,8286,641,0.028361090996862178,0.7150615496017378,0.001448225923244026,0.28047308713492636,0.7195269128650736,0.03005068790731354
13464,35.0,371,4330,4701,4,248,6152,1805,4347,6152,446,0.060305591677503254,0.7038361508452535,0.0006501950585175553,0.29340052015604684,0.7065994798439532,0.04031209362808843
13465,,7985,234505,242490,840,9975,312262,92321,219941,312262,22216,0.025571475235539386,0.7509879524245665,0.0026900487411212377,0.29565236884411167,0.7043476311558883,0.0319443288008147
13466,41.0,89,2034,2123,6,120,2890,802,2088,2890,208,0.030795847750865052,0.7038062283737024,0.0020761245674740486,0.2775086505190311,0.7224913494809688,0.04152249134948097
13467,,122,2491,2613,0,160,3548,957,2591,3548,303,0.034385569334836524,0.7020856820744081,0.0,0.26972942502818487,0.7302705749718151,0.04509582863585118
13468,26.0,130,1871,2001,28,104,3128,734,2394,3128,170,0.04156010230179028,0.5981457800511509,0.008951406649616368,0.23465473145780052,0.7653452685421995,0.03324808184143223
13469,,55364,1017836,1073200,4897,68503,1468810,411300,1057510,1468810,107132,0.03769309849469979,0.6929664149890047,0.0033339914624764266,0.280022603331949,0.719977396668051,0.04663843519583881
13470,14.0,93,2222,2315,2,123,3137,903,2234,3137,245,0.02964615875039847,0.7083200510041441,0.000637551801083838,0.28785463818935286,0.7121453618106471,0.03920943576665604
13471,23.0,476,10227,10703,29,466,13810,4060,9750,13810,1028,0.03446777697320782,0.7405503258508327,0.002099927588703838,0.2939898624185373,0.7060101375814627,0.03374366401158581
13472,25.0,1671,32977,35459,664,2710,49000,13183,35817,49000,3261,0.03410204081632653,0.673,0.013551020408163266,0.2690408163265306,0.7309591836734693,0.05530612244897959
13473,,95,5367,5462,28,44,7706,2074,5632,7706,831,0.012328056060212821,0.6964702828964443,0.003633532312483779,0.2691409291461199,0.7308590708538801,0.0057098364910459385
13474,24.0,3406,89669,93075,336,4369,121580,35726,85854,121580,8917,0.028014476065142294,0.7375308438887975,0.002763612436255963,0.2938476723145254,0.7061523276854745,0.035935186708340186
13475,13.0,302,5382,5684,417,1006,8933,2143,6790,8933,486,0.033807231613119895,0.602485167356991,0.046680846300235085,0.23989701108250308,0.760102988917497,0.11261614239337289
13476,,319,5897,6216,54,581,8557,2345,6212,8557,485,0.03727942035760196,0.6891433913754821,0.006310622881851116,0.27404464181371974,0.7259553581862802,0.06789762767324997
13477,15.0,84,2069,2153,3,94,2866,800,2066,2866,232,0.02930914166085136,0.7219120725750174,0.00104675505931612,0.2791346824842987,0.7208653175157014,0.03279832519190509
13478,,178,2495,2673,25,170,3672,1013,2659,3672,305,0.04847494553376906,0.6794662309368191,0.006808278867102397,0.2758714596949891,0.724128540305011,0.046296296296296294
13479,27.0,723,16445,17168,92,954,22545,6346,16199,22545,1369,0.03206919494344644,0.7294300288312264,0.004080727434020847,0.2814814814814815,0.7185185185185186,0.04231536926147705
13480,15.0,3,14185,14188,13,848,18645,5417,13228,18645,1233,0.00016090104585679806,0.7607937784928935,0.0006972378653794583,0.29053365513542506,0.7094663448645749,0.04548136229552159
13481,,328,8720,9048,46,394,12015,3449,8566,12015,956,0.02729920932168123,0.7257594673325011,0.0038285476487723677,0.2870578443612152,0.7129421556387848,0.032792342904702454
13482,25.0,380,9081,9461,48,440,13141,3545,9596,13141,953,0.02891712959439921,0.6910432995966821,0.0036526900540293735,0.269766380031961,0.7302336199680389,0.033482992161935926
13483,26.0,10839,225719,236558,871,10594,314333,91704,222629,314333,24332,0.03448253921796311,0.7180887784610588,0.0027709467348321685,0.291741560701549,0.708258439298451,0.033703111031931104
13484,14.0,2214,53275,55489,235,3398,74472,20728,53744,74472,5652,0.029729294231388977,0.7153695348587389,0.0031555483940272854,0.2783327962187131,0.7216672037812869,0.045627886991083895
13485,40.0,1454,31539,32993,107,1549,43788,12445,31343,43788,3121,0.0332054444139947,0.7202658262537681,0.0024435918516488536,0.28421028592308395,0.715789714076916,0.03537498858134649
13486,23.0,148,4714,4862,28,137,6426,1871,4555,6426,626,0.023031434796140678,0.733582321817616,0.004357298474945534,0.29116090880796763,0.7088390911920324,0.02131963896669779
13487,17.0,742,20716,21458,41,1131,28616,8085,20531,28616,2121,0.02592954990215264,0.723930668157674,0.0014327648867766285,0.2825342465753425,0.7174657534246576,0.03952334358400895
13488,25.0,5,2247,2252,11,125,3070,885,2185,3070,254,0.0016286644951140066,0.7319218241042346,0.0035830618892508143,0.28827361563517917,0.7117263843648208,0.04071661237785016
13489,16.0,1432,35178,36610,108,1377,47970,13630,34340,47970,4176,0.029851990827600584,0.7333333333333333,0.00225140712945591,0.28413591828225976,0.7158640817177403,0.028705440900562852
13490,,72,3169,3241,24,568,4706,1193,3513,4706,255,0.01529961750956226,0.6733956651083723,0.005099872503187421,0.25350616234594137,0.7464938376540586,0.12069698257543561
13491,15.0,23,4207,4230,13,482,5927,1607,4320,5927,421,0.003880546650919521,0.7098025982790619,0.002193352454867555,0.2711321073055509,0.7288678926944492,0.08132276024970474
13492,,110,1905,2015,7,109,2930,756,2174,2930,188,0.03754266211604096,0.6501706484641638,0.002389078498293515,0.25802047781569964,0.7419795221843003,0.03720136518771331
13493,26.0,120,2396,2516,21,221,3754,960,2794,3754,198,0.031965903036760786,0.6382525306339905,0.005594033031433138,0.2557272242940863,0.7442727757059137,0.05887053809270112
13494,14.0,193,9346,9539,24,183,12677,3596,9081,12677,1241,0.015224422181904236,0.7372406720833005,0.0018931923956772108,0.2836633272856354,0.7163366727143646,0.014435592017038732
13495,24.0,5196,90643,95839,643,6354,129983,36806,93177,129983,9526,0.03997445819837979,0.6973450374279714,0.004946800735480794,0.2831601055522645,0.7168398944477354,0.048883315510489835
13496,14.0,167,3537,3704,19,277,5116,1452,3664,5116,424,0.032642689601250975,0.6913604378420641,0.003713838936669273,0.2838154808444097,0.7161845191555903,0.054143862392494135
13497,,572,8462,9034,59,564,12852,3419,9433,12852,704,0.044506691565515094,0.6584189231248054,0.004590725178960473,0.2660286336756925,0.7339713663243075,0.04388422035480859
13498,,3422,35945,39367,101,3782,54917,15176,39741,54917,3454,0.062312216617805054,0.6545332046542964,0.001839139064406286,0.276344301400295,0.723655698599705,0.06886756377806508
13499,,75,12757,12832,28,298,19055,4952,14103,19055,1635,0.003935974809761217,0.6694830753083181,0.001469430595644188,0.25987929677250066,0.7401207032274993,0.01563893991078457
13500,,209,4843,5052,20,214,6812,1931,4881,6812,557,0.030681150910158543,0.71095126247798,0.002935995302407516,0.2834703464474457,0.7165296535525543,0.03141514973576042
13501,,2100,30290,32390,211,3230,51702,12226,39478,51704,3240,0.040615813089896334,0.5858347516633142,0.004080922172365774,0.2364613956367012,0.7635386043632988,0.06247098870493579
13502,36.0,662,15800,16462,16,952,22130,6055,16075,22130,1563,0.02991414369633981,0.7139629462268414,0.0007230004518752824,0.2736104835065522,0.7263895164934479,0.043018526886579304
13503,15.0,395,16324,16719,90,917,23127,6278,16849,23127,1792,0.01707960392614693,0.7058416569377783,0.0038915553249448697,0.2714576036667099,0.7285423963332901,0.03965062481082717
13504,23.0,678,8977,9655,102,556,13187,3753,9434,13187,813,0.05141427163115189,0.6807461894289831,0.007734890422385683,0.2845984681883673,0.7154015318116327,0.042162736027906274
13505,,219,5110,5329,57,225,7044,2003,5041,7044,512,0.031090289608177172,0.7254400908574673,0.008091993185689948,0.28435547984099946,0.7156445201590006,0.031942078364565585
13506,17.0,163,3178,3341,0,228,4526,1333,3193,4526,240,0.03601414052143173,0.7021652673442333,0.0,0.2945205479452055,0.7054794520547946,0.05037560760053027
13507,24.0,418,12681,13099,44,354,16769,4956,11813,16769,1291,0.02492694853598903,0.7562168286719542,0.0026238893195777925,0.295545351541535,0.7044546484584651,0.021110382252966783
13508,13.0,52,4116,4168,23,1069,6387,1666,4721,6387,232,0.0081415374980429,0.6444340065758573,0.003601064662595898,0.26084233599498985,0.7391576640050102,0.167371222796305
13509,,1094,22924,24018,120,958,32180,9103,23077,32180,2474,0.03399627097576134,0.7123679303915476,0.0037290242386575512,0.28287756370416406,0.7171224362958359,0.029770043505282784
13510,37.0,937,19852,20789,90,1283,27946,7837,20109,27946,1958,0.033528948686753025,0.7103699992843341,0.0032204966721534386,0.28043369355185,0.71956630644815,0.04590996922636513
13511,40.0,52,1797,1849,7,48,2395,701,1694,2395,236,0.021711899791231733,0.7503131524008351,0.0029227557411273487,0.2926931106471816,0.7073068893528184,0.020041753653444676
13512,16.0,137,2809,2946,8,217,4491,1081,3410,4491,235,0.030505455355154754,0.6254731685593409,0.0017813404586951682,0.2407036294811846,0.7592963705188154,0.04831885994210643
13513,,336,8405,8741,219,588,12214,3393,8821,12214,795,0.02750941542492222,0.6881447519240216,0.017930243982315377,0.2777959718355985,0.7222040281644015,0.04814147699361389
13514,,311,9042,9355,43,929,13104,3505,9599,13104,779,0.023733211233211232,0.690018315018315,0.0032814407814407815,0.26747557997557997,0.73252442002442,0.07089438339438339
13515,23.0,42,4790,4836,33,220,6870,1799,5071,6870,431,0.00611353711790393,0.6972343522561864,0.00480349344978166,0.261863173216885,0.738136826783115,0.03202328966521106
13516,33.0,168,4873,5041,31,148,6423,1878,4545,6423,444,0.026156001868285848,0.7586797446676008,0.004826405106647984,0.2923867351704811,0.7076132648295189,0.023042192122061343
13517,24.0,1273,35209,36482,194,3104,49469,13873,35596,49469,4002,0.025733287513392225,0.7117386646182458,0.003921647900705492,0.28043825426024377,0.7195617457397562,0.06274636641128788
13518,25.0,990,25646,26636,110,1538,36527,10327,26200,36527,2554,0.02710323870013962,0.7021107673775563,0.0030114709666821805,0.2827223697538807,0.7172776302461193,0.042105839515974484
13519,,128,15424,15552,41,255,20892,5727,15165,20892,1885,0.006126747080222095,0.7382730231667624,0.0019624736741336397,0.2741240666283745,0.7258759333716255,0.012205628948879953
13520,,6,2253,2259,3,114,2972,849,2123,2972,183,0.002018842530282638,0.7580753701211306,0.001009421265141319,0.28566621803499326,0.7143337819650067,0.03835800807537012
13521,,2875,12407,16287,478,771,22672,4043,18887,22930,542,0.12538159616223288,0.5410815525512429,0.020846053205407764,0.17631923244657655,0.8236807675534235,0.03362407326646315
13522,25.0,2443,63593,66036,915,4032,88441,24732,63709,88441,6306,0.027622935064054003,0.7190443346411732,0.010345880304383713,0.27964405648963714,0.7203559435103628,0.045589715177349874
13523,,694,11547,12241,61,875,17487,4790,12697,17487,1064,0.03968662434951679,0.6603190941842512,0.003488305598444559,0.273917767484417,0.726082232515583,0.050037170469491625
13524,15.0,555,6556,7678,61,439,10618,2635,7990,10625,596,0.05223529411764706,0.617035294117647,0.005741176470588236,0.248,0.752,0.04131764705882353
13525,15.0,766,8239,9005,53,798,13665,3414,10251,13665,916,0.05605561653860227,0.6029271862422246,0.0038785217709476766,0.24983534577387487,0.7501646542261251,0.058397365532382
13526,17.0,78,2246,2324,5,95,2948,885,2063,2948,193,0.026458616010854818,0.7618724559023067,0.0016960651289009499,0.3002035278154681,0.6997964721845319,0.032225237449118045
13527,,1861,48830,50691,214,5213,69309,19394,49915,69309,5008,0.02685076974130344,0.7045261077204981,0.0030876220981402125,0.27981935967911814,0.7201806403208818,0.07521389718506977
13528,16.0,1548,20239,21787,124,1736,29276,7856,21420,29276,1876,0.05287607596666211,0.6913171198251127,0.004235551304823063,0.2683426697636289,0.7316573302363711,0.059297718267522885
13529,36.0,46,1926,1972,4,48,2525,754,1771,2525,215,0.018217821782178217,0.7627722772277228,0.0015841584158415843,0.2986138613861386,0.7013861386138613,0.01900990099009901
13530,17.0,1630,34000,35630,115,2344,47746,13475,34271,47746,3036,0.03413898546475097,0.712101537301554,0.0024085787291081976,0.28222259456289533,0.7177774054371047,0.04909311774808361
13531,,232,3071,3303,27,235,4488,1298,3190,4488,216,0.05169340463458111,0.6842691622103387,0.006016042780748663,0.28921568627450983,0.7107843137254902,0.05236185383244207
13532,15.0,306,5625,5931,24,289,7990,2243,5747,7990,687,0.03829787234042553,0.7040050062578223,0.003003754693366708,0.2807259073842303,0.7192740926157697,0.036170212765957444
13533,17.0,576,15998,16574,61,608,21877,6347,15530,21877,1851,0.026329021346619737,0.7312702838597613,0.0027883164967774376,0.29012204598436714,0.7098779540156328,0.027791744754765278
13534,25.0,86,1763,1849,10,72,2507,707,1800,2507,172,0.03430394894295971,0.7032309533306741,0.003988831272437176,0.2820103709613083,0.7179896290386917,0.028719585161547666
13535,35.0,10907,261496,272403,1304,14692,372445,101907,270538,372445,28618,0.02928486085193787,0.7021063512733424,0.0035011880948864933,0.27361623863926215,0.7263837613607378,0.03944743519177328
13536,23.0,212,4471,4683,16,322,6450,1826,4624,6450,445,0.032868217054263564,0.6931782945736434,0.00248062015503876,0.28310077519379845,0.7168992248062015,0.04992248062015504
13537,14.0,103,2541,2644,8,178,3475,1016,2459,3475,273,0.02964028776978417,0.7312230215827338,0.002302158273381295,0.29237410071942443,0.7076258992805755,0.05122302158273381
13538,,363,6244,6607,13,241,8780,2544,6236,8780,742,0.04134396355353075,0.7111617312072893,0.001480637813211845,0.289749430523918,0.710250569476082,0.02744874715261959
13539,16.0,119,5524,5643,10,157,7470,2078,5392,7470,590,0.015930388219544848,0.7394912985274431,0.0013386880856760374,0.2781793842034806,0.7218206157965195,0.021017402945113787
13540,23.0,137,3183,3320,47,206,4584,1263,3321,4584,328,0.02988656195462478,0.694371727748691,0.01025305410122164,0.2755235602094241,0.724476439790576,0.04493891797556719
13541,35.0,392,12483,12875,63,448,16818,4923,11895,16818,1404,0.023308360090379357,0.7422404566535854,0.003745986443096682,0.2927220834819836,0.7072779165180164,0.026638125817576408
13542,,266,7097,7363,35,552,9810,2641,7169,9810,678,0.02711518858307849,0.7234454638124362,0.003567787971457696,0.2692150866462793,0.7307849133537206,0.056269113149847096
13543,16.0,102,1545,1647,6,101,2230,636,1594,2230,165,0.045739910313901344,0.6928251121076233,0.0026905829596412557,0.2852017937219731,0.7147982062780269,0.045291479820627804
13544,26.0,7059,118884,125943,3307,6695,172212,48055,124157,172212,9640,0.04099017490070379,0.690335168280956,0.0192030752793069,0.2790455949643463,0.7209544050356538,0.038876501056836925
13545,23.0,321,3904,4225,64,386,6187,1566,4625,6191,378,0.05184945889193991,0.6305927959941852,0.010337586819576805,0.25294782749151995,0.7470521725084801,0.062348570505572604
13546,33.0,222,8333,8666,4,389,11305,3330,7975,11305,827,0.01963732861565679,0.7371074745687749,0.00035382574082264487,0.29455992923485186,0.7054400707651481,0.03440955329500221
13547,,689,15537,16226,517,667,21210,6189,15026,21215,1400,0.032477020975724726,0.7323591798255951,0.024369549846806504,0.29172755126090033,0.7082724487390997,0.03144001885458402
13548,17.0,148,4470,4618,15,178,6012,1732,4280,6012,411,0.024617431803060547,0.7435129740518962,0.00249500998003992,0.2880904856952761,0.7119095143047239,0.029607451763140388
13549,15.0,329,38300,38629,105,2845,51777,14309,37468,51777,4226,0.006354172702165054,0.7397106823493057,0.002027927458137783,0.2763582285570813,0.7236417714429186,0.05494717731811422
13550,41.0,56,1601,1657,10,89,2263,653,1610,2263,184,0.024745912505523642,0.7074679628811312,0.004418912947414936,0.28855501546619533,0.7114449845338047,0.03932832523199293
13551,14.0,314,7034,7348,24,705,10324,2780,7544,10324,805,0.030414567996900427,0.681325067803177,0.002324680356450988,0.26927547462223944,0.7307245253777606,0.06828748547074777
13552,,277,11811,12088,86,1080,16623,4506,12117,16623,1306,0.016663658786019372,0.7105215665042411,0.005173554713348974,0.27107020393430786,0.7289297960656921,0.06497022198159177
13553,38.0,301,9390,9691,29,405,12758,3669,9089,12758,1111,0.023593039661388933,0.7360087788054555,0.0022730835554162095,0.2875842608559335,0.7124157391440664,0.03174478758426086
13554,16.0,96,3865,3961,10,365,5849,1509,4340,5849,335,0.016413062061890922,0.6607967173875876,0.0017096939647803042,0.2579928192853479,0.7420071807146521,0.06240382971448111
13555,27.0,126,13879,14005,74,1820,20248,5261,14987,20248,1320,0.0062228368233899645,0.6854504148557883,0.0036546819438956933,0.2598281311734492,0.7401718688265507,0.08988542078229948
13556,,1546,60675,62221,256,2699,83963,23657,60306,83963,6647,0.018412872336624465,0.7226397341686219,0.0030489620428045686,0.28175505877588936,0.7182449412241106,0.03214511153722473
13557,,1464,27310,28774,14,1113,38357,11439,26918,38357,2964,0.03816773991709466,0.7119952029616498,0.00036499204838751726,0.2982245743932007,0.7017754256067993,0.029016867846807622
13558,16.0,91,3055,3146,0,123,4209,1209,3000,4209,379,0.021620337372297457,0.7258256117842719,0.0,0.2872416250890948,0.7127583749109052,0.029223093371347115
13559,24.0,24570,567251,591821,3007,28410,780836,224852,555984,780836,55572,0.0314662746082404,0.7264662489946673,0.0038510007223027626,0.2879631574363887,0.7120368425636113,0.03638408065201912
13560,,193,10749,10942,157,638,16402,4022,12380,16402,1222,0.011766857700280454,0.6553469089135471,0.009572003414217779,0.24521399829289112,0.7547860017071089,0.03889769540299964
13561,,688,22183,22871,29,1198,30016,8767,21249,30016,2216,0.022921108742004266,0.7390391791044776,0.0009661513859275053,0.2920775586353945,0.7079224413646056,0.03991204690831557
13562,,392,11055,11447,23,505,14924,4463,10461,14924,1254,0.02626641651031895,0.7407531492897347,0.001541141785044224,0.2990485124631466,0.7009514875368534,0.03383811310640579
13563,24.0,3800,137018,140818,1308,7459,186828,52708,134120,186828,13778,0.020339563662834265,0.7333911405142698,0.007001091913417689,0.282120453037018,0.717879546962982,0.03992442246344231
13564,27.0,27218,498821,526039,3186,33359,714165,200110,514055,714165,49325,0.038111640867306576,0.6984674409975286,0.0044611539350150175,0.2802013540288309,0.7197986459711692,0.04671049407349842
13565,37.0,126,2784,2910,16,113,3829,1081,2748,3829,255,0.03290676416819013,0.7270827892400105,0.004178636719770175,0.28231914337947245,0.7176808566205276,0.029511621833376862
13566,16.0,139,14520,14659,77,2573,21040,5496,15544,21040,1066,0.006606463878326996,0.6901140684410646,0.0036596958174904943,0.2612167300380228,0.7387832699619772,0.12229087452471483
13567,15.0,216,4693,4909,17,212,6714,1850,4864,6714,494,0.032171581769437,0.6989871909442955,0.002532022639261245,0.2755436401549002,0.7244563598450998,0.031575811736669644
13568,,284,6678,6962,0,353,9222,2638,6584,9222,772,0.030795922793320323,0.7241379310344828,0.0,0.2860550856647148,0.7139449143352852,0.03827803079592279
13569,17.0,1123,13421,14544,674,1194,20636,5658,14978,20636,1240,0.054419461135879046,0.6503682884279899,0.032661368482264,0.27418104283775924,0.7258189571622408,0.05786005039736383
13570,33.0,511,15529,16040,43,577,20731,6133,14598,20731,1543,0.0246490762626019,0.7490714389079157,0.0020741884134870482,0.29583715209107136,0.7041628479089287,0.02783271429260528
13571,,4488,91817,96305,3748,9073,141843,37712,104161,141873,7977,0.03163392611702015,0.6471774051440373,0.026417993557618435,0.2658152009191319,0.7341847990808681,0.06395156231277269
13572,13.0,2670,17460,20130,74,1991,29669,7765,21904,29669,1730,0.0899929219050187,0.5884930398732684,0.0024941858505510804,0.2617209882368802,0.7382790117631197,0.06710708146550272
13573,,67,2482,2549,32,479,4059,916,3143,4059,223,0.016506528701650654,0.6114806602611481,0.007883715200788372,0.22567134762256713,0.7743286523774329,0.11800936191180093
13574,,118,3703,3821,9,186,5137,1436,3701,5137,396,0.022970605411718904,0.7208487444033482,0.0017519953280124587,0.2795405878917656,0.7204594121082344,0.036207903445590814
13575,26.0,224,3133,4122,47,305,5604,1275,4329,5604,238,0.03997144896502498,0.5590649536045682,0.008386866523911492,0.22751605995717344,0.7724839400428265,0.054425410421127765
13576,33.0,336,9096,9432,72,443,13104,3559,9545,13104,955,0.02564102564102564,0.6941391941391941,0.005494505494505495,0.2715964590964591,0.7284035409035409,0.033806471306471304
13577,15.0,2371,32985,35356,937,2245,48792,13325,35467,48792,2772,0.0485940318084932,0.6760329562223315,0.019203967863584193,0.27309804886046896,0.726901951139531,0.046011641252664374
13578,14.0,2156,53097,55253,108,2463,75155,21106,54049,75155,6638,0.028687379415873862,0.7064999002062404,0.0014370301377153883,0.2808329452464906,0.7191670547535094,0.032772270640675935
13579,14.0,71,1461,1532,3,38,2048,597,1451,2048,157,0.03466796875,0.71337890625,0.00146484375,0.29150390625,0.70849609375,0.0185546875
13580,33.0,465,9361,9826,15,419,12891,3821,9070,12891,954,0.036071677914824296,0.7261655418509038,0.0011636025133814289,0.296408346908696,0.703591653091304,0.03250329687378791
13581,16.0,38071,672769,710840,2562,57276,1012134,272375,739759,1012134,66008,0.03761458463009839,0.6647034878780873,0.002531285383160728,0.26910962382451337,0.7308903761754867,0.056589344889115475
13582,,248,10755,11003,0,420,14320,4246,10074,14320,1229,0.017318435754189943,0.7510474860335196,0.0,0.29650837988826817,0.7034916201117318,0.029329608938547486
13583,,172,6522,6694,18,403,8923,2559,6364,8923,734,0.01927602824162277,0.7309200941387426,0.0020172587694721506,0.28678695505995744,0.7132130449400426,0.045164182449848704
13584,17.0,41,2242,2283,0,118,3064,901,2163,3064,284,0.013381201044386422,0.7317232375979112,0.0,0.29406005221932113,0.7059399477806788,0.038511749347258484
13585,,275,11388,11663,2,761,15419,4515,10904,15419,1224,0.017835138465529542,0.7385692976198197,0.00012971009793112393,0.2928205460795123,0.7071794539204878,0.04935469226279266
13586,24.0,1285,17982,19267,742,1430,29001,7338,21663,29001,1531,0.044308816937346986,0.6200475845660495,0.025585324643977794,0.253025757732492,0.746974242267508,0.049308644529498985
13587,,610,14258,14868,27,942,20137,5676,14461,20137,1458,0.030292496399662312,0.708049858469484,0.0013408154144112826,0.28186919600734966,0.7181308039926504,0.04677956001390475
13588,16.0,214,8591,8805,28,482,11985,3385,8600,11985,1187,0.017855652899457654,0.7168126825198164,0.0023362536503963287,0.28243637880684186,0.7175636211931581,0.04021693783896537
13589,15.0,348,5300,5648,58,256,7736,2143,5593,7736,503,0.04498448810754912,0.6851085832471562,0.00749741468459152,0.27701654601861425,0.7229834539813857,0.033092037228541885
13590,13.0,511,4415,4926,55,426,6971,1876,5095,6971,422,0.07330368670205135,0.6333381150480563,0.007889829292784393,0.26911490460479126,0.7308850953952087,0.061110314158657295
13591,17.0,372,7431,7803,40,530,10441,2921,7520,10441,776,0.035628771190498995,0.7117134374102098,0.0038310506656450533,0.27976247485873,0.72023752514127,0.050761421319796954
13592,16.0,1946,53105,55051,222,2034,73095,21070,52025,73095,6354,0.026622888022436557,0.7265202818250223,0.003037143443463985,0.2882550106026404,0.7117449893973596,0.02782680073876462
13593,26.0,158,11600,11758,49,442,15560,4469,11091,15560,1347,0.010154241645244215,0.7455012853470437,0.003149100257069409,0.2872107969151671,0.712789203084833,0.028406169665809767
13594,,199,4582,4781,0,235,6243,1845,4398,6243,398,0.031875700784879064,0.7339420150568637,0.0,0.2955309947140798,0.7044690052859203,0.03764215921832453
13595,26.0,2064,25873,27937,276,1230,37149,10546,26603,37149,2175,0.055560041993055,0.6964655845379418,0.007429540499071308,0.2838838192145145,0.7161161807854854,0.03310990874586126
13596,27.0,915,6775,7898,327,688,15055,2601,12571,15172,433,0.06030846295808068,0.4465462694437121,0.02155286053255998,0.1714342209332982,0.8285657790667018,0.04534669127339837
13597,,130,3231,3361,25,162,4628,1264,3364,4628,371,0.028089887640449437,0.6981417458945549,0.0054019014693171994,0.2731201382886776,0.7268798617113224,0.035004321521175455
13598,15.0,665,5126,5791,16,432,7993,2187,5806,7993,459,0.08319779807331415,0.6413111472538471,0.0020017515325910173,0.27361441261103464,0.7263855873889653,0.054047291379957466
13599,24.0,250,3032,3282,11,223,4644,1163,3481,4644,218,0.053832902670111975,0.652885443583118,0.0023686477174849267,0.25043066322136087,0.7495693367786391,0.04801894918173988
13600,16.0,816,23245,24061,39,1329,32196,9065,23131,32196,2354,0.0253447633246366,0.7219840974034042,0.0012113306000745435,0.28155671511989067,0.7184432848801093,0.04127841967946329
13601,,229,3087,3316,34,278,4760,1290,3470,4760,290,0.048109243697478994,0.6485294117647059,0.007142857142857143,0.2710084033613445,0.7289915966386554,0.058403361344537816
13602,,27,2052,2079,1,104,2741,814,1927,2741,250,0.009850419554906968,0.7486318861729296,0.00036483035388544326,0.2969719080627508,0.7030280919372491,0.0379423568040861
13603,14.0,105,5749,5854,35,283,8217,2090,6128,8218,414,0.012776831345826235,0.6995619372110002,0.004258943781942078,0.2543197858359698,0.7456802141640302,0.03443660257970309
13604,,121,3857,3978,4,194,5166,1533,3633,5166,296,0.023422377080913666,0.7466124661246613,0.0007742934572202865,0.2967479674796748,0.7032520325203252,0.037553232675183894
13605,26.0,472,7436,7908,46,586,10982,3040,7942,10982,723,0.042979420870515386,0.6771079949007467,0.004188672372973957,0.2768166089965398,0.7231833910034602,0.05336004370788563
13606,15.0,1713,14409,16122,39,1112,21549,6162,15387,21549,1380,0.07949324794654045,0.6686621188918279,0.0018098287623555618,0.2859529444521788,0.7140470555478212,0.05160332265998422
13607,,58,1912,1970,12,85,2621,734,1887,2621,189,0.022128958412819536,0.7294925600915682,0.004578405188859214,0.28004578405188857,0.7199542159481114,0.03243037008775276
13608,,187,2725,2912,4,176,4204,1155,3049,4204,239,0.0444814462416746,0.6481921979067554,0.0009514747859181732,0.2747383444338725,0.7252616555661275,0.04186489058039962
13609,24.0,2849,56729,59578,470,3391,79572,22675,56897,79572,6065,0.035804051676469106,0.7129266576182577,0.005906600311667421,0.2849620469511889,0.7150379530488111,0.042615492886945154
13610,15.0,2623,46193,48816,170,3742,65924,18566,47358,65924,4169,0.0397882410047934,0.7007008069898671,0.002578727018991566,0.28162732843880833,0.7183726715611917,0.056762332382743766
13611,27.0,186,5934,6120,5,350,8138,2313,5825,8138,693,0.022855738510690587,0.7291717866797739,0.0006144015728680265,0.2842221676087491,0.7157778323912509,0.04300811010076186
13612,25.0,3886,75666,79552,430,3591,106039,30314,75726,106040,7995,0.036646548472274616,0.7135609204073934,0.004055073557148246,0.28587325537533004,0.71412674462467,0.03386457940399849
13613,,86,4480,4566,52,622,6434,1629,4805,6434,239,0.01336649051911719,0.6963009014609886,0.008082064034815045,0.2531861983214175,0.7468138016785826,0.09667391980105688
13614,17.0,2047,5247,7294,98,731,10229,2783,7446,10229,469,0.20011731352038323,0.5129533678756477,0.009580604164629974,0.27206960602209407,0.7279303939779059,0.07146348616678072
13615,35.0,106,2983,3089,14,134,4049,1183,2866,4049,302,0.026179303531736232,0.7367251173129168,0.003457643862682144,0.2921709063966412,0.7078290936033589,0.03309459125710052
13616,,219,2130,2349,35,99,3252,916,2336,3252,196,0.06734317343173432,0.6549815498154982,0.01076260762607626,0.2816728167281673,0.7183271832718328,0.03044280442804428
13617,13.0,141,1811,1952,12,127,2666,733,1933,2666,165,0.05288822205551388,0.6792948237059265,0.00450112528132033,0.27494373593398347,0.7250562640660165,0.047636909227306824
13618,,133,3468,3601,20,147,4754,1353,3401,4754,334,0.027976440891880523,0.7294909549852756,0.004206983592763988,0.2846024400504838,0.7153975599495161,0.030921329406815315
13619,23.0,1208,31268,32476,264,1961,43776,12443,31333,43776,2847,0.027595029239766082,0.7142726608187134,0.006030701754385965,0.2842425073099415,0.7157574926900585,0.04479623538011696
13620,17.0,151,3842,3993,25,235,5343,1500,3843,5343,428,0.02826127643645892,0.7190716825753322,0.004679019277559424,0.2807411566535654,0.7192588433464346,0.04398278120905858
13621,33.0,2265,69815,72080,593,3160,97114,27483,69631,97114,8215,0.023323104804662563,0.7188973783388595,0.006106225672920485,0.28299730213975327,0.7170026978602467,0.03253907778487139
13622,15.0,91,2006,2097,35,117,2795,800,1995,2795,232,0.03255813953488372,0.7177101967799642,0.012522361359570662,0.28622540250447226,0.7137745974955277,0.04186046511627907
13623,16.0,257,9595,9852,23,608,13601,3730,9871,13601,1093,0.018895669436070878,0.7054628336151754,0.0016910521285199618,0.2742445408425851,0.7257554591574149,0.04470259539739725
13624,,1346,30083,31429,117,1638,41554,11837,29717,41554,2727,0.032391586850844686,0.7239495596091833,0.002815613418684122,0.2848582567261876,0.7151417432738124,0.0394185878615777
13625,,24,3522,3546,21,424,5034,1342,3692,5034,348,0.004767580452920143,0.699642431466031,0.004171632896305125,0.2665872069924513,0.7334127930075487,0.08422725466825585
13626,16.0,159,4208,4367,2,208,5818,1637,4181,5818,437,0.027328979030594707,0.723272602268821,0.00034376074252320387,0.28136816775524237,0.7186318322447577,0.0357511172224132
13627,15.0,20,3967,3987,0,440,5563,1509,4054,5563,478,0.003595182455509617,0.7131044400503326,0.0,0.27125651626820063,0.7287434837317994,0.07909401402121158
13628,,372,12686,13058,56,577,17133,4959,12174,17133,1295,0.021712484678690247,0.7404424210587754,0.003268546080663048,0.2894414288215724,0.7105585711784276,0.0336776980096889
13629,41.0,675,20456,21131,53,761,27918,8108,19810,27918,2094,0.024177949709864602,0.7327172433555412,0.0018984167920338133,0.29042194999641807,0.7095780500035819,0.02725839959882513
13630,,272,4246,4518,24,244,6314,1739,4575,6314,433,0.04307887234716503,0.6724738675958188,0.003801076971808679,0.27541970224897055,0.7245802977510295,0.03864428254672157
13631,15.0,75,6572,6647,22,362,8825,2534,6291,8825,776,0.0084985835694051,0.7447025495750709,0.0024929178470254956,0.2871388101983003,0.7128611898016998,0.04101983002832861
13632,,1705,46837,48542,35,2811,63951,18682,45269,63951,4904,0.026661037356726244,0.7323888602211068,0.0005472940219855827,0.2921299119638473,0.7078700880361527,0.04395552845147066
13633,,426,9535,9961,22,646,13357,3842,9515,13357,995,0.031893389234109455,0.7138579022235532,0.0016470764393202067,0.28763943999401065,0.7123605600059894,0.04836415362731152
13634,33.0,611,11982,12593,162,724,16925,4830,12095,16925,1131,0.03610044313146234,0.7079468242245199,0.009571639586410635,0.28537666174298376,0.7146233382570163,0.04277695716395864
13635,27.0,136,2314,2450,14,204,3759,895,2864,3759,183,0.036179835062516624,0.6155892524607608,0.0037243947858473,0.23809523809523808,0.7619047619047619,0.05426975259377494
13636,23.0,331,8887,9218,25,452,12266,3533,8733,12266,914,0.026985162237078104,0.7245230719060819,0.002038154247513452,0.288031958258601,0.7119680417413989,0.036849828795043206
13637,,1135,30500,31635,97,1937,42359,11996,30363,42359,2935,0.02679477796926273,0.7200358837555183,0.0022899501876814843,0.28319837578790813,0.7168016242120919,0.04572818055194882
13638,,77,2009,2086,12,111,2832,781,2051,2832,236,0.027189265536723163,0.7093926553672316,0.00423728813559322,0.2757768361581921,0.724223163841808,0.03919491525423729
13639,25.0,3057,40953,44010,151,2322,58838,17002,41836,58838,4423,0.051956218770182534,0.6960297766749379,0.0025663686733063667,0.28896291512287975,0.7110370848771203,0.03946429178422108
13640,23.0,3517,74647,78164,630,3382,102710,29645,73065,102710,7318,0.034242040697108365,0.7267744133969428,0.006133774705481453,0.2886281764190439,0.7113718235809561,0.032927660403076625
13641,17.0,579,16447,17026,23,991,22829,6477,16352,22829,1797,0.025362477550484035,0.7204432958079635,0.0010074904726444435,0.2837180778833939,0.716281922116606,0.043409698190897544
13642,,311,8625,8936,100,348,11761,3435,8326,11761,921,0.026443329648839383,0.7333560071422498,0.008502678343678259,0.29206700110534817,0.7079329988946518,0.02958932063600034
13643,,173,4231,4404,7,293,6012,1663,4349,6012,428,0.028775781769793746,0.7037591483699268,0.001164337990685296,0.27661343978709246,0.7233865602129075,0.048735861610113104
13644,15.0,110,3941,4051,8,254,5473,1519,3954,5473,470,0.020098666179426274,0.7200803946647177,0.0014617211766855473,0.2775443084231683,0.7224556915768318,0.046409647359766125
13645,26.0,420,10823,11243,49,710,14933,4256,10677,14933,1066,0.028125627804192057,0.7247706422018348,0.0032813232438224068,0.2850063617491462,0.7149936382508538,0.04754570414518181
13646,14.0,876,14625,15501,121,1018,22227,5545,16682,22227,1373,0.039411526521797816,0.6579835335402888,0.005443829576641022,0.24947136365681377,0.7505286363431862,0.04580015296711207
13647,26.0,270,6771,7041,6,586,9630,2642,6988,9630,662,0.028037383177570093,0.7031152647975077,0.0006230529595015577,0.2743509865005192,0.7256490134994807,0.060851505711318796
13648,27.0,2134,76370,78504,98,2681,101591,29531,72060,101591,7463,0.021005797757675384,0.7517398194721974,0.0009646523806242679,0.2906851984919924,0.7093148015080076,0.02639013298422104
13649,,137,3374,3511,5,173,4602,1346,3256,4602,299,0.0297696653628857,0.7331594958713603,0.0010864841373315949,0.29248152976966535,0.7075184702303347,0.037592351151673184
13650,,645,12224,12869,127,873,17425,4806,12619,17425,1187,0.03701578192252511,0.7015208034433286,0.007288378766140602,0.2758106169296987,0.7241893830703013,0.05010043041606887
13651,,2678,59084,61762,297,3891,83672,24274,59398,83672,5347,0.03200592790897791,0.7061382541351946,0.003549574529113682,0.29010899703604554,0.7098910029639545,0.04650301176020652
13652,24.0,531,13532,14063,56,529,18448,5381,13067,18448,1607,0.028783607979184736,0.7335212489158717,0.003035559410234172,0.29168473547268,0.7083152645273201,0.028675195143104945
13653,26.0,606,10900,11506,63,836,16348,4463,11885,16348,943,0.037068754587717155,0.6667482260827012,0.0038536824076339615,0.2729997553217519,0.7270002446782481,0.05113775385368241
13654,16.0,13899,263715,277614,1772,20732,378126,104297,273829,378126,28194,0.03675758874026118,0.6974262547404834,0.004686268598297922,0.2758260474021887,0.7241739525978114,0.054828284751643634
13655,,398,5796,6194,0,208,8890,2363,6527,8890,605,0.044769403824521936,0.6519685039370079,0.0,0.26580427446569177,0.7341957255343082,0.023397075365579303
13656,,317,4075,4392,54,159,6013,1633,4380,6013,261,0.052719108598037585,0.6776983203060036,0.008980542158656245,0.2715782471312157,0.7284217528687843,0.0264427074671545
13657,,74,4292,4366,26,287,5797,1643,4154,5797,414,0.01276522339140935,0.7403829567017423,0.004485078488873555,0.28342245989304815,0.7165775401069518,0.049508366396411936
13658,,343,3111,3454,47,262,4749,1324,3425,4749,377,0.07222573173299641,0.655085281111813,0.009896820383238577,0.2787955359022952,0.7212044640977048,0.05516950937039377
13659,24.0,248,7477,7725,9,399,10306,2848,7458,10306,745,0.02406365224141277,0.7254997089074325,0.0008732777023093344,0.27634387735299826,0.7236561226470017,0.03871531146904716
13660,15.0,2,1726,1728,0,36,2318,669,1649,2318,269,0.0008628127696289905,0.7446074201898188,0.0,0.2886108714408973,0.7113891285591026,0.015530629853321829
13661,25.0,6,2577,2583,4,215,3489,943,2546,3489,246,0.0017196904557179708,0.7386070507308684,0.0011464603038119805,0.2702780166236744,0.7297219833763255,0.061622241329893954
13662,27.0,12,3801,3813,27,187,5028,1397,3631,5028,441,0.002386634844868735,0.7559665871121718,0.0053699284009546535,0.27784407319013527,0.7221559268098647,0.03719172633253779
13663,,406,8811,9217,20,520,12391,3588,8803,12391,928,0.03276571705269954,0.7110806230328465,0.001614074731660076,0.2895650068598176,0.7104349931401824,0.04196594302316197
13664,24.0,6226,35738,41964,156,3235,58049,14966,43083,58049,3578,0.10725421626556875,0.6156522937518304,0.002687384795603714,0.2578166721218281,0.7421833278781719,0.055728780857551376
13665,16.0,3725,70999,74724,174,3412,99254,28395,70859,99254,7543,0.03752997360307897,0.7153263344550346,0.0017530779615934874,0.2860841880427993,0.7139158119572007,0.03437644830435045
13666,24.0,275,5701,5976,18,323,8056,2285,5776,8061,576,0.0341148740851011,0.7072323533060414,0.002232973576479345,0.28346359012529465,0.7165364098747053,0.040069470289046026
13667,,641,25121,25762,179,3915,37350,9306,28044,37350,1975,0.0171619812583668,0.6725836680053547,0.004792503346720214,0.2491566265060241,0.7508433734939759,0.10481927710843374
13668,24.0,6369,169708,176077,941,7328,226246,66695,159551,226246,15598,0.028150773936334784,0.7501038692396772,0.004159189554732459,0.29478974213908754,0.7052102578609124,0.032389522908692306
13669,23.0,435,9323,9758,33,508,13141,3746,9395,13141,891,0.0331025036146412,0.7094589452857469,0.0025112244121451945,0.28506201963320904,0.714937980366791,0.038657636405144205
13670,17.0,2624,32711,35335,108,2214,48481,13575,34906,48481,3646,0.05412429611600421,0.6747179307357521,0.002227676821847734,0.28000660052391657,0.7199933994760834,0.04566737484787855
13671,25.0,311,12781,13092,4,495,16936,4933,12003,16936,1365,0.01836324988190836,0.754664619744922,0.00023618327822390176,0.29127302786962683,0.7087269721303732,0.02922768068020784
13672,15.0,2270,52586,54857,73,6631,76177,21837,54340,76177,4449,0.029799020701786628,0.6903133491736351,0.0009582944983393938,0.28666132822242935,0.7133386717775707,0.0870472714861441
13673,15.0,283,5802,6085,17,360,8112,2344,5768,8112,576,0.034886587771203154,0.7152366863905325,0.002095660749506903,0.28895463510848124,0.7110453648915187,0.04437869822485207
13674,,108,4061,4169,5,282,5579,1622,3957,5579,449,0.019358307940491128,0.7279082272808747,0.0008962179602079225,0.2907331062914501,0.7092668937085499,0.050546692955726835
13675,17.0,4173,87373,91546,478,6298,131400,34706,96694,131400,8600,0.03175799086757991,0.6649391171993911,0.0036377473363774734,0.2641248097412481,0.7358751902587519,0.04792998477929985
13676,26.0,70,5663,5733,10,415,7609,2110,5499,7609,594,0.00919963201471941,0.7442502299908004,0.001314233144959916,0.27730319358654226,0.7226968064134578,0.05454067551583651
13677,17.0,48,1719,1767,22,176,2977,668,2309,2977,181,0.016123614376889486,0.5774269398723547,0.007389989922741014,0.22438696674504535,0.7756130332549547,0.059119919381928114
13678,,171,4949,5120,10,279,6850,1870,4980,6850,450,0.024963503649635038,0.7224817518248176,0.00145985401459854,0.272992700729927,0.727007299270073,0.04072992700729927
13679,14.0,2110,37243,39353,138,2388,52914,15024,37890,52914,3766,0.03987602524851646,0.7038401935215632,0.0026080054427939678,0.2839324186415693,0.7160675813584306,0.04512983331443474
13680,,303,6569,6875,58,359,9028,2619,6409,9028,596,0.03356225077536553,0.7276251661497564,0.006424457244129375,0.29009747452370405,0.709902525476296,0.03976517501107665
13681,,449,5791,6240,34,298,8576,2290,6286,8576,545,0.052355410447761194,0.6752565298507462,0.00396455223880597,0.2670242537313433,0.7329757462686567,0.03474813432835821
13682,26.0,1883,30807,32690,168,2202,45707,12293,33414,45707,2869,0.041197190802284116,0.6740105454306781,0.003675585796486315,0.26895223926313255,0.7310477607368674,0.04817642811823134
13683,27.0,780,15423,16203,54,934,21767,6162,15605,21767,1551,0.035834060734138834,0.7085496393623375,0.0024808195892865345,0.2830890797996968,0.7169109202003032,0.04290899067395599
13684,16.0,661,17294,17995,86,2320,26148,6897,19252,26149,1716,0.02527821331599679,0.6613637232781369,0.0032888446976939846,0.2637576962790164,0.7362423037209836,0.0887223220773261
13685,16.0,695,9761,10456,44,739,14029,3941,10088,14029,1061,0.04954023807826645,0.6957730415567752,0.0031363603963219045,0.28091809822510516,0.7190819017748948,0.05267659847458835
13686,39.0,424,11195,11619,95,491,15298,4429,10871,15300,1206,0.027712418300653595,0.7316993464052287,0.006209150326797385,0.28947712418300653,0.7105228758169935,0.03209150326797386
13687,17.0,11582,186230,198238,2541,12381,269627,75994,193673,269667,17138,0.0429492670590024,0.6905924714555359,0.009422732481171222,0.28180682100516563,0.7181931789948344,0.045912180578268756
13688,25.0,819,25388,26207,75,919,34143,10031,24112,34143,2897,0.023987347333274758,0.7435784787511349,0.0021966435286881643,0.2937937498169464,0.7062062501830536,0.026916205371525642
13689,23.0,250,7035,7285,19,282,9625,2803,6822,9625,758,0.025974025974025976,0.730909090909091,0.001974025974025974,0.2912207792207792,0.7087792207792207,0.0292987012987013
13690,25.0,295,8235,8530,37,372,11125,3284,7841,11125,872,0.02651685393258427,0.7402247191011236,0.0033258426966292134,0.29519101123595504,0.704808988764045,0.03343820224719101
13691,,26849,396691,423540,3746,24642,563845,159594,404251,563845,35356,0.04761769635272105,0.703546187338719,0.006643669802871357,0.283045872535892,0.716954127464108,0.04370350007537532
13692,23.0,410,15237,15647,117,416,19665,5872,13793,19665,1253,0.020849224510551743,0.7748283752860412,0.005949656750572082,0.2986015764047801,0.70139842359522,0.02115433511314518
13693,16.0,261,9937,10198,65,412,13612,3812,9800,13612,991,0.01917425800764032,0.7300176315016162,0.004775198354393183,0.28004701733764326,0.7199529826623567,0.030267411107846018
13694,40.0,913,22989,23902,280,1166,31869,9226,22643,31869,2103,0.02864852991935737,0.7213593146945307,0.00878596755467696,0.2894976309266058,0.7105023690733943,0.03658727917411905
13695,,225,7832,8057,7,604,10842,3043,7799,10842,893,0.02075262866629773,0.7223759453975281,0.0006456373362848183,0.2806677734735289,0.7193322265264711,0.05570927873086146
13696,14.0,4217,74787,79004,202,6552,110463,30647,79816,110463,7210,0.038175678734055744,0.6770321284049863,0.0018286666123498367,0.2774413151915121,0.722558684808488,0.05931397843621846
13697,24.0,2089,39239,41328,330,1856,57462,15498,41964,57462,3469,0.03635446033900665,0.6828686784309631,0.005742925759632453,0.26970867703873863,0.7302913229612613,0.032299606696599495
13698,,307,3243,3550,14,236,4864,1404,3460,4864,320,0.06311677631578948,0.666735197368421,0.0028782894736842104,0.2886513157894737,0.7113486842105263,0.04851973684210526
13699,,203,3719,3922,25,241,5401,1524,3877,5401,447,0.037585632290316605,0.6885761895945195,0.00462877244954638,0.28216996852434734,0.7178300314756526,0.04462136641362711
13700,40.0,99,2584,2683,1,76,3516,1051,2465,3516,283,0.028156996587030716,0.7349260523321957,0.0002844141069397042,0.2989192263936291,0.7010807736063709,0.02161547212741752
13701,33.0,1289,30746,32035,127,1456,42489,12219,30270,42489,2905,0.030337263762385557,0.7236225846689731,0.002989008919955753,0.2875803149050342,0.7124196850949658,0.03426769281461084
13702,43.0,0,2341,2341,0,74,3078,848,2230,3078,236,0.0,0.7605588044184536,0.0,0.27550357374918777,0.7244964262508122,0.024041585445094216
13703,,2432,48832,51264,197,3450,70418,19533,50885,70418,4855,0.03453662415859581,0.6934590587633843,0.002797580164162572,0.27738646368826153,0.7226135363117385,0.04899315515919225
13704,26.0,126,4249,4375,40,310,5876,1668,4208,5876,389,0.021443158611300205,0.7231109598366235,0.0068073519400953025,0.2838665759019741,0.7161334240980258,0.052756977535738596
13705,26.0,528,22888,23416,64,911,31326,8889,22437,31326,2541,0.0168550086190385,0.7306390857434719,0.002043031347762242,0.2837579007852902,0.7162420992147098,0.029081274340803168
13706,,1268,36286,37554,202,1713,49552,14040,35512,49552,3524,0.0255892799483371,0.7322812399095899,0.004076525670003229,0.28333871488537293,0.716661285114627,0.03456974491443332
13707,16.0,126,2619,2745,6,208,3773,1025,2748,3773,234,0.03339517625231911,0.6941425921017758,0.0015902464882056719,0.2716671084018023,0.7283328915981977,0.05512854492446329
13708,,6005,115513,121518,416,5924,163318,46038,117280,163318,12166,0.036768757883393136,0.7072888475244615,0.002547177898333313,0.28189176943141603,0.718108230568584,0.03627279295607343
13709,15.0,452,20425,20877,55,1062,28703,7943,20760,28703,2575,0.015747482841514823,0.7115980907919033,0.0019161760094763614,0.27673065533219526,0.7232693446678048,0.036999616764798106
13710,33.0,297,11693,11990,55,537,15980,4517,11463,15980,1449,0.01858573216520651,0.7317271589486859,0.00344180225281602,0.28266583229036296,0.7173341677096371,0.03360450563204005
13711,,162,4745,4907,29,280,6588,1865,4723,6588,449,0.02459016393442623,0.7202489374620522,0.0044019429265330905,0.28309046751669703,0.716909532483303,0.042501517911353974
13712,36.0,158,2801,2959,19,269,4371,1119,3252,4371,290,0.03614733470601693,0.6408144589338824,0.004346831388698238,0.2560054907343857,0.7439945092656143,0.06154198123999085
13713,,152,4859,5011,16,225,6610,1926,4684,6610,489,0.022995461422087745,0.7350983358547655,0.002420574886535552,0.2913767019667171,0.708623298033283,0.0340393343419062
13714,17.0,152,2335,2487,3,191,3430,888,2542,3430,244,0.044314868804664724,0.6807580174927114,0.0008746355685131195,0.2588921282798834,0.7411078717201166,0.055685131195335275
13715,,70,2693,2763,164,433,3955,909,3046,3955,125,0.017699115044247787,0.6809102402022756,0.04146649810366625,0.22983565107458911,0.7701643489254109,0.10948166877370417
13716,15.0,113,2507,2620,7,113,3464,956,2508,3464,265,0.03262124711316397,0.723729792147806,0.0020207852193995382,0.2759815242494226,0.7240184757505773,0.03262124711316397
13717,,2730,73870,76600,633,3475,100878,29024,71854,100878,6642,0.0270623921965146,0.7322706635738219,0.006274906322488551,0.28771387220206585,0.7122861277979341,0.03444755050655247
13718,27.0,73,2467,2540,4,233,3397,908,2489,3397,234,0.021489549602590523,0.7262290256108331,0.0011775095672652341,0.2672946717692081,0.7327053282307919,0.06858993229319989
13719,26.0,25734,592014,617748,2795,34810,846038,236434,609604,846038,66150,0.03041707346478527,0.6997487110508038,0.0033036341157252984,0.27946026065023083,0.7205397393497691,0.041144723995848884
13720,,1484,19225,20709,94,1539,29079,8006,21073,29079,1812,0.05103339179476598,0.661130025104027,0.0032325733347088963,0.2753189586987173,0.7246810413012827,0.052924791086350974
13721,16.0,2547,50722,53269,869,7858,78549,20374,58175,78549,3922,0.03242561967688958,0.6457370558504882,0.011063158028746387,0.25937949560147167,0.7406205043985283,0.10003946581114972
13722,40.0,109,2009,2118,5,83,2711,826,1885,2711,180,0.04020656584286241,0.7410549612689045,0.0018443378827001106,0.3046846182220583,0.6953153817779417,0.030616008852821838
13723,,22,2287,2309,7,134,3144,822,2322,3144,269,0.006997455470737914,0.7274173027989822,0.0022264631043256997,0.26145038167938933,0.7385496183206107,0.04262086513994911
13724,,1459,35306,36765,173,2174,49800,13565,36235,49800,3215,0.02929718875502008,0.7089558232931726,0.0034738955823293174,0.2723895582329317,0.7276104417670682,0.04365461847389558
13725,,65,2846,2911,5,264,4015,1011,3004,4015,313,0.0161892901618929,0.7088418430884185,0.0012453300124533001,0.25180572851805727,0.7481942714819427,0.06575342465753424
13726,,1014,27915,28929,86,1383,38099,10826,27273,38099,2694,0.026614871781411586,0.7326963962308722,0.0022572770938869787,0.2841544397490748,0.7158455602509253,0.03630016535867083
13727,35.0,59,1732,1791,0,99,2429,727,1702,2429,185,0.02428983120625772,0.7130506381226842,0.0,0.2993001235076163,0.7006998764923837,0.04075751337999177
13728,,4191,99896,104087,175,6021,137914,39398,98516,137914,9662,0.030388502980118044,0.7243354554287454,0.0012689067099786824,0.28567078034137217,0.7143292196586278,0.04365764171875226
13729,34.0,201,4641,4842,21,240,6507,1876,4631,6507,556,0.030889810972798526,0.7132319041032734,0.003227293683725219,0.2883049024127862,0.7116950975872137,0.036883356385431075
13730,15.0,2,2534,2536,17,244,3637,868,2769,3637,222,0.0005499037668408029,0.6967280725872972,0.004674182018146824,0.23865823480890844,0.7613417651910915,0.06708825955457795
13731,,75,5070,5145,12,124,6361,1983,4378,6361,372,0.011790598962427292,0.7970444898600849,0.0018864958339883666,0.3117434365665776,0.6882565634334225,0.019493790284546456
13732,24.0,77,1910,1987,0,87,2664,787,1877,2664,230,0.028903903903903905,0.7169669669669669,0.0,0.29542042042042044,0.7045795795795796,0.03265765765765766
13733,,1122,24884,26006,123,1154,34482,9971,24511,34482,2740,0.03253871585174874,0.7216518763412795,0.003567078475726466,0.28916536163795603,0.710834638362044,0.0334667362681979
13734,,4791,128272,133063,4922,6975,181790,49613,132177,181790,13467,0.026354584960668902,0.705605368832169,0.0270751966554816,0.2729138016392541,0.727086198360746,0.03836844710930194
13735,,12810,180787,193597,2707,14811,273104,75160,197944,273104,19984,0.04690520827230652,0.6619712636944168,0.009911974925303182,0.2752065147343137,0.7247934852656863,0.054232087409924426
13736,23.0,14573,299491,314064,1390,13720,414886,119528,295360,414888,28301,0.03512514220705347,0.7218598754362623,0.003350301768188041,0.2880970285956692,0.7119029714043308,0.03306916565434527
13737,,102,3007,3109,12,206,4134,1166,2968,4134,309,0.02467343976777939,0.7273826802128689,0.002902757619738752,0.28205128205128205,0.717948717948718,0.049830672472181904
13738,,791,9292,10083,42,962,14065,3888,10177,14065,909,0.056238890863846425,0.6606469960895841,0.0029861357980803414,0.2764308567365802,0.7235691432634198,0.06839672947031639
13739,24.0,729,19759,20488,40,1207,28009,7690,20319,28009,1911,0.02602734835231533,0.7054518190581599,0.0014281123924452855,0.2745546074476061,0.7254453925523938,0.04309329144203649
13740,,23,4468,4491,24,182,5937,1726,4211,5937,525,0.0038740104429846726,0.7525686373589355,0.00404244567963618,0.2907192184605019,0.709280781539498,0.030655213070574363
13741,23.0,1244,32460,33704,69,1277,44749,12629,32120,44749,3591,0.027799503899528483,0.7253793380857673,0.0015419338979642003,0.2822185970636215,0.7177814029363785,0.028536950546380925
13742,,216,4127,4343,15,254,5804,1605,4199,5804,421,0.037215713301171606,0.7110613370089593,0.002584424534803584,0.27653342522398344,0.7234665747760165,0.04376292212267402
13743,15.0,445,5018,5463,83,413,7798,2035,5763,7798,527,0.05706591433700949,0.6434983329058733,0.010643754808925366,0.2609643498332906,0.7390356501667095,0.05296229802513465
13744,24.0,2279,57730,60009,233,3136,80172,22531,57641,80172,5471,0.028426383275956695,0.7200768348051689,0.002906251559147832,0.28103327845132964,0.7189667215486704,0.03911590081325151
13745,26.0,650,13137,13787,212,565,17907,5318,12589,17907,1190,0.036298654157592,0.733623722566594,0.01183894566370693,0.29697883509242196,0.703021164907578,0.031551907075445355
13746,34.0,834,24567,25401,149,1046,33119,9706,23413,33119,2693,0.02518191974395362,0.7417796431051662,0.004498928107732721,0.29306440411848184,0.7069355958815181,0.031583079199251185
13747,,137,3700,3837,12,162,5186,1513,3673,5186,445,0.026417277284998073,0.7134593135364443,0.0023139220979560356,0.2917470111839568,0.7082529888160431,0.031237948322406478
13748,,533,23544,24077,90,1213,32075,9090,22985,32075,2260,0.01661730319563523,0.7340296180826189,0.0028059236165237722,0.28339828526890104,0.716601714731099,0.03781761496492596
13749,24.0,115,2084,2199,19,97,3042,846,2196,3042,209,0.03780407626561473,0.6850756081525312,0.006245890861275477,0.2781065088757396,0.7218934911242604,0.03188691650230112
13750,25.0,388,16496,16884,25,1008,22440,6304,16136,22440,1806,0.017290552584670233,0.7351158645276292,0.0011140819964349377,0.2809269162210339,0.7190730837789662,0.044919786096256686
13751,,608,16048,16656,35,776,22240,6391,15849,22240,1588,0.027338129496402876,0.7215827338129497,0.0015737410071942446,0.28736510791366904,0.7126348920863309,0.034892086330935254
13752,27.0,2512,43604,46116,216,2099,61475,17589,43886,61475,4078,0.04086213908092721,0.7092964619764132,0.003513623424156161,0.28611630744204963,0.7138836925579504,0.03414396095973973
13753,23.0,339,5487,5826,16,404,8056,2272,5784,8056,524,0.04208043694141013,0.6811072492552135,0.0019860973187686196,0.282025819265144,0.717974180734856,0.05014895729890765
13754,24.0,1102,23123,24225,280,1190,32214,9273,22941,32214,2062,0.03420872912398336,0.7177935059290992,0.008691873098652759,0.28785621158502517,0.7121437884149748,0.03694046066927423
13755,,172,7620,7792,24,681,11240,2945,8295,11240,675,0.015302491103202847,0.6779359430604982,0.002135231316725979,0.26201067615658363,0.7379893238434164,0.06058718861209964
13756,,24,4053,4077,23,825,5998,1563,4435,5998,198,0.0040013337779259755,0.6757252417472491,0.00383461153717906,0.26058686228742917,0.7394131377125709,0.1375458486162054
13757,23.0,838,10191,11029,130,1066,15278,3874,11404,15278,852,0.05485011127110878,0.6670375703626129,0.008508967142296112,0.25356722084042416,0.7464327791595758,0.06977353056682811
13758,,288,6187,6475,20,458,9025,2529,6496,9025,705,0.031911357340720224,0.6855401662049861,0.00221606648199446,0.28022160664819945,0.7197783933518006,0.05074792243767313
13759,27.0,85,2041,2126,0,124,2996,817,2179,2996,198,0.028371161548731642,0.6812416555407209,0.0,0.2726969292389853,0.7273030707610146,0.04138851802403204
13760,16.0,41,1618,1659,5,63,2254,635,1619,2254,198,0.01818988464951198,0.7178349600709849,0.0022182786157941437,0.28172138420585624,0.7182786157941438,0.027950310559006212
13761,,249,6712,6961,69,996,9857,2570,7287,9857,659,0.025261235670082174,0.6809374048899259,0.007000101450745663,0.2607284163538602,0.7392715836461398,0.1010449426803287
13762,14.0,144,3165,3309,19,233,4544,1286,3258,4544,322,0.03169014084507042,0.6965228873239436,0.004181338028169014,0.2830105633802817,0.7169894366197183,0.051276408450704226
13763,,1985,24557,26542,130,1736,37616,10401,27215,37616,2023,0.052770097830710336,0.652833900467886,0.003455976180348788,0.2765046788600595,0.7234953211399404,0.04615057422373458
13764,15.0,351,19566,19917,83,1199,26474,7489,18985,26474,2380,0.013258291153584649,0.7390647427664879,0.0031351514693661706,0.2828813175190753,0.7171186824809247,0.04528971821409685
13765,,205,4798,5003,24,252,6605,1897,4708,6605,486,0.031037093111279335,0.7264193792581378,0.0036336109008327025,0.28720666161998487,0.7127933383800151,0.03815291445874338
13766,17.0,672,19639,20311,68,960,26505,7740,18765,26505,1908,0.025353706847764574,0.740954536879834,0.002565553669119034,0.2920203735144312,0.7079796264855688,0.03621958121109225
13767,,166,3350,3516,19,199,4785,1328,3457,4785,342,0.03469174503657262,0.7001044932079414,0.003970741901776384,0.277533960292581,0.7224660397074191,0.041588296760710554
13768,14.0,1837,30527,32364,45,1856,43545,12313,31232,43545,3214,0.04218624411528304,0.7010448960845103,0.0010334137099552187,0.282764955792858,0.717235044207142,0.04262257434837524
13769,48.0,491,13540,14031,41,594,18528,5313,13215,18528,1423,0.02650043177892919,0.7307858376511226,0.00221286701208981,0.2867551813471503,0.7132448186528497,0.03205958549222798
13770,25.0,899,29586,30485,20,1293,40727,11691,29036,40727,3366,0.022073808529967834,0.7264468288850149,0.0004910747170181944,0.2870577258329855,0.7129422741670145,0.03174798045522626
13771,23.0,208,4693,4901,37,200,6562,1906,4656,6562,461,0.03169765315452606,0.7151782992989942,0.005638524839987808,0.2904602255409936,0.7095397744590064,0.03047851264858275
13772,24.0,22,11483,11505,7,557,15192,4391,10801,15192,1323,0.0014481305950500263,0.755858346498157,0.0004607688256977356,0.2890337019483939,0.7109662980516062,0.036664033701948394
13773,25.0,79,2434,2513,11,102,3272,978,2294,3272,233,0.024144254278728607,0.7438875305623472,0.0033618581907090463,0.2988997555012225,0.7011002444987775,0.03117359413202934
13774,17.0,17,18582,18599,29,351,25144,7052,18092,25144,1759,0.0006761056315622017,0.7390232262169901,0.0011533566656061088,0.28046452433980273,0.7195354756601973,0.013959592745784283
13775,14.0,233,4605,4838,17,247,6679,1813,4866,6679,442,0.03488546189549334,0.6894744722263811,0.0025452912112591706,0.27144782153016916,0.7285521784698308,0.036981584069471475
13776,,952,13464,14416,15,1026,19683,5451,14232,19683,1274,0.0483666107808769,0.6840420667581162,0.0007620789513793629,0.27693949093126047,0.7230605090687395,0.05212620027434842
13777,23.0,627,10142,10769,48,589,14432,4057,10375,14432,1066,0.04344512195121951,0.7027439024390244,0.0033259423503325942,0.28111141906873616,0.7188885809312638,0.040812084257206206
13778,16.0,24,2554,2578,4,173,3529,994,2535,3529,328,0.006800793425899688,0.7237177670728252,0.0011334655709832814,0.2816661943893454,0.7183338056106546,0.04902238594502692
13779,,510,7895,8405,39,607,11353,3211,8142,11353,777,0.04492204703602572,0.6954109046067118,0.0034352153615784375,0.2828327314366247,0.7171672685633753,0.05346604421738747
13780,17.0,200,3590,3790,12,177,5032,1462,3570,5032,332,0.0397456279809221,0.7134340222575517,0.0023847376788553257,0.2905405405405405,0.7094594594594594,0.035174880763116055
13781,34.0,148,29323,29471,107,2096,40077,11077,29000,40077,3459,0.0036928911844698953,0.7316665419068293,0.002669860518501884,0.27639294358360156,0.7236070564163984,0.052299323801681764
13782,25.0,1007,26995,28002,103,1409,37804,10548,27256,37804,2607,0.026637392868479527,0.7140778753571051,0.002724579409586287,0.27901809332345784,0.7209819066765422,0.037271188234049304
13783,15.0,175,3031,3206,41,221,4371,1226,3145,4371,287,0.040036604895904826,0.6934339967970716,0.009380004575611988,0.28048501487073896,0.719514985129261,0.050560512468542665
13784,,491,8154,8645,140,657,11682,3285,8397,11682,851,0.042030474233864065,0.6979969183359014,0.011984249272384865,0.2812018489984592,0.7187981510015409,0.05624036979969183
13785,,1015,24771,25786,161,892,34568,9807,24761,34568,2217,0.02936241610738255,0.716587595464013,0.004657486692895163,0.2837016894237445,0.7162983105762555,0.025804211987965748
13786,27.0,1725,41542,43267,235,2268,59108,16151,42957,59108,4395,0.029183866820058198,0.7028151857616566,0.003975773160993436,0.27324558435406376,0.7267544156459362,0.03837044054950261
13787,,766,13610,14376,57,787,19099,5449,13650,19099,1184,0.04010681187496728,0.7126027540708938,0.0029844494476150584,0.2853028954395518,0.7146971045604482,0.04120634588198335
13788,14.0,350,4839,5189,57,186,6900,1937,4963,6900,413,0.050724637681159424,0.701304347826087,0.00826086956521739,0.2807246376811594,0.7192753623188406,0.026956521739130435
13789,40.0,240,52147,52387,327,2532,72421,19736,52685,72421,6401,0.003313955896770274,0.7200535756203311,0.004515264909349498,0.2725176399110755,0.7274823600889245,0.03496223471092639
13790,,626,20597,21223,83,678,27111,8078,19033,27111,1937,0.023090258566633468,0.7597285234775553,0.003061487956917856,0.29796023754195716,0.7020397624580429,0.025008299214341043
13791,27.0,1837,33323,35160,146,1856,46850,13073,33777,46850,2748,0.039210245464247596,0.7112700106723586,0.0031163287086446102,0.2790394877267876,0.7209605122732123,0.03961579509071505
13792,25.0,63,1872,1935,26,189,2650,721,1929,2650,166,0.023773584905660377,0.7064150943396227,0.009811320754716982,0.2720754716981132,0.7279245283018868,0.07132075471698113
13793,17.0,302,8259,8561,41,411,11164,3208,7956,11164,807,0.027051236116087424,0.7397886062343246,0.0036725188104622,0.28735220351128626,0.7126477964887137,0.03681476173414547
13794,25.0,800,19408,20208,51,1067,26801,7511,19290,26801,2003,0.029849632476400136,0.7241520838774672,0.0019029140703705086,0.2802507369128018,0.7197492630871982,0.03981194731539868
13795,,818,38185,39003,72,1461,49428,15006,34422,49428,3797,0.016549324269644734,0.7725378328073157,0.0014566642388929353,0.30359310512260257,0.6964068948773974,0.029558145180869144
13796,,3177,73502,76679,286,3889,101421,29239,72182,101421,7489,0.03132487354689857,0.7247217045779474,0.002819928811587344,0.2882933514755327,0.7117066485244673,0.03834511590301811
13797,16.0,57,3622,3679,2,140,4885,1394,3491,4885,399,0.011668372569089048,0.741453428863869,0.00040941658137154553,0.28536335721596723,0.7146366427840327,0.028659160696008188
13798,41.0,5630,151416,157046,303,7297,206223,59390,146833,206223,14401,0.027300543586311905,0.734234299762878,0.0014692832516256674,0.28798921555791546,0.7120107844420845,0.03538402603007424
13799,14.0,70,1462,1532,1,126,2175,594,1581,2175,149,0.03218390804597701,0.672183908045977,0.0004597701149425287,0.2731034482758621,0.7268965517241379,0.057931034482758624
13800,,89,2616,2705,6,176,3587,1052,2535,3587,280,0.02481182046278227,0.7293002509060497,0.0016727069974909396,0.29328129356007804,0.706718706439922,0.04906607192640089
13801,,16,5232,5248,1,216,7090,1980,5110,7090,675,0.002256699576868829,0.7379407616361072,0.00014104372355430183,0.27926657263751764,0.7207334273624824,0.030465444287729196
13802,,82,2070,2152,12,122,2907,797,2110,2907,186,0.0282077743378053,0.7120743034055728,0.0041279669762641896,0.2741658066735466,0.7258341933264534,0.04196766425868593
13803,,4654,101439,106093,899,5888,144348,40713,103635,144348,10524,0.03224152741984648,0.7027392135672126,0.006228004544572838,0.2820475517499377,0.7179524482500623,0.04079031230082855
13804,16.0,1166,24238,25404,85,1140,34069,9608,24461,34069,2852,0.03422466171592944,0.7114385511755555,0.002494936746015439,0.2820159088907805,0.7179840911092196,0.03346150459361883
13805,,134,2908,3042,0,176,4214,1150,3064,4214,283,0.03179876601803512,0.6900806834361651,0.0,0.2728998576174656,0.7271001423825344,0.041765543426673
13806,,257,5521,5778,50,507,7798,2181,5617,7798,488,0.032957168504744803,0.7080020518081559,0.006411900487304437,0.27968709925621954,0.7203129007437804,0.065016670941267
13807,23.0,218,8853,9071,25,337,11731,3514,8217,11731,998,0.018583240985423237,0.7546671213025318,0.002131105617594408,0.29954820560907,0.70045179439093,0.02872730372517262
13808,24.0,70,2059,2129,18,201,2888,733,2155,2888,195,0.024238227146814405,0.7129501385041551,0.006232686980609419,0.25380886426592797,0.746191135734072,0.0695983379501385
13809,,134,3260,3394,18,166,4548,1287,3261,4548,369,0.029463500439753737,0.7167985927880387,0.00395778364116095,0.28298153034300794,0.7170184696569921,0.036499560246262094
13810,16.0,110,2006,2116,2,68,3021,769,2252,3021,203,0.036411784177424696,0.6640185369083085,0.0006620324395895399,0.25455147302217807,0.7454485269778219,0.022509102946044357
13811,14.0,199,9272,9471,50,1333,13489,3510,9979,13489,967,0.014752761509378012,0.6873748980650901,0.0037067239973311585,0.26021202461264736,0.7397879753873526,0.09882126176884869
13812,26.0,103,1602,1705,7,128,2320,630,1690,2320,158,0.04439655172413793,0.6905172413793104,0.003017241379310345,0.27155172413793105,0.728448275862069,0.05517241379310345
13813,15.0,571,22789,23360,24,841,30133,8602,21531,30133,2599,0.018949324660671025,0.7562804898284273,0.0007964689874887997,0.2854677595991106,0.7145322404008894,0.02790960076992002
13814,,736,12250,12986,48,1684,18785,4934,13851,18785,949,0.03918019696566409,0.6521160500399255,0.0025552302368911364,0.2626563747671014,0.7373436252328985,0.08964599414426404
13815,42.0,1497,36428,37925,172,2085,51632,14510,37122,51632,4103,0.028993647350480323,0.705531453362256,0.0033312674310505114,0.28102726991013327,0.7189727300898667,0.04038193368453672
13816,,724,7822,8546,21,446,11450,3199,8251,11450,907,0.06323144104803494,0.6831441048034934,0.001834061135371179,0.2793886462882096,0.7206113537117904,0.038951965065502185
13817,,181,1937,2118,44,116,2912,763,2149,2912,195,0.06215659340659341,0.6651785714285714,0.01510989010989011,0.2620192307692308,0.7379807692307693,0.03983516483516483
13818,,2804,46447,49251,1081,3705,68165,18968,49197,68165,4355,0.041135480085087654,0.6813907430499523,0.01585857844935084,0.2782659722731607,0.7217340277268393,0.05435340717376953
13819,,13,910,1479,22,225,2115,349,1823,2172,63,0.005985267034990792,0.4189686924493554,0.010128913443830571,0.16068139963167588,0.8393186003683242,0.10359116022099447
13820,24.0,4708,94527,99235,542,4717,130906,37889,93017,130906,8637,0.03596473805631522,0.7220982995431836,0.004140375536644615,0.2894366950330772,0.7105633049669229,0.036033489679617434
13821,,687,9128,9815,56,693,13395,3785,9610,13395,933,0.05128779395296752,0.6814483016050765,0.00418066442702501,0.2825681224337439,0.717431877566256,0.05173572228443449
13822,24.0,100,2435,2555,45,154,3515,938,2577,3515,235,0.02844950213371266,0.6927453769559033,0.012802275960170697,0.26685633001422476,0.7331436699857753,0.0438122332859175
13823,,47,2175,2222,16,62,2979,868,2111,2979,231,0.0157771064115475,0.730110775427996,0.005370929842228936,0.2913729439409198,0.7086270560590803,0.02081235313863713
13824,16.0,159,2767,2926,0,190,3975,1146,2829,3975,295,0.04,0.6961006289308176,0.0,0.28830188679245283,0.7116981132075472,0.04779874213836478
13825,13.0,137,1682,1819,37,192,2580,656,1924,2580,116,0.05310077519379845,0.6519379844961241,0.01434108527131783,0.25426356589147286,0.7457364341085271,0.07441860465116279
13826,16.0,194,3736,3930,38,166,5513,1463,4050,5513,419,0.03518955196807546,0.6776709595501542,0.006892798839107564,0.2653727553056412,0.7346272446943588,0.03011064756031199
13827,24.0,220,2878,3098,42,299,4973,1121,3852,4973,211,0.04423889000603257,0.5787251156243716,0.008445606273878947,0.22541725316710234,0.7745827468328976,0.06012467323547155
13828,27.0,3708,118201,121909,58,6319,160709,46693,114016,160709,12043,0.023072758837401765,0.7354970785705841,0.00036090075851383555,0.2905437778842504,0.7094562221157495,0.03931951539739529
13829,,721,13300,14021,54,954,18800,5300,13500,18800,1508,0.03835106382978724,0.7074468085106383,0.002872340425531915,0.28191489361702127,0.7180851063829787,0.05074468085106383
13830,46.0,253,6872,7125,39,327,9358,2729,6629,9358,731,0.027035691387048515,0.7343449455011755,0.004167557170335541,0.2916221414832229,0.708377858516777,0.03494336396665954
13831,15.0,185,2418,2603,16,199,3489,964,2525,3489,264,0.0530237890513041,0.6930352536543423,0.004585841215247922,0.2762969332186873,0.7237030667813127,0.05703640011464603
13832,,739,11894,12633,164,1216,17683,4553,13130,17683,884,0.041791551207374315,0.6726234236272126,0.009274444381609456,0.25747893456992593,0.7425210654300741,0.06876661200022621
13833,17.0,452,11765,12217,51,713,16480,4536,11944,16480,1322,0.027427184466019418,0.7138956310679612,0.0030946601941747574,0.2752427184466019,0.724757281553398,0.04326456310679612
13834,,71,2730,2801,11,127,3696,1031,2665,3696,294,0.019209956709956708,0.7386363636363636,0.002976190476190476,0.27895021645021645,0.7210497835497836,0.034361471861471864
13835,,34,8244,8278,32,487,11280,3027,8253,11280,912,0.0030141843971631206,0.7308510638297873,0.0028368794326241137,0.26835106382978724,0.7316489361702128,0.04317375886524823
13836,,1448,21644,23092,71,1480,32059,8776,23283,32059,1997,0.045166723852896225,0.6751302286409433,0.002214666708256652,0.27374528213606164,0.7262547178639384,0.04616488349605415
13837,13.0,108,1585,1693,0,124,2699,648,2051,2699,138,0.04001482030381623,0.5872545387180437,0.0,0.24008892182289737,0.7599110781771027,0.04594294183030752
13838,34.0,914,14322,15236,201,914,20695,5687,15008,20695,1098,0.04416525730852863,0.6920512201014738,0.009712490939840541,0.27480067649190626,0.7251993235080938,0.04416525730852863
13839,15.0,219,6598,6817,0,855,9717,2395,7322,9717,694,0.02253782031491201,0.67901615725018,0.0,0.2464752495626222,0.7535247504373778,0.08799012040753319
13840,,2172,2136,4308,94,340,6112,1647,4465,6112,242,0.3553664921465969,0.3494764397905759,0.015379581151832461,0.2694698952879581,0.7305301047120419,0.055628272251308904
13841,,267,4879,5146,17,631,7189,1951,5238,7189,451,0.03714007511475866,0.6786757546251218,0.0023647238837112253,0.27138684100709415,0.7286131589929058,0.08777298650716372
13842,27.0,1858,36396,38254,324,2113,50420,15134,35286,50420,3835,0.036850456168187225,0.7218564061880206,0.0064260214200714,0.30015866719555734,0.6998413328044427,0.041907973026576756
13843,,167,3208,3375,94,213,4738,1272,3466,4738,361,0.03524693963697763,0.6770789362600254,0.019839594765723934,0.268467707893626,0.731532292106374,0.0449556775010553
13844,33.0,21,2192,2213,4,87,2924,813,2111,2924,280,0.007181942544459644,0.7496580027359782,0.0013679890560875513,0.2780437756497948,0.7219562243502052,0.02975376196990424
13845,15.0,296,5784,6080,19,341,8098,2318,5780,8098,609,0.036552235119782665,0.7142504322054828,0.0023462583353914546,0.28624351691775746,0.7137564830822425,0.04210916275623611
13846,16.0,2669,52959,55628,1379,4498,83478,20692,62786,83478,4835,0.03197249574738254,0.6344066700208438,0.01651932245621601,0.24787369127195188,0.7521263087280481,0.05388246004935432
13847,16.0,33,4466,4499,2,198,5940,1695,4245,5940,429,0.005555555555555556,0.7518518518518519,0.0003367003367003367,0.28535353535353536,0.7146464646464646,0.03333333333333333
13848,,90,4760,4850,4,1231,7186,1424,5762,7186,412,0.012524352908433064,0.6623991093793488,0.0005566379070414695,0.19816309490676315,0.8018369050932368,0.17130531589201226
13849,24.0,1185,16024,17209,20,615,22099,6358,15741,22099,1337,0.05362233585230101,0.7251006832888366,0.0009050183266211141,0.28770532603285215,0.7122946739671479,0.027829313543599257
13850,25.0,683,22817,23500,71,2287,31918,8998,22920,31918,1582,0.02139858387116987,0.7148630866595651,0.002224450153518391,0.2819098941036406,0.7180901058963595,0.07165235917037409
13851,,209,3211,3420,27,163,4666,1289,3377,4666,309,0.04479211315902272,0.6881697385340763,0.005786540934419202,0.2762537505357908,0.7237462494642092,0.03493356193741963
13852,15.0,1,1958,1959,5,267,2875,712,2163,2875,157,0.00034782608695652176,0.6810434782608695,0.0017391304347826088,0.24765217391304348,0.7523478260869565,0.0928695652173913
13853,,581,11706,12287,74,1047,16653,4605,12048,16653,1116,0.03488860865910046,0.7029364078544407,0.004443643787906083,0.276526751936588,0.723473248063412,0.06287155467483337
13854,23.0,365,15058,15423,38,968,20316,5972,14344,20316,1489,0.017966135065957865,0.7411892104745028,0.0018704469383736956,0.29395550305178186,0.7060444969482181,0.047647174640677296
13855,42.0,319,11619,11938,50,514,15635,4587,11048,15635,1125,0.020402942117045093,0.7431403901503038,0.0031979533098816758,0.29338023664854496,0.706619763351455,0.03287496002558363
13856,26.0,168,4440,4608,51,212,6184,1748,4436,6184,402,0.027166882276843468,0.7179818887451488,0.008247089262613196,0.28266494178525226,0.7173350582147477,0.03428201811125485
13857,24.0,103,5944,6047,14,303,8810,2200,6610,8810,590,0.011691259931895574,0.6746878547105561,0.0015891032917139615,0.24971623155505107,0.7502837684449489,0.03439273552780931
13858,,66,2068,2134,1,181,2896,796,2100,2896,225,0.022790055248618785,0.7140883977900553,0.0003453038674033149,0.27486187845303867,0.7251381215469613,0.0625
13859,,1755,35203,36958,193,2085,49511,14129,35382,49511,3559,0.03544666841711943,0.711013714124134,0.003898123649290057,0.2853709276726384,0.7146290723273616,0.042111853931449575
13860,16.0,2244,32662,34906,396,3496,49793,13189,36604,49793,3263,0.04506657562307955,0.6559556564175687,0.007952925109955215,0.2648765890787862,0.7351234109212138,0.07021067218283694
13861,,1689,45414,47103,424,1535,61065,18015,43050,61065,4870,0.027659051830017194,0.7436993367722918,0.0069434209448947844,0.29501351019405553,0.7049864898059445,0.025137148939654467
13862,,396,13149,13545,57,663,17482,5140,12342,17482,1229,0.022651870495366662,0.7521450634938794,0.0032604965106967166,0.2940167028944057,0.7059832971055944,0.037924722571788125
13863,15.0,333,7648,7981,32,502,10866,2964,7902,10866,858,0.030646051905024847,0.7038468617706608,0.0029449659488312166,0.27277747101049143,0.7272225289895086,0.04619915332228971
13864,,241,6032,6273,10,307,8562,2365,6197,8562,676,0.02814762905863116,0.7045082924550339,0.00116795141322121,0.2762205092268162,0.7237794907731838,0.03585610838589115
13865,17.0,95,3132,3227,104,263,4822,1239,3583,4822,278,0.019701368726669433,0.6495230194939859,0.021567814184985483,0.2569473247615097,0.7430526752384903,0.05454168394856906
13866,23.0,797,19194,19991,144,1363,27450,7758,19692,27450,1326,0.029034608378870674,0.6992349726775956,0.005245901639344262,0.28262295081967215,0.7173770491803279,0.04965391621129326
13867,,46,2986,3032,5,121,4020,1164,2856,4020,406,0.011442786069651741,0.7427860696517413,0.0012437810945273632,0.28955223880597014,0.7104477611940299,0.03009950248756219
13868,17.0,92,2613,2705,14,217,3693,1013,2680,3693,239,0.024911995667479016,0.7075548334687246,0.0037909558624424585,0.2743027349038722,0.7256972650961279,0.05875981586785811
13869,,431,6431,6862,64,371,9344,2640,6704,9344,635,0.04612585616438356,0.6882491438356164,0.00684931506849315,0.2825342465753425,0.7174657534246576,0.039704623287671235
13870,,984,19416,20400,122,990,27591,7721,19870,27591,1901,0.03566380341415679,0.7037077307817766,0.004421731724112935,0.2798376282120981,0.7201623717879019,0.03588126563009677
13871,14.0,672,16595,17267,19,1077,23908,6202,17706,23908,1904,0.028107746361050696,0.6941191233060063,0.0007947130667558976,0.25941107579053035,0.7405889242094696,0.04504768278400535
13872,36.0,487,12948,13435,211,687,18391,5132,13259,18391,1326,0.02648034364634876,0.704040019574792,0.01147300309934207,0.27904953509868957,0.7209504649013104,0.03735522810070143
13873,33.0,56,1755,1811,10,65,2416,689,1727,2416,212,0.023178807947019868,0.7264072847682119,0.0041390728476821195,0.285182119205298,0.714817880794702,0.026903973509933773
13874,,244,6305,6549,8,278,8665,2511,6154,8665,708,0.02815926139642239,0.7276399307559146,0.0009232544720138488,0.2897864974033468,0.7102135025966532,0.03208309290248124
13875,15.0,597,19087,19684,39,898,26215,7344,18871,26215,1854,0.022773221438107952,0.728094602326912,0.0014876978828914744,0.280144955178333,0.719855044821667,0.03425519740606523
13876,35.0,11751,66423,78174,4497,6458,117508,28776,88732,117508,4337,0.10000170201177792,0.5652636416244,0.038269734826565,0.24488545460734587,0.7551145453926541,0.05495796030908534
13877,13.0,162,1427,1589,4,288,2264,610,1654,2264,111,0.0715547703180212,0.6303003533568905,0.0017667844522968198,0.26943462897526504,0.730565371024735,0.127208480565371
13878,,82,2195,2277,24,99,3028,853,2175,3028,198,0.027080581241743725,0.7249009247027741,0.007926023778071334,0.28170409511228534,0.7182959048877147,0.03269484808454425
13879,17.0,478,13821,14299,143,331,18458,5517,12941,18458,1542,0.025896630187452595,0.7487810163614693,0.0077473182359952325,0.29889478816773213,0.7011052118322678,0.017932603749051902
13880,,973,22668,23641,46,1130,31175,9090,22085,31175,1961,0.03121090617481957,0.727121090617482,0.001475541299117883,0.29157979149959906,0.708420208500401,0.03624699278267843
13881,14.0,177,6670,6847,16,594,9557,2629,6928,9557,684,0.018520456210107776,0.6979177566181857,0.001674165533117087,0.2750863241603014,0.7249136758396987,0.06215339541697185
13882,16.0,50,2343,2393,14,63,3133,910,2223,3133,267,0.015959144589849983,0.7478455154803703,0.004468560485157995,0.29045643153526973,0.7095435684647303,0.02010852218321098
13883,27.0,71,2050,2121,12,166,2913,818,2095,2913,232,0.02437349811191212,0.7037418468932373,0.004119464469618949,0.2808101613456917,0.7191898386543083,0.05698592516306213
13884,36.0,420,6072,6492,185,263,8708,2442,6266,8708,549,0.04823151125401929,0.6972898484152503,0.021244832338079927,0.280431786862655,0.719568213137345,0.03020211299954065
13885,27.0,1135,27384,28519,80,1365,37722,10828,26894,37722,2741,0.0300885424950957,0.7259424208684587,0.002120778325645512,0.28704734637612006,0.7129526536238799,0.036185780181326545
13886,48.0,893,38325,39218,66,928,49310,14894,34416,49310,3666,0.018109916852565404,0.7772257148651389,0.0013384708983978908,0.3020482660717907,0.6979517339282093,0.018819712025958224
13887,25.0,326,9012,9338,85,340,12214,3587,8627,12214,908,0.02669068282299001,0.7378418208613067,0.006959227116423776,0.2936793843130833,0.7063206156869166,0.027836908465695104
13888,15.0,8242,110864,119106,470,7179,158065,45365,112700,158065,10622,0.052143105684370354,0.7013823427071142,0.002973460285325657,0.28700218264637967,0.7129978173536203,0.04541802423053807
13889,23.0,180,5896,6076,12,207,7897,2334,5563,7897,708,0.022793465873116373,0.746612637710523,0.0015195643915410916,0.2955552741547423,0.7044447258452577,0.02621248575408383
13890,17.0,55,3665,3720,11,338,5203,1386,3817,5203,360,0.010570824524312896,0.7044013069383048,0.0021141649048625794,0.266384778012685,0.733615221987315,0.06496252162214107
13891,,152,3871,4023,17,163,5364,1515,3849,5364,447,0.028337061894108874,0.7216629381058911,0.003169276659209545,0.28243847874720357,0.7175615212527964,0.030387770320656225
13892,16.0,64,2191,2255,10,111,2937,866,2071,2937,237,0.021790943139257744,0.7459993190330269,0.0034048348655090228,0.2948586993530814,0.7051413006469186,0.03779366700715015
13893,,27,2905,2932,6,246,4034,1111,2923,4034,327,0.0066931085770946955,0.7201289043133366,0.001487357461576599,0.27540902330193356,0.7245909766980664,0.060981655924640554
13894,33.0,1052,25553,26605,49,1368,35579,10063,25516,35579,3077,0.029568003597627814,0.7182045588689957,0.0013772168976081396,0.2828353804210349,0.7171646195789652,0.03844964726383541
13895,24.0,431,8363,8794,13,686,11845,3312,8533,11845,903,0.03638666103841283,0.7060363022372309,0.0010975094976783454,0.2796116504854369,0.7203883495145631,0.057914731954411144
13896,,266,3019,3285,31,315,4762,1174,3588,4762,284,0.05585888282234355,0.6339773204535909,0.006509869802603948,0.24653506929861402,0.753464930701386,0.06614867702645948
13897,37.0,2925,42511,45436,450,1379,58949,17370,41579,58949,4371,0.049619162326757026,0.7211487896317156,0.007633717281039542,0.29466148704812634,0.7053385129518737,0.023393102512341175
13898,,1895,53082,54977,235,1955,71419,20836,50590,71426,5198,0.02653095511438412,0.7431747542911544,0.0032901184442639935,0.291714501722062,0.708285498277938,0.027370985355472797
13899,16.0,3536,34106,37642,194,2366,49028,14085,34943,49028,2411,0.07212205270457697,0.6956433058660357,0.003956922574855185,0.2872848168393571,0.7127151831606429,0.04825813820673901
13900,27.0,9224,252527,261751,1819,13253,350422,100667,249755,350422,23474,0.02632254824183413,0.7206368321623642,0.005190884133987022,0.28727363008030316,0.7127263699196968,0.037820114033936224
13901,,874,20802,21676,74,1324,28954,8197,20757,28954,2074,0.030185811977619673,0.718449955101195,0.00255577813082821,0.283104234302687,0.716895765697313,0.04572770601643987
13902,25.0,3337,72245,75582,133,4415,100666,29145,71521,100666,7536,0.03314922615381559,0.717670315697455,0.0013212008026543222,0.28952178491248287,0.7104782150875172,0.04385790634375062
13903,23.0,179,3071,3250,4,264,4351,1240,3111,4351,326,0.04113996782348885,0.7058147552286831,0.0009193288899103654,0.28499195587221327,0.7150080441277867,0.060675706734084116
13904,,121,2420,2541,19,118,3356,967,2389,3356,235,0.03605482717520858,0.7210965435041716,0.00566150178784267,0.28814064362336117,0.7118593563766389,0.035160905840286055
13905,14.0,285,5109,5394,14,299,7121,2082,5039,7121,554,0.040022468754388425,0.7174554135655105,0.001966016008987502,0.29237466647942706,0.707625333520573,0.04198848476337593
13906,35.0,185,7269,7454,31,556,10348,2929,7419,10348,779,0.017877850792423655,0.7024545805952841,0.0029957479706223425,0.2830498647081562,0.7169501352918438,0.05373018940858137
13907,35.0,793,22442,23235,106,614,29978,8972,21006,29978,2475,0.02645273200346921,0.7486156514777503,0.003535926345987057,0.2992861431716592,0.7007138568283408,0.020481686570151446
13908,,2352,69460,71812,136,3077,94182,27349,66833,94182,7083,0.02497292476269351,0.7375082287485931,0.0014440126563462232,0.2903845745471534,0.7096154254528466,0.0326707863498333
13909,14.0,32,7278,7310,8,174,9738,2726,7012,9738,1097,0.003286095707537482,0.747381392483056,0.0008215239268843705,0.27993427808584925,0.7200657219141507,0.017868145409735057
13910,,236,9806,10042,4,492,13203,3917,9286,13203,1059,0.01787472544118761,0.7427099901537529,0.0003029614481557222,0.29667499810649095,0.7033250018935091,0.03726425812315383
13911,,1150,12109,13259,84,1276,19460,5151,14309,19460,945,0.05909558067831449,0.6222507708119219,0.004316546762589928,0.26469681397738953,0.7353031860226105,0.06557040082219938
13912,,1149,27247,28396,125,1366,37328,10760,26568,37328,2592,0.030781183026146592,0.7299346335190742,0.003348692670381483,0.28825546506643807,0.7117445349335619,0.03659451350192885
13913,15.0,659,11336,11995,85,607,16076,4530,11546,16076,1175,0.040992784274695195,0.705150534958945,0.005287384921622294,0.2817865140582234,0.7182134859417766,0.037758148793232145
13914,,298,8994,9292,15,349,12061,3520,8541,12061,982,0.024707735676975377,0.7457093110024045,0.0012436779703175525,0.29184976370118565,0.7081502362988144,0.028936240776055052
13915,24.0,1019,32631,33650,165,1076,43138,12864,30274,43138,3314,0.02362186471324586,0.7564328434327043,0.00382493393295934,0.29820575826417545,0.7017942417358246,0.024943205526449998
13916,16.0,147,28215,28362,126,1991,38762,10697,28065,38762,3100,0.0037923739745111193,0.7279036169444301,0.0032506062638666734,0.2759661524173159,0.7240338475826841,0.05136473866157577
13917,,795,17550,18345,51,807,24109,7003,17106,24109,1832,0.03297523746318802,0.7279439213571696,0.0021153925919780996,0.2904724376788751,0.7095275623211249,0.03347297689659463
13918,14.0,68,2815,2883,26,128,4250,1077,3173,4250,276,0.016,0.6623529411764706,0.00611764705882353,0.25341176470588234,0.7465882352941177,0.03011764705882353
13919,,181,4745,4926,39,462,7156,1805,5351,7156,398,0.02529346003353829,0.6630799329234209,0.005449972051425377,0.25223588596981555,0.7477641140301845,0.0645612073784237
13920,,2417,32606,35023,233,1490,49607,13075,36532,49607,2545,0.048722962485133144,0.6572862700828512,0.004696917773701292,0.26357167335255105,0.736428326647449,0.030036083617231438
13921,,173,4120,4293,33,226,5750,1667,4083,5750,458,0.03008695652173913,0.7165217391304348,0.005739130434782609,0.28991304347826086,0.7100869565217391,0.03930434782608696
13922,15.0,539,10928,11467,30,573,15222,4416,10806,15222,1050,0.03540927604782552,0.71790829063198,0.001970831690973591,0.29010642491131255,0.7098935750886874,0.03764288529759559
13923,,497,7958,8455,446,717,12028,3182,8846,12028,788,0.04132025274359827,0.6616228799467908,0.037080146325241106,0.26454938476887263,0.7354506152311274,0.059610907881609575
13924,,1938,13223,15161,394,1116,20849,6103,14746,20849,1254,0.09295409851791453,0.63422706124994,0.018897788862775194,0.2927238716485203,0.7072761283514797,0.05352774713415512
13925,27.0,2472,46400,48872,493,2983,65882,18378,47504,65882,4385,0.037521629580158464,0.7042894872651103,0.007483075802191798,0.2789532801068577,0.7210467198931423,0.04527792113172035
13926,24.0,839,17087,17926,67,1043,23953,6858,17095,23953,1646,0.03502692773347806,0.7133553208366384,0.0027971444077986058,0.28631069177138563,0.7136893082286143,0.04354360622886486
13927,,349,21110,21459,33,1033,28070,8264,19806,28070,2326,0.012433202707516923,0.7520484503028144,0.001175632347702173,0.29440684004275025,0.7055931599572497,0.03680085500534378
13928,,163,10309,10472,30,1347,14808,3987,10821,14808,1152,0.011007563479200433,0.6961777417612102,0.002025931928687196,0.2692463533225284,0.7307536466774717,0.09096434359805511
13929,,905,21495,22400,62,725,28948,8550,20399,28949,2303,0.031261874330719544,0.7425126947390238,0.0021416974679608967,0.29534698953331723,0.7046530104666828,0.025044042972123388
13930,15.0,583,14649,15232,127,805,20156,5880,14276,20156,1415,0.02892438975987299,0.726781107362572,0.006300853343917444,0.29172454852153207,0.7082754514784679,0.03993847985711451
13931,14.0,3839,60382,64221,1395,5253,90421,24650,65771,90421,5897,0.04245695137191582,0.6677873502836731,0.015427832030169982,0.2726136627553334,0.7273863372446666,0.058094911580274494
13932,25.0,1288,35649,36937,344,1567,49447,13666,35781,49447,3746,0.026048091896373894,0.7209537484579449,0.0069569437984104195,0.2763767265961535,0.7236232734038466,0.03169049689566607
13933,25.0,353,6779,7132,30,451,9512,2763,6749,9512,737,0.03711101766190076,0.7126787216148024,0.003153910849453322,0.290475189234651,0.709524810765349,0.04741379310344827
13934,14.0,178,4720,4898,14,164,6379,1862,4517,6379,549,0.027904060197523124,0.7399278883837592,0.002194701363850133,0.2918952813920677,0.7081047186079322,0.02570935883367299
13935,,1022,18080,19102,210,1115,26672,7225,19447,26672,1665,0.03831733653269346,0.6778644271145771,0.007873425314937012,0.27088332333533294,0.7291166766646671,0.041804139172165564
13936,17.0,7,1997,2004,0,76,2657,769,1888,2657,297,0.0026345502446368085,0.7515995483628152,0.0,0.2894241625893865,0.7105758374106135,0.02860368837034249
13937,15.0,62,1780,1842,0,64,2557,689,1868,2557,211,0.024247164646069613,0.6961282753226438,0.0,0.26945639421196715,0.7305436057880329,0.025029331247555728
13938,24.0,256,11786,12042,4,435,15719,4457,11262,15719,1304,0.016286023283923912,0.7497932438450283,0.00025446911381131113,0.28354221006425345,0.7164577899357466,0.02767351612698009
13939,,426,12709,13135,44,537,17740,4994,12746,17740,1573,0.024013528748590755,0.7164036076662909,0.002480270574971815,0.281510710259301,0.718489289740699,0.030270574971815106
13940,16.0,663,14061,14724,4,283,19366,5946,13420,19366,1605,0.03423525766807808,0.7260663017659816,0.00020654755757513167,0.3070329443354332,0.6929670556645667,0.014613239698440566
13941,,288,7148,7436,28,339,9706,2848,6858,9706,767,0.02967236760766536,0.7364516793735834,0.00288481351741191,0.29342674634246857,0.7065732536575314,0.03492684937152277
13942,24.0,208,4693,4901,37,200,6562,1906,4656,6562,461,0.03169765315452606,0.7151782992989942,0.005638524839987808,0.2904602255409936,0.7095397744590064,0.03047851264858275
13943,,2088,60899,62987,168,3660,84594,23714,60880,84594,7325,0.024682601602950563,0.7198973922500413,0.0019859564508121143,0.28032720996761,0.71967279003239,0.04326547982126392
13944,25.0,325,5103,5428,50,307,7344,2114,5230,7344,533,0.044253812636165575,0.6948529411764706,0.006808278867102397,0.2878540305010893,0.7121459694989106,0.041802832244008714
13945,,1239,21732,22971,129,1171,30651,8800,21851,30651,2078,0.04042282470392483,0.7090143877850641,0.004208671821474014,0.2871031940230335,0.7128968059769665,0.038204300022837756
13946,,430,3394,3824,2,277,5215,1455,3760,5215,298,0.08245445829338446,0.6508149568552253,0.0003835091083413231,0.27900287631831255,0.7209971236816874,0.05311601150527325
13947,27.0,1597,56786,58383,19,2391,75144,21508,53636,75144,5735,0.021252528478654317,0.7556957308634089,0.00025284786543170444,0.28622378366868945,0.7137762163313105,0.03181890769722134
13948,,291,10102,10393,9,232,13634,3951,9683,13634,1246,0.02134369957459293,0.7409417632389614,0.000660114419832771,0.28979023030658646,0.7102097696934135,0.017016282822355875
13949,17.0,53,1914,1967,2,139,2659,758,1901,2659,222,0.01993230537796164,0.7198194810078977,0.000752162467092892,0.28506957502820607,0.7149304249717939,0.052275291462956
13950,15.0,15,4032,4047,14,609,5626,1578,4048,5626,267,0.0026661926768574476,0.7166725915392819,0.002488446498400284,0.2804834696054035,0.7195165303945965,0.10824742268041238
13951,,1877,30104,31981,1341,1768,44289,12092,32197,44289,3247,0.04238072659125291,0.6797173112962587,0.03027839869945133,0.273024904603852,0.726975095396148,0.03991961886698729
13952,27.0,585,5248,5833,40,224,8272,2249,6023,8272,604,0.07072050290135397,0.6344294003868471,0.004835589941972921,0.27188104448742745,0.7281189555125726,0.027079303675048357
13953,17.0,2110,56011,58121,247,2352,75244,22085,53159,75244,5294,0.0280421030248259,0.7443915793950349,0.0032826537664132687,0.29351177502525116,0.7064882249747488,0.031258306310137686
13954,17.0,105,4414,4519,2,336,6198,1740,4458,6198,520,0.016940948693126814,0.7121652145853501,0.00032268473701193933,0.2807357212003872,0.7192642787996127,0.05421103581800581
13955,27.0,159,3005,3164,13,149,4181,1183,2998,4181,300,0.03802917962209998,0.7187275771346567,0.0031093039942597465,0.2829466634776369,0.717053336522363,0.03563740731882325
13956,23.0,455,10085,10540,53,602,13968,4030,9938,13968,923,0.03257445589919817,0.7220074455899198,0.0037943871706758304,0.288516609392898,0.711483390607102,0.043098510882016036
13957,25.0,440,33909,34349,300,1837,46640,12899,33741,46640,3957,0.009433962264150943,0.7270368782161235,0.006432246998284734,0.276565180102916,0.723434819897084,0.03938679245283019
13958,,734,18731,19465,58,934,25478,7458,18020,25478,2022,0.028809168694560013,0.735183295392103,0.0022764738205510635,0.29272313368396263,0.7072768663160374,0.036659078420598165
13959,17.0,2176,54273,56449,99,3539,75362,21539,53823,75362,5784,0.028873968312942862,0.7201640083861893,0.001313659403943632,0.2858071707226454,0.7141928292773546,0.04696000636925771
13960,,330,15703,16033,57,413,20794,6092,14702,20794,2019,0.01586996248917957,0.7551697605078388,0.002741175339040108,0.29296912570933925,0.7070308742906608,0.01986149850918534
13961,,505,16064,16569,35,764,21616,6213,15403,21616,1715,0.023362324204293117,0.7431532198371577,0.0016191709844559584,0.2874259807549963,0.7125740192450037,0.03534418948926721
13962,15.0,429,14458,14887,47,999,20028,5664,14364,20028,1821,0.021420011983223488,0.7218893549031357,0.0023467145995606153,0.28280407429598564,0.7171959257040144,0.04988016776512882
13963,,234,3576,3810,15,237,5420,1427,3993,5420,311,0.04317343173431734,0.6597785977859778,0.0027675276752767526,0.2632841328413284,0.7367158671586715,0.04372693726937269
13964,41.0,1067,42745,43812,25,1772,56005,17312,38693,56005,4153,0.01905187036871708,0.7632354254084457,0.0004463887152932774,0.3091152575662887,0.6908847424337112,0.0316400321399875
13965,,3,1431,1434,10,197,2162,527,1635,2162,95,0.0013876040703052729,0.6618871415356151,0.004625346901017576,0.24375578168362627,0.7562442183163737,0.09111933395004625
13966,24.0,144,3548,3692,18,247,4931,1398,3533,4931,374,0.029203001419590348,0.719529507199351,0.0036503751774487935,0.2835124721151896,0.7164875278848104,0.05009125937943622
13967,13.0,1568,28438,31200,169,3003,45116,12080,33036,45116,1938,0.03475485415373703,0.6303307030765138,0.0037458994591719123,0.2677542335313414,0.7322457664686586,0.06656175192836244
13968,,555,5125,5680,10,525,8085,2163,5922,8085,373,0.0686456400742115,0.6338899196042053,0.0012368583797155227,0.2675324675324675,0.7324675324675325,0.06493506493506493
13969,36.0,525,11930,12455,92,622,16336,4690,11646,16336,1176,0.03213761018609207,0.7302889324191969,0.005631733594515181,0.2870959843290891,0.7129040156709109,0.03807541625857003
13970,24.0,139,4674,4813,5,171,6243,1826,4417,6243,506,0.022264936729136632,0.7486785199423354,0.0008008970046452026,0.292487586096428,0.707512413903572,0.02739067755886593
13971,17.0,4584,85119,89703,344,5254,119732,33985,85747,119732,8894,0.03828550429292086,0.7109127050412588,0.002873083219189523,0.28384224768649985,0.7161577523135001,0.04388133498145859
13972,36.0,1637,46311,47948,357,1920,62218,18656,43562,62218,3780,0.02631071394130316,0.7443344369796522,0.005737889356777781,0.29984891831945737,0.7001510816805426,0.030859236876788067
13973,17.0,142,2180,2322,18,149,3129,887,2242,3129,240,0.04538191115372323,0.696708213486737,0.005752636625119847,0.28347714924896134,0.7165228507510387,0.047619047619047616
13974,14.0,1851,17447,19298,98,1686,26693,7409,19284,26693,1803,0.06934402277750722,0.6536170531600045,0.003671374517663807,0.27756340613644026,0.7224365938635597,0.0631626269059304
13975,23.0,139,3112,3251,6,157,4246,1234,3012,4246,327,0.03273669335845502,0.7329251059821008,0.001413094677343382,0.29062647197362224,0.7093735280263778,0.036975977390485165
13976,,6686,98913,105599,1688,6935,142042,39785,102257,142042,9143,0.04707058475662128,0.6963644555835597,0.011883809014235226,0.2800932118669126,0.7199067881330874,0.04882358738964532
13977,,345,20343,20688,121,893,27694,7995,19699,27694,2723,0.01245757203726439,0.7345634433451289,0.004369177439156496,0.2886906911244313,0.7113093088755688,0.03224525167906406
13978,,637,10873,11510,27,641,15094,4383,10711,15094,1044,0.042202199549489866,0.7203524579303034,0.001788790247780575,0.29038028355638,0.70961971644362,0.042467205512124025
13979,,83,2095,2178,12,103,2860,849,2011,2860,253,0.02902097902097902,0.7325174825174825,0.004195804195804196,0.29685314685314684,0.7031468531468531,0.03601398601398601
13980,,6975,144316,151291,1168,9135,203998,57493,146505,203998,13687,0.034191511681487076,0.707438308218708,0.005725546328885577,0.28183119442347476,0.7181688055765253,0.044779850782850815
13981,15.0,210,4560,4770,60,274,6420,1819,4601,6420,452,0.03271028037383177,0.7102803738317757,0.009345794392523364,0.2833333333333333,0.7166666666666667,0.0426791277258567
13982,14.0,588,10129,10717,80,891,14967,4101,10866,14967,986,0.03928643014632191,0.6767555288300928,0.005345092536914545,0.27400280617358186,0.7259971938264181,0.05953096812988575
13983,24.0,264,4215,4479,45,320,6395,1701,4694,6395,342,0.041282251759186865,0.6591086786551994,0.007036747458952306,0.26598905394839717,0.7340109460516028,0.05003909304143862
13984,,2868,44437,47305,217,3816,66041,17998,48043,66041,4545,0.043427567723081116,0.6728698838600263,0.0032858375857421906,0.27252767220363106,0.727472327796369,0.057782286761254374
13985,23.0,12807,153637,166444,603,9343,223551,63351,160204,223555,18283,0.05728791572543669,0.6872447496141889,0.0026973228064682067,0.2833799288765628,0.7166200711234372,0.0417928473977321
13986,26.0,336,5763,6099,47,275,8064,2294,5770,8064,534,0.041666666666666664,0.7146577380952381,0.005828373015873016,0.28447420634920634,0.7155257936507936,0.034102182539682536
13987,25.0,127,2720,2847,1,130,4408,1096,3312,4408,271,0.028811252268602542,0.617059891107078,0.00022686025408348456,0.24863883847549909,0.7513611615245009,0.029491833030852996
13988,15.0,31,7284,7315,4,411,9706,2794,6912,9706,907,0.0031939006799917577,0.7504636307438698,0.00041211621677313,0.28786317741603135,0.7121368225839687,0.04234494127343911
13989,,44,11457,11501,41,1151,16433,4230,12203,16433,1103,0.002677539098156149,0.6971946692630682,0.0024949796141909572,0.2574088723909207,0.7425911276090793,0.07004198868131199
13990,23.0,645,13212,13857,111,896,18263,5378,12885,18263,1200,0.035317308218803044,0.7234298855609703,0.006077862344631222,0.2944751683732136,0.7055248316267864,0.04906094288999617
13991,36.0,417,8677,9094,33,522,12322,3321,9001,12322,995,0.03384190878104204,0.7041876318779419,0.002678136666125629,0.2695179354000974,0.7304820645999026,0.042363252718714495
13992,,479,4022,4501,13,131,6018,1714,4304,6018,183,0.0795945496842805,0.6683283482884679,0.002160186108341642,0.28481222997673644,0.7151877700232635,0.021768029245596544
13993,,2030,41292,43322,227,2449,58707,16278,42429,58707,3954,0.03457850000851687,0.703357350912157,0.003866659853169128,0.27727528233430426,0.7227247176656958,0.04171563868022553
13994,16.0,10,3106,3116,32,143,4236,1180,3056,4236,385,0.002360717658168083,0.7332389046270066,0.007554296506137866,0.2785646836638338,0.7214353163361662,0.03375826251180359
13995,24.0,1317,36534,37855,272,1851,50416,14314,36102,50416,4029,0.026122659473183117,0.7246509044747699,0.005395112662646779,0.2839178038717867,0.7160821961282132,0.03671453506823231
13996,38.0,117,4009,4126,8,168,5280,1607,3673,5280,371,0.02215909090909091,0.759280303030303,0.0015151515151515152,0.30435606060606063,0.6956439393939394,0.031818181818181815
13997,,127,3038,3165,6,137,4131,1164,2967,4131,334,0.030743161462115712,0.7354151537158073,0.0014524328249818446,0.28177196804647786,0.7182280319535221,0.03316388283708545
13998,35.0,160,3998,4158,14,290,5659,1584,4075,5659,381,0.028273546562996996,0.7064852447428874,0.0024739353242622373,0.27990811097367024,0.7200918890263297,0.051245803145432055
13999,,747,9027,9774,39,744,13556,3683,9873,13556,936,0.05510475066391266,0.6659043965771614,0.002876954853939215,0.271687813514311,0.728312186485689,0.05488344644437887
14000,17.0,1100,26250,27350,44,1270,36560,10579,25981,36560,2991,0.030087527352297593,0.7179978118161926,0.0012035010940919038,0.2893599562363239,0.7106400437636762,0.034737417943107224
14001,37.0,513,8424,8937,54,426,12284,3389,8895,12284,697,0.04176164115923152,0.6857701074568544,0.004395962227287529,0.2758873331162488,0.7241126668837512,0.03467925757082384
14002,17.0,610,12699,13309,103,848,17961,5053,12908,17961,1334,0.033962474249763376,0.7070319024553199,0.005734647291353488,0.2813317744000891,0.718668225599911,0.04721340682590056
14003,44.0,112,2738,2850,24,180,3877,1127,2750,3877,302,0.028888315708021667,0.7062161465050296,0.006190353366004642,0.290688676811968,0.709311323188032,0.04642765024503482
14004,,2135,71797,73932,695,4641,99692,28277,71415,99692,7739,0.02141596116037395,0.7201881795931468,0.0069714721341732535,0.28364362235685914,0.7163563776431409,0.046553384424026
14005,,306,4858,5164,39,799,7332,2000,5332,7332,440,0.041734860883797055,0.6625750136388434,0.005319148936170213,0.27277686852154936,0.7272231314784506,0.10897435897435898
14006,27.0,1806,46406,48212,63,2164,63002,18343,44659,63002,4775,0.028665756642646267,0.7365797911177423,0.0009999682549760324,0.29114948731786294,0.7088505126821371,0.03434811593282753
14007,39.0,2582,75060,77642,360,2491,107665,29245,78420,107665,7452,0.023981795383829472,0.6971624947754609,0.0033437050109134817,0.2716295917893466,0.7283704082106535,0.02313658106162634
14008,23.0,774,8996,9770,17,461,14991,3668,11323,14991,682,0.05163097858715229,0.6000933893669536,0.0011340137415782802,0.24468014141818425,0.7553198585818157,0.030751784403975718
14009,34.0,501,10249,10750,64,586,14313,4033,10280,14313,1064,0.03500314399496961,0.7160623209669531,0.004471459512331447,0.28177181583176136,0.7182281841682386,0.04094180115978481
14010,16.0,102,2116,2218,28,168,3055,842,2213,3055,230,0.03338788870703764,0.6926350245499182,0.009165302782324058,0.2756137479541735,0.7243862520458265,0.05499181669394435
14011,,221,4062,4283,10,170,6557,1570,4987,6557,399,0.0337044380051853,0.6194906207106908,0.0015250876925423213,0.23943876772914444,0.7605612322708556,0.02592649077321946
14012,15.0,617,25213,25830,137,2551,36216,9751,26465,36216,1924,0.01703666887563508,0.6961840070686989,0.0037828584051248066,0.26924563728738676,0.7307543627126132,0.07043848022973272
14013,,56,1504,1560,6,85,2175,561,1614,2175,191,0.02574712643678161,0.6914942528735633,0.002758620689655172,0.2579310344827586,0.7420689655172413,0.03908045977011494
14014,14.0,163,6325,6488,90,471,9184,2544,6640,9184,650,0.017748257839721254,0.6886977351916377,0.00979965156794425,0.2770034843205575,0.7229965156794426,0.051284843205574915
14015,17.0,352,20870,21222,164,1524,28129,7598,20531,28129,1800,0.012513775818550251,0.7419389242418856,0.0058302819154609125,0.27011269508336594,0.7298873049166341,0.05417896121440506
14016,15.0,1114,9887,11001,65,1601,15647,4098,11549,15647,799,0.07119575637502397,0.6318783153320126,0.004154150955454719,0.26190324023774525,0.7380967597622548,0.1023199335335847
14017,26.0,904,22923,23831,218,1881,31599,8789,22810,31599,1645,0.028608500268995855,0.7254343491882654,0.006898952498496788,0.27814171334535903,0.721858286654641,0.05952720022785531
14018,,193,3849,4042,8,180,5465,1514,3951,5465,453,0.035315645013723695,0.7043000914913083,0.001463860933211345,0.27703568161024705,0.722964318389753,0.03293687099725526
14019,14.0,2181,35812,37993,88,3864,53111,14260,38851,53111,3289,0.04106493946640056,0.6742859294684717,0.0016569072320234979,0.26849428555289867,0.7315057144471013,0.07275329027884996
14020,,3279,76332,79611,258,3717,105041,30271,74770,105041,8364,0.03121638217457945,0.7266876743366876,0.0024561837758589502,0.288182709608629,0.711817290391371,0.03538618253824697
14021,25.0,1038,35861,36899,107,1619,47861,14138,33723,47861,3559,0.021687804266521803,0.7492739391153549,0.0022356407095547523,0.29539708739892606,0.704602912601074,0.033827124381020035
14022,17.0,203,9003,9206,105,238,11731,3612,8119,11731,858,0.017304577614866593,0.7674537550080982,0.008950643593896513,0.30790213963004004,0.6920978603699599,0.020288125479498764
14023,23.0,355,4373,4728,8,277,6481,1813,4668,6481,439,0.054775497608393765,0.6747415522295942,0.0012343774108933806,0.2797407807437124,0.7202592192562877,0.0427403178521833
14024,,124,1441,1565,23,86,2112,557,1555,2112,120,0.058712121212121215,0.6822916666666666,0.010890151515151516,0.2637310606060606,0.7362689393939394,0.04071969696969697
14025,16.0,235,5741,5976,86,458,8288,2300,5988,8288,466,0.028354247104247103,0.6926882239382239,0.010376447876447877,0.2775096525096525,0.7224903474903475,0.05526061776061776
14026,,4836,103060,107896,192,6964,153452,41359,112093,153452,10731,0.03151474076584209,0.6716106665276438,0.0012512055887182964,0.2695240205406251,0.7304759794593749,0.04538226937413654
14027,40.0,160,3376,3536,104,138,4868,1332,3536,4868,412,0.03286770747740345,0.6935086277732129,0.021364009860312245,0.2736236647493837,0.7263763352506163,0.028348397699260477
14028,,418,10989,11407,24,433,14659,4395,10264,14659,1004,0.028514905518793914,0.7496418582440821,0.001637219455624531,0.29981581281124225,0.7001841871887577,0.029538167678559248
14029,27.0,100,3193,3293,3,207,4242,1228,3014,4242,247,0.023573785950023574,0.7527109853842527,0.0007072135785007072,0.2894860914662895,0.7105139085337105,0.048797736916548796
14030,26.0,332,9126,9458,85,243,12602,3577,9025,12602,1091,0.026345024599269958,0.7241707665449929,0.006744961117282971,0.283843834312014,0.716156165687986,0.019282653547056022
14031,33.0,71,2417,2488,6,85,3310,970,2340,3310,238,0.021450151057401813,0.7302114803625378,0.0018126888217522659,0.2930513595166163,0.7069486404833837,0.0256797583081571
14032,27.0,225,8038,8263,5,276,10788,3088,7700,10788,917,0.02085650723025584,0.7450871338524286,0.0004634779384501298,0.28624397478680014,0.7137560252131998,0.025583982202447165
14033,,896,23631,24527,23,995,32409,9225,23184,32409,2472,0.027646641365052918,0.7291493103767472,0.0007096794100404208,0.28464315467925577,0.7153568453207443,0.030701348390879075
14034,27.0,207,1828,2035,32,168,2936,733,2203,2936,171,0.07050408719346049,0.6226158038147139,0.010899182561307902,0.24965940054495914,0.7503405994550408,0.05722070844686648
14035,,411,6603,7014,94,466,9562,2655,6907,9562,668,0.04298263961514327,0.6905459108973018,0.009830579376699435,0.27766157707592554,0.7223384229240745,0.04873457435682912
14036,27.0,68,2106,2174,0,195,2987,735,2252,2987,200,0.022765316370940744,0.705055239370606,0.0,0.24606628724472715,0.7539337127552729,0.06528289253431536
14037,27.0,514,17795,18309,13,866,24457,7015,17442,24457,1833,0.021016477899987732,0.7276035490861512,0.0005315451608946314,0.28682994643660303,0.713170053563397,0.03540908533344237
14038,16.0,32,2303,2335,12,91,3100,887,2213,3100,291,0.01032258064516129,0.7429032258064516,0.003870967741935484,0.2861290322580645,0.7138709677419355,0.02935483870967742
14039,,1033,26052,27085,607,1603,36544,10087,26457,36544,2528,0.028267294220665498,0.7128940455341506,0.01661011383537653,0.2760234238178634,0.7239765761821366,0.04386492994746059
14040,16.0,263,4865,5128,19,252,7049,1919,5130,7049,531,0.037310256774010495,0.6901688182720953,0.0026954177897574125,0.2722371967654987,0.7277628032345014,0.03574975173783516
14041,25.0,309,12303,12612,62,453,17006,4706,12300,17006,1489,0.01817005762671998,0.7234505468658121,0.003645772080442197,0.2767258614606609,0.7232741385393391,0.026637657297424438
14042,15.0,175,2866,3041,93,164,4407,1140,3267,4407,238,0.039709552983889264,0.650329022010438,0.02110279101429544,0.2586793737236215,0.7413206262763785,0.03721352393918766
14043,,1763,40441,42204,85,2309,56697,16083,40614,56697,4381,0.031095119671234808,0.713282889747253,0.0014991974884032665,0.28366580242340866,0.7163341975765913,0.04072525883203697
14044,15.0,1365,20731,22096,3,854,31133,8523,22610,31133,1961,0.04384415250698616,0.6658850737159927,9.636077474062892e-05,0.27376096103812675,0.7262390389618733,0.027430700542832365
14045,,692,13824,14516,27,969,19380,5425,13955,19380,1335,0.035706914344685245,0.713312693498452,0.0013931888544891642,0.27992776057791535,0.7200722394220846,0.05
14046,23.0,84,2244,2328,30,83,2998,874,2124,2998,218,0.028018679119412943,0.7484989993328885,0.01000667111407605,0.2915276851234156,0.7084723148765844,0.027685123415610406
14047,45.0,140,3923,4063,8,125,5407,1510,3897,5407,382,0.025892361753282783,0.7255409654152025,0.001479563528759016,0.2792676160532643,0.7207323839467357,0.023118180136859626
14048,,147,4348,4495,15,386,6348,1683,4665,6348,466,0.023156899810964082,0.684940138626339,0.0023629489603024575,0.2651228733459357,0.7348771266540642,0.06080655324511657
14049,47.0,15007,373450,388457,2699,17644,502714,147289,355425,502714,35807,0.029851963541894597,0.7428677140481467,0.0053688578396464,0.29298766296542367,0.7070123370345763,0.03509749081982996
14050,,189,4963,5152,35,166,6570,1982,4588,6570,438,0.028767123287671233,0.7554033485540335,0.00532724505327245,0.30167427701674276,0.6983257229832572,0.025266362252663623
14051,24.0,2709,47623,50332,459,2544,66167,19493,46674,66167,4464,0.04094185923496607,0.7197394471564375,0.00693699276074176,0.2946030498586909,0.7053969501413091,0.038448169026856285
14052,23.0,98,3403,3501,2,96,4566,1366,3200,4566,338,0.02146298729741568,0.7452912833990364,0.0004380201489268506,0.29916776171703896,0.700832238282961,0.02102496714848883
14053,24.0,97,3211,3308,27,58,4292,1242,3050,4292,409,0.022600186393289843,0.7481360671015843,0.006290773532152842,0.2893755824790308,0.7106244175209693,0.013513513513513514
14054,14.0,212,4842,5054,36,303,6803,1939,4864,6803,499,0.031162722328384535,0.7117448184624431,0.005291783036895487,0.2850213141261208,0.7149786858738791,0.044539173893870354
14055,34.0,66,4465,4531,10,237,5723,1665,4058,5723,398,0.011532413070068146,0.7801852175432465,0.0017473353136466887,0.29093132972217367,0.7090686702778263,0.041411846933426526
14056,16.0,322,4956,5278,17,394,7811,2000,5811,7811,478,0.0412239149916784,0.6344898220458328,0.0021764178722314684,0.2560491614389963,0.7439508385610037,0.05044168480348227
14057,17.0,5809,88772,94581,1997,6159,130200,35816,94384,130200,8581,0.04461597542242703,0.6818125960061444,0.015337941628264209,0.27508448540706604,0.7249155145929339,0.04730414746543779
14058,13.0,172,2268,2440,7,186,3329,916,2413,3329,192,0.051667167317512766,0.6812856713727846,0.0021027335536197055,0.2751577050165215,0.7248422949834785,0.055872634424752175
14059,33.0,111,3330,3441,12,611,5098,1272,3826,5098,326,0.02177324440957238,0.6531973322871715,0.0023538642604943117,0.24950961161239701,0.750490388387603,0.11985092193016869
14060,17.0,201,4291,4492,75,195,6064,1698,4366,6064,395,0.03314643799472296,0.7076187335092349,0.012368073878627968,0.2800131926121372,0.7199868073878628,0.03215699208443272
14061,27.0,3467,62790,66257,954,3412,89043,25060,63983,89043,5464,0.03893624428646834,0.7051649203193963,0.010713924732994172,0.2814370584998259,0.7185629415001741,0.038318565187605985
14062,26.0,137,2021,2158,21,153,3022,817,2205,3022,174,0.045334215751158174,0.6687624090006619,0.006949040370615486,0.2703507610853739,0.7296492389146261,0.050628722700198546
14063,,1172,25846,27018,136,995,35911,10155,25756,35911,3111,0.03263623959232547,0.7197237615215394,0.0037871404305087576,0.28278243435159145,0.7172175656484086,0.027707387708501573
14064,,391,7149,7540,131,432,10825,2808,8017,10825,804,0.03612009237875289,0.6604157043879908,0.01210161662817552,0.25939953810623556,0.7406004618937644,0.03990762124711316
14065,16.0,1371,27700,29071,32,1798,40327,11186,29141,40327,2815,0.03399707392069829,0.6868847174349691,0.0007935130309718054,0.2773823988890818,0.7226176011109182,0.04458551342772832
14066,17.0,26,1758,1784,12,167,2577,682,1895,2577,188,0.010089251067132324,0.6821885913853318,0.004656577415599534,0.2646488164532402,0.7353511835467598,0.06480403570042685
14067,13.0,40,4199,4239,10,109,5641,1619,4022,5641,546,0.007090941322460556,0.7443715653252969,0.001772735330615139,0.287005850026591,0.7129941499734089,0.019322815103705017
14068,25.0,1688,46942,48630,93,2300,63760,18392,45368,63760,4854,0.026474278544542033,0.7362296110414053,0.001458594730238394,0.28845671267252193,0.7115432873274781,0.03607277289836888
14069,16.0,52,2984,3036,15,123,4051,1170,2881,4051,377,0.01283633670698593,0.736608244877808,0.00370278943470748,0.28881757590718343,0.7111824240928166,0.030362873364601334
14070,24.0,1367,42981,44348,72,3432,59549,16673,42876,59549,4341,0.022955885069438613,0.721775344674134,0.001209088313825589,0.2799879091168617,0.7200120908831382,0.05763320962568641
14071,,301,9454,9755,3,367,12725,3820,8905,12725,953,0.023654223968565816,0.7429469548133595,0.00023575638506876227,0.300196463654224,0.6998035363457761,0.028840864440078585
14072,24.0,444,14018,14465,4,515,19551,5475,14076,19551,1680,0.02270983581402486,0.7169965730653164,0.00020459311544166538,0.2800368267607795,0.7199631732392205,0.02634136361311442
14073,,290,14111,14401,85,1082,20073,5555,14518,20073,1121,0.014447267473720918,0.7029841080057789,0.0042345439147113036,0.2767398993673093,0.7232601006326906,0.053903253126089776
14074,25.0,1010,20445,21455,72,1332,28716,8278,20438,28716,2372,0.035172029530575286,0.7119724195570414,0.0025073129962390303,0.28827134698425966,0.7117286530157404,0.04638529043042206
14075,38.0,114,5606,5720,42,177,7269,2178,5091,7269,471,0.015683037556747832,0.7712202503783189,0.005777961205117622,0.29962855963681384,0.7003714403631861,0.024349979364424266
14076,15.0,289,6442,6731,20,467,9157,2562,6595,9157,678,0.031560554766845036,0.7035055149066288,0.0021841214371519056,0.2797859560991591,0.7202140439008409,0.050999235557497
14077,,75,2588,2663,9,176,3541,1015,2526,3541,262,0.021180457497881954,0.7308669867269133,0.0025416548997458347,0.2866421914713358,0.7133578085286643,0.049703473595029656
14078,,74,2998,3072,20,118,4181,1195,2986,4181,348,0.017699115044247787,0.717053336522363,0.004783544606553456,0.28581679024156903,0.714183209758431,0.02822291317866539
14079,17.0,146,8512,8658,21,303,10987,3287,7700,10987,740,0.013288431783016292,0.7747337762810594,0.0019113497770091928,0.2991717484299627,0.7008282515700374,0.02757804678256121
14080,,656,6612,7268,54,740,10877,2685,8192,10877,642,0.06031074744874506,0.6078882044681438,0.004964604210719868,0.24685115381079342,0.7531488461892066,0.06803346510986485
14081,34.0,330,4230,4560,16,252,6080,1675,4405,6080,445,0.054276315789473686,0.6957236842105263,0.002631578947368421,0.2754934210526316,0.7245065789473685,0.04144736842105263
14082,,345,63204,63549,75,6017,84740,23322,61418,84740,6573,0.004071276846825584,0.7458579183384471,0.0008850601840925183,0.2752183148454095,0.7247816851545905,0.0710054283691291
14083,14.0,34,2357,2391,2,374,3475,908,2567,3475,321,0.009784172661870504,0.6782733812949641,0.0005755395683453237,0.261294964028777,0.7387050359712231,0.10762589928057555
14084,16.0,436,9244,9680,92,1289,13980,3477,10503,13980,856,0.03118741058655222,0.6612303290414878,0.006580829756795422,0.24871244635193132,0.7512875536480687,0.09220314735336195
14085,14.0,713,7243,7956,51,471,10365,2983,7382,10365,566,0.06878919440424505,0.6987940183309214,0.004920405209840811,0.28779546550892426,0.7122045344910757,0.04544138929088278
14086,23.0,71,1915,1986,13,73,2639,789,1850,2639,210,0.026904130352406214,0.7256536566881394,0.0049261083743842365,0.29897688518378174,0.7010231148162183,0.027661993179234557
14087,26.0,1042,28273,29315,116,1353,39472,10977,28495,39472,3235,0.026398459667612485,0.7162798946088367,0.0029387920551276854,0.2780958654235914,0.7219041345764086,0.034277462505066886
14088,25.0,1824,37034,38858,318,2046,52036,14717,37874,52591,4193,0.03468274039284288,0.7041889296647715,0.006046661976383792,0.27983875568062977,0.7201612443193702,0.03890399498012968
14089,16.0,855,17122,17977,87,894,23858,6895,16963,23858,1745,0.03583703579512113,0.7176628384608936,0.0036465755721351327,0.28900159275714643,0.7109984072428536,0.037471707603319644
14090,27.0,99185,1612140,1711325,5066,74055,2295831,656041,1639790,2295831,180923,0.04320222176632339,0.7022032545078448,0.00220660841324993,0.28575317608308276,0.7142468239169172,0.03225629412617915
14091,17.0,243,15912,16155,139,2835,24716,6245,18471,24716,1355,0.00983168797540055,0.6437934940928953,0.005623887360414306,0.2526703350056643,0.7473296649943356,0.11470302637967308
14092,14.0,98,1774,1872,19,142,2611,713,1898,2611,197,0.03753351206434316,0.6794331673688242,0.007276905400229797,0.27307545001914973,0.7269245499808502,0.05438529299119112
14093,16.0,8668,144939,153607,1047,11586,210294,58222,152072,210294,14047,0.041218484597753624,0.6892208051584924,0.0049787440440526125,0.2768600150265818,0.7231399849734181,0.055094296556249825
14094,,229,3383,3612,35,183,4964,1360,3604,4964,399,0.04613215149073328,0.6815068493150684,0.007050765511684126,0.273972602739726,0.726027397260274,0.03686543110394843
14095,15.0,344,4912,5256,3,442,7142,1832,5310,7142,564,0.04816577989358723,0.6877625315037804,0.00042005040604872583,0.25651078129375526,0.7434892187062447,0.06188742649117894
14096,17.0,665,19093,19758,83,2356,28390,7524,20866,28390,1977,0.023423740753786546,0.6725255371609722,0.0029235646354350124,0.2650228953856992,0.7349771046143008,0.08298696724198662
14097,48.0,58,1696,1754,14,47,2280,687,1593,2280,216,0.02543859649122807,0.743859649122807,0.0061403508771929825,0.3013157894736842,0.6986842105263158,0.0206140350877193
14098,,110,3931,4041,17,232,5368,1523,3845,5368,440,0.020491803278688523,0.7323025335320418,0.0031669150521609537,0.2837183308494784,0.7162816691505216,0.043219076005961254
14099,26.0,1282,21147,22429,109,1408,30217,8561,21656,30217,2104,0.04242644868782473,0.6998378396267002,0.003607240957077142,0.2833173379223616,0.7166826620776384,0.04659628685839097
14100,15.0,491,10468,10959,4,1702,16044,4201,11843,16044,984,0.030603340812764897,0.6524557466965843,0.0002493143854400399,0.2618424333084019,0.7381575666915982,0.10608327100473697
14101,27.0,31,1666,1697,5,110,2466,634,1832,2466,181,0.012570965125709651,0.67558799675588,0.00202757502027575,0.2570965125709651,0.7429034874290349,0.04460665044606651
14102,16.0,1342,21793,23135,67,1594,31387,8834,22553,31387,2195,0.04275655526173257,0.6943320483002517,0.0021346417306528183,0.28145410520279096,0.718545894797209,0.05078535699493421
14103,34.0,160,3339,3499,8,183,4840,1366,3474,4840,427,0.03305785123966942,0.6898760330578513,0.001652892561983471,0.2822314049586777,0.7177685950413223,0.037809917355371904
14104,42.0,266,8635,8901,13,293,11364,3423,7941,11364,833,0.023407250967969025,0.7598556846180923,0.0011439633931714186,0.30121436114044353,0.6987856388595565,0.02578317493840197
14105,17.0,688,21506,22194,40,1069,28950,8434,20516,28950,2185,0.02376511226252159,0.74286701208981,0.001381692573402418,0.29132987910189984,0.7086701208981002,0.03692573402417962
14106,13.0,534,6688,7222,13,773,10272,2768,7504,10272,692,0.051985981308411214,0.6510903426791277,0.0012655763239875389,0.26947040498442365,0.7305295950155763,0.07525311526479751
14107,,110,2995,3105,11,158,4115,1154,2961,4115,333,0.026731470230862697,0.7278250303766707,0.0026731470230862697,0.2804374240583232,0.7195625759416768,0.03839611178614824
14108,13.0,193,4329,4522,26,398,6422,1719,4703,6422,403,0.030052943008408595,0.6740890688259109,0.004048582995951417,0.26767362192463406,0.7323263780753659,0.06197446278417938
14109,,2754,55637,58391,219,2927,77934,22220,55714,77934,5978,0.035337593348217726,0.7138989401288269,0.00281007005928093,0.2851130443708779,0.7148869556291221,0.03755742038134832
14110,,3179,52993,56172,269,2687,73437,21610,51827,73437,4975,0.04328880537058976,0.7216117216117216,0.003663003663003663,0.29426583329929057,0.7057341667007094,0.03658918528807004
14111,25.0,590,1066,1656,8,96,2341,617,1724,2341,118,0.25202904741563437,0.45536095685604444,0.0034173430158052115,0.26356258009397693,0.7364374199060231,0.04100811618966254
14112,,1028,14786,15814,83,1262,21819,5967,15852,21819,1439,0.04711489985792199,0.6776662541821349,0.0038040240157660755,0.2734772446033274,0.7265227553966727,0.05783949768550346
14113,34.0,81,1858,1939,3,122,2571,716,1855,2571,188,0.03150525087514586,0.7226760015558149,0.0011668611435239206,0.2784908595877091,0.721509140412291,0.047452353169972775
14114,,155,7789,8421,40,378,11059,2959,8100,11059,814,0.01401573379148205,0.7043132290442173,0.0036169635590921423,0.2675648792838412,0.7324351207161588,0.03418030563342074
14115,16.0,774,15973,16747,61,1112,22832,6426,16406,22832,1635,0.03389978976874562,0.6995882971268396,0.002671688857743518,0.2814470918009811,0.718552908199019,0.048703573931324455
14116,16.0,5714,242812,248526,601,11811,338038,96212,241826,338038,30293,0.016903425058721208,0.7182979428348292,0.0017779066258822973,0.2846188890006449,0.7153811109993551,0.034939858832438955
14117,23.0,127,2267,2394,45,140,3289,939,2350,3289,217,0.038613560352690784,0.6892672544846458,0.013681970203709334,0.2854971115840681,0.7145028884159319,0.042566129522651264
14118,23.0,137,3183,3320,47,206,4584,1263,3321,4584,328,0.02988656195462478,0.694371727748691,0.01025305410122164,0.2755235602094241,0.724476439790576,0.04493891797556719
14119,16.0,806,13983,14789,290,718,19459,5602,13857,19459,1129,0.04142042242664063,0.718587799989722,0.014903129657228018,0.2878873528958323,0.7121126471041678,0.03689809342720592
14120,24.0,169,4195,4364,7,287,5912,1645,4267,5912,489,0.02858592692828146,0.709573748308525,0.0011840324763193505,0.27824763193504737,0.7217523680649527,0.04854533152909337
14121,15.0,69,1931,2000,4,127,2735,732,2003,2735,220,0.02522851919561243,0.7060329067641682,0.0014625228519195613,0.2676416819012797,0.7323583180987203,0.046435100548446066
14122,,14,4631,4645,0,180,6290,1708,4582,6290,418,0.0022257551669316376,0.736248012718601,0.0,0.2715421303656598,0.7284578696343402,0.028616852146263912
14123,15.0,100,3057,3157,13,244,4272,1271,3001,4272,217,0.023408239700374533,0.7155898876404494,0.003043071161048689,0.2975187265917603,0.7024812734082397,0.05711610486891386
14124,15.0,134,3445,3579,9,189,4693,1352,3341,4693,349,0.02855316428723631,0.7340720221606648,0.0019177498401875134,0.2880886426592798,0.7119113573407202,0.040272746643937776
14125,26.0,1776,25252,27681,169,1764,38743,9158,29752,38910,2205,0.045643793369313804,0.6489848368028784,0.0043433564636340275,0.23536365972757645,0.7646363402724236,0.04533538936006168
14126,,35,2256,2291,33,85,2897,926,1971,2897,189,0.012081463583016915,0.7787366240938902,0.011391094235415948,0.3196410079392475,0.6803589920607525,0.029340697273041078
14127,15.0,336,19942,20278,976,2308,30027,7696,22331,30027,1925,0.011189929063842542,0.6641356112831784,0.03250407966163786,0.2563026609384887,0.7436973390615113,0.07686415559329936
14128,26.0,19045,1132122,1151167,4395,55800,1513243,435089,1078154,1513243,117046,0.012585553014287857,0.7481428957543501,0.0029043583879125824,0.2875209070849824,0.7124790929150177,0.03687444779192767
14129,,4000,77001,81001,788,4339,108217,30671,77546,108217,7161,0.03696276925067226,0.7115425487677537,0.0072816655423824355,0.28342127392184224,0.7165787260781578,0.040095363944666736
14130,41.0,113,5993,6106,18,323,8138,2370,5768,8138,680,0.0138854755468174,0.7364217252396166,0.0022118456623248955,0.2912263455394446,0.7087736544605554,0.03969034160727451
14131,23.0,320,3455,3775,22,212,5403,1397,4006,5403,343,0.059226355728299096,0.6394595595039793,0.0040718119563205625,0.2585600592263557,0.7414399407736443,0.03923746066999815
14132,27.0,942,19946,20888,82,1020,27003,7701,19302,27003,1614,0.03488501277635818,0.7386586675554568,0.0030366996259674852,0.2851905343850683,0.7148094656149316,0.03777358071325408
14133,,113,2253,2366,61,54,3163,893,2270,3163,179,0.035725576983876066,0.7122984508378122,0.019285488460322478,0.28232690483717987,0.7176730951628201,0.01707239962061334
14134,17.0,0,1436,1436,15,194,2127,546,1581,2127,99,0.0,0.6751292900799247,0.007052186177715092,0.2566995768688293,0.7433004231311706,0.09120827456511518
14135,17.0,374,9466,9840,46,586,13836,3748,10088,13836,877,0.027030933795894767,0.6841572708875397,0.00332466030644695,0.27088753975137325,0.7291124602486267,0.04235328129517202
14136,14.0,490,5573,6063,61,541,8225,2203,6022,8225,532,0.059574468085106386,0.6775683890577507,0.007416413373860183,0.2678419452887538,0.7321580547112462,0.06577507598784195
14137,41.0,3278,80951,84229,509,4358,112936,31756,81180,112936,8963,0.02902528865906354,0.7167864985478501,0.004506977403130977,0.281185804349366,0.718814195650634,0.03858822696040235
14138,15.0,358,4348,4706,40,402,6552,1838,4714,6552,406,0.05463980463980464,0.6636141636141636,0.006105006105006105,0.2805250305250305,0.7194749694749695,0.06135531135531135
14139,,187,3275,3462,2,265,4769,1234,3535,4769,273,0.03921157475361711,0.6867267771021178,0.0004193751310547285,0.25875445586076745,0.7412455441392325,0.05556720486475152
14140,16.0,1,1860,1861,5,226,2675,733,1942,2675,176,0.00037383177570093456,0.6953271028037383,0.001869158878504673,0.27401869158878506,0.725981308411215,0.08448598130841121
14141,13.0,909,10181,11090,22,940,15082,4370,10712,15082,1001,0.06027052115104098,0.6750430977323962,0.0014586924811033019,0.28974937011006496,0.710250629889935,0.0623259514653229
14142,,2899,57310,60209,187,3070,79679,22590,57089,79679,5643,0.036383488748603775,0.7192610349025464,0.002346917004480478,0.2835125942845668,0.7164874057154331,0.03852960002008057
14143,24.0,3691,83729,87420,492,2930,111279,34042,77237,111279,7592,0.03316888181957063,0.7524240872042344,0.004421319386407139,0.30591576128469883,0.6940842387153012,0.026330215045066906
14144,25.0,75,1941,2016,8,119,2660,784,1876,2660,214,0.02819548872180451,0.7296992481203007,0.0030075187969924814,0.29473684210526313,0.7052631578947368,0.04473684210526316
14145,14.0,245,2957,3202,11,144,4314,1206,3108,4314,323,0.05679184051923968,0.6854427445526193,0.0025498377375985167,0.2795549374130737,0.7204450625869263,0.03337969401947149
14146,,173,3083,3256,10,290,4326,1156,3170,4326,270,0.03999075358298659,0.712667591308368,0.002311604253351826,0.2672214516874711,0.7327785483125289,0.06703652334720296
14147,,669,14930,15599,255,1771,22187,5892,16295,22187,1400,0.030152792175598322,0.672916572767837,0.011493216748546446,0.2655609140487673,0.7344390859512328,0.07982151710461081
14148,,485,20379,20864,77,2226,29201,8051,21150,29201,2020,0.01660902023903291,0.6978870586623745,0.0026368959967124415,0.2757097359679463,0.7242902640320537,0.07623026608677785
14149,,281,3086,3367,15,161,4528,1280,3248,4528,310,0.06205830388692579,0.6815371024734982,0.0033127208480565372,0.2826855123674912,0.7173144876325088,0.0355565371024735
14150,17.0,329,5201,5530,7,237,7336,2119,5217,7336,625,0.04484732824427481,0.708969465648855,0.0009541984732824427,0.2888495092693566,0.7111504907306434,0.032306434023991276
14151,25.0,5687,141780,147467,638,6959,196703,56109,140594,196703,13573,0.028911607855497883,0.7207820927998048,0.0032434685795336114,0.28524730176967306,0.7147526982303269,0.035378209788361134
14152,45.0,61,1409,1470,4,94,1999,556,1443,1999,161,0.030515257628814407,0.7048524262131065,0.002001000500250125,0.27813906953476736,0.7218609304652326,0.04702351175587794
14153,23.0,1070,36847,37917,224,2236,49360,14017,35343,49360,3338,0.021677471636952998,0.7464951377633712,0.00453808752025932,0.28397487844408426,0.7160251215559157,0.0452998379254457
14154,,28,4021,4049,54,326,5648,1516,4132,5648,151,0.004957507082152974,0.7119334277620396,0.009560906515580737,0.26841359773371104,0.7315864022662889,0.05771954674220963
14155,25.0,455,9175,9630,716,546,14049,3589,10460,14049,1039,0.03238664673642252,0.6530713929817069,0.050964481457755,0.2554630222791658,0.7445369777208343,0.03886397608370702
14156,16.0,137,1451,1588,4,141,2204,598,1606,2204,140,0.06215970961887477,0.6583484573502723,0.0018148820326678765,0.2713248638838475,0.7286751361161524,0.06397459165154265
14157,23.0,46,3509,3555,5,159,4694,1368,3326,4694,437,0.0097997443544951,0.7475500639113762,0.0010651896037494673,0.29143587558585426,0.7085641244141457,0.03387302939923306
14158,,290,9775,10256,37,582,13865,3842,10023,13865,949,0.020915975477821855,0.7050126217093401,0.0026685899747565813,0.27710061305445366,0.7228993869455463,0.04197619906238731
14159,,111,3277,3388,21,153,4589,1346,3243,4589,311,0.024188276312922204,0.7140989322292438,0.004576160383525822,0.2933100893440837,0.7066899106559164,0.033340597079973854
14160,,73,3422,3495,2,296,4823,1344,3479,4823,430,0.015135807588637777,0.7095168981961435,0.00041467965996267884,0.27866473149492016,0.7213352685050798,0.061372589674476466
14161,15.0,141,2721,2862,8,183,4093,1049,3044,4093,347,0.03444905936965551,0.664793549963352,0.0019545565599804545,0.2562912289274371,0.743708771072563,0.044710481309552894
14162,25.0,691,17317,18008,65,868,23566,6959,16607,23566,1834,0.02932190443859798,0.7348298395994229,0.0027582109819231098,0.29529831112619875,0.7047016888738012,0.03683272511245014
14163,,2427,103638,106065,608,7144,140783,40466,100317,140783,11552,0.017239297358345822,0.7361542231661493,0.004318703252523387,0.28743527272468977,0.7125647272753103,0.050744763217149796
14164,16.0,689,16232,16921,121,1428,23906,6466,17440,23906,1677,0.0288212164310215,0.6789927214925123,0.0050614908391198865,0.2704760311218941,0.7295239688781059,0.05973395800217519
14165,13.0,20,3445,3465,31,415,4882,1315,3567,4882,312,0.004096681687832855,0.7056534207292093,0.006349856616140926,0.26935682097501024,0.7306431790249898,0.08500614502253175
14166,15.0,491,1864,2355,2,145,3270,900,2370,3270,216,0.15015290519877675,0.5700305810397553,0.0006116207951070336,0.27522935779816515,0.7247706422018348,0.04434250764525994
14167,13.0,449,6379,6828,84,429,9225,2569,6656,9225,680,0.04867208672086721,0.691490514905149,0.009105691056910569,0.27848238482384824,0.7215176151761518,0.046504065040650404
14168,26.0,90,2359,2449,1,120,3400,945,2455,3400,285,0.026470588235294117,0.6938235294117647,0.0002941176470588235,0.27794117647058825,0.7220588235294118,0.03529411764705882
14169,,1959,42119,44078,479,1849,58216,16674,41542,58216,4283,0.03365054280610141,0.7234952590353168,0.008227978562594477,0.2864161055379964,0.7135838944620035,0.03176102789611104
14170,39.0,163,2825,2988,13,160,4040,1143,2897,4040,298,0.04034653465346535,0.6992574257425742,0.0032178217821782176,0.2829207920792079,0.717079207920792,0.039603960396039604
14171,24.0,2055,32060,34115,284,1662,44687,12841,31846,44687,3070,0.045986528520598834,0.7174346006668606,0.006355315863673999,0.28735426410365433,0.7126457358963457,0.037192024526148545
14172,15.0,346,4656,5002,13,437,6945,1945,5000,6945,451,0.04982001439884809,0.6704103671706263,0.0018718502519798417,0.28005759539236863,0.7199424046076314,0.06292296616270698
14173,17.0,1485,33654,35139,65,650,44975,13466,31509,44975,3531,0.0330183435241801,0.7482823790994997,0.0014452473596442469,0.2994107837687604,0.7005892162312396,0.014452473596442469
14174,24.0,1543,19951,21494,152,1549,28718,7932,20786,28718,1704,0.053729368340413676,0.6947210808552128,0.0052928476913434086,0.2762030782087889,0.7237969217912111,0.05393829653875618
14175,16.0,355,7278,7633,54,416,10226,2826,7400,10226,734,0.03471543125366712,0.7117152356737727,0.00528065714844514,0.276354390768629,0.723645609231371,0.04068061803246626
14176,24.0,77,1733,1810,3,105,2388,700,1688,2388,144,0.032244556113902846,0.72571189279732,0.001256281407035176,0.2931323283082077,0.7068676716917923,0.04396984924623116
14177,24.0,535,13779,14314,7,658,18956,5524,13432,18956,1414,0.028223253851023422,0.726893859464022,0.00036927621861152144,0.29141169023000635,0.7085883097699937,0.03471196454948301
14178,14.0,7522,98641,106163,458,9432,151310,40149,111161,151310,9927,0.04971251073954134,0.6519132905954662,0.0030268984204613048,0.2653426739805697,0.7346573260194303,0.06233560240565726
14179,16.0,79,1269,1348,0,116,1891,506,1385,1891,140,0.04177683765203596,0.6710735060814383,0.0,0.2675832892649392,0.7324167107350608,0.061343204653622425
14180,14.0,361,4157,4518,10,662,6758,1751,5007,6758,365,0.0534181710565256,0.6151228174015981,0.001479727730097662,0.2591003255401006,0.7408996744598993,0.09795797573246523
14181,13.0,82,8020,8102,29,1842,11415,2770,8645,11415,290,0.00718353044240035,0.7025843188786685,0.0025405168637757337,0.24266316250547526,0.7573368374945247,0.16136662286465178
14182,25.0,360,6873,7233,30,408,9615,2774,6841,9615,681,0.0374414976599064,0.7148205928237129,0.0031201248049922,0.2885075403016121,0.7114924596983879,0.042433697347893914
14183,24.0,146,3485,3631,33,249,5014,1390,3624,5014,340,0.029118468288791385,0.6950538492221779,0.00658157159952134,0.2772237734343837,0.7227762265656162,0.04966094934184284
14184,16.0,1116,30853,31969,95,1324,42270,12385,29897,42282,3671,0.02639421030225628,0.7296958516626461,0.0022468189773426042,0.29291424246724374,0.7070857575327563,0.03131356132633272
14185,15.0,23,2974,2997,8,601,4468,1107,3361,4468,269,0.005147717099373322,0.6656222023276633,0.0017905102954341987,0.24776186213070725,0.7522381378692927,0.13451208594449418
14186,,285,9036,9321,16,441,12325,3587,8738,12325,892,0.023123732251521298,0.7331440162271805,0.0012981744421906693,0.2910344827586207,0.7089655172413794,0.03578093306288033
14187,,31653,374921,406575,2136,28103,564764,156293,408593,564886,37273,0.05603431488831375,0.6637109080416226,0.0037812939247919048,0.2766806045821635,0.7233193954178365,0.04974986103390772
14188,24.0,207,6219,6426,20,308,8502,2486,6016,8502,671,0.024347212420606917,0.7314749470712774,0.002352387673488591,0.29240178781463183,0.7075982121853681,0.0362267701717243
14189,,68,5059,5127,63,451,7112,1887,5225,7112,384,0.009561304836895388,0.7113329583802025,0.008858267716535433,0.26532620922384703,0.734673790776153,0.06341394825646794
14190,15.0,190,2178,2368,10,158,3199,906,2293,3199,218,0.05939356048765239,0.6808377618005627,0.0031259768677711786,0.28321350422006875,0.7167864957799313,0.04939043451078462
14191,27.0,150,4820,4970,6,265,6672,1925,4747,6672,545,0.022482014388489208,0.7224220623501199,0.0008992805755395684,0.28851918465227816,0.7114808153477218,0.03971822541966427
14192,23.0,1833,35498,37331,163,1804,50303,14538,35769,50307,3753,0.03643628123322798,0.7056274474725187,0.0032401057506907588,0.2889856282425905,0.7110143717574096,0.035859820700896494
14193,,5012,145962,150974,242,5300,198237,57563,140674,198237,17024,0.025282868485701458,0.73630048880885,0.0012207610082880592,0.290374652562337,0.709625347437663,0.026735674974903777
14194,45.0,371,5926,6297,125,208,8330,2377,5953,8330,602,0.04453781512605042,0.7114045618247299,0.015006002400960384,0.2853541416566627,0.7146458583433374,0.02496998799519808
14195,,499,11515,12014,38,713,15877,4553,11324,15877,1047,0.03142911129306544,0.7252629589972917,0.0023933992567865465,0.28676702147760913,0.7132329785223909,0.04490772816023178
14196,,100,3861,3961,6,161,5121,1479,3642,5121,339,0.019527436047646944,0.7539543057996485,0.0011716461628588166,0.2888107791446983,0.7111892208553017,0.03143917203671158
14197,15.0,55,1765,1820,0,60,2410,711,1699,2410,185,0.022821576763485476,0.7323651452282157,0.0,0.2950207468879668,0.7049792531120332,0.024896265560165973
14198,26.0,167,4201,4368,32,426,6096,1685,4411,6096,459,0.02739501312335958,0.6891404199475065,0.005249343832020997,0.27641076115485563,0.7235892388451444,0.06988188976377953
14199,16.0,281,3874,4155,10,380,5750,1606,4144,5750,312,0.0488695652173913,0.6737391304347826,0.0017391304347826088,0.27930434782608693,0.7206956521739131,0.06608695652173913
14200,16.0,84,3108,3192,3,63,4212,1183,3029,4212,406,0.019943019943019943,0.7378917378917379,0.0007122507122507123,0.2808641975308642,0.7191358024691358,0.014957264957264958
14201,,400,12611,13011,65,478,16613,4947,11666,16613,1071,0.024077529645458375,0.759104315897189,0.003912598567386986,0.2977788478902065,0.7022211521097935,0.02877264792632276
14202,24.0,68,3502,3570,0,110,4573,1362,3211,4573,352,0.01486988847583643,0.7657992565055762,0.0,0.29783511917778266,0.7021648808222174,0.024054231357970697
14203,,2034,31252,33286,175,2404,45615,12610,33005,45615,3159,0.044590595198947716,0.6851255069604297,0.003836457305710841,0.27644415214293544,0.7235558478570646,0.052701962073879206
14204,24.0,2031,44785,46816,305,2471,62214,17613,44601,62214,4198,0.03264538528305526,0.7198540521426046,0.004902433535860096,0.28310348153148807,0.7168965184685119,0.03971774841675507
14205,24.0,796,19212,20008,188,1132,27379,7687,19697,27384,2240,0.02906806894536956,0.7015775635407537,0.006865322816243062,0.28071136430032134,0.7192886356996786,0.04133800759567631
14206,13.0,64,3337,3401,14,190,4500,1246,3254,4500,380,0.014222222222222223,0.7415555555555555,0.003111111111111111,0.2768888888888889,0.7231111111111111,0.042222222222222223
14207,26.0,672,14962,15634,24,1042,21307,5905,15402,21307,1491,0.03153893086778993,0.7022105411367157,0.0011263903881353545,0.2771389684141362,0.7228610315858638,0.04890411601820998
14208,26.0,167,2753,2920,22,186,3923,1090,2833,3923,246,0.04256946214631659,0.7017588580168238,0.005607953097119552,0.2778485852663778,0.7221514147336222,0.04741269436655621
14209,16.0,49,1910,1959,3,54,2684,720,1964,2684,197,0.01825633383010432,0.7116244411326379,0.0011177347242921013,0.26825633383010433,0.7317436661698957,0.020119225037257823
14210,,398,9871,10269,12,472,13453,3975,9478,13453,984,0.02958447929829778,0.73373968631532,0.0008919943507024455,0.2954731286701851,0.704526871329815,0.03508511112762953
14211,23.0,2441,54674,57115,388,2702,75918,21524,54394,75918,6288,0.032153112568824256,0.7201717642719777,0.0051107774177401935,0.2835164256171132,0.7164835743828868,0.03559103242972681
14212,,3472,77076,80548,761,3403,102072,30763,71309,102072,6746,0.034015204953366254,0.7551140371502468,0.007455521592601301,0.30138529665334274,0.6986147033466572,0.03333921153695431
14213,,459,7507,7966,38,400,10747,3085,7662,10747,769,0.04270959337489532,0.6985205173536801,0.0035358704754815296,0.28705685307527684,0.7129431469247232,0.03721968921559505
14214,14.0,23,2502,2525,2,252,3500,950,2550,3500,242,0.006571428571428572,0.7148571428571429,0.0005714285714285715,0.2714285714285714,0.7285714285714285,0.072
14215,,240,5362,5602,30,181,7326,2144,5182,7326,559,0.03276003276003276,0.7319137319137319,0.004095004095004095,0.29265629265629267,0.7073437073437073,0.024706524706524707
14216,26.0,210,5630,5840,26,209,7415,2226,5189,7415,472,0.028320971004720162,0.7592717464598786,0.003506405933917734,0.30020229265003373,0.6997977073499663,0.02818610923803102
14217,26.0,186,8197,8383,8,539,11683,3184,8499,11683,1152,0.015920568347171104,0.701617735170761,0.0006847556278353163,0.2725327398784559,0.7274672601215442,0.046135410425404436
14218,,195,4570,4765,42,187,6434,1810,4627,6437,516,0.03029361503806121,0.7099580549945627,0.006524778623582414,0.28118688830200406,0.718813111697996,0.02905080006214075
14219,,10,1546,1556,10,58,2108,588,1520,2108,191,0.004743833017077799,0.7333965844402277,0.004743833017077799,0.27893738140417457,0.7210626185958254,0.027514231499051234
14220,,204,2703,2907,76,107,3951,1076,2875,3951,231,0.051632498101746395,0.6841305998481397,0.01923563654770944,0.2723361174386231,0.7276638825613768,0.027081751455327766
14221,33.0,180,4007,4187,50,162,5507,1584,3923,5507,451,0.032685672780098055,0.7276193934991828,0.009079353550027237,0.2876339204648629,0.7123660795351371,0.029417105502088252
14222,37.0,4728,102391,107119,837,5052,141262,40877,100385,141262,9325,0.03346972292619388,0.7248304568815392,0.005925160340360465,0.28937010661041185,0.7106298933895882,0.035763333380526965
14223,,1269,26774,28043,57,3051,38785,10587,28198,38785,2758,0.032718834601005546,0.6903184220703881,0.0014696403248678613,0.2729663529715096,0.7270336470284904,0.07866443212582183
14224,14.0,1261,25135,26396,113,1394,36209,9823,26386,36209,3019,0.03482559584633654,0.6941644342566765,0.003120771079013505,0.271286144328758,0.7287138556712419,0.03849871578889227
14225,27.0,98,3524,3622,8,136,4677,1376,3301,4677,328,0.020953602736797094,0.7534744494333975,0.001710498182595681,0.29420568740645714,0.7057943125935429,0.029078469104126578
14226,,1645,32077,33722,84,1446,43788,12996,30792,43788,2951,0.037567370055723026,0.7325522974330867,0.0019183337900794738,0.29679364209372433,0.7032063579062757,0.033022745957796654
14227,,224,2871,3095,17,446,4720,1148,3572,4720,273,0.04745762711864407,0.6082627118644067,0.0036016949152542373,0.24322033898305084,0.7567796610169492,0.09449152542372881
14228,,98,5365,5463,5,211,6995,2161,4834,6995,564,0.014010007147962831,0.7669764117226591,0.0007147962830593281,0.3089349535382416,0.6910650464617584,0.030164403145103644
14229,14.0,654,12557,13211,87,753,17622,5015,12607,17622,1300,0.037112700034048346,0.71257519010328,0.004937010554988083,0.28458744750879583,0.7154125524912042,0.04273067756213823
14230,,90,2333,2423,9,105,3205,920,2285,3205,255,0.028081123244929798,0.7279251170046802,0.0028081123244929796,0.2870514820592824,0.7129485179407177,0.0327613104524181
14231,33.0,338,2999,3337,21,202,5041,1197,3844,5041,252,0.06705018845467169,0.5949216425312438,0.00416584011108907,0.23745288633207698,0.762547113667923,0.040071414401904384
14232,,3424,99343,102767,895,4810,135623,39366,96257,135623,9668,0.02524645524726632,0.7324937510599234,0.0065991756560465405,0.29026050153734984,0.7097394984626502,0.03546596078836185
14233,24.0,306,9500,9806,33,324,12714,3791,8923,12714,1097,0.02406795658329401,0.7472078024225264,0.0025955639452571967,0.2981752398930313,0.7018247601069687,0.025483718735252476
14234,26.0,2122,39597,41719,467,2304,55708,15906,39802,55708,3660,0.038091476987147266,0.7107955769368852,0.008382997056078121,0.2855245207151576,0.7144754792848423,0.04135851224240684
14235,,1922,47305,49227,486,1749,64205,18783,45422,64205,4736,0.02993536328946344,0.73678062456195,0.00756950393271552,0.29254730939957946,0.7074526906004205,0.027240869091192273
14236,25.0,2272,45306,47578,318,2522,63448,17943,45505,63448,4178,0.035808851342831925,0.7140650611524398,0.005011978312949187,0.2827985121674442,0.7172014878325558,0.03974908586559072
14237,16.0,871,21895,22766,209,3614,33638,8554,25084,33638,2064,0.025893334918841784,0.650900766989714,0.006213211249182472,0.2542957369641477,0.7457042630358524,0.10743801652892562
14238,38.0,399,5840,6239,4,343,8790,2250,6540,8790,532,0.04539249146757679,0.664391353811149,0.0004550625711035267,0.25597269624573377,0.7440273037542662,0.039021615472127416
14239,27.0,128,2060,2188,28,173,3426,825,2601,3426,239,0.037361354349095155,0.6012842965557501,0.008172796263864565,0.24080560420315236,0.7591943957968477,0.05049620548744892
14240,16.0,150,3646,3796,9,227,5046,1448,3598,5046,372,0.029726516052318668,0.7225525168450257,0.0017835909631391202,0.2869599682917162,0.7130400317082838,0.044986127625842254
14241,13.0,1573,55946,57519,390,3868,78684,22480,56204,78684,6226,0.019991357836408926,0.7110213003914392,0.0049565350007625434,0.2856997610695948,0.7143002389304052,0.04915865995628082
14242,,872,11736,12608,296,915,17396,4774,12622,17396,665,0.050126465854219364,0.6746378477810991,0.017015405840423086,0.27443090365601286,0.7255690963439871,0.05259829845941596
14243,,61,2176,2237,12,86,3049,861,2188,3049,277,0.020006559527714005,0.7136766152836995,0.003935716628402755,0.28238766808789767,0.7176123319121023,0.028205969170219745
14244,16.0,86,2825,2911,4,198,3873,1137,2736,3873,312,0.022205009036922282,0.7294087270849471,0.0010327911179963851,0.2935708752904725,0.7064291247095275,0.05112316034082107
14245,,226,7870,8096,7,294,10592,3054,7538,10592,929,0.021336858006042295,0.7430135951661632,0.0006608761329305136,0.28833081570996977,0.7116691842900302,0.027756797583081572
14246,16.0,285,4348,4633,35,264,6352,1766,4586,6352,418,0.04486775818639799,0.6845088161209067,0.00551007556675063,0.27802267002518893,0.7219773299748111,0.041561712846347604
14247,27.0,52,1561,1613,9,78,2187,610,1577,2187,170,0.02377686328303612,0.7137631458619113,0.00411522633744856,0.27892089620484684,0.7210791037951532,0.03566529492455418
14248,17.0,191,4016,4207,0,288,5527,1574,3953,5527,383,0.034557626198661116,0.726614800072372,0.0,0.28478378867378323,0.7152162113262167,0.05210783426813823
14249,36.0,151,4816,4967,9,202,6399,1907,4492,6399,501,0.023597437099546804,0.752617596499453,0.0014064697609001407,0.298015314892952,0.7019846851070479,0.03156743241131427
14250,24.0,341,5906,6247,34,304,8223,2333,5890,8223,607,0.04146905022497872,0.718229356682476,0.0041347440107016905,0.28371640520491304,0.716283594795087,0.036969475860391586
14251,27.0,367,9884,10251,29,386,13405,3932,9473,13405,1100,0.027377844088026855,0.7373368146214099,0.00216337187616561,0.29332338679597164,0.7066766132040283,0.028795225662066392
14252,24.0,67,2538,2605,3,418,3749,973,2776,3749,263,0.017871432381968526,0.6769805281408375,0.0008002133902373967,0.2595358762336623,0.7404641237663377,0.11149639903974393
14253,,1078,12670,13748,65,649,20522,5341,15181,20522,1045,0.05252899327550921,0.6173862196666992,0.0031673326186531527,0.2602572848650229,0.7397427151349771,0.031624597992398404
14254,16.0,146,14986,15132,43,726,19987,5701,14286,19987,1678,0.007304748086256066,0.7497873617851604,0.002151398408965828,0.28523540301195777,0.7147645969880422,0.03632361034672537
14255,26.0,911,19812,20723,83,1430,27928,7578,20350,27928,2122,0.03261959323975938,0.7093955886565454,0.002971927814379834,0.2713405900887998,0.7286594099112003,0.05120309366943569
14256,17.0,327,6143,6470,7,294,8785,2483,6302,8785,643,0.03722253841775754,0.6992601024473535,0.0007968127490039841,0.28264086511098463,0.7173591348890154,0.03346613545816733
14257,39.0,200,4717,4917,36,245,6523,1898,4625,6523,476,0.030660738923808065,0.7231335275180132,0.0055189330062854515,0.29097041238693855,0.7090295876130615,0.037559405181664875
14258,23.0,383,8162,8545,77,379,11178,3208,7970,11178,750,0.03426373233136518,0.730184290570764,0.006888531043120415,0.28699230631597783,0.7130076936840222,0.033905886562891396
14259,,669,16401,17070,141,706,22623,6493,16130,22623,1950,0.02957167484418512,0.7249701631083411,0.00623259514653229,0.28700879635768906,0.7129912036423109,0.031207178535119128
14260,23.0,156,4666,4822,2,199,6276,1891,4385,6276,473,0.0248565965583174,0.7434671765455704,0.00031867431485022306,0.3013065646908859,0.6986934353091141,0.0317080943275972
14261,,513,15204,15717,22,706,20593,5883,14710,20593,1596,0.0249113776526004,0.738309134171806,0.0010683241878308163,0.28567959986403146,0.7143204001359685,0.03428349439129801
14262,45.0,263,9305,9568,0,392,13185,3455,9730,13185,968,0.01994690936670459,0.7057262040197194,0.0,0.2620401971937808,0.7379598028062192,0.029730754645430412
14263,27.0,33,1582,1615,12,92,2201,601,1600,2201,204,0.014993184915947297,0.7187641980917765,0.005452067242162653,0.27305770104497956,0.7269422989550205,0.04179918218991367
14264,25.0,2642,88067,90709,1193,5248,122518,34156,88362,122518,9350,0.02156417832481758,0.7188086648492467,0.00973734471669469,0.27878352568602166,0.7212164743139784,0.042834522274278065
14265,17.0,367,6562,6929,40,223,9029,2578,6451,9029,658,0.04064680474028132,0.7267692989256839,0.004430169453981615,0.2855244213091151,0.714475578690885,0.0246981947059475
14266,15.0,127,2735,2862,3,127,3770,1092,2678,3770,296,0.03368700265251989,0.7254641909814323,0.0007957559681697613,0.2896551724137931,0.7103448275862069,0.03368700265251989
14267,23.0,332,8334,8666,141,554,11503,3192,8311,11503,821,0.028862035990611146,0.7245066504390159,0.012257671911675216,0.277492827957924,0.7225071720420759,0.048161349213248716
14268,,2123,36930,39053,155,2179,54545,14976,39569,54545,3639,0.03892199101659181,0.6770556421303511,0.002841690347419562,0.27456228801906685,0.7254377119809332,0.03994866623888532
14269,15.0,232,2555,2787,9,119,3615,1070,2545,3615,261,0.06417704011065006,0.706777316735823,0.0024896265560165973,0.2959889349930844,0.7040110650069157,0.032918395573997235
14270,,416,11902,12318,60,656,16294,4724,11570,16294,1381,0.02553087025899104,0.73045292745796,0.003682337056585246,0.28992267092181173,0.7100773290781883,0.040260218485332025
14271,14.0,613,12630,13243,44,1093,18307,4958,13349,18307,1436,0.03348445949636751,0.6899000382367401,0.0024034522313869013,0.270825367345824,0.729174632654176,0.059703938384224615
14272,,753,13418,14171,28,723,18893,5397,13496,18893,1488,0.03985603133435664,0.7102101307362515,0.0014820303816228233,0.2856613560577992,0.7143386439422008,0.03826814163976076
14273,23.0,305,7711,8016,14,395,10661,3015,7646,10661,789,0.028608948503892694,0.7232904980771034,0.0013131976362442547,0.2828064909483163,0.7171935090516837,0.037050933308320044
14274,42.0,5734,106872,112606,502,5598,147763,42937,104826,147763,9906,0.03880538429782828,0.7232663115935654,0.00339733221442445,0.29058018583813267,0.7094198141618673,0.03788499150666946
14275,33.0,1870,58999,60869,234,2470,81573,23407,58166,81573,6711,0.022924251897073786,0.7232662768317948,0.0028685962266926557,0.28694543537690165,0.7130545646230984,0.030279626837311367
14276,,109,1946,2055,22,144,3205,763,2442,3205,189,0.034009360374414974,0.6071762870514821,0.006864274570982839,0.23806552262090483,0.7619344773790951,0.04492979719188767
14277,,1485,28670,30155,69,1566,42321,11783,30538,42321,3163,0.03508896292620685,0.6774414593227949,0.0016303962571772878,0.2784196970771012,0.7215803029228988,0.037002906358545404
14278,27.0,56,4542,4598,18,216,6719,1713,5006,6719,495,0.008334573597261497,0.6759934514064593,0.0026789700848340527,0.254948653073374,0.745051346926626,0.032147641018008634
14279,25.0,391,8895,9286,8,313,12277,3576,8701,12277,962,0.03184817137737232,0.7245255355542886,0.0006516249898183595,0.2912763704488067,0.7087236295511933,0.025494827726643316
14280,,1066,18253,19319,110,1198,26790,7391,19399,26790,2298,0.03979096677864875,0.6813363195222097,0.004106009705113848,0.27588652482269505,0.724113475177305,0.04471817842478537
14281,,20,6783,6803,12,373,9084,2577,6507,9084,747,0.002201673271686482,0.7466974900924703,0.001321003963011889,0.2836856010568032,0.7163143989431968,0.041061206516952886
14282,16.0,509,10909,11418,29,645,15373,4286,11087,15373,1106,0.033109998048526636,0.7096207636765758,0.0018864242503089832,0.27880049437325183,0.7211995056267482,0.04195667729135497
14283,16.0,524,6726,7250,104,636,9917,2601,7316,9917,670,0.052838560048401734,0.6782293032166986,0.010487042452354543,0.2622768982555208,0.7377231017444792,0.06413229807401431
14284,,234,7040,7274,47,368,9673,2717,6956,9673,638,0.024191047244908507,0.7277990282228884,0.004858885557738034,0.280884937454771,0.719115062545229,0.03804404011165099
14285,,71,3161,3232,10,442,4629,1207,3422,4629,266,0.015338085979693238,0.6828688701663426,0.002160293799956794,0.2607474616547851,0.739252538345215,0.0954849859580903
14286,26.0,92,10933,11025,27,551,15212,4097,11115,15212,1245,0.0060478569550354985,0.7187089140152512,0.0017749145411517222,0.2693268472258743,0.7306731527741257,0.03622140415461478
14287,27.0,7512,175406,182918,883,8610,241620,69457,172163,241620,18119,0.031090141544574124,0.7259581160499958,0.003654498799768231,0.28746378611042134,0.7125362138895787,0.035634467345418426
14288,,3830,59968,63798,515,4379,85872,23930,61942,85872,5483,0.04460126700204956,0.6983417179057202,0.00599729830445314,0.2786705794671138,0.7213294205328862,0.05099450344699087
14289,15.0,892,1689,2581,9,402,3723,1001,2722,3723,29,0.23959172710179963,0.4536663980660757,0.0024174053182917004,0.26886919151222133,0.7311308084877787,0.10797743755036261
14290,17.0,386,6375,6761,40,309,9121,2583,6538,9121,561,0.04231992106128714,0.6989365201184081,0.004385484047801776,0.2831926323867997,0.7168073676132003,0.03387786426926872
14291,27.0,27222,498931,526153,3192,33369,714336,200149,514187,714336,49331,0.03810811718854993,0.6984542288222909,0.004468485418626529,0.2801888747032209,0.7198111252967792,0.046713311382878646
14292,15.0,83,1643,1726,7,48,2341,669,1672,2341,190,0.03545493378897907,0.7018368218709953,0.00299017513882956,0.28577530969671083,0.7142246903032892,0.02050405809483127
14293,,532,12723,13255,122,1058,18767,4989,13778,18767,1322,0.02834763148079075,0.6779453295678585,0.006500772632812916,0.26583897266478396,0.734161027335216,0.0563755528320989
14294,26.0,427,5739,6166,200,317,8301,2307,5994,8301,526,0.05143958559209734,0.6913624864474159,0.024093482712926155,0.2779183230936032,0.7220816769063968,0.038188170099987956
14295,15.0,3136,29811,32947,492,2521,46986,12772,34214,46986,3108,0.06674328523389945,0.6344655854935513,0.010471204188481676,0.2718256501936747,0.7281743498063253,0.05365427999829737
14296,,525,15745,16270,149,1127,22046,6067,15979,22046,1741,0.023813843781184795,0.7141885149233421,0.006758595663612446,0.27519731470561554,0.7248026852943845,0.05112038465027669
14297,14.0,111,10338,10449,24,415,13820,3962,9858,13820,1173,0.008031837916063676,0.7480463096960926,0.0017366136034732273,0.2866859623733719,0.713314037626628,0.030028943560057888
14298,,258,7219,7477,17,417,9953,2852,7101,9953,704,0.025921832613282427,0.7253089520747513,0.001708027730332563,0.2865467698181453,0.7134532301818547,0.04189691550286346
14299,14.0,673,12353,13026,75,1588,18426,4957,13469,18426,1234,0.03652447628351243,0.6704113752306523,0.0040703353956366,0.26902203408227504,0.7309779659177249,0.08618256811027895
14300,23.0,676,27602,28278,93,890,35994,10987,25007,35994,2646,0.018780907929099293,0.766850030560649,0.00258376396066011,0.30524531866422183,0.6947546813357782,0.024726343279435462
14301,27.0,190,3785,3975,18,161,5372,1537,3835,5372,458,0.03536857781087118,0.7045793000744601,0.0033507073715562173,0.2861131794489948,0.7138868205510052,0.029970215934475054
14302,17.0,2381,78010,80391,77,3078,103919,30696,73223,103919,7912,0.022912075751306306,0.7506808187145758,0.0007409617105630347,0.2953839047719859,0.7046160952280142,0.029619222663805463
14303,23.0,561,11306,11867,72,1134,16261,4506,11755,16261,1235,0.034499723264251894,0.6952831929155648,0.0044277719697435585,0.277104729106451,0.722895270893549,0.06973740852346104
14304,,128,2845,2973,1,220,4046,1119,2927,4046,330,0.03163618388531883,0.7031636183885319,0.00024715768660405336,0.27656945130993577,0.7234305486900643,0.05437469105289174
14305,41.0,411,9560,9971,60,675,13496,3716,9780,13496,838,0.030453467694131594,0.7083580320094843,0.004445761707172495,0.27534084173088325,0.7246591582691168,0.05001481920569058
14306,23.0,1617,27944,29561,180,1942,40833,11249,29584,40833,2594,0.03960032326794505,0.6843484436607645,0.004408199250606128,0.27548796316704627,0.7245120368329537,0.04755957191487278
14307,,6,12446,12452,29,792,16762,4828,11934,16762,1497,0.0003579525116334566,0.7425128266316668,0.0017301038062283738,0.2880324543610548,0.7119675456389453,0.04724973153561628
14308,,2844,22581,25425,186,1950,35480,9538,25942,35480,2596,0.08015783540022547,0.6364430665163472,0.0052423900789177,0.2688275084554679,0.7311724915445321,0.05496054114994363
14309,,103,5266,5369,5,402,7434,2048,5386,7434,645,0.013855259617971483,0.7083669626042507,0.0006725854183481302,0.2754909873553941,0.7245090126446059,0.05407586763518967
14310,,1442,26593,28035,166,1104,36303,10735,25568,36303,2441,0.03972123515962868,0.7325289920943173,0.004572624851940611,0.29570558906977384,0.7042944109302262,0.030410709858689364
14311,,700,13969,14669,18,905,19700,5483,14217,19700,1279,0.03553299492385787,0.7090862944162436,0.0009137055837563451,0.2783248730964467,0.7216751269035533,0.045939086294416245
14312,17.0,327,6258,6585,30,502,8960,2388,6572,8960,646,0.036495535714285716,0.6984375,0.0033482142857142855,0.26651785714285714,0.7334821428571429,0.056026785714285716
14313,,858,16428,17286,90,705,22180,6585,15595,22180,1442,0.03868349864743012,0.7406672678088367,0.0040577096483318306,0.29688908926961227,0.7031109107303878,0.031785392245266005
14314,14.0,78,1928,2006,9,112,2699,768,1931,2699,172,0.028899592441645052,0.7143386439422008,0.0033345683586513525,0.28454983327158206,0.7154501667284179,0.041496850685439055
14315,14.0,49,6260,6309,56,546,8491,2272,6219,8491,497,0.005770816158285243,0.737251207160523,0.006595218466611707,0.26757743493110353,0.7324225650688965,0.06430338004946413
14316,13.0,914,7566,8480,37,696,11765,3333,8432,11765,819,0.07768805779855503,0.6430939226519337,0.0031449213769655757,0.2832979175520612,0.7167020824479388,0.059158521036974075
14317,16.0,144,3429,3573,33,101,4767,1388,3379,4767,387,0.030207677784770296,0.7193203272498426,0.006922592825676526,0.2911684497587581,0.7088315502412419,0.02118732955737361
14318,14.0,365,14161,14526,58,1928,20055,5749,14306,20055,1036,0.018199950137122913,0.706108202443281,0.0028920468711044625,0.28666168037895784,0.7133383196210421,0.09613562702567938
14319,,180,3841,4021,59,134,5270,1551,3719,5270,351,0.03415559772296015,0.728842504743833,0.011195445920303606,0.29430740037950665,0.7056925996204934,0.025426944971537004
14320,16.0,2289,30574,32863,247,2023,45035,12579,32456,45035,3242,0.05082713445098257,0.6788941934051294,0.00548462307094482,0.2793160874875097,0.7206839125124903,0.04492061729765738
14321,42.0,92,2456,2548,2,226,3462,986,2476,3462,207,0.02657423454650491,0.7094165222414789,0.0005777007510109763,0.2848064702484113,0.7151935297515887,0.06528018486424032
14322,24.0,135,1920,2055,30,132,2791,772,2019,2791,156,0.048369759942672876,0.6879254747402365,0.010748835542816195,0.27660336796847007,0.7233966320315299,0.047294876388391256
14323,34.0,194,4236,4430,18,350,6235,1628,4607,6235,389,0.03111467522052927,0.6793905372894948,0.0028869286287089013,0.2611066559743384,0.7388933440256615,0.056134723336006415
14324,26.0,613,14516,15129,104,813,20508,5794,14714,20508,1320,0.029890774331968014,0.7078213380144334,0.005071191730056563,0.282523893114882,0.717476106885118,0.03964306612053833
14325,,497,14478,14975,29,686,19895,5749,14146,19895,1471,0.024981151042975623,0.7277205327971852,0.0014576526765518974,0.2889670771550641,0.7110329228449359,0.03448102538326213
14326,25.0,3887,94216,98103,250,6634,131721,37925,93796,131721,8804,0.029509341714684827,0.7152693951609842,0.001897950972130488,0.287919162472195,0.7120808375278049,0.050364026996454626
14327,,439,11796,12235,42,734,16633,4726,11907,16633,1224,0.026393314495280467,0.7091925689893585,0.0025251007034209102,0.28413395058017193,0.715866049419828,0.04412914086454638
14328,24.0,353,2989,3342,162,411,5183,1177,4006,5183,86,0.06810727377966429,0.57669303492186,0.0312560293266448,0.22708855874975883,0.7729114412502411,0.07929770403241367
14329,27.0,262,8333,8595,58,433,11625,3260,8365,11625,852,0.02253763440860215,0.7168172043010753,0.004989247311827957,0.28043010752688174,0.7195698924731183,0.037247311827956986
14330,16.0,892,17433,18325,181,1157,25240,6965,18275,25240,1700,0.03534072900158479,0.690689381933439,0.007171156893819334,0.2759508716323296,0.7240491283676703,0.04583993660855785
14331,27.0,415,11321,11736,108,352,15456,4421,11035,15456,1223,0.026850414078674948,0.7324663561076604,0.006987577639751553,0.286037784679089,0.713962215320911,0.022774327122153208
14332,,1022,25404,26426,326,1319,35623,10067,25556,35623,2578,0.028689329927294165,0.7131347724784549,0.0091513909552817,0.2825983213092665,0.7174016786907336,0.03702664009207535
14333,27.0,679,17301,17980,81,1299,23894,6476,17418,23894,1386,0.02841717586004855,0.7240729890349041,0.003389972378002846,0.27103038419686953,0.7289696158031305,0.05436511258056416
14334,16.0,38,5787,5825,32,437,7991,2169,5822,7991,609,0.0047553497684895505,0.7241897134276061,0.004004505068201727,0.2714303591540483,0.7285696408459517,0.054686522337629835
14335,24.0,57,1950,2007,12,91,2631,780,1851,2631,209,0.021664766248574687,0.7411630558722919,0.004561003420752566,0.29646522234891676,0.7035347776510832,0.03458760927404029
14336,16.0,225,6708,6933,16,413,9239,2641,6598,9239,732,0.024353284987552765,0.7260526030955731,0.001731789154670419,0.285853447342786,0.7141465526572139,0.04470180755493019
14337,23.0,308,11199,11507,26,593,15065,4454,10611,15065,1074,0.020444739462329903,0.7433786923332227,0.0017258546299369398,0.2956521739130435,0.7043478260869566,0.0393627613674079
14338,13.0,1087,20670,21757,80,1439,29166,8300,20866,29166,2000,0.03726942330110403,0.7087019131865872,0.0027429198381677296,0.28457793320990193,0.715422066790098,0.049338270589042034
14339,,126,7916,8042,26,427,10658,3029,7629,10658,1037,0.011822105460686808,0.7427284668793395,0.0024394820791893415,0.28419966222555826,0.7158003377744417,0.04006380183899418
14340,17.0,185,2574,2759,4,124,3847,1091,2756,3847,261,0.04808942032752794,0.6690927995840915,0.0010397712503249284,0.28359760852612426,0.7164023914738757,0.03223290876007279
14341,,157,1718,1875,15,200,2924,723,2201,2924,102,0.05369357045143639,0.5875512995896033,0.005129958960328317,0.2472640218878249,0.7527359781121751,0.06839945280437756
14342,,732,36090,36822,223,2600,49984,13885,36099,49984,4370,0.014644686299615878,0.7220310499359796,0.004461427656850192,0.2777888924455826,0.7222111075544174,0.05201664532650448
14343,15.0,1074,31285,32359,307,2786,46768,12326,34442,46768,2938,0.02296442011631885,0.6689403010605542,0.006564317482039001,0.26355627779678414,0.7364437222032159,0.059570646595963055
14344,15.0,154,2869,3023,15,279,4165,1110,3055,4165,255,0.03697478991596639,0.6888355342136855,0.003601440576230492,0.2665066026410564,0.7334933973589436,0.06698679471788715
14345,15.0,149,3269,3418,16,189,4868,1292,3576,4868,338,0.030608052588331963,0.6715283483976993,0.003286770747740345,0.2654067378800329,0.7345932621199671,0.038824979457682825
14346,16.0,212,4082,4294,27,293,5727,1575,4152,5727,433,0.037017635760433036,0.712764099877772,0.004714510214772132,0.2750130958617077,0.7249869041382923,0.05116116640474943
14347,23.0,126,2900,3026,15,150,4050,1160,2890,4050,313,0.03111111111111111,0.7160493827160493,0.003703703703703704,0.28641975308641976,0.7135802469135802,0.037037037037037035
14348,24.0,128,2244,2372,26,104,3357,900,2457,3357,204,0.038129282097110515,0.6684539767649688,0.0077450104259755735,0.2680965147453083,0.7319034852546917,0.030980041703902294
14349,39.0,3459,68016,71475,265,6019,95188,25389,69799,95188,6203,0.0363386141110224,0.7145438500651342,0.0027839643652561247,0.26672479724335,0.73327520275665,0.06323276043198722
14350,25.0,1481,21438,22919,79,1017,30336,8654,21682,30336,1749,0.048819883966244725,0.7066851265822784,0.0026041666666666665,0.2852716244725738,0.7147283755274262,0.033524525316455694
14351,,2064,94389,96457,690,10589,133162,36108,97054,133162,8051,0.0154999173938511,0.708828344422583,0.005181658431083943,0.2711584385935928,0.7288415614064072,0.07951968279238822
14352,,208,5139,5347,15,285,7142,1987,5155,7142,538,0.029123494819378325,0.7195463455614673,0.002100252030243629,0.27821338560627273,0.7217866143937273,0.03990478857462895
14353,,370,8137,8507,23,923,11303,3020,8283,11303,680,0.032734672210917456,0.7198973723790144,0.002034858002300274,0.2671857029107317,0.7328142970892684,0.08165973635318056
14354,15.0,183,4744,4927,28,286,6614,1891,4723,6614,505,0.0276685817961899,0.7172664045963109,0.0042334442092530995,0.28590867856062896,0.714091321439371,0.04324160870879951
14355,24.0,307,10874,11181,111,785,15016,4132,10884,15016,1199,0.020444858817261588,0.724160895045285,0.0073921150772509325,0.2751731486414491,0.7248268513585508,0.052277570591369206
14356,,1096,32498,33594,89,1181,44492,12869,31623,44492,3195,0.02463364200305673,0.7304234469118044,0.0020003596152117233,0.2892430099793221,0.7107569900206778,0.026544097815337588
14357,35.0,162,2553,2715,28,177,3655,1034,2621,3655,243,0.04432284541723666,0.6984952120383037,0.007660738714090287,0.28290013679890563,0.7170998632010944,0.048426812585499315
14358,23.0,193,5195,5388,11,185,6848,2032,4816,6848,496,0.028183411214953272,0.7586156542056075,0.0016063084112149532,0.2967289719626168,0.7032710280373832,0.02701518691588785
14359,,1055,13388,14443,18,1162,19468,5553,13915,19468,1375,0.05419149373330594,0.6876926237928909,0.0009245942058763099,0.28523731251284157,0.7147626874871584,0.05968769262379289
14360,15.0,95,3435,3530,12,282,4860,1298,3562,4860,388,0.01954732510288066,0.7067901234567902,0.0024691358024691358,0.26707818930041155,0.7329218106995885,0.05802469135802469
14361,37.0,128,6373,6501,9,279,8516,2456,6060,8516,684,0.015030530765617662,0.7483560356975105,0.0010568341944574918,0.28839830906528885,0.7116016909347112,0.032761860028182245
14362,,35,2032,2067,13,144,2830,768,2062,2830,222,0.012367491166077738,0.7180212014134275,0.004593639575971731,0.2713780918727915,0.7286219081272085,0.05088339222614841
14363,,334,11667,12001,24,524,15464,4623,10841,15464,1181,0.021598551474392137,0.7544619762027935,0.0015519917227108122,0.2989524055871702,0.7010475944128298,0.0338851526125194
14364,17.0,203,12740,12943,27,1608,18073,4944,13129,18073,1437,0.011232224865821944,0.7049189398550324,0.0014939412383112932,0.2735572400818901,0.7264427599181099,0.08897250041498368
14365,24.0,83,3081,3164,1,136,4041,1160,2881,4041,299,0.020539470428111852,0.7624350408314774,0.00024746349913387774,0.28705765899529817,0.7129423410047018,0.033655035882207376
14366,14.0,70,2182,2252,31,97,3126,834,2292,3126,234,0.022392834293026232,0.6980166346769033,0.009916826615483045,0.2667946257197697,0.7332053742802304,0.031030070377479207
14367,13.0,656,13292,13948,107,787,18503,5262,13241,18503,1245,0.03545371020915527,0.7183699940550181,0.005782846024968924,0.2843863157325839,0.7156136842674161,0.04253364319299573
14368,13.0,101,2716,2838,35,103,4513,1054,3469,4523,228,0.022330311739995577,0.6004864028299801,0.007738226840592527,0.2330311739995578,0.7669688260004421,0.02277249613088658
14369,26.0,62,2080,2142,3,109,2971,829,2142,2971,267,0.020868394479973074,0.7001009761023225,0.0010097610232245036,0.27903062941770446,0.7209693705822955,0.03668798384382363
14370,16.0,512,14422,14934,20,941,20354,5695,14659,20354,1554,0.025154760734990664,0.708558514296944,0.000982607841210573,0.2797975827847106,0.7202024172152893,0.046231698928957454
14371,16.0,15875,90106,105981,1409,18979,181008,40789,140219,181008,8217,0.08770330593122956,0.49780120215681073,0.007784186334305666,0.22534363122071951,0.7746563687792805,0.10485171926102714
14372,27.0,2552,64416,66968,379,3458,89241,25507,63734,89241,6845,0.02859672123799599,0.7218206878004505,0.004246926860971975,0.285821539426945,0.714178460573055,0.038749005501955376
14373,33.0,185,4371,4556,3,173,6013,1789,4224,6013,492,0.030766672210211208,0.7269249958423416,0.0004989190088142358,0.297522035589556,0.7024779644104441,0.028770996174954266
14374,,2326,43807,46133,173,2735,64797,17515,47282,64797,4061,0.03589672361374755,0.6760652499344105,0.0026698766918221524,0.2703057240304335,0.7296942759695665,0.04220874423198605
14375,,218,3776,3994,86,212,5331,1525,3806,5331,346,0.04089289063965485,0.708309885574939,0.016132057775276685,0.28606265241042955,0.7139373475895704,0.03976739823672857
14376,16.0,1204,23976,25180,97,1949,34711,9178,25533,34711,2308,0.034686410647921405,0.6907320445968137,0.0027945031834288843,0.2644118579124773,0.7355881420875227,0.056149347469102016
14377,36.0,2507,31075,33582,488,2414,45446,11739,33707,45446,2275,0.05516437090172953,0.683778550367469,0.010738018747524534,0.2583065616335871,0.7416934383664129,0.0531179861814021
14378,27.0,461,13302,13763,49,570,18074,5208,12866,18074,1638,0.025506252074803584,0.7359743277636384,0.002711076684740511,0.2881487219209915,0.7118512780790085,0.03153701449596105
14379,35.0,1426,27322,28748,148,1541,39124,10692,28432,39124,3240,0.036448215928841635,0.6983437276352111,0.0037828442899499027,0.2732849401901646,0.7267150598098354,0.03938758818116757
14380,15.0,130,2623,2753,2,235,3780,1048,2732,3780,261,0.03439153439153439,0.6939153439153439,0.0005291005291005291,0.27724867724867724,0.7227513227513227,0.062169312169312166
14381,34.0,98,3798,3896,6,123,5035,1520,3515,5035,459,0.019463753723932473,0.7543197616683217,0.0011916583912611719,0.3018867924528302,0.6981132075471698,0.02442899702085402
14382,,75,1823,1898,9,93,2587,736,1851,2587,269,0.028991109393119444,0.7046772323154232,0.003478933127174333,0.28449942017781216,0.7155005798221878,0.03594897564746811
14383,,211,4966,5177,38,247,6901,1917,4984,6901,549,0.030575278945080425,0.7196058542240255,0.005506448340820171,0.2777858281408492,0.7222141718591508,0.03579191421533111
14384,,96,2255,2351,2,104,3203,859,2344,3203,264,0.029971901342491416,0.7040274742428972,0.0006244146113019045,0.26818607555416796,0.731813924445832,0.03246955978769903
14385,,27,3081,3108,44,396,4473,1163,3310,4473,216,0.006036217303822937,0.6887994634473508,0.009836798569192935,0.26000447127207693,0.7399955287279231,0.08853118712273642
14386,,116,2527,2643,5,153,3669,1019,2650,3669,320,0.03161624420823113,0.6887435268465522,0.001362769146906514,0.27773235213954756,0.7222676478604524,0.041700735895339326
14387,26.0,428,8274,8702,94,503,11549,3252,8297,11549,645,0.037059485669754956,0.7164256645597021,0.008139232834011603,0.2815828210234652,0.7184171789765348,0.04355355442029613
14388,,709,11384,12093,69,734,16611,4707,11904,16611,1208,0.042682559749563545,0.6853289988561796,0.004153873938956113,0.2833664439227018,0.7166335560772982,0.0441875865390404
14389,17.0,742,12860,13602,76,1004,19758,5213,14545,19758,1271,0.037554408340925195,0.6508755946958195,0.003846543172385869,0.26384249417957284,0.7361575058204272,0.05081485980362385
14390,,170,5134,5304,10,219,7031,2056,4975,7031,547,0.02417863746266534,0.7301948513724933,0.0014222727919214904,0.2924192860190585,0.7075807139809416,0.031147774143080644
14391,15.0,571,12241,12812,103,799,17082,4886,12196,17082,1144,0.033426999180423835,0.7166022713967919,0.006029738906451235,0.2860320805526285,0.7139679194473715,0.04677438239082075
14392,,725,48331,49056,220,2111,65265,18212,47053,65265,6073,0.011108557419750248,0.7405347429709646,0.0033708725963380068,0.27904696238412624,0.7209530376158737,0.03234505477667969
14393,,91,3007,3234,12,196,4369,1157,3212,4369,329,0.020828564888990615,0.6882581826504921,0.002746623941405356,0.2648203250171664,0.7351796749828337,0.04486152437628748
14394,13.0,428,5294,5722,25,593,8061,1991,6070,8061,488,0.05309514948517554,0.6567423396600918,0.0031013521895546458,0.246991688376132,0.753008311623868,0.0735640739362362
14395,,80,2140,2220,2,88,3162,841,2321,3162,202,0.02530044275774826,0.676786843769766,0.0006325110689437065,0.2659709044908286,0.7340290955091714,0.027830487033523088
14396,26.0,138,3329,3467,5,146,4565,1307,3258,4565,336,0.03023001095290252,0.7292442497261774,0.001095290251916758,0.28630887185104054,0.7136911281489595,0.031982475355969334
14397,23.0,838,22773,23611,49,1111,31314,9103,22211,31314,2398,0.026761193076579166,0.7272465989653191,0.0015647952992271826,0.29070064507887844,0.7092993549211215,0.035479338315130615
14398,25.0,288,4572,4860,142,401,6661,1834,4827,6661,331,0.04323675123855277,0.6863834259120252,0.02131812040234199,0.27533403392883954,0.7246659660711605,0.06020117099534605
14399,17.0,959,2326,3285,75,383,4900,1128,3772,4900,149,0.1957142857142857,0.4746938775510204,0.015306122448979591,0.23020408163265307,0.769795918367347,0.07816326530612244
14400,16.0,609,11509,12118,48,876,16595,4525,12070,16595,1211,0.03669780054233203,0.6935221452244652,0.002892437481169027,0.2726724917143718,0.7273275082856282,0.05278698403133474
14401,23.0,1216,41888,43104,84,2044,56127,16436,39703,56139,3680,0.021660521206291528,0.7461479541851476,0.0014962860043819803,0.2927732948574075,0.7072267051425924,0.03640962610662819
14402,33.0,8259,135730,143989,1445,8989,205606,55144,150462,205606,12908,0.0401690612141669,0.6601461046856609,0.007028005019308775,0.26820228981644506,0.731797710183555,0.043719541258523585
14403,23.0,144,2049,2193,12,98,2898,868,2030,2898,212,0.049689440993788817,0.7070393374741201,0.004140786749482402,0.2995169082125604,0.7004830917874396,0.033816425120772944
14404,23.0,3238,78126,81364,446,4278,109464,31560,77904,109464,8174,0.029580501352042682,0.7137140977855734,0.0040743988891325,0.2883139662354747,0.7116860337645253,0.03908134181100636
14405,23.0,237,7092,7329,20,517,10123,2980,7143,10123,730,0.023412032006322237,0.7005828311765286,0.0019756989034871086,0.29437913661957915,0.7056208633804208,0.05107181665514176
14406,14.0,243,12919,13162,76,665,17728,5007,12721,17728,1712,0.013707129963898917,0.7287342057761733,0.0042870036101083035,0.2824345667870036,0.7175654332129964,0.03751128158844765
14407,27.0,166,3405,3571,8,156,4637,1375,3262,4637,317,0.03579900797929696,0.7343109769247358,0.0017252533965926246,0.29652792753935736,0.7034720724606427,0.033642441233556176
14408,,244,6770,7014,15,442,9406,2648,6758,9406,681,0.025940888794386562,0.7197533489262173,0.001594726770146715,0.28152243248990005,0.7184775675101,0.046991282160323194
14409,47.0,893,17315,18208,93,852,24327,6893,17434,24327,1574,0.03670818432194681,0.7117605952234143,0.0038229128129239117,0.28334772063961855,0.7166522793603815,0.03502281415710939
14410,23.0,328,10598,10926,8,369,13938,4073,9865,13938,1200,0.023532788061414837,0.7603673410819343,0.0005739704405223131,0.29222270053092264,0.7077772994690773,0.026474386569091693
14411,17.0,128,2986,3114,12,103,4065,1213,2852,4065,315,0.03148831488314883,0.7345633456334564,0.002952029520295203,0.2984009840098401,0.70159901599016,0.025338253382533826
14412,38.0,8478,60575,69053,1437,4609,91823,25746,66081,91827,4173,0.09232578653337253,0.6596643688675444,0.015648992126498742,0.28037505308896077,0.7196249469110393,0.050192209263070775
14413,,1262,37179,38441,86,2048,51321,14660,36661,51321,3780,0.02459032364918844,0.7244402876015666,0.001675727285126946,0.28565304651117474,0.7143469534888253,0.03990569162720913
14414,,193,5316,5509,10,357,7360,2096,5264,7360,523,0.026222826086956523,0.7222826086956522,0.001358695652173913,0.2847826086956522,0.7152173913043478,0.04850543478260869
14415,16.0,12,2825,2837,8,231,3884,1073,2811,3884,352,0.003089598352214212,0.7273429454170958,0.0020597322348094747,0.2762615859938208,0.7237384140061792,0.05947476828012358
14416,13.0,1679,14038,15717,201,1540,22269,5789,16480,22269,1449,0.07539629080784947,0.6303830436930262,0.009026000269432843,0.25995778885446136,0.7400422111455386,0.06915442992500787
14417,,1789,43110,44899,240,1745,59441,17080,42361,59441,4700,0.030097071045238136,0.7252569775071079,0.0040376171329553675,0.28734375262865697,0.712656247371343,0.02935684123752965
14418,,247,2603,2850,23,125,4611,1006,3605,4611,214,0.05356755584471915,0.5645196269789633,0.004988072001734982,0.21817393190197354,0.7818260680980265,0.027109086965950987
14419,25.0,180,4082,4262,15,141,5543,1595,3948,5543,322,0.032473389861086055,0.7364243189608515,0.0027061158217571712,0.28775031571351256,0.7122496842864875,0.02543748872451741
14420,,1848,34262,36110,538,2064,49491,13482,36027,49509,3126,0.037326546688480886,0.6920357914722576,0.010866711103031772,0.27231412470459915,0.7276858752954009,0.041689389807913715
14421,25.0,881,22439,23320,31,1097,32011,8984,23027,32011,2619,0.02752178938489894,0.7009777888850708,0.0009684171066195995,0.28065352535066074,0.7193464746493393,0.034269469869732276
14422,,69,2443,2512,0,122,3348,996,2352,3348,275,0.02060931899641577,0.7296893667861409,0.0,0.2974910394265233,0.7025089605734767,0.03643966547192354
14423,15.0,1812,32097,33909,370,2553,46077,12659,33418,46077,3243,0.03932547691907025,0.6965948303926037,0.008030036677735096,0.27473576838769886,0.7252642316123011,0.05540725307637216
14424,,1452,12849,14301,35,1287,19846,5406,14440,19846,1202,0.07316335785548725,0.6474352514360576,0.0017635795626322684,0.2723974604454298,0.7276025395545702,0.0648493399173637
14425,15.0,1003,13211,14214,45,885,18864,5350,13514,18864,1235,0.05317005937234945,0.7003286683630195,0.002385496183206107,0.28360899067005935,0.7163910093299406,0.0469147582697201
14426,,150,4007,4157,20,222,5442,1620,3822,5442,372,0.027563395810363836,0.7363101800808526,0.003675119441381845,0.29768467475192945,0.7023153252480706,0.040793825799338476
14427,,294,5803,6097,19,258,8289,2276,6013,8289,550,0.03546869344914948,0.700084449270117,0.002292194474604898,0.2745807696947762,0.7254192303052238,0.031125588128845458
14428,14.0,296,3314,3610,11,220,4894,1364,3530,4894,320,0.06048222313036371,0.6771557008581937,0.0022476501838986514,0.2787086228034328,0.7212913771965672,0.04495300367797303
14429,41.0,573,16834,17407,154,733,23538,6533,17005,23538,1771,0.024343614580678054,0.7151839578553828,0.006542611946639476,0.2775511938142578,0.7224488061857423,0.03114113348627751
14430,,184,3563,3747,17,234,5057,1372,3685,5057,416,0.036385208621712475,0.7045679256476172,0.003361676883527783,0.2713070990705952,0.7286929009294048,0.04627249357326478
14431,,1189,22289,23478,571,420,32374,8937,23437,32374,2375,0.036727003150676465,0.688484586396491,0.01763761042812133,0.2760548588373386,0.7239451411626614,0.012973373694940385
14432,,731,19225,19956,65,992,25539,7716,17823,25539,1776,0.028622890481224794,0.7527702729159325,0.002545127060574024,0.3021261599906026,0.6978738400093973,0.038842554524452795
14433,,392,7064,7456,112,512,10508,2857,7651,10508,739,0.03730491054434716,0.6722497145032357,0.010658545869813475,0.27188808526836694,0.7281119147316331,0.04872478111914732
14434,23.0,0,1747,1747,3,141,2313,606,1707,2313,202,0.0,0.7552961521833117,0.0012970168612191958,0.2619974059662776,0.7380025940337225,0.0609597924773022
14435,26.0,282,2590,2872,14,167,4928,1025,3903,4928,163,0.057224025974025976,0.5255681818181818,0.002840909090909091,0.20799512987012986,0.7920048701298701,0.033887987012987016
14436,,5435,134869,140304,715,6363,185569,53495,132077,185572,14241,0.02928782359407669,0.7267745133964175,0.0038529519539585713,0.2882708598279913,0.7117291401720087,0.03428857801823551
14437,16.0,12789,255613,268402,1273,13507,353300,102504,250799,353303,25470,0.03619839061655293,0.7234951302423133,0.0036031395148074033,0.29013056781289714,0.7098694321871029,0.03823064055499104
14438,27.0,719,17858,18577,168,784,23901,7108,16793,23901,1619,0.0300824233295678,0.7471653905694322,0.007028994602736287,0.2973934145014853,0.7026065854985147,0.03280197481276934
14439,13.0,16,2554,2570,49,142,3670,934,2736,3670,295,0.004359673024523161,0.6959128065395095,0.01335149863760218,0.2544959128065395,0.7455040871934605,0.038692098092643054
14440,16.0,436,4972,5408,32,437,7375,2015,5360,7375,454,0.059118644067796614,0.6741694915254237,0.004338983050847458,0.27322033898305087,0.7267796610169491,0.05925423728813559
14441,,118,3268,3386,8,124,4449,1295,3154,4449,389,0.02652281411553158,0.7345470892335356,0.0017981568891885817,0.29107664643740166,0.7089233535625984,0.027871431782423017
14442,,251,6027,6278,20,218,8137,2451,5686,8137,533,0.030846749416246773,0.7406906722379255,0.002457908320019663,0.30121666461840974,0.6987833353815903,0.02679120068821433
14443,16.0,310,6884,7194,90,265,9574,2753,6821,9574,768,0.03237936076874869,0.7190307081679549,0.009400459578023814,0.2875496135366618,0.7124503864633382,0.027679130979736788
14444,,1214,19108,20322,60,1013,26848,7716,19132,26848,2131,0.04521752085816448,0.7117103694874851,0.002234803337306317,0.2873957091775924,0.7126042908224076,0.03773092967818832
14445,17.0,332,4870,5202,9,237,7105,2001,5104,7105,457,0.04672765657987333,0.685432793807178,0.001266713581984518,0.2816326530612245,0.7183673469387755,0.033356790992258974
14446,,160,4195,4355,14,118,5581,1630,3951,5581,457,0.02866869736606343,0.7516574090664755,0.00250851101953055,0.2920623544167712,0.7079376455832288,0.02114316430747178
14447,13.0,661,10500,11161,206,497,15181,4334,10847,15181,982,0.043541268691127066,0.6916540412357552,0.013569593570911007,0.28548843949673935,0.7145115605032607,0.03273829128515908
14448,25.0,355,10069,10424,34,373,13652,3968,9684,13652,998,0.026003515968356285,0.7375476120714913,0.0024904775857017285,0.29065338411954295,0.7093466158804571,0.02732200410196308
14449,23.0,141,5905,6046,1,230,7756,2421,5335,7756,647,0.01817947395564724,0.7613460546673543,0.00012893243940175349,0.31214543579164516,0.6878545642083548,0.0296544610624033
14450,23.0,682,13204,13886,49,459,18418,5233,13185,18418,1523,0.03702899337604517,0.7169073732218482,0.002660440873058964,0.28412422630035833,0.7158757736996416,0.024921272668042133
14451,,113,3010,3123,12,127,4205,1187,3018,4205,348,0.026872770511296076,0.7158145065398336,0.002853745541022592,0.28228299643281807,0.7177170035671819,0.030202140309155766
14452,14.0,62,4920,4982,27,936,7833,1877,5956,7833,273,0.007915230435337674,0.6281118345461509,0.0034469551895825352,0.239627218179497,0.760372781820503,0.11949444657219456
14453,,591,9208,9799,86,1697,14527,2876,11651,14527,521,0.04068286638672816,0.6338542025194466,0.005920011013973979,0.19797618228126937,0.8020238177187307,0.1168169615199284
14454,26.0,1160,22989,24149,120,794,32178,9258,22920,32178,2565,0.036049474796444776,0.714432220771956,0.003729256013425322,0.2877121014357636,0.7122878985642365,0.024675243955497545
14455,25.0,389,18704,19093,24,819,25109,7404,17705,25109,1731,0.01549245290533275,0.7449121828826317,0.0009558325699948226,0.2948743478434028,0.7051256521565973,0.03261778645107332
14456,,160,3010,3170,10,189,4331,1169,3162,4331,281,0.03694296929115678,0.6949896097898869,0.0023089355806972986,0.2699145693835142,0.7300854306164858,0.04363888247517894
14457,15.0,288,1251,1539,1,191,2205,569,1636,2205,99,0.1306122448979592,0.5673469387755102,0.00045351473922902497,0.25804988662131517,0.7419501133786848,0.08662131519274377
14458,25.0,256,5521,5777,21,290,7613,2179,5434,7613,533,0.03362669118612899,0.7252068829633521,0.0027584395113621437,0.28622093786943387,0.7137790621305662,0.03809273610928675
14459,,51,3801,3852,25,117,5174,1522,3652,5174,516,0.009856977193660611,0.7346347120216467,0.004831851565519907,0.29416312330885197,0.705836876691148,0.022613065326633167
14460,27.0,1668,31746,33414,564,2570,46834,12441,34393,46834,3084,0.0356151513857454,0.6778408848272622,0.012042533202374344,0.2656403467566298,0.7343596532433702,0.05487466370585472
14461,,111,4593,4704,134,525,6838,1834,5004,6838,460,0.01623281661304475,0.6716876279613923,0.019596373208540508,0.26820707809300964,0.7317929219069903,0.07677683533196841
14462,,1330,22936,31681,441,1714,42184,9188,32996,42184,2339,0.031528541627157215,0.5437132562108856,0.010454200644794234,0.21780769960174473,0.7821923003982553,0.040631519059359
14463,,344,11142,11486,106,336,14500,4484,10016,14500,930,0.02372413793103448,0.7684137931034483,0.007310344827586207,0.30924137931034484,0.6907586206896552,0.023172413793103447
14464,23.0,487,9566,10053,63,823,13706,3529,10177,13706,826,0.035531883846490586,0.697942506931271,0.004596527068437181,0.25747847657960016,0.7425215234203998,0.06004669487815555
14465,23.0,272,5141,5413,24,312,7442,2061,5381,7442,536,0.03654931470034937,0.6908089223327063,0.0032249395323837677,0.27694168234345606,0.7230583176565439,0.04192421392098898
14466,17.0,607,15128,15735,16,1242,21405,5970,15435,21405,1455,0.02835786031301098,0.7067507591684186,0.0007474889044615744,0.27890679747722497,0.7210932025227751,0.05802382620882971
14467,,8,1574,1582,7,92,2138,606,1532,2138,215,0.0037418147801683817,0.7362020579981291,0.003274087932647334,0.28344246959775493,0.7165575304022451,0.04303086997193639
14468,15.0,4352,64348,68700,781,5585,95059,26321,68738,95059,6084,0.04578209322631208,0.6769269611504434,0.008215950094152052,0.27689119389011035,0.7231088061098897,0.058752984988270446
14469,,13407,269563,282970,991,18313,379744,106078,273666,379744,27396,0.03530536361338164,0.7098545335805174,0.002609652818741047,0.2793408190781158,0.7206591809218842,0.048224593410297466
14470,,141,4517,4658,15,152,6329,1786,4543,6329,456,0.022278401011218203,0.7136988465792384,0.0023700426607678937,0.28219307947543054,0.7178069205245694,0.024016432295781324
14471,17.0,3803,35910,39713,1816,4878,57736,13333,44403,57736,2418,0.06586878204239989,0.621968962172648,0.0314535125398365,0.23093044201191631,0.7690695579880837,0.08448801441041984
14472,23.0,1386,29512,30898,174,1398,40200,11711,28489,40200,3164,0.034477611940298504,0.7341293532338309,0.004328358208955224,0.291318407960199,0.708681592039801,0.03477611940298508
14473,15.0,201,2810,3011,28,392,4468,1116,3352,4468,350,0.04498657117278424,0.6289167412712623,0.006266786034019696,0.24977618621307074,0.7502238137869293,0.08773500447627573
14474,23.0,169,5835,6004,15,282,7821,2298,5523,7821,525,0.021608489962920342,0.7460682777138473,0.0019179133103183737,0.29382431914077484,0.7061756808592251,0.03605677023398542
14475,26.0,150,4648,4798,30,268,6511,1844,4667,6511,526,0.023037935800952234,0.7138688373521732,0.004607587160190447,0.28321302411303945,0.7167869758869605,0.041161111964367995
14476,15.0,125,1459,1584,4,127,2211,584,1627,2211,177,0.056535504296698326,0.6598824061510629,0.0018091361374943465,0.2641338760741746,0.7358661239258254,0.0574400723654455
14477,,514,7758,8272,100,545,11755,3184,8571,11755,735,0.04372607401105912,0.6599744789451297,0.008507018290089324,0.27086346235644404,0.7291365376435559,0.04636324968098681
14478,24.0,550,14640,15190,45,799,19920,5643,14277,19920,1465,0.027610441767068273,0.7349397590361446,0.002259036144578313,0.2832831325301205,0.7167168674698795,0.040110441767068274
14479,,197,6559,6756,24,334,8919,2574,6345,8919,680,0.022087677990806145,0.7353963448817132,0.0026908846283215607,0.2885973763874874,0.7114026236125126,0.03744814441080839
14480,26.0,528,12752,13280,71,791,18353,5067,13289,18356,1297,0.02876443669644803,0.694704728699063,0.0038679450860753975,0.2760405317062541,0.7239594682937459,0.043092176944868166
14481,27.0,1769,51018,52787,671,1942,68205,20279,47926,68205,4781,0.025936514918261124,0.7480096767099186,0.009837988417271461,0.2973242430906825,0.7026757569093175,0.028472985851477166
14482,14.0,532,8506,9038,45,337,12316,3477,8839,12316,894,0.04319584280610588,0.6906463137382267,0.0036537836960051965,0.28231568691133485,0.7176843130886652,0.027362780123416693
14483,15.0,202,6179,6381,20,255,8230,2679,5551,8230,413,0.02454434993924666,0.7507897934386392,0.002430133657351154,0.3255164034021871,0.6744835965978129,0.030984204131227218
14484,25.0,91,2039,2130,0,68,2755,814,1941,2755,228,0.033030852994555354,0.74010889292196,0.0,0.29546279491833033,0.7045372050816697,0.024682395644283123
14485,,2211,48323,50534,233,2388,66704,19241,47463,66704,4295,0.03314643799472296,0.7244393139841688,0.0034930438954185656,0.28845346605900696,0.7115465339409931,0.03579995202686496
14486,36.0,1816,55320,57136,173,2689,72857,21348,51509,72857,5451,0.02492553906968445,0.7592956064619735,0.002374514459832274,0.29301233923988085,0.7069876607601191,0.036907915505716676
14487,23.0,224,6329,6553,20,309,8688,2473,6215,8688,699,0.02578268876611418,0.7284760589318601,0.0023020257826887663,0.28464548802946593,0.7153545119705341,0.035566298342541436
14488,,387,18009,18396,31,1108,25571,6917,18654,25571,1838,0.015134331860310508,0.7042743733135193,0.001212310820851746,0.2705017402526299,0.72949825974737,0.04333033514528176
14489,23.0,265,5068,5333,19,386,7344,2059,5285,7344,537,0.0360838779956427,0.6900871459694989,0.0025871459694989107,0.2803649237472767,0.7196350762527233,0.0525599128540305
14490,25.0,379,9027,9406,32,535,12802,3635,9167,12802,1140,0.02960474925792845,0.7051241993438525,0.002499609436025621,0.28394000937353536,0.7160599906264646,0.04179034525855335
14491,25.0,347,11186,11533,48,378,15032,4464,10568,15032,1273,0.023084087280468336,0.7441458222458754,0.0031931878658861094,0.2969664715274082,0.7030335284725918,0.025146354443853113
14492,15.0,1756,20540,22296,119,1815,30449,8377,22072,30449,2038,0.05767020263391245,0.6745705934513448,0.0039081743242799435,0.27511576734868143,0.7248842326513186,0.05960786889553023
14493,17.0,1452,28677,30129,164,1861,40973,11378,29595,40973,2947,0.0354379713469846,0.6998999341029458,0.0040026358821663045,0.27769506748346473,0.7223049325165353,0.04542015473604569
14494,24.0,33,15592,15625,25,567,20478,6095,14383,20478,2093,0.0016114854966305303,0.7614024807110069,0.00122082234593222,0.29763648793827524,0.7023635120617248,0.027688250805742748
14495,23.0,292,5433,5725,83,284,7735,2130,5605,7735,463,0.037750484809308336,0.7023917259211376,0.010730446024563672,0.27537168713639304,0.724628312863607,0.03671622495151907
14496,,726,14489,15215,36,922,20272,5820,14452,20272,1455,0.035812943962115235,0.7147296764009471,0.001775848460931334,0.287095501183899,0.7129044988161011,0.04548145224940805
14497,,1075,19039,20114,89,1900,28077,7667,20410,28077,1920,0.038287566335434696,0.6780995120561314,0.0031698543291662214,0.27307048473839796,0.726929515261602,0.06767104747658226
14498,16.0,102,7422,7524,39,673,10443,2691,7752,10443,650,0.009767308244757253,0.7107153116920425,0.0037345590347601263,0.25768457339844875,0.7423154266015513,0.06444508283060424
14499,,81,2418,2499,5,115,3284,987,2297,3284,242,0.02466504263093788,0.7362971985383678,0.0015225334957369061,0.30054811205846527,0.6994518879415347,0.03501827040194884
14500,27.0,288,6030,6318,10,1037,9186,1877,7309,9186,433,0.031352057478772045,0.6564337034617896,0.001088613106901807,0.20433268016546918,0.7956673198345308,0.11288917918571739
14501,27.0,112,13187,13299,7,1370,18348,5068,13280,18348,1969,0.006104207543056464,0.7187159363418356,0.000381512971441029,0.27621539132330497,0.723784608676695,0.07466753869631568
14502,15.0,252,3885,4137,14,319,5532,1520,4012,5532,351,0.0455531453362256,0.7022776572668112,0.0025307302964569776,0.274765003615329,0.725234996384671,0.0576644974692697
14503,25.0,537,8359,8896,131,284,11935,3438,8497,11935,852,0.044993715961457896,0.7003770423125262,0.01097612065354001,0.2880603267700042,0.7119396732299959,0.023795559279430247
14504,,3047,61268,64315,279,2773,87522,24814,62710,87524,5985,0.0348133083497098,0.7000137105251131,0.003187697088798501,0.28351080846396415,0.7164891915360359,0.03168273844888259
14505,,171,14983,15154,50,573,19776,5881,13895,19776,1695,0.008646844660194174,0.7576355177993528,0.0025283171521035598,0.2973806634304207,0.7026193365695793,0.028974514563106797
14506,17.0,2983,41063,44046,893,3415,61453,16521,44932,61453,3795,0.04854116153808602,0.6682017151318894,0.0145314305241404,0.26883960099588305,0.731160399004117,0.05557092412087286
14507,17.0,210,6555,6765,82,329,8931,2545,6386,8931,692,0.0235136042996305,0.7339603627813235,0.00918150263128429,0.2849624902026649,0.7150375097973352,0.036837980069421114
14508,27.0,622,17160,17798,7,949,23830,6771,17059,23830,1689,0.02610155266470835,0.7201007133864876,0.0002937473772555602,0.28413764162819977,0.7158623583718002,0.03982375157364666
14509,16.0,12891,266008,278899,2046,17438,374847,105815,269032,374847,26521,0.03439003113270214,0.709644201500879,0.005458226956598292,0.2822885070442074,0.7177114929557926,0.04652031362129082
14510,24.0,988,24508,25496,71,1295,33632,9819,23813,33632,2454,0.029376784015223596,0.7287107516650809,0.0021110846812559467,0.29195409134157946,0.7080459086584205,0.03850499524262607
14511,16.0,3829,61070,64899,536,4603,88137,24529,63608,88137,5572,0.043443729648161386,0.6928985556576693,0.006081441392377775,0.27830536551051205,0.721694634489488,0.05222551255431884
14512,,203,4639,4842,7,309,6536,1803,4733,6536,454,0.03105875152998776,0.7097613219094248,0.0010709914320685434,0.2758567931456548,0.7241432068543452,0.047276621787025706
14513,45.0,4917,176436,181353,318,7617,237146,67025,170121,237146,19646,0.020734062560616665,0.7439973687095713,0.0013409460838470816,0.28263179644607117,0.7173682035539288,0.032119453838563586
14514,15.0,2266,3908,6174,51,949,9001,2336,6665,9001,49,0.2517498055771581,0.4341739806688146,0.0056660371069881124,0.2595267192534163,0.7404732807465837,0.10543272969670037
14515,24.0,20,4132,4152,17,499,5839,1333,4506,5839,317,0.0034252440486384657,0.707655420448707,0.0029114574413426956,0.22829251584175372,0.7717074841582463,0.08545983901352971
14516,23.0,298,5966,6264,34,378,8289,2369,5920,8289,537,0.03595126070696103,0.7197490650259379,0.004101821691398238,0.2858004584388949,0.7141995415611051,0.04560260586319218
14517,16.0,407,9566,9973,16,731,13341,3672,9669,13341,1029,0.030507458211528372,0.7170377033205907,0.0011993103965219998,0.27524173600179896,0.724758263998201,0.05479349374109887
14518,,6313,142423,148736,319,9321,197590,57187,140403,197590,13597,0.031949997469507566,0.720800647806063,0.0016144541727820235,0.2894225416266005,0.7105774583733995,0.04717343995141454
14519,,487,8640,9127,37,551,11923,3479,8444,11923,757,0.040845424809192316,0.7246498364505577,0.0031032458273924346,0.2917889792837373,0.7082110207162627,0.04621320137549274
14520,27.0,1608,47566,49174,71,3606,65812,18027,47785,65812,4393,0.02443323406065763,0.7227557284385826,0.001078830608399684,0.2739166109524099,0.7260833890475901,0.054792439068862824
14521,15.0,2,2245,2247,3,201,3110,829,2281,3110,246,0.0006430868167202572,0.7218649517684887,0.0009646302250803858,0.26655948553054665,0.7334405144694534,0.06463022508038585
14522,23.0,709,21140,21849,25,1107,28788,8369,20419,28788,2049,0.024628317354453245,0.7343337501736835,0.0008684173961372795,0.2907114075309157,0.7092885924690844,0.038453522300958734
14523,16.0,49,5754,5803,28,524,8423,2189,6234,8423,568,0.0058174047251573074,0.6831295262970438,0.0033242312715184613,0.25988365190549684,0.7401163480945031,0.062210613795559776
14524,23.0,144,3384,3528,18,217,4718,1355,3363,4718,361,0.03052140737600678,0.7172530733361594,0.0038151759220008477,0.28719796523950825,0.7128020347604918,0.04599406528189911
14525,,140,7303,7443,0,273,9525,2930,6595,9525,869,0.014698162729658792,0.7667191601049869,0.0,0.30761154855643047,0.6923884514435695,0.028661417322834646
14526,,112,2545,2657,10,140,3590,1028,2562,3590,264,0.03119777158774373,0.7089136490250696,0.002785515320334262,0.2863509749303621,0.7136490250696379,0.03899721448467967
14527,,195,7651,7846,33,387,11006,2951,8055,11006,762,0.01771760857713974,0.6951662729420316,0.0029983645284390333,0.2681264764673814,0.7318735235326186,0.035162638560785026
14528,23.0,49,1676,1725,0,108,2332,640,1692,2332,173,0.021012006861063463,0.7186963979416809,0.0,0.274442538593482,0.725557461406518,0.04631217838765009
14529,25.0,291,10779,11070,17,610,14686,4150,10536,14686,1156,0.01981478959553316,0.733964319760316,0.0011575650279177449,0.2825820509328612,0.7174179490671387,0.04153615688410731
14530,17.0,1573,36749,38322,142,2083,51296,14297,36999,51296,3813,0.03066515907673113,0.7164106363069245,0.002768247036805989,0.27871568933250157,0.7212843106674984,0.04060745477230193
14531,25.0,394,4174,4568,53,332,6337,1731,4606,6337,326,0.06217453053495345,0.6586712955657251,0.008363578980590185,0.27315764557361527,0.7268423544263847,0.052390721161432854
14532,35.0,89,3442,3531,7,152,4570,1337,3233,4570,345,0.01947483588621444,0.7531728665207877,0.0015317286652078775,0.2925601750547046,0.7074398249452954,0.03326039387308534
14533,,85,1953,2038,13,69,2638,789,1849,2638,188,0.03222137983320698,0.740333586050038,0.004927975739196361,0.29909021986353296,0.700909780136467,0.026156178923426837
14534,,727,15003,15730,288,1046,21241,6155,15086,21241,1439,0.03422626053387317,0.7063226778400263,0.013558683677792947,0.2897697848500541,0.7102302151499459,0.049244385857539666
14535,,735,13133,13868,109,801,18132,5225,12907,18132,1149,0.04053606882859034,0.7242995808515332,0.0060114714317229204,0.2881645709243327,0.7118354290756673,0.04417604235605559
14536,13.0,512,4123,4635,24,542,6810,1836,4974,6810,246,0.07518355359765051,0.6054331864904552,0.003524229074889868,0.2696035242290749,0.7303964757709251,0.07958883994126285
14537,25.0,1016,26080,27096,67,1223,36671,10322,26349,36671,2148,0.027705816585312643,0.7111886777017261,0.0018270568023779007,0.28147582558424916,0.7185241744157509,0.033350604019524964
14538,27.0,13806,413862,427668,796,21530,557121,163320,393801,557121,41803,0.024780972176600774,0.7428583736746596,0.00142877400062105,0.29314996203697224,0.7068500379630278,0.0386451058208181
14539,,400,10345,10745,29,379,13989,4122,9867,13989,1022,0.02859389520337408,0.7395096146972622,0.002073057402244621,0.2946600900707699,0.7053399099292301,0.02709271570519694
14540,26.0,208,4693,4901,37,200,6562,1906,4656,6562,461,0.03169765315452606,0.7151782992989942,0.005638524839987808,0.2904602255409936,0.7095397744590064,0.03047851264858275
14541,,175,3611,3786,18,272,5262,1432,3830,5262,374,0.03325731660965412,0.6862409730140631,0.0034207525655644243,0.27213987077156976,0.7278601292284302,0.05169137210186241
14542,,951,23481,24432,116,1399,32845,9517,23328,32845,1669,0.02895417871822195,0.7149033338407672,0.0035317399908661898,0.28975490942304766,0.7102450905769524,0.04259400213122241
14543,,309,12885,13194,39,516,17334,5103,12231,17334,1583,0.017826237452405677,0.7433367947386639,0.002249913464866736,0.29439252336448596,0.705607476635514,0.029768085842852197
14544,17.0,806,7518,8324,75,507,11020,3080,7940,11020,642,0.07313974591651543,0.6822141560798548,0.006805807622504537,0.279491833030853,0.720508166969147,0.04600725952813067
14545,23.0,216,4073,4289,11,249,5916,1607,4309,5916,451,0.036511156186612576,0.6884719405003381,0.0018593644354293441,0.2716362407031778,0.7283637592968222,0.04208924949290061
14546,13.0,831,12457,13288,145,841,18712,5053,13659,18712,1391,0.04441000427533134,0.6657225309961522,0.0077490380504489096,0.2700406156477127,0.7299593843522874,0.044944420692603675
14547,27.0,111,29629,29740,390,1563,40338,11061,29277,40338,3217,0.0027517477316674104,0.7345183201943577,0.009668302840993605,0.27420794288264166,0.7257920571173583,0.03874758292428975
14548,,2216,64902,67118,491,3315,89925,25470,64455,89925,6854,0.024642757853767027,0.7217347789824854,0.005460105643591882,0.28323603002502085,0.7167639699749792,0.03686405337781484
14549,15.0,96,4736,4832,2,263,6487,1828,4659,6487,501,0.014798828426082935,0.7300755356867581,0.0003083089255433945,0.2817943579466626,0.7182056420533375,0.04054262370895637
14550,14.0,242,3503,3745,25,212,5201,1432,3769,5201,269,0.04652951355508556,0.673524322245722,0.004806767929244376,0.27533166698711786,0.7246683330128821,0.04076139203999231
14551,17.0,1272,25225,26497,38,1620,36014,10055,25959,36014,2540,0.03531959793413673,0.7004220580885211,0.0010551452213028267,0.2791969789526295,0.7208030210473705,0.04498250680290998
14552,,165,3519,3684,52,143,4986,1375,3611,4986,362,0.03309265944645006,0.7057761732851986,0.010429201764941836,0.2757721620537505,0.7242278379462495,0.028680304853590053
14553,36.0,1097,28842,29939,136,1464,39546,11364,28182,39546,2843,0.027739847266474486,0.7293278713397057,0.003439033024831841,0.287361553633743,0.7126384463662571,0.03702017903201335
14554,27.0,386,6429,6815,22,423,9006,2485,6521,9006,462,0.04286031534532534,0.7138574283810792,0.0024428159005107706,0.27592715967133025,0.7240728403286698,0.04696868754163891
14555,16.0,118,2860,2978,0,147,3911,1096,2815,3911,242,0.03017131168499105,0.7312707747379187,0.0,0.2802352339555101,0.7197647660444899,0.03758629506520072
14556,15.0,216,1901,2117,12,161,2852,784,2068,2852,172,0.07573632538569425,0.6665497896213184,0.004207573632538569,0.27489481065918653,0.7251051893408135,0.056451612903225805
14557,,3050,83067,86117,287,2545,108581,32893,75688,108581,7317,0.028089628940606553,0.7650233466260211,0.0026431880347390427,0.30293513598143323,0.6970648640185668,0.023438723165194648
14558,16.0,248,2623,2871,9,241,3974,1118,2856,3974,233,0.06240563663814796,0.6600402617010569,0.002264720684448918,0.2813286361348767,0.7186713638651233,0.060644187216909916
14559,,266,7354,7620,19,343,9951,2993,6958,9951,772,0.02673098181087328,0.7390212038991056,0.0019093558436338056,0.3007737915787358,0.6992262084212642,0.03446889759823133
14560,,158,3696,3854,11,294,5386,1496,3890,5386,376,0.029335313776457483,0.6862235425176383,0.0020423319717786854,0.2777571481619012,0.7222428518380988,0.05458596360935759
14561,16.0,132,3819,3951,10,201,5254,1477,3777,5254,446,0.025123715264560333,0.7268747620860297,0.001903311762466692,0.2811191473163304,0.7188808526836696,0.03825656642558051
14562,13.0,105,4677,4790,68,901,6875,1820,5055,6875,263,0.015272727272727273,0.6802909090909091,0.00989090909090909,0.2647272727272727,0.7352727272727273,0.13105454545454545
14563,15.0,808,14593,15401,175,816,20741,5786,14955,20741,1418,0.03895665589894412,0.7035822766501133,0.008437394532568343,0.27896437008823105,0.721035629911769,0.039342365363290104
14564,33.0,972,26233,27205,168,917,34961,10179,24782,34961,2139,0.02780240839792912,0.7503503904350562,0.004805354537913675,0.2911529990560911,0.708847000943909,0.02622922685277881
14565,37.0,116,3004,3120,27,92,3973,1179,2794,3973,225,0.029197080291970802,0.7561036999748301,0.006795872136924239,0.29675308331235845,0.7032469166876416,0.023156305059149257
14566,33.0,450,18600,19050,79,644,24524,7200,17325,24525,1971,0.01834862385321101,0.7584097859327217,0.0032212028542303772,0.29357798165137616,0.7064220183486238,0.026258919469928643
14567,26.0,244,5107,5351,17,361,7456,2034,5422,7456,493,0.03272532188841202,0.6849517167381974,0.0022800429184549357,0.27280042918454933,0.7271995708154506,0.04841738197424893
14568,13.0,1216,21793,23216,111,2458,33034,8692,24342,33034,2294,0.036810558818187324,0.659714233819701,0.003360174365804928,0.26312284313131923,0.7368771568686807,0.07440818550584247
14569,,946,18051,18997,24,888,26204,7425,18779,26204,1963,0.0361013585712105,0.6888642955274004,0.0009158907037093573,0.2833536864600824,0.7166463135399176,0.033887956037246224
14570,17.0,54,2017,2071,4,51,2688,797,1891,2688,243,0.020089285714285716,0.7503720238095238,0.001488095238095238,0.29650297619047616,0.7034970238095238,0.018973214285714284
14571,16.0,463,24185,24648,91,966,31897,9101,22796,31897,2566,0.014515471674452142,0.7582217763426028,0.0028529328777000974,0.2853246386807537,0.7146753613192464,0.03028497977866257
14572,13.0,421,5427,5848,48,476,8277,2382,5895,8277,603,0.05086383955539447,0.6556723450525552,0.005799202609641174,0.28778542950344327,0.7122145704965567,0.05750875921227498
14573,45.0,86,2268,2354,17,73,3138,899,2239,3138,251,0.027405991077119184,0.722753346080306,0.005417463352453792,0.28648820905035055,0.7135117909496494,0.023263224984066286
14574,,391,10367,10758,57,471,14233,4194,10039,14233,1099,0.027471369352912247,0.7283777137637883,0.00400477762945268,0.2946673224197288,0.7053326775802712,0.033092109885477415
14575,,737,10292,11029,140,637,16256,4231,12025,16256,996,0.0453371062992126,0.6331200787401575,0.00861220472440945,0.26027312992125984,0.7397268700787402,0.03918553149606299
14576,47.0,45,1734,1779,0,172,2292,608,1684,2292,119,0.01963350785340314,0.756544502617801,0.0,0.26527050610820246,0.7347294938917975,0.07504363001745201
14577,23.0,1349,27224,28573,176,1366,38131,10814,27317,38131,2605,0.03537803886601453,0.7139597702656632,0.004615667042563793,0.2836012693084367,0.7163987306915633,0.03582387034171671
14578,,410,15256,15666,36,902,20100,5666,14434,20100,1440,0.020398009950248756,0.7590049751243781,0.001791044776119403,0.28189054726368157,0.7181094527363184,0.044875621890547265
14579,,855,52115,53856,335,4628,72819,19648,53171,72819,5079,0.011741441107403288,0.7156786003652893,0.004600447685356844,0.26981968991609334,0.7301803100839067,0.06355484145621335
14580,,87,2317,2404,0,98,3221,904,2317,3221,239,0.027010245265445515,0.719341819310773,0.0,0.28065818068922693,0.719341819310773,0.030425333747283453
14581,24.0,103,4057,4160,76,303,5531,1526,4005,5531,326,0.018622310612909056,0.7335020791900199,0.013740734044476587,0.2758994756825167,0.7241005243174833,0.05478213704574218
14582,26.0,69,1967,2036,0,105,2884,761,2123,2884,220,0.0239251040221914,0.6820388349514563,0.0,0.26386962552011095,0.736130374479889,0.03640776699029126
14583,13.0,391,7118,7509,14,760,10253,2634,7619,10253,666,0.03813517994733249,0.6942358334146104,0.0013654540134594752,0.25690041938944697,0.743099580610553,0.07412464644494295
14584,,2848,70491,73339,237,3629,98281,27894,70387,98281,7292,0.028978134125619396,0.7172393443290158,0.002411452874919873,0.2838188459620883,0.7161811540379117,0.03692473621554522
14585,26.0,23250,924069,947319,581,50378,1227494,361438,866056,1227494,100913,0.018941029446987112,0.7528093823676532,0.0004733220691913769,0.29445194844129585,0.7055480515587041,0.041041341138938356
14586,34.0,315,8547,8862,84,397,11843,3358,8485,11843,912,0.026597990374060628,0.7216921388161783,0.007092797433082834,0.28354302119395425,0.7164569788060458,0.033521911677784344
14587,26.0,835,10007,10842,74,837,15344,4038,11306,15344,857,0.05441866527632951,0.6521767466110532,0.004822732012513035,0.2631647549530761,0.7368352450469239,0.05454900938477581
14588,13.0,123,2644,2767,7,197,3780,1045,2735,3780,309,0.03253968253968254,0.6994708994708995,0.001851851851851852,0.27645502645502645,0.7235449735449735,0.052116402116402116
14589,14.0,79,3907,3986,9,414,5381,1552,3829,5381,420,0.014681286006318527,0.7260732205909682,0.0016725515703400855,0.28842222635197917,0.7115777736480208,0.07693737223564394
14590,35.0,1005,24853,25858,93,1402,34376,9558,24818,34376,2669,0.0292355131487084,0.7229753316267163,0.002705375843611822,0.2780428205724924,0.7219571794275076,0.04078426809401908
14591,,53,1823,1876,10,69,2541,718,1823,2541,204,0.02085792994883904,0.7174340810704447,0.003935458480913027,0.2825659189295553,0.7174340810704447,0.02715466351829988
14592,15.0,655,28732,29552,168,5194,43030,10756,32274,43030,2925,0.015221938182663259,0.6677201952126424,0.003904252846851034,0.2499651405995817,0.7500348594004184,0.1207064838484778
14593,23.0,138,3543,3681,3,155,4731,1369,3362,4731,336,0.029169308814204185,0.7488902980342422,0.0006341154090044388,0.2893679983090256,0.7106320016909744,0.032762629465229336
14594,25.0,940,25127,26067,476,2087,35404,9916,25488,35404,2233,0.02655067224042481,0.7097220653033556,0.013444808496215117,0.2800813467404813,0.7199186532595186,0.05894814145294317
14595,,9846,115316,125169,482,13507,174215,47206,127009,174215,11177,0.05651637344660333,0.6619177453146974,0.0027666963235083086,0.27096403868782826,0.7290359613121717,0.07753063743076084
14596,24.0,101,3757,3858,2,155,5114,1451,3663,5114,442,0.019749706687524442,0.734649980445835,0.00039108330074305825,0.2837309346890888,0.7162690653109113,0.030308955807587017
14597,23.0,1104,26424,27528,144,966,36807,10613,26194,36807,2760,0.02999429456353411,0.7179069198793707,0.003912299290895754,0.2883418914880322,0.7116581085119679,0.026245007743092345
14598,,11140,6114,17254,57,709,25508,6661,18847,25508,646,0.4367257331033401,0.2396895091735926,0.002234593068841148,0.2611337619570331,0.7388662380429669,0.027795201505410067
14599,16.0,146,2777,2923,1,85,3716,1080,2636,3716,286,0.039289558665231435,0.7473089343379978,0.00026910656620021526,0.2906350914962325,0.7093649085037675,0.022874058127018298
14600,15.0,489,5855,6344,59,362,8546,2392,6154,8546,552,0.05721975193072783,0.685115843669553,0.006903814650128715,0.2798970278492862,0.7201029721507138,0.04235899836180669
14601,,73,2198,2271,12,97,2987,866,2121,2987,215,0.024439236692333444,0.7358553732842317,0.004017408771342484,0.28992299966521595,0.710077000334784,0.03247405423501841
14602,23.0,126,2404,2530,16,160,3666,925,2741,3666,178,0.03436988543371522,0.6557555919258047,0.00436442989634479,0.25231860338243317,0.7476813966175668,0.0436442989634479
14603,14.0,84,1614,1698,8,188,2354,594,1760,2354,165,0.0356839422259983,0.6856414613423959,0.0033984706881903144,0.2523364485981308,0.7476635514018691,0.07986406117247238
14604,,829,21748,22577,129,927,30625,8679,21946,30625,2602,0.02706938775510204,0.7101387755102041,0.004212244897959184,0.28339591836734696,0.7166040816326531,0.03026938775510204
14605,34.0,134,4211,4345,34,355,5819,1535,4284,5819,353,0.023028011685856678,0.7236638597697199,0.00584292833820244,0.2637910293864925,0.7362089706135074,0.06100704588417254
14606,27.0,341,36653,36994,34,2459,47666,14681,32985,47666,3142,0.007153946209037889,0.768954810556791,0.0007132966894641883,0.3079973146477573,0.6920026853522427,0.05158813409977762
14607,,742,18960,19702,102,869,26751,7635,19116,26751,2220,0.027737280849314046,0.7087585510822025,0.0038129415722776717,0.28540989121901983,0.7145901087809802,0.03248476692460095
14608,33.0,514,15236,15750,66,837,20876,5992,14884,20876,1528,0.02462157501437057,0.7298333013987354,0.0031615251963977775,0.2870281663153861,0.7129718336846139,0.04009388771795363
14609,25.0,444,12543,12987,149,855,17485,5069,12416,17485,1409,0.02539319416642837,0.7173577352016014,0.00852158993422934,0.2899056334000572,0.7100943665999429,0.048899056334000573
14610,17.0,126,2102,2228,65,163,3284,824,2460,3284,194,0.03836784409257003,0.6400730816077954,0.01979293544457978,0.25091352009744217,0.7490864799025578,0.04963459196102314
14611,,156,3441,3597,5,302,5015,1385,3630,5015,376,0.03110667996011964,0.6861415752741775,0.0009970089730807576,0.2761714855433699,0.7238285144566301,0.060219341974077766
14612,45.0,3291,65397,68688,340,3142,91356,26281,65075,91356,6182,0.03602390647576514,0.7158478917640877,0.003721704102631464,0.287676780944875,0.712323219055125,0.03439292438372959
14613,,108,2055,2163,12,120,2948,842,2106,2948,188,0.036635006784260515,0.6970827679782904,0.004070556309362279,0.2856173677069199,0.7143826322930801,0.0407055630936228
14614,23.0,3771,71901,75672,350,6394,104000,28512,75488,104000,6252,0.03625961538461538,0.6913557692307692,0.0033653846153846156,0.27415384615384614,0.7258461538461538,0.06148076923076923
14615,,4,2146,2150,14,417,3125,819,2306,3125,161,0.00128,0.68672,0.00448,0.26208,0.73792,0.13344
14616,16.0,212,5718,5930,30,263,7797,2265,5532,7797,554,0.02718994485058356,0.7333589842247018,0.003847633705271258,0.29049634474798,0.70950365525202,0.0337309221495447
14617,,324,7633,7957,17,320,10435,3090,7345,10435,690,0.03104935313847628,0.7314805941542885,0.0016291327264015333,0.2961188308576905,0.7038811691423096,0.030666027791087687
14618,17.0,256,3864,4120,19,210,5558,1527,4031,5558,374,0.046059733717164444,0.6952141057934509,0.003418495861820799,0.27473911478949264,0.7252608852105074,0.037783375314861464
14619,25.0,188,5168,5356,29,201,6990,2072,4918,6990,552,0.026895565092989987,0.7393419170243205,0.004148783977110157,0.29642346208869813,0.7035765379113018,0.028755364806866954
14620,24.0,3976,104586,108562,322,5831,143848,41532,102316,143848,11354,0.027640286969579,0.7270591179578444,0.002238473944719426,0.28872142817418384,0.7112785718258161,0.04053584339024526
14621,26.0,454,13226,13680,39,599,17840,5251,12589,17840,1314,0.02544843049327354,0.7413677130044843,0.00218609865470852,0.2943385650224215,0.7056614349775785,0.0335762331838565
14622,14.0,35,6597,6632,23,358,8890,2466,6424,8890,717,0.003937007874015748,0.7420697412823397,0.0025871766029246343,0.2773903262092238,0.7226096737907761,0.04026996625421822
14623,23.0,72,3506,3578,7,153,4663,1383,3280,4663,363,0.015440703409822003,0.7518764743727214,0.0015011794981771391,0.29659017799699766,0.7034098220030024,0.03281149474587176
14624,17.0,108,1736,1844,24,162,2793,682,2111,2793,172,0.03866809881847476,0.6215538847117794,0.008592910848549946,0.24418188327962764,0.7558181167203724,0.05800214822771214
14625,26.0,420,6038,6458,87,248,8695,2432,6263,8695,611,0.048303622771707876,0.6944220816561242,0.010005750431282346,0.279700977573318,0.720299022426682,0.028522139160437034
14626,16.0,704,12329,13033,149,754,17785,4891,12894,17785,1174,0.039583919032892885,0.6932246274950801,0.008377846499859433,0.27500702839471464,0.7249929716052853,0.04239527691875176
14627,15.0,138,2733,2871,17,183,3824,1110,2714,3824,284,0.03608786610878661,0.7146966527196653,0.00444560669456067,0.29027196652719667,0.7097280334728033,0.04785564853556486
14628,,212,1953,2165,15,243,3252,795,2457,3252,228,0.06519065190651907,0.6005535055350554,0.004612546125461255,0.2444649446494465,0.7555350553505535,0.07472324723247233
14629,15.0,180,3821,4001,20,370,5296,1386,3910,5296,303,0.033987915407854986,0.721487915407855,0.0037764350453172208,0.2617069486404834,0.7382930513595166,0.06986404833836858
14630,,876,14119,28630,12,766,38870,5934,32937,38871,1552,0.022536080882920428,0.36322708445885105,0.00030871343675233467,0.15265879447402947,0.8473412055259705,0.019706207712690695
14631,14.0,391,4760,5151,12,423,7135,1952,5183,7135,442,0.05480028030833917,0.6671338472319551,0.0016818500350385423,0.27358093903293623,0.7264190609670638,0.059285213735108616
14632,,1522,40700,42222,119,2003,55953,16049,39904,55953,4238,0.02720140117598699,0.727396207531321,0.0021267849802512825,0.2868300180508641,0.7131699819491358,0.035797901810448056
14633,15.0,31,2059,2090,5,72,2973,809,2164,2973,255,0.010427177934746047,0.6925664312142616,0.0016818028927009755,0.2721157080390178,0.7278842919609821,0.024217961654894045
14634,17.0,145,2924,3069,26,185,4137,1165,2972,4137,281,0.03504955281605028,0.7067923616146966,0.0062847474014986705,0.2816050277979212,0.7183949722020788,0.04471839497220208
14635,16.0,72,4655,4727,83,867,7418,1806,5612,7418,350,0.009706120248045295,0.6275276354812618,0.011188999730385549,0.24346184955513617,0.7565381504448638,0.11687786465354542
14636,,523,21286,21809,34,1653,29288,8340,20948,29288,2306,0.017857142857142856,0.7267822999180552,0.0011608850040972412,0.28475826276973504,0.715241737230265,0.05643949740508058
14637,23.0,977,15097,16074,104,1114,21669,6121,15548,21669,1428,0.04508745212054086,0.6967095851216023,0.004799483132585721,0.2824772716784346,0.7175227283215654,0.05140984817019706
14638,,1012,24207,25219,81,1328,33349,9379,23970,33349,2758,0.030345737503373413,0.7258688416444271,0.0024288584365348286,0.28123781822543403,0.718762181774566,0.039821283996521635
14639,46.0,607,14036,14643,120,519,19119,5468,13651,19119,1369,0.031748522412260054,0.7341388147915686,0.006276478895339714,0.285998221664313,0.714001778335687,0.027145771222344264
14640,,28,2046,2074,14,218,2969,718,2251,2969,174,0.009430784776018861,0.6891209161333782,0.004715392388009431,0.24183226675648367,0.7581677332435164,0.07342539575614684
14641,15.0,19,5092,5111,6,276,6784,1957,4827,6784,669,0.002800707547169811,0.7505896226415094,0.000884433962264151,0.2884728773584906,0.7115271226415094,0.04068396226415094
14642,24.0,56,1763,1819,6,58,2410,699,1711,2410,188,0.023236514522821577,0.7315352697095435,0.0024896265560165973,0.29004149377593363,0.7099585062240664,0.024066390041493777
14643,,263,10065,10328,31,497,13277,3885,9392,13277,1005,0.01980869172252768,0.7580778790389395,0.0023348648037960383,0.2926112826692777,0.7073887173307223,0.0374331550802139
14644,,1894,36956,38850,125,2504,51589,14887,36702,51589,3101,0.036713252825214676,0.7163542615673884,0.002422997150555351,0.28856926864254007,0.7114307313574599,0.04853747891992479
14645,41.0,265,5497,5762,39,345,7783,2168,5615,7783,583,0.034048567390466404,0.7062829243222408,0.005010921238596942,0.27855582680200436,0.7214441731979956,0.04432738018758833
14646,48.0,266,6035,6301,10,361,8470,2384,6086,8470,654,0.03140495867768595,0.7125147579693034,0.0011806375442739079,0.2814639905548996,0.7185360094451003,0.04262101534828808
14647,16.0,7760,181054,188814,963,17357,262303,71624,190679,262303,17059,0.029584106929772057,0.690247538152442,0.0036713266718260943,0.27305825705386516,0.7269417429461348,0.0661715649458832
14648,16.0,3134,73031,76165,619,4944,102323,28837,73487,102324,7072,0.030628200617645908,0.7137230757202612,0.006049411672725851,0.28182049177123647,0.7181795082287635,0.04831711035534186
14649,,176,3023,3199,52,130,4101,1182,2932,4114,254,0.0427807486631016,0.7348079727758872,0.012639766650461837,0.287311618862421,0.712688381137579,0.03159941662615459
14650,,81,1944,2025,13,90,2699,780,1919,2699,199,0.03001111522786217,0.7202667654686921,0.004816598740274175,0.28899592441645056,0.7110040755835495,0.033345683586513526
14651,24.0,5300,97834,103134,491,4783,141424,38967,102457,141424,10569,0.03747595881887091,0.6917779160538522,0.003471829392465211,0.27553314854621563,0.7244668514537843,0.03382028510012445
14652,16.0,68,1594,1662,3,85,2214,605,1609,2214,181,0.03071364046973803,0.7199638663053297,0.0013550135501355014,0.2732610659439928,0.7267389340560072,0.03839205058717254
14653,16.0,632,13351,13983,142,687,18625,5275,13350,18625,1416,0.03393288590604027,0.7168322147651006,0.007624161073825503,0.2832214765100671,0.7167785234899329,0.03688590604026846
14654,17.0,31,2160,2191,24,118,3074,818,2256,3074,230,0.010084580351333767,0.7026675341574495,0.007807417046193884,0.2661027976577749,0.7338972023422251,0.038386467143786594
14655,17.0,141,2882,3023,9,227,4041,1151,2890,4041,269,0.034892353377876766,0.7131898045038357,0.0022271714922048997,0.2848304875030933,0.7151695124969067,0.05617421430339025
14656,,2062,17780,19842,277,1744,26967,7738,19229,26967,1391,0.0764638261578967,0.6593243594022323,0.010271813698223754,0.2869433010716802,0.7130566989283198,0.06467163570289614
14657,,211,6700,6911,18,387,9263,2707,6556,9263,642,0.02277879736586419,0.7233077836554033,0.00194321494116377,0.29223793587390695,0.7077620641260931,0.041779121235021054
14658,16.0,1443,23269,24712,122,1124,33977,9224,24753,33977,2884,0.04246990611295877,0.68484563086794,0.003590664272890485,0.27147776437001503,0.728522235629985,0.033081201989581185
14659,,174,5606,5780,30,291,7667,2216,5451,7667,601,0.02269466544932829,0.7311856006260598,0.003912873353332464,0.2890309116994913,0.7109690883005086,0.0379548715273249
14660,23.0,686,17697,18383,134,753,24753,6952,17801,24753,2033,0.027713812467175695,0.7149436431947642,0.005413485234113037,0.2808548458772674,0.7191451541227326,0.030420555084232213
14661,,689,19827,20516,39,981,25983,7753,18230,25983,1750,0.026517338259631297,0.7630758572913059,0.0015009814109225262,0.2983874071508294,0.7016125928491707,0.03775545549012816
14662,17.0,132,7852,7984,14,514,10905,2983,7922,10905,763,0.012104539202200825,0.7200366804218249,0.0012838147638697846,0.27354424575882624,0.7264557542411738,0.04713434204493352
14663,23.0,4680,78264,82944,571,4624,112806,32120,80689,112809,7890,0.04148605164481557,0.6937744328909927,0.00506165288230549,0.284729055305871,0.715270944694129,0.04098963735162975
14664,,553,11476,12029,132,760,16460,4508,11952,16460,1225,0.03359659781287971,0.6972053462940462,0.00801944106925881,0.27387606318347507,0.7261239368165249,0.046172539489671933
14665,17.0,4,5548,5552,24,157,7399,2094,5305,7399,702,0.0005406135964319503,0.7498310582511151,0.0032436815785917015,0.28301121773212595,0.716988782267874,0.02121908365995405
14666,14.0,14,5533,5557,32,859,8081,2035,6046,8081,508,0.001732458854102215,0.6846924885533968,0.0039599059522336345,0.2518252691498577,0.7481747308501423,0.10629872540527162
14667,33.0,2110,34986,37096,411,2153,49425,14242,35183,49425,3564,0.04269094587759231,0.7078603945371775,0.008315629742033384,0.2881537683358624,0.7118462316641376,0.043560950935761254
14668,,4852,69916,74768,360,3898,98565,28267,70298,98565,6492,0.04922639882311165,0.7093390148632882,0.003652412113833511,0.28678537006036625,0.7132146299396337,0.039547506721452845
14669,26.0,80,2667,2747,2,96,3636,1076,2560,3636,318,0.022002200220022004,0.7334983498349835,0.00055005500550055,0.29592959295929594,0.7040704070407041,0.026402640264026403
14670,16.0,208,4331,4539,22,236,5945,1762,4183,5945,408,0.03498738435660219,0.728511354079058,0.003700588730025231,0.29638351555929354,0.7036164844407065,0.03969722455845248
14671,24.0,174,1840,2014,26,181,2808,736,2072,2808,177,0.06196581196581197,0.6552706552706553,0.009259259259259259,0.2621082621082621,0.7378917378917379,0.06445868945868946
14672,34.0,1014,24933,25947,41,1185,34188,9917,24271,34188,2392,0.02965952965952966,0.7292909792909793,0.0011992511992511992,0.2900725400725401,0.70992745992746,0.03466128466128466
14673,,403,13968,14371,57,502,18450,5452,12998,18450,1507,0.021842818428184283,0.7570731707317073,0.003089430894308943,0.2955013550135501,0.7044986449864499,0.027208672086720866
14674,,109,2744,2853,35,239,4061,1122,2939,4061,255,0.026840679635557745,0.6756956414676188,0.008618566855454321,0.2762866289091357,0.7237133710908643,0.05885249938438808
14675,,1313,28913,30226,113,1530,39912,11389,28523,39912,3002,0.03289737422329124,0.7244187211866105,0.0028312287031469234,0.28535277610743637,0.7146472238925636,0.038334335538184
14676,41.0,90,2512,2602,6,97,3327,977,2350,3327,244,0.027051397655545536,0.7550345656747821,0.0018034265103697023,0.2936579501051999,0.7063420498948001,0.029155395250976854
14677,,648,11901,12549,68,1026,17131,4779,12352,17131,1208,0.0378261630961415,0.6947055046407098,0.00396941217675559,0.2789679528340435,0.7210320471659565,0.05989142490222404
14678,17.0,334,6807,7141,63,350,9555,2720,6835,9555,735,0.03495552066980638,0.7124018838304552,0.006593406593406593,0.2846677132391418,0.7153322867608581,0.03663003663003663
14679,16.0,487,10937,11424,17,654,15422,4328,11094,15422,1146,0.031578264816495914,0.7091816884969524,0.0011023213590973934,0.28063804953961874,0.7193619504603813,0.0424069511088056
14680,,586,20538,21124,216,1017,28058,7869,20189,28058,1999,0.020885309002779955,0.7319837479506736,0.007698339154608312,0.2804547722574667,0.7195452277425334,0.03624634685294747
14681,15.0,404,1770,2174,6,220,3048,816,2232,3048,157,0.1325459317585302,0.5807086614173228,0.001968503937007874,0.2677165354330709,0.7322834645669292,0.07217847769028872
14682,16.0,925,17862,18787,156,876,24310,7054,17256,24310,1553,0.038050185109008636,0.73475935828877,0.006417112299465241,0.29016865487453725,0.7098313451254628,0.036034553681612506
14683,25.0,68,2251,2319,16,129,3137,872,2265,3137,242,0.021676761236850493,0.7175645521198597,0.005100414408670704,0.2779725852725534,0.7220274147274466,0.04112209116990755
14684,,966,25545,26511,145,737,33744,10154,23590,33744,2542,0.028627311522048365,0.7570234708392604,0.00429706021811285,0.30091275486012325,0.6990872451398767,0.021840919867235655
14685,,81,2912,2993,7,25,3894,1158,2736,3894,371,0.020801232665639446,0.7478171545968156,0.0017976373908577298,0.29738058551617874,0.7026194144838213,0.0064201335387776065
14686,,1486,36192,37678,113,1714,50316,14477,35839,50316,4204,0.029533349232848397,0.7192940615311233,0.0022458065029016617,0.2877215994912155,0.7122784005087844,0.0340647110263137
14687,26.0,158,3894,4052,25,216,5503,1563,3940,5503,414,0.028711611848082862,0.7076140287116118,0.004542976558240959,0.2840268944212248,0.7159731055787752,0.03925131746320189
14688,26.0,3445,71663,75108,326,4027,99521,28743,70778,99521,8599,0.0346158097286,0.720079179268697,0.0032756905577717267,0.2888134162639041,0.7111865837360959,0.040463821705971605
14689,,4061,78279,82340,483,4684,112240,31502,80738,112240,7741,0.036181397006414824,0.6974251603706344,0.00430327868852459,0.2806664290805417,0.7193335709194583,0.0417320028510335
14690,33.0,1208,34539,35747,94,1408,47524,13717,33807,47524,4307,0.025418735796650115,0.7267696321858429,0.001977947984176416,0.2886331116909351,0.7113668883090649,0.029627135762982915
14691,,226,5318,5544,39,275,7835,2153,5682,7835,381,0.028844926611359286,0.6787492022973836,0.0049776643267389915,0.2747925973197192,0.7252074026802808,0.03509891512444161
14692,,2494,44518,47012,118,3121,66832,17412,49420,66832,3921,0.03731745271726119,0.6661180272923151,0.001765621259276993,0.2605338759875509,0.7394661240124492,0.04669918601867369
14693,,388,4878,5266,140,358,7581,1981,5600,7581,394,0.05118058303653872,0.6434507320933913,0.018467220683287166,0.2613111726685134,0.7386888273314867,0.04722332146154861
14694,15.0,353,11875,12228,28,642,16609,4568,12041,16609,1396,0.021253537238846407,0.7149738093804564,0.0016858329821181287,0.2750316093684147,0.7249683906315852,0.038653741947137096
14695,23.0,612,14436,15048,75,1230,20718,5914,14804,20718,1302,0.029539530842745437,0.6967854039965248,0.003620040544454098,0.2854522637320205,0.7145477362679795,0.05936866492904721
14696,33.0,215,1923,2138,43,225,3018,779,2239,3018,186,0.0712392312789927,0.6371769383697813,0.014247846255798542,0.25811795891318756,0.7418820410868124,0.07455268389662027
14697,17.0,267,4447,4714,8,281,6765,1799,4966,6765,531,0.039467849223946784,0.6573540280857354,0.0011825572801182557,0.26592756836659276,0.7340724316334073,0.04153732446415373
14698,,395,7235,7630,26,365,10031,2931,7100,10031,836,0.03937792842189213,0.7212640813478217,0.0025919649087827734,0.29219419798624263,0.7078058020137573,0.036387199680988934
14699,17.0,1609,35555,37164,229,1992,49143,14312,34831,49143,3349,0.03274118389190729,0.7235008037767332,0.004659870174796003,0.2912317115357223,0.7087682884642778,0.04053476588730847
14700,14.0,1498,18027,19525,31,986,26502,7675,18827,26502,1909,0.05652403592181722,0.6802128141272357,0.0011697230397705834,0.2896007848464267,0.7103992151535733,0.03720473926496114
14701,33.0,8054,136922,144976,1210,7766,197069,54307,142762,197069,12659,0.040868934231157616,0.694792179388945,0.006139981427824772,0.2755735300833718,0.7244264699166282,0.039407517164038994
14702,,2562,21524,24086,1150,2902,34663,8875,25788,34663,1807,0.07391166373366413,0.6209502928194328,0.033176585985056115,0.25603669618902,0.74396330381098,0.08372039350315899
14703,,215,8586,8801,11,285,11175,3440,7735,11175,853,0.01923937360178971,0.7683221476510067,0.0009843400447427293,0.30782997762863534,0.6921700223713646,0.025503355704697986
14704,13.0,28,1596,1624,3,161,2230,603,1627,2230,175,0.012556053811659192,0.715695067264574,0.0013452914798206279,0.2704035874439462,0.7295964125560538,0.07219730941704036
14705,,179,4178,4357,28,229,6043,1615,4428,6043,430,0.029621049147774286,0.6913784544100612,0.0046334602018864805,0.26725136521595233,0.7327486347840476,0.03789508522257157
14706,14.0,126,2468,2594,60,137,3741,1004,2737,3741,238,0.03368083400160385,0.6597166533012564,0.01603849238171612,0.26837743918738305,0.7316225608126169,0.03662122427158514
14707,16.0,622,13824,14446,64,1403,20014,5395,14619,20014,1228,0.031078245228340164,0.6907164984510843,0.003197761566903168,0.26956130708504045,0.7304386929149596,0.07010092934945539
14708,,66410,1290550,1356960,8934,82708,1821784,513854,1307930,1821784,128467,0.03645327876411254,0.7083990198618497,0.004903984226450556,0.2820608809825973,0.7179391190174027,0.0453994546005454
14709,27.0,688,9900,10588,181,639,14650,4104,10546,14650,1049,0.046962457337883956,0.6757679180887372,0.012354948805460751,0.28013651877133106,0.7198634812286689,0.04361774744027304
14710,,21746,529327,551073,2668,28677,731571,209777,521794,731571,51577,0.02972507111408189,0.723548363726829,0.0036469460927237413,0.2867486546076867,0.7132513453923133,0.03919920281148378
14711,,429,10955,11384,85,552,14942,4208,10734,14942,1013,0.028711015928255923,0.7331682505688663,0.005688662829607817,0.281622272788114,0.718377727211886,0.0369428456699237
14712,25.0,1603,37352,38955,84,2403,51886,14684,37202,51886,3728,0.03089465366380141,0.7198859037119839,0.001618933816443742,0.28300504953166555,0.7169949504683344,0.04631307096326562
14713,,664,17154,17818,153,1003,23706,6751,16955,23706,1659,0.028009786551927783,0.7236142748671223,0.006454062262718299,0.28478022441575973,0.7152197755842403,0.04230996372226441
14714,17.0,43,2730,2773,17,89,3594,1067,2527,3594,328,0.011964385086254869,0.7595993322203672,0.0047301057317751805,0.29688369504730105,0.703116304952699,0.02476349471341124
14715,46.0,1744,33258,35002,518,1977,47927,13067,34878,47945,3040,0.036375013035770155,0.6936698300135572,0.010804046303055585,0.2725414537490875,0.7274585462509126,0.04123474814892064
14716,27.0,365,3124,3489,6,143,4788,1352,3436,4788,409,0.07623224728487886,0.6524644945697577,0.0012531328320802004,0.28237259816207183,0.7176274018379282,0.029866332497911444
14717,,1176,3813,4989,103,381,6858,2033,4825,6858,255,0.1714785651793526,0.5559930008748907,0.015018955963837854,0.29644211140274135,0.7035578885972587,0.05555555555555555
14718,,220,5266,5486,11,319,7374,1991,5383,7374,584,0.029834553837808517,0.714130729590453,0.0014917276918904258,0.2700027122321671,0.7299972877678329,0.04326010306482235
14719,23.0,1919,57374,59293,221,2365,77501,22353,55148,77501,6137,0.02476097082618289,0.7403001251596754,0.0028515761086953715,0.2884220848763242,0.7115779151236759,0.030515735280835087
14720,17.0,2328,46501,48829,260,3025,65581,18346,47235,65581,4625,0.035498086335981456,0.7090620759061314,0.00396456290693951,0.27974565804120094,0.720254341958799,0.046126164590353916
14721,43.0,1001,20041,21042,499,1038,28666,7828,20838,28666,1850,0.03491941673062164,0.6991209097885998,0.017407381567013186,0.27307611804925697,0.7269238819507431,0.036210144421963304
14722,,128,2385,2513,33,155,3389,911,2478,3389,227,0.03776925346709944,0.7037474181174388,0.009737385659486574,0.2688108586603718,0.7311891413396282,0.045736205370315725
14723,16.0,55,1942,1997,2,89,2613,753,1860,2613,203,0.02104860313815538,0.7432070417145044,0.0007654037504783774,0.2881745120551091,0.711825487944891,0.03406046689628779
14724,,118,2831,2949,14,203,4044,1127,2917,4044,303,0.029179030662710187,0.7000494559841741,0.0034619188921859545,0.2786844708209693,0.7213155291790306,0.05019782393669634
14725,17.0,160,5014,5174,21,362,8144,1863,6281,8144,450,0.019646365422396856,0.6156679764243614,0.0025785854616895876,0.2287573673870334,0.7712426326129665,0.044449901768172886
14726,46.0,3967,69428,73395,377,6283,102377,26961,75416,102377,6145,0.03874893774968987,0.6781601336237632,0.0036824677417779386,0.263350166541313,0.7366498334586871,0.06137120642331774
14727,14.0,2,2140,2142,15,13,2753,779,1974,2753,252,0.000726480203414457,0.777333817653469,0.005448601525608427,0.28296403922993096,0.717035960770069,0.00472212132219397
14728,,256,5759,6015,1,288,8081,2321,5760,8081,602,0.031679247617869076,0.712659324341047,0.00012374706100730108,0.2872169285979458,0.7127830714020542,0.03563915357010271
14729,13.0,253,5881,6134,68,389,8502,2302,6200,8502,573,0.029757704069630676,0.6917195953893202,0.007998118089861209,0.2707598212185368,0.7292401787814632,0.045753940249353094
14730,,10339,159841,170180,949,11414,236341,65220,171121,236341,14317,0.04374611260847674,0.6763151547975171,0.004015384550289624,0.2759571974392932,0.7240428025607067,0.04829462513909986
14731,27.0,452,13530,13982,10,649,18333,5260,13073,18333,1334,0.024654993727158677,0.7380134184257896,0.0005454644629902362,0.28691430753286423,0.7130856924671357,0.035400643648066325
14732,35.0,1517,28851,30368,53,1139,42071,11832,30239,42071,4031,0.036058092272586814,0.6857692947636139,0.0012597751420218202,0.2812388581207958,0.7187611418792043,0.027073280882317988
14733,26.0,245,5314,5559,2,444,7541,2130,5411,7541,416,0.032489059806391725,0.7046810767802679,0.0002652168147460549,0.2824559077045485,0.7175440922954516,0.05887813287362419
14734,24.0,2240,45270,47510,192,2810,63646,18042,45604,63646,4310,0.03519467052132106,0.7112780064733055,0.003016686044684662,0.28347421676146184,0.7165257832385382,0.044150457216478645
14735,,139,3814,3953,8,175,5371,1536,3835,5371,416,0.025879724446099425,0.7101098491900949,0.0014894805436603984,0.2859802643827965,0.7140197356172036,0.032582386892571216
14736,,71,2240,2311,3,91,3111,869,2242,3111,283,0.022822243651558983,0.7200257152041144,0.0009643201542912247,0.27933140469302475,0.7206685953069752,0.02925104468016715
14737,14.0,124,5958,6082,12,515,8516,2398,6118,8516,641,0.01456082667919211,0.6996242367308596,0.0014091122592766556,0.28158759981211834,0.7184124001878817,0.06047440112728981
14738,,182,3401,3583,5,194,4881,1364,3517,4881,334,0.03728744109813563,0.6967834460151608,0.001024380249948781,0.27945093218602746,0.7205490678139725,0.039745953698012704
14739,16.0,1429,23472,24901,312,1620,33071,9249,23822,33071,2011,0.04321006319736325,0.7097456986483626,0.00943424752804572,0.2796710108554323,0.7203289891445678,0.04898551601100662
14740,23.0,67,3175,3242,0,121,4216,1273,2943,4216,375,0.015891840607210626,0.7530834914611005,0.0,0.3019449715370019,0.698055028462998,0.028700189753320685
14741,,3668,63346,67014,165,3356,87760,25351,62418,87769,5861,0.041791520924244326,0.721735464685709,0.0018799348289259305,0.28883774453394706,0.7111622554660529,0.03823673506591165
14742,,200,6788,6988,70,504,9586,2472,7114,9586,774,0.020863759649488837,0.7081160025036511,0.007302315877321094,0.25787606926768203,0.742123930732318,0.05257667431671187
14743,,951,21534,22485,70,1033,30126,8471,21655,30126,2499,0.03156741684923322,0.714797849034057,0.002323574321184359,0.28118568678218153,0.7188143132178185,0.034289318196906324
14744,25.0,102,2835,2937,13,106,3799,1119,2680,3799,250,0.026849170834430114,0.7462490128981311,0.003421953145564622,0.29455119768360094,0.7054488023163991,0.027902079494603844
14745,,18186,346447,364633,2173,23603,492256,138413,353843,492256,34294,0.03694419164012221,0.7037943671585516,0.004414369758824676,0.281180930247676,0.718819069752324,0.04794862835597738
14746,17.0,339,9557,9896,20,343,12693,3742,8951,12693,982,0.026707634129047506,0.7529346884109351,0.0015756716300323013,0.2948081619790436,0.7051918380209564,0.027022768455053966
14747,45.0,242,9294,9536,22,333,12286,3660,8626,12286,922,0.01969721634380596,0.7564707797493082,0.0017906560312550871,0.29790004883607357,0.7020999511639264,0.027104020836724727
14748,25.0,12,1824,1836,4,62,2389,715,1674,2389,239,0.0050230221850146506,0.7634993721222268,0.0016743407283382169,0.29928840519045624,0.7007115948095437,0.02595228128924236
14749,,172,2875,3047,473,413,4802,1117,3685,4802,250,0.03581840899625156,0.5987088713036235,0.09850062473969179,0.23261141191170345,0.7673885880882966,0.08600583090379009
14750,,225,5458,5683,11,404,7541,2044,5497,7541,541,0.029836891658931178,0.7237766874419839,0.0014586924811033019,0.2710515846704681,0.7289484153295319,0.05357379657870309
14751,24.0,220,5967,6187,20,318,8369,2300,6069,8369,692,0.026287489544748476,0.7129884096068826,0.002389771776795316,0.27482375433146133,0.7251762456685387,0.03799737125104553
14752,,647,13159,13806,56,569,18039,5347,12692,18039,1327,0.03586673318920117,0.7294750263318366,0.0031043849437330227,0.2964133266810799,0.7035866733189201,0.03154276844614447
14753,15.0,258,5572,5830,17,396,8208,2261,5947,8208,588,0.031432748538011694,0.678849902534113,0.002071150097465887,0.27546296296296297,0.7245370370370371,0.04824561403508772
14754,,148,3416,3564,17,275,4974,1463,3511,4974,334,0.029754724567752314,0.6867712102935264,0.003417772416566144,0.29412947326095695,0.705870526739043,0.05528749497386409
14755,13.0,131,3475,3606,25,407,5013,1337,3676,5013,235,0.026132056652702972,0.6931976860163575,0.004987033712347895,0.26670656293636547,0.7332934370636346,0.08118890883702373
14756,,64,2351,2415,23,102,3331,900,2431,3331,251,0.019213449414590213,0.7057940558390874,0.006904833383368358,0.2701891323926749,0.7298108676073252,0.030621435004503154
14757,,750,16678,17428,164,699,22979,6632,16347,22979,1850,0.03263849601810349,0.7257931154532399,0.0071369511292919624,0.2886113407894164,0.7113886592105836,0.03041907828887245
14758,,1497,36216,37713,94,1915,50259,14244,36015,50259,3991,0.029785710022085597,0.7205873574882111,0.0018703117849539386,0.28341192622216915,0.7165880737778308,0.03810262838496588
14759,,203,5094,5297,2,210,6769,2056,4713,6769,513,0.02998965873836608,0.7525483823312158,0.0002954646181119811,0.3037376274191166,0.6962623725808834,0.031023784901758014
14760,16.0,276,6727,7003,31,323,9348,2716,6632,9348,816,0.029525032092426188,0.7196191698759092,0.003316217372700043,0.290543431750107,0.709456568249893,0.034552845528455285
14761,16.0,3487,43592,47079,1036,3856,68624,18262,50362,68624,3792,0.05081312660293775,0.6352296572627653,0.015096759151317323,0.26611681044532526,0.7338831895546748,0.05619025413849382
14762,25.0,69,1619,1688,3,416,2396,374,2022,2396,77,0.028797996661101836,0.6757095158597662,0.0012520868113522537,0.15609348914858096,0.843906510851419,0.17362270450751252
14763,,3099,49421,52520,192,4219,73324,20142,53182,73324,4738,0.04226447002345753,0.6740085101740222,0.0026185150837379303,0.27469859800338225,0.7253014019966177,0.057539141345262126
14764,15.0,598,6558,7156,46,290,9232,2784,6448,9232,733,0.06477469670710571,0.7103552859618717,0.00498266897746967,0.30155979202772965,0.6984402079722704,0.031412478336221836
14765,,147,4376,4523,16,368,6077,1705,4372,6077,407,0.024189567220668094,0.7200921507322692,0.0026328780648346224,0.28056606878393947,0.7194339312160606,0.06055619549119631
14766,,122,1588,1710,6,133,2400,632,1768,2400,134,0.050833333333333335,0.6616666666666666,0.0025,0.2633333333333333,0.7366666666666667,0.05541666666666667
14767,,300,4899,5199,47,277,7215,1955,5260,7215,432,0.04158004158004158,0.679002079002079,0.006514206514206514,0.27096327096327094,0.729036729036729,0.03839223839223839
14768,,1388,43907,45295,87,1841,58774,17303,41471,58774,4324,0.023615884574811993,0.7470480144281485,0.0014802463674413856,0.2943988838602103,0.7056011161397897,0.03132337428114473
14769,,619,14546,15165,108,332,19654,5913,13741,19654,1387,0.031494861096977717,0.7401037956650046,0.005495064617889488,0.30085478782944947,0.6991452121705505,0.016892235677215834
14770,24.0,322,10054,10376,25,453,13655,3927,9728,13655,1036,0.02358110582204321,0.7362870743317466,0.001830831197363603,0.28758696448187476,0.7124130355181252,0.03317466129622849
14771,,1073,27159,28232,66,1365,37402,10737,26665,37402,2749,0.02868830543821186,0.7261376396984118,0.0017646115181006363,0.2870702101491899,0.7129297898508101,0.03649537457889952
14772,26.0,980,16117,17097,92,1147,24116,6371,17745,24116,1527,0.04063692154586167,0.668311494443523,0.0038148946757339524,0.26418145629457623,0.7358185437054238,0.0475617847072483
14773,26.0,60,1757,1817,5,133,2591,649,1942,2591,145,0.023157082207641837,0.6781165573137785,0.0019297568506368198,0.2504824392126592,0.7495175607873408,0.051331532226939404
14774,26.0,616,13848,14464,15,690,19495,5515,13980,19495,1612,0.03159784560143627,0.7103359835855347,0.0007694280584765325,0.28289304949987176,0.7171069505001283,0.035393690689920494
14775,26.0,2117,69327,71444,265,5076,98205,27021,71184,98205,7701,0.021556947202280942,0.7059416526653429,0.0026984369431291687,0.275148923170918,0.724851076829082,0.051687795937070416
14776,,1066,31774,32840,29,2256,43287,11819,31468,43287,2843,0.024626331231085544,0.7340310023794673,0.0006699470972809389,0.27303809457804884,0.7269619054219512,0.05211726384364821
14777,14.0,147,2669,2816,32,389,4036,1081,2955,4036,245,0.036422200198216056,0.6612983151635282,0.007928642220019821,0.2678394449950446,0.7321605550049554,0.09638255698711595
14778,16.0,197,4298,4495,10,156,6059,1733,4326,6059,560,0.03251361610826869,0.7093579798646641,0.001650437365901964,0.2860207955108104,0.7139792044891896,0.02574682290807064
14779,33.0,204,6132,6336,27,233,8273,2353,5920,8273,603,0.02465852774084371,0.7412063338571256,0.0032636286715822557,0.28441919497159435,0.7155808050284057,0.02816390668439502
14780,33.0,893,19873,20766,98,1355,29118,7910,21208,29118,2144,0.030668315131533758,0.6824987979943677,0.0033656157703138953,0.27165327288962154,0.7283467271103785,0.04653478947729926
14781,,31,4307,4338,19,246,5888,1570,4318,5888,537,0.005264945652173913,0.7314877717391305,0.0032269021739130435,0.26664402173913043,0.7333559782608695,0.041779891304347824
14782,,283,7380,7663,41,218,10037,2935,7102,10037,892,0.028195675998804424,0.7352794659758892,0.004084885922088274,0.29241805320314834,0.7075819467968516,0.02171963734183521
14783,27.0,374,13202,13576,46,565,17717,5179,12538,17717,1423,0.021109668679799062,0.74516001580403,0.002596376361686516,0.29231811254727097,0.707681887452729,0.03189027487723655
14784,,181,10302,10483,119,1080,14546,3830,10716,14546,987,0.012443283376873367,0.7082359411522068,0.008180943214629451,0.26330262615151934,0.7366973738484807,0.07424721572941015
14785,26.0,55,1957,2012,2,127,2699,731,1968,2699,196,0.02037791774731382,0.7250833642089662,0.0007410151908114116,0.27084105224157096,0.729158947758429,0.04705446461652464
14786,24.0,386,11642,12028,21,435,15731,4664,11067,15731,1198,0.02453753734664039,0.7400673828745788,0.0013349437416566017,0.29648464814697095,0.703515351853029,0.02765240607717246
14787,,293,4788,5081,4,782,7214,1903,5311,7214,384,0.04061546991960078,0.663709453839756,0.0005544774050457444,0.2637926254505129,0.7362073745494871,0.10840033268644303
14788,14.0,182,4968,5150,23,331,7183,1954,5229,7183,584,0.025337602672977865,0.6916330224140331,0.0032020047333983013,0.27203118474175136,0.7279688152582486,0.04608102464151469
14789,26.0,584,24971,25555,104,1304,35007,9885,25122,35007,2871,0.016682377810152256,0.7133144799611506,0.0029708344045476618,0.2823720970091696,0.7176279029908305,0.037249692918559146
14790,,224,4365,4589,24,438,6844,1780,5064,6844,468,0.03272939801285798,0.6377849210987726,0.0035067212156633548,0.26008182349503217,0.7399181765049678,0.06399766218585623
14791,26.0,86,2316,2402,2,95,3212,915,2297,3212,259,0.026774595267745952,0.7210460772104608,0.0006226650062266501,0.2848692403486924,0.7151307596513076,0.029576587795765878
14792,39.0,1495,32015,33510,112,1333,44194,12831,31363,44194,3145,0.03382812146445219,0.7244196044711951,0.002534280671584378,0.2903335294383853,0.7096664705616147,0.030162465493053355
14793,27.0,70,1722,1792,25,44,2356,673,1683,2356,207,0.029711375212224108,0.730899830220713,0.010611205432937181,0.28565365025466893,0.7143463497453311,0.01867572156196944
14794,16.0,183,3802,3985,6,342,5470,1513,3957,5470,402,0.03345521023765996,0.6950639853747714,0.0010968921389396709,0.27659963436928703,0.723400365630713,0.06252285191956124
14795,33.0,736,17381,18117,181,944,24178,6973,17205,24178,1854,0.030440896682934898,0.7188766647365373,0.0074861444288195885,0.28840268012242537,0.7115973198775747,0.03904375878898172
14796,15.0,434,11797,12231,52,650,16204,4701,11503,16204,1237,0.026783510244384103,0.7280301160207356,0.0032090841767464825,0.29011355220933105,0.709886447790669,0.04011355220933103
14797,17.0,109,1449,1558,1,88,2354,561,1793,2354,140,0.04630416312659303,0.6155480033984707,0.0004248088360237893,0.2383177570093458,0.7616822429906542,0.037383177570093455
14798,17.0,608,25393,26001,183,2459,35860,9759,26101,35860,2815,0.016954824316787506,0.7081148912437256,0.005103179029559398,0.2721416620189626,0.7278583379810374,0.06857222532069158
14799,,931,21799,22730,116,1179,30762,8546,22216,30762,2187,0.03026461218386321,0.7086340289968143,0.003770886158247188,0.27781028541707303,0.722189714582927,0.03832650672908133
14800,27.0,1158,29116,30274,61,1281,40077,11669,28408,40077,3113,0.028894378321730668,0.726501484642064,0.0015220700152207,0.29116450832148116,0.7088354916785189,0.0319634703196347
14801,,249,3349,3598,65,224,5196,1350,3846,5196,285,0.04792147806004619,0.6445342571208622,0.012509622786759045,0.25981524249422633,0.7401847575057737,0.04311008468052348
14802,23.0,102,2158,2260,0,130,3000,883,2117,3000,151,0.034,0.7193333333333334,0.0,0.29433333333333334,0.7056666666666667,0.043333333333333335
14803,14.0,14,9570,9584,19,1194,13741,3657,10084,13741,1078,0.0010188487009679063,0.696455862018776,0.0013827232370278728,0.2661378356742595,0.7338621643257405,0.08689323921112001
14804,15.0,253,7096,7349,40,424,9726,2756,6970,9726,659,0.02601274933168826,0.7295907875796833,0.004112687641373638,0.28336417849064366,0.7166358215093563,0.04359448899856056
14805,15.0,174,2586,2760,3,183,3760,1032,2728,3760,254,0.04627659574468085,0.6877659574468085,0.0007978723404255319,0.274468085106383,0.725531914893617,0.04867021276595745
14806,35.0,278,3922,4200,80,287,5863,1606,4257,5863,355,0.04741599863551083,0.6689408152822787,0.013644891693672181,0.27392120075046905,0.726078799249531,0.04895104895104895
14807,,1664,12305,13969,150,2418,19769,5168,14601,19769,774,0.08417218878041378,0.6224391724417017,0.0075876372097728765,0.2614193940007082,0.7385806059992919,0.12231271182153877
14808,,210,8343,8553,13,355,11188,3246,7942,11188,847,0.018770110833035394,0.745709688952449,0.0011619592420450482,0.29013228459063284,0.7098677154093672,0.03173042545584555
14809,,774,12664,13438,60,827,17965,5116,12849,17965,1222,0.04308377400500974,0.704926245477317,0.003339827442248817,0.28477595324241584,0.7152240467575842,0.046033954912329526
14810,24.0,537,14417,14954,17,670,19837,5717,14120,19837,1433,0.027070625598628825,0.7267732015929829,0.0008569844230478399,0.2881988203861471,0.7118011796138529,0.033775268437767805
14811,14.0,128,12378,12506,26,737,16794,4718,12076,16794,1414,0.007621769679647493,0.7370489460521615,0.0015481719661783971,0.2809336667857568,0.7190663332142432,0.04388472073359533
14812,,1353,32382,33735,64,1843,46035,12640,33397,46037,3240,0.029389404174902795,0.7033907509177401,0.0013901861546147664,0.27456176553641637,0.7254382344635837,0.0400330169211721
14813,,892,16128,17020,129,977,23129,6621,16508,23129,1496,0.03856630204505167,0.6973064118638939,0.005577413636560163,0.28626399757879717,0.7137360024212028,0.04224134203813394
14814,,3,4323,4326,6,543,6298,1608,4690,6298,541,0.000476341695776437,0.6864083836138457,0.000952683391552874,0.2553191489361702,0.7446808510638298,0.0862178469355351
14815,,114,4730,4844,64,291,6964,1883,5081,6964,498,0.016369902354968408,0.6792073520964963,0.009190120620333142,0.27039058012636413,0.7296094198736358,0.04178632969557725
14816,24.0,879,14586,15465,65,779,20560,5839,14721,20560,1283,0.042752918287937744,0.7094357976653697,0.00316147859922179,0.28399805447470816,0.7160019455252918,0.037889105058365756
14817,34.0,1099,30888,31987,107,1630,43033,11968,31065,43033,3097,0.025538540190086678,0.7177747310203797,0.0024864638765598494,0.2781121464922269,0.7218878535077731,0.03787790765226687
14818,26.0,451,13155,13606,68,835,18497,5097,13400,18497,1411,0.024382332270097853,0.7111964102286857,0.003676271827863978,0.27555819862680436,0.7244418013731957,0.04514245553332973
14819,16.0,110,1733,1843,20,223,2627,715,1912,2627,183,0.041872858774267226,0.6596878568709554,0.007613247049866768,0.27217358203273695,0.727826417967263,0.08488770460601447
14820,16.0,588,15152,15740,16,665,20866,6044,14822,20866,1696,0.028179814051567144,0.7261573852199751,0.0007667976612671331,0.2896578165436595,0.7103421834563405,0.03187002779641522
14821,16.0,95,6499,6594,44,451,8758,2584,6174,8758,728,0.010847225393925554,0.7420643982644439,0.005023978077186572,0.29504453071477504,0.7049554692852249,0.051495775291162366
14822,,161,4989,5150,6,412,7016,1929,5087,7016,510,0.022947548460661344,0.7110889395667047,0.0008551881413911061,0.2749429874572406,0.7250570125427594,0.05872291904218928
14823,15.0,79,2098,2177,0,143,2960,816,2144,2960,203,0.02668918918918919,0.7087837837837838,0.0,0.2756756756756757,0.7243243243243244,0.04831081081081081
14824,,1288,129548,130836,454,12664,182798,52142,130656,182798,8959,0.007046028949988512,0.7086948434884408,0.0024836157944835282,0.2852438210483703,0.7147561789516297,0.06927865731572555
14825,,9407,201883,211290,1413,10651,286358,78710,207648,286358,21504,0.03285048785087199,0.7050021302006579,0.0049343828354716825,0.27486572751590665,0.7251342724840933,0.037194700340133675
14826,,2194,29026,31220,196,2413,45668,11958,33710,45668,2602,0.04804239292283437,0.6355872821231497,0.004291845493562232,0.2618463694490672,0.7381536305509329,0.0528378733467636
14827,,195,7100,7295,4,216,9451,2795,6656,9451,774,0.02063273727647868,0.7512432546820442,0.0004232356364405883,0.29573590096286106,0.7042640990371389,0.02285472436779177
14828,17.0,267,8046,8313,4,227,11112,3211,7901,11112,1005,0.024028077753779697,0.7240820734341252,0.0003599712023038157,0.288966882649388,0.7110331173506119,0.02042836573074154
14829,26.0,185,3551,3736,22,219,5035,1382,3653,5035,285,0.036742800397219465,0.7052631578947368,0.004369414101290963,0.2744786494538232,0.7255213505461767,0.04349553128103277
14830,,95,2982,3077,30,120,4033,1152,2881,4033,235,0.02355566575750062,0.7393999504091248,0.007438631291842301,0.2856434416067444,0.7143565583932556,0.029754525167369206
14831,,108,2101,2209,5,120,2943,857,2086,2943,207,0.03669724770642202,0.7138973836221543,0.0016989466530750934,0.291199456337071,0.708800543662929,0.040774719673802244
14832,17.0,463,13053,13516,32,1184,18653,5156,13497,18653,1600,0.024821744491502706,0.699780196215086,0.001715541735913794,0.27641666219911004,0.7235833378008899,0.06347504422881038
14833,24.0,1263,38888,40151,160,1639,53101,15462,37639,53101,4343,0.023784862808610006,0.7323402572456262,0.0030131259298318298,0.29118095704412345,0.7088190429558765,0.030865708743714807
14834,,136,2102,2238,31,266,3117,764,2353,3117,188,0.04363169714469041,0.6743663779274944,0.009945460378569138,0.24510747513634906,0.754892524863651,0.08533846647417388
14835,47.0,4052,94072,98124,352,4031,125923,37666,88257,125923,8499,0.032178394733289394,0.7470597110932872,0.002795359068637183,0.29911930306615947,0.7008806969338405,0.032011626152490015
14836,,2086,51674,53760,153,2287,70823,20577,50246,70823,5518,0.02945370854101069,0.7296217330528219,0.0021603151518574475,0.29054120836451436,0.7094587916354856,0.03229176962286263
14837,,167,1626,1793,11,464,2785,646,2139,2785,150,0.0599640933572711,0.5838420107719928,0.0039497307001795335,0.23195691202872532,0.7680430879712747,0.16660682226211848
14838,16.0,9957,146702,156687,1409,11301,217506,59976,157535,217511,13464,0.04577699518645034,0.6744578435113626,0.006477833304982277,0.2757377787790043,0.7242622212209957,0.051955993030237554
14839,,20,12920,12940,28,623,17179,4928,12251,17179,1387,0.0011642121194481634,0.7520810291635136,0.0016298969672274288,0.2868618662320275,0.7131381337679725,0.03626520752081029
14840,,482,10089,10571,244,1100,15027,3819,11208,15027,866,0.03207559725826845,0.6713914953084448,0.01623743927596992,0.25414254342184067,0.7458574565781593,0.07320157050642177
14841,27.0,0,8380,8380,14,227,10971,3219,7752,10971,1135,0.0,0.7638319205177285,0.001276091513991432,0.29340989882417284,0.7065901011758272,0.020690912405432502
14842,41.0,46,1928,1974,7,60,2576,736,1840,2576,228,0.017857142857142856,0.7484472049689441,0.002717391304347826,0.2857142857142857,0.7142857142857143,0.023291925465838508
14843,16.0,258,6778,7036,27,1041,10030,2598,7432,10030,636,0.02572283150548355,0.6757726819541375,0.002691924227318046,0.25902293120638087,0.7409770687936191,0.10378863409770687
14844,,90,1978,2068,0,138,2790,758,2032,2790,227,0.03225806451612903,0.7089605734767025,0.0,0.2716845878136201,0.72831541218638,0.04946236559139785
14845,23.0,4008,104565,108573,448,5257,144914,41547,103367,144914,10096,0.027657783236954333,0.7215658942545233,0.0030914887450487877,0.28670107788067406,0.713298922119326,0.03627668824268187
14846,,174,2908,3082,29,129,4146,1142,3004,4146,253,0.041968162083936326,0.7013989387361312,0.006994693680656054,0.2754462132175591,0.7245537867824409,0.031114327062228653
14847,15.0,17,1902,1919,16,308,2794,715,2079,2794,134,0.006084466714387974,0.6807444523979957,0.00572655690765927,0.2559055118110236,0.7440944881889764,0.11023622047244094
14848,23.0,245,6255,6500,23,429,8696,2540,6156,8696,608,0.028173873045078197,0.719296228150874,0.0026448942042318307,0.2920883164673413,0.7079116835326587,0.04933302667893284
14849,,45,1476,1521,5,94,2004,568,1436,2004,161,0.02245508982035928,0.7365269461077845,0.00249500998003992,0.2834331337325349,0.716566866267465,0.046906187624750496
14850,,645,14180,14825,30,1286,20189,5388,14801,20189,1411,0.03194809054435584,0.7023626727425826,0.0014859576997374808,0.26687800287285157,0.7331219971271484,0.06369805339541335
14851,23.0,743,27891,28634,72,1519,36263,10695,25568,36263,2046,0.020489203871714972,0.7691310702368805,0.001985494857016794,0.2949287152193696,0.7050712847806304,0.04188842621956264
14852,,3212,55711,58923,211,3998,78957,21862,57095,78957,5334,0.0406803703281533,0.7055865851032841,0.0026723406411084515,0.276884886710488,0.7231151132895121,0.05063515584432032
14853,,150,2979,3129,98,118,4201,1205,2996,4201,344,0.035705784337062604,0.7091168769340633,0.023327779100214236,0.2868364675077362,0.7131635324922637,0.028088550345155915
14854,25.0,579,10661,11240,24,470,14676,4174,10502,14676,1034,0.03945216680294358,0.7264240937585174,0.001635322976287817,0.2844099209593895,0.7155900790406106,0.03202507495230308
14855,24.0,3798,71551,75349,473,3910,103130,28619,74511,103130,7519,0.03682730534277126,0.6937942402792592,0.004586444293610006,0.27750412101231453,0.7224958789876854,0.0379133132939009
14856,34.0,141,2904,3045,31,165,4071,1124,2947,4071,288,0.034635224760501106,0.7133382461311717,0.0076148366494718745,0.27609923851633505,0.723900761483665,0.040530582166543844
14857,,1114,24818,25932,45,1008,34154,9680,24474,34154,2377,0.032616970193827956,0.7266498799554957,0.0013175616326052586,0.2834221467470867,0.7165778532529132,0.02951338057035779
14858,15.0,620,22520,23140,155,1004,31097,8691,22406,31097,2667,0.01993761456089012,0.7241856127600733,0.00498440364022253,0.27948033572370323,0.7205196642762968,0.032286072611505935
14859,,1014,24081,25095,110,2440,34240,9583,24657,34240,2165,0.029614485981308412,0.7033002336448598,0.0032126168224299065,0.27987733644859814,0.7201226635514019,0.07126168224299065
14860,,621,16906,17527,75,787,22398,6711,15687,22398,1554,0.027725689793731582,0.754799535672828,0.00334851326011251,0.2996249665148674,0.7003750334851326,0.035137065809447275
14861,13.0,212,3962,4174,23,359,5703,1594,4109,5703,385,0.037173417499561635,0.6947220761002981,0.0040329651060845165,0.279502016482553,0.720497983517447,0.0629493249167105
14862,17.0,272,3583,3855,10,197,5202,1450,3752,5202,284,0.05228758169934641,0.6887735486351403,0.0019223375624759708,0.27873894655901577,0.7212610534409842,0.03787004998077662
14863,16.0,740,13027,13767,39,918,18758,5245,13513,18758,1230,0.03944983473717881,0.6944770231367949,0.002079112911824288,0.27961403134662544,0.7203859686533746,0.04893911930909479
14864,33.0,431,14732,15163,143,527,19728,5891,13837,19728,1362,0.021847120843471207,0.7467558799675588,0.007248580697485807,0.2986111111111111,0.7013888888888888,0.02671330089213301
14865,17.0,917,25208,26125,13,1251,34703,9984,24719,34703,3089,0.02642422845287151,0.726392530905109,0.0003746073826470334,0.28769846987292164,0.7123015301270783,0.036048756591649134
14866,,5104,110709,115813,305,6666,155583,43969,111614,155583,10700,0.0328056407191017,0.7115751720946376,0.0019603684207143454,0.28260799701766903,0.717392002982331,0.042845298008137134
14867,,5,15297,15302,36,664,20054,5837,14217,20054,1815,0.00024932681759250023,0.7627904657424953,0.0017951530866660017,0.2910641268574848,0.7089358731425152,0.033110601376284035
14868,15.0,74,4064,4138,0,187,5407,1603,3804,5407,472,0.013685962641020899,0.7516182726095801,0.0,0.29646754207508785,0.7035324579249121,0.034584797484742004
14869,14.0,55,2235,2290,16,74,3104,865,2239,3104,247,0.017719072164948453,0.7200386597938144,0.005154639175257732,0.27867268041237114,0.7213273195876289,0.02384020618556701
14870,24.0,143,4791,4934,16,236,6707,1889,4818,6707,504,0.02132100790219174,0.7143283137021023,0.0023855673177277472,0.28164604144923217,0.7183539585507679,0.03518711793648427
14871,46.0,80,2565,2645,5,64,3332,1012,2320,3332,248,0.024009603841536616,0.7698079231692677,0.0015006002400960385,0.3037214885954382,0.6962785114045619,0.01920768307322929
14872,17.0,5385,160262,165647,697,14342,227179,62751,164428,227179,15821,0.023703775436990215,0.7054437249921868,0.0030680652701173964,0.276218312432047,0.723781687567953,0.06313083515641851
14873,,1208,11625,12833,518,1174,18736,4776,13960,18736,959,0.06447480785653288,0.6204632792485055,0.02764730999146029,0.25491033304867633,0.7450896669513236,0.0626601195559351
14874,33.0,740,25393,26133,73,843,33329,10010,23321,33331,2334,0.022201554108787616,0.7618433290330323,0.0021901533107317513,0.300321022471573,0.699678977528427,0.025291770423929674
14875,26.0,11773,294862,306635,531,20189,408883,115998,292957,408955,26823,0.028788008460588575,0.7210133144233473,0.0012984313677543984,0.2836448998056021,0.716355100194398,0.049367289799611205
14876,,494,9363,9857,25,634,13215,3716,9499,13215,921,0.03738176314793795,0.7085130533484677,0.0018917896329928112,0.28119561104805146,0.7188043889519485,0.04797578509269769
14877,,97,3323,3420,4,131,4517,1282,3235,4517,374,0.02147442993137038,0.7356652645561214,0.0008855435023245517,0.28381669249501884,0.7161833075049812,0.02900154970112907
14878,23.0,693,16546,17239,104,777,22707,6619,16088,22707,1671,0.030519223147047168,0.7286739771876514,0.004580085436209099,0.2914960144448848,0.7085039855551152,0.03421852292244682
14879,,45,3739,3784,16,94,4937,1442,3495,4937,469,0.009114847073121329,0.7573425156977922,0.0032408345148875837,0.29208021065424344,0.7079197893457565,0.019039902774964552
14880,,303,6163,6466,12,388,8729,2425,6304,8729,572,0.03471187994042846,0.7060373467751174,0.0013747279184328101,0.27780960018329703,0.722190399816703,0.04444953602932753
14881,25.0,1931,37293,39224,698,3568,54688,15109,39579,54688,2461,0.03530939145699239,0.6819229081334114,0.012763311878291399,0.2762763311878291,0.7237236688121709,0.0652428320655354
14882,,537,10480,11017,77,604,14426,4209,10217,14426,1044,0.037224455843615695,0.7264661028698184,0.005337584916123666,0.2917648689865521,0.7082351310134479,0.041868847913489535
14883,46.0,178,7872,8050,32,291,10414,3055,7359,10414,887,0.01709237564816593,0.7559055118110236,0.0030727866333781447,0.29335509890531974,0.7066449010946803,0.027943153447282505
14884,41.0,179,3256,3435,66,150,4617,1288,3329,4617,302,0.03876976391596275,0.7052198397227637,0.014294996751137101,0.2789690275070392,0.7210309724929608,0.03248862897985705
14885,36.0,311,16665,16976,35,629,21147,6573,14574,21147,1325,0.014706577765167636,0.7880550432685487,0.0016550810989738498,0.31082423038728896,0.689175769612711,0.02974417175013004
14886,39.0,947,62412,63359,31,1701,79104,24460,54644,79104,5483,0.011971581715210356,0.7889866504854369,0.0003918891585760518,0.30921318770226536,0.6907868122977346,0.021503337378640776
14887,,63,9063,9126,3,395,12126,3420,8706,12126,1027,0.005195447798119743,0.7474022761009401,0.00024740227610094015,0.28203859475507176,0.7179614052449282,0.03257463301995712
14888,25.0,1261,19461,20722,532,1350,29020,7674,21346,29020,1667,0.04345279117849759,0.6706064782908339,0.018332184700206755,0.2644383184011027,0.7355616815988973,0.046519641626464506
14889,17.0,776,15500,16292,28,1595,22901,6159,16746,22905,1490,0.03387906570617769,0.6767081423270028,0.00122244051517136,0.2688932547478716,0.7311067452521284,0.06963545077493997
14890,,683,13335,14018,162,1103,18774,5013,13761,18774,1268,0.0363801001384894,0.7102908277404921,0.00862895493767977,0.2670182166826462,0.7329817833173538,0.058751464791733245
14891,17.0,3488,79806,83306,328,6088,113280,31854,81426,113280,7960,0.030790960451977403,0.7045021186440678,0.0028954802259887006,0.2811970338983051,0.7188029661016949,0.053742937853107346
14892,,118,5917,6035,11,356,8178,2282,5896,8178,675,0.014428955734898509,0.7235265346050379,0.0013450721447786744,0.2790413303986305,0.7209586696013696,0.04353142577647347
14893,23.0,86,2802,2888,5,72,3677,1125,2552,3677,256,0.023388632036986674,0.7620342670655426,0.0013598041881968997,0.3059559423443024,0.6940440576556975,0.019581180310035355
14894,41.0,878,25367,26245,101,1037,34406,10042,24364,34406,2975,0.025518804859617508,0.737284194617218,0.002935534499796547,0.29186769749462305,0.708132302505377,0.030140091844445736
14895,17.0,224,5347,5571,0,187,7406,2087,5319,7406,658,0.030245746691871456,0.7219821766135566,0.0,0.28179854172292734,0.7182014582770726,0.02524979746151769
14896,15.0,583,9827,10410,41,533,14143,4017,10126,14143,991,0.041221805840345044,0.694831365339744,0.002898960616559429,0.2840274340663226,0.7159725659336774,0.03768648801527257
14897,26.0,371,13175,13546,9,571,17609,5215,12394,17609,1366,0.021068771650860355,0.7481969447441649,0.0005111022772445908,0.29615537509228235,0.7038446249077176,0.03242660003407349
14898,,1098,21457,22555,636,869,30284,8584,21700,30284,2504,0.036256769251089685,0.7085259542993,0.021001188746532822,0.28345000660414743,0.7165499933958526,0.028695020472856953
14899,,144,3281,3425,21,175,4646,1334,3312,4646,368,0.030994403788204908,0.706198880757641,0.004520017219113216,0.2871287128712871,0.7128712871287128,0.037666810159276795
14900,,53,5557,5610,80,551,7792,2116,5676,7792,512,0.006801848049281314,0.7131673511293635,0.01026694045174538,0.2715605749486653,0.7284394250513347,0.0707135523613963
14901,27.0,166,4380,4546,29,223,6449,1682,4767,6449,431,0.02574042487207319,0.6791750659016902,0.004496821212591099,0.26081563033028377,0.7391843696697162,0.03457900449682121
14902,,341,5474,5815,34,349,7697,2165,5532,7697,481,0.04430297518513707,0.7111861764323762,0.004417305443679355,0.28127842016370014,0.7187215798362998,0.04534234117188515
14903,27.0,275,7349,7624,11,333,9865,2892,6973,9865,672,0.027876330461226558,0.7449569183983781,0.0011150532184490624,0.29315762797769895,0.706842372022301,0.03375570197668525
14904,25.0,259,11127,11386,50,573,15196,4351,10845,15196,1218,0.017043958936562253,0.7322321663595683,0.003290339563042906,0.2863253487759937,0.7136746512240063,0.037707291392471705
14905,16.0,26,2717,2743,124,310,4001,1071,2930,4001,222,0.006498375406148463,0.6790802299425144,0.030992251937015745,0.26768307923019247,0.7323169207698076,0.07748062984253937
14906,,45,8015,8060,29,1376,11913,3043,8870,11913,944,0.003777386048854193,0.6727944262570301,0.0024343154537060352,0.2554352388147402,0.7445647611852598,0.11550407118274154
14907,26.0,1679,45329,47008,233,2784,63219,17960,45259,63219,4727,0.02655847134563976,0.7170154542147139,0.0036856008478463754,0.284091807842579,0.7159081921574211,0.04403739382147772
14908,,713,16620,17333,149,879,23465,6524,16941,23465,1622,0.030385680801193266,0.7082889409759215,0.006349882804176433,0.27803111016407417,0.7219688898359259,0.03746004687832943
14909,25.0,552,14838,15390,77,960,20328,5639,14689,20328,1490,0.02715466351829988,0.7299291617473436,0.003787878787878788,0.27740062967335694,0.722599370326643,0.047225501770956316
14910,,167,4021,4188,12,315,5590,1636,3954,5590,446,0.029874776386404293,0.7193202146690518,0.002146690518783542,0.2926654740608229,0.7073345259391771,0.05635062611806798
14911,14.0,419,6821,7240,29,479,9767,2744,7023,9767,700,0.04289955974198833,0.6983720692126548,0.002969181939182963,0.28094604279717417,0.7190539572028258,0.04904269478857377
14912,26.0,199,5761,5960,30,443,8026,2112,5914,8026,582,0.024794418141041615,0.717792175429853,0.00373785198106155,0.2631447794667331,0.7368552205332669,0.05519561425367556
14913,23.0,152,3884,4036,35,200,5576,1517,4059,5576,396,0.027259684361549498,0.6965566714490674,0.006276901004304161,0.27205882352941174,0.7279411764705882,0.035868005738880916
14914,24.0,6893,164008,170901,419,11234,231570,65284,166286,231570,16534,0.029766377337306214,0.7082437275985664,0.0018093880899943862,0.28191907414604656,0.7180809258539534,0.04851232888543421
14915,17.0,158,3352,3510,17,178,4652,1285,3367,4652,377,0.033963886500429925,0.7205503009458297,0.003654342218400688,0.27622527944969905,0.7237747205503009,0.03826311263972485
14916,36.0,686,20278,20964,43,1422,28338,7998,20340,28338,1938,0.02420777754252241,0.7155762580280894,0.001517397134589597,0.28223586703366504,0.717764132966335,0.050179970357823414
14917,14.0,159,1406,1565,3,115,2275,607,1668,2275,138,0.0698901098901099,0.618021978021978,0.0013186813186813187,0.26681318681318683,0.7331868131868132,0.05054945054945055
14918,43.0,1691,34731,36422,216,2072,49847,13915,35932,49847,3306,0.03392380684895781,0.6967520613076013,0.004333259774911228,0.2791542118883784,0.7208457881116216,0.04156719561859289
14919,,3059,131094,134153,338,3557,174472,51379,123093,174472,14592,0.017532899261772664,0.7513755788894493,0.0019372736026411115,0.2944827823375671,0.7055172176624329,0.02038722545737998
14920,,107,3008,3115,8,171,4228,1183,3045,4228,332,0.02530747398297067,0.7114474929044465,0.001892147587511826,0.27980132450331124,0.7201986754966887,0.04044465468306528
14921,,1539,30149,31688,152,1581,41812,12037,29775,41812,2733,0.036807615038744856,0.721060939443222,0.0036353200038266526,0.28788386109250935,0.7121161389074907,0.0378121113555917
14922,,395,6873,7268,40,326,9356,2766,6590,9356,634,0.04221889696451475,0.7346088071825566,0.004275331338178709,0.2956391620350577,0.7043608379649423,0.034843950406156475
14923,17.0,238,9446,9684,47,451,13194,3587,9607,13194,1091,0.018038502349552826,0.7159314840078824,0.0035622252539032895,0.2718659996968319,0.7281340003031681,0.03418220403213582
14924,16.0,4043,69499,73542,994,4972,101694,27950,73744,101694,5999,0.039756524475386947,0.6834129840501898,0.009774421303125062,0.27484414026392906,0.725155859736071,0.04889177335929357
14925,23.0,124,4127,4251,9,172,5677,1632,4045,5677,496,0.02184252245904527,0.7269684692619341,0.0015853443720274794,0.2874757794609829,0.7125242205390171,0.030297692443191828
14926,,567,3000,3567,0,329,5773,1357,4416,5773,235,0.09821583232288239,0.5196604884808592,0.0,0.2350597609561753,0.7649402390438247,0.056989433570067555
14927,27.0,35,1933,1968,0,107,2618,730,1888,2618,229,0.013368983957219251,0.7383498854087089,0.0,0.27883880825057294,0.721161191749427,0.040870893812070284
14928,27.0,65,2401,2466,19,138,3365,968,2397,3365,149,0.019316493313521546,0.7135215453194651,0.005646359583952452,0.287667161961367,0.712332838038633,0.04101040118870728
14929,24.0,5037,106910,111947,545,3030,147232,42399,104833,147232,10172,0.034211312758096066,0.7261329058900239,0.0037016409476200826,0.2879740817213649,0.712025918278635,0.020579765268419908
14930,,133,3270,3403,6,127,4459,1317,3142,4459,319,0.029827315541601257,0.7333482843686925,0.0013455931823278763,0.29535770352096885,0.7046422964790312,0.02848172235927338
14931,26.0,280,5579,5859,5,398,8134,2210,5924,8134,507,0.03442340791738382,0.6858864027538726,0.0006147037128104253,0.271699041062208,0.728300958937792,0.04893041553970986
14932,25.0,2016,80393,82409,235,4110,109239,31626,77613,109239,9647,0.01845494740889243,0.7359367991285164,0.0021512463497468854,0.28951198747699997,0.710488012523,0.0376239255211051
14933,,263,23050,23313,29,1222,30882,8795,22087,30882,2423,0.008516287805193964,0.7463894825464672,0.0009390583511430607,0.28479373097597305,0.715206269024027,0.039569976037821385
14934,25.0,118,9275,9393,53,531,12612,3595,9017,12612,954,0.00935616872819537,0.7354107199492547,0.004202346971138598,0.285045987947986,0.7149540120520139,0.04210275927687916
14935,43.0,474,11282,11756,46,600,15587,4509,11078,15587,1200,0.030409957015461602,0.7238083017899531,0.0029511772631038687,0.2892795278116379,0.7107204721883621,0.038493616475267854
14936,,2738,48419,51157,615,2597,68345,19270,49075,68345,4071,0.04006145292267174,0.7084497768673641,0.008998463676933207,0.2819518618772405,0.7180481381227596,0.03799839051869193
14937,25.0,137,2773,2910,19,201,3998,1185,2813,3998,149,0.03426713356678339,0.6935967983991996,0.004752376188094047,0.2963981990995498,0.7036018009004502,0.05027513756878439
14938,26.0,3784,51895,55679,147,3772,74742,21184,53558,74742,5716,0.050627491905488216,0.6943218003264563,0.001966765673918279,0.2834283267774478,0.7165716732225522,0.050466939605576515
14939,13.0,90,1629,1719,12,62,2291,633,1658,2291,205,0.0392841553906591,0.7110432125709297,0.005237887385421213,0.276298559580969,0.723701440419031,0.027062418158009603
14940,13.0,2907,45920,48827,155,3491,66368,18688,47680,66368,4763,0.04380122950819672,0.6918997107039537,0.0023354628736740597,0.2815814850530376,0.7184185149469624,0.05260065091610415
14941,,686,19822,20508,50,1126,27495,7747,19748,27495,2478,0.024949990907437717,0.7209310783778868,0.0018185124568103291,0.2817603200581924,0.7182396799418076,0.040952900527368614
14942,14.0,184,5688,5872,37,202,7907,2168,5739,7907,707,0.023270519792588845,0.7193625901100291,0.004679398001770583,0.27418742886050335,0.7258125711394966,0.0255469836853421
14943,,165,2764,2929,8,146,3905,1100,2805,3905,254,0.04225352112676056,0.7078104993597951,0.00204865556978233,0.28169014084507044,0.7183098591549296,0.037387964148527526
14944,25.0,662,19062,19724,50,836,25825,7301,18524,25825,2097,0.025634075508228462,0.7381219748305905,0.001936108422071636,0.28271055179090027,0.7172894482090997,0.03237173281703776
14945,27.0,205,6927,7132,13,213,9042,2679,6363,9042,701,0.02267197522671975,0.7660915726609158,0.00143773501437735,0.2962840079628401,0.70371599203716,0.023556735235567353
14946,16.0,937,25147,26084,35,622,34773,9906,24867,34773,3304,0.026946193886061023,0.723176027377563,0.0010065280533747448,0.2848761970494349,0.7151238029505651,0.01788744140568832
14947,,1101,37359,38460,57,1926,50596,14609,35987,50596,4257,0.021760613487232194,0.7383785279468733,0.0011265712704561625,0.2887382401770891,0.711261759822911,0.038066250296466125
14948,16.0,1194,6779,7973,38,1006,11333,3121,8212,11333,383,0.10535603988352599,0.5981646519015266,0.0033530397952880966,0.2753904526603724,0.7246095473396277,0.08876731668578487
14949,26.0,3197,92915,96112,562,4702,131870,36065,95805,131870,8871,0.024243573216046106,0.7045954348980056,0.004261772958216425,0.2734890422385683,0.7265109577614317,0.03565632820201714
14950,44.0,204,4025,4229,62,170,5870,1731,4139,5870,456,0.03475298126064736,0.6856899488926746,0.010562180579216355,0.2948892674616695,0.7051107325383305,0.028960817717206135
14951,39.0,84,1944,2028,11,77,2693,777,1916,2693,248,0.031191979205347196,0.7218715187523208,0.004084663943557371,0.28852580764946156,0.7114741923505384,0.028592647604901596
14952,17.0,268,9518,9786,21,1186,13234,3644,9590,13234,712,0.02025086897385522,0.7192081003475895,0.0015868218225782076,0.2753513676892852,0.7246486323107149,0.08961765150370259
14953,,2813,78375,81188,301,3824,108195,31030,77165,108195,8035,0.025999353020010166,0.7243865243310689,0.002782013956282638,0.28679698692176164,0.7132030130782384,0.03534359258745783
14954,26.0,1195,15709,16904,57,1090,22821,6412,16409,22821,1598,0.052364050655098374,0.6883572148459752,0.0024976994873143156,0.28096928267823496,0.719030717321765,0.0477630252837299
14955,,302,5168,5470,65,320,7633,2081,5552,7633,558,0.03956504650858116,0.6770601336302895,0.008515655705489322,0.2726319926634351,0.7273680073365649,0.04192322808856282
14956,,90,1880,1970,12,96,2610,737,1873,2610,174,0.034482758620689655,0.7203065134099617,0.004597701149425287,0.28237547892720305,0.717624521072797,0.0367816091954023
14957,,194,3224,3418,92,207,4764,1305,3459,4764,311,0.04072208228379513,0.6767422334172963,0.019311502938706968,0.2739294710327456,0.7260705289672544,0.04345088161209068
14958,23.0,2159,2968,5127,1,699,7132,2031,5101,7132,331,0.302720134604599,0.41615255187885586,0.00014021312394840157,0.2847728547392036,0.7152271452607964,0.0980089736399327
14959,,305,9746,10051,12,429,12991,3957,9034,12991,1169,0.02347779231775845,0.7502116850127011,0.0009237164190593487,0.30459548918482027,0.6954045108151797,0.03302286198137172
14960,23.0,1139,19208,20347,268,1275,28186,7760,20426,28186,2061,0.040410132689987936,0.6814730717377422,0.00950826651529128,0.275313985666643,0.724686014333357,0.04523522316043426
14961,15.0,128,2512,2640,3,115,3436,997,2439,3436,259,0.037252619324796274,0.7310826542491269,0.0008731082654249127,0.290162980209546,0.709837019790454,0.033469150174621654
14962,16.0,79,1496,1575,11,93,2170,583,1587,2170,191,0.03640552995391705,0.6894009216589861,0.005069124423963134,0.26866359447004606,0.7313364055299539,0.04285714285714286
14963,,632,12169,12801,51,517,16868,4804,12064,16868,1060,0.03746739388190657,0.7214251837799384,0.0030234764050272706,0.2847996205833531,0.7152003794166469,0.03064975100782547
14964,37.0,106,2316,2422,0,80,3316,944,2372,3316,268,0.031966224366706875,0.6984318455971049,0.0,0.28468033775633295,0.715319662243667,0.024125452352231604
14965,27.0,141,1804,1945,9,120,2772,749,2023,2772,142,0.050865800865800864,0.6507936507936508,0.003246753246753247,0.2702020202020202,0.7297979797979798,0.04329004329004329
14966,15.0,207,1676,1883,5,161,2715,723,1992,2715,169,0.07624309392265194,0.6173112338858195,0.001841620626151013,0.2662983425414365,0.7337016574585635,0.05930018416206261
14967,17.0,5077,108213,113294,298,5519,148485,43300,105185,148485,10007,0.03419200592652456,0.7287806849176685,0.002006936727615584,0.2916119473347476,0.7083880526652524,0.03716873758292084
14968,23.0,77,2968,3045,2,162,4008,1072,2936,4008,390,0.019211576846307386,0.7405189620758483,0.000499001996007984,0.26746506986027946,0.7325349301397206,0.040419161676646706
14969,27.0,629,13248,13877,11,797,18184,5218,12966,18184,1241,0.03459084909810823,0.7285525736911571,0.0006049274087109547,0.28695556533216016,0.7130444346678398,0.04382974043114826
14970,14.0,66,3900,3966,28,479,5790,1455,4335,5790,358,0.011398963730569948,0.6735751295336787,0.004835924006908463,0.25129533678756477,0.7487046632124352,0.08272884283246977
14971,,126,2749,2875,7,224,3980,1131,2849,3980,286,0.03165829145728643,0.6907035175879397,0.0017587939698492463,0.2841708542713568,0.7158291457286432,0.05628140703517588
14972,14.0,403,14494,14897,72,760,20473,5690,14783,20473,1794,0.019684462462755823,0.707956821179114,0.0035168270404923557,0.27792702583890977,0.7220729741610902,0.03712206320519709
14973,,1968,45330,47298,100,2269,62125,17907,44218,62125,4328,0.03167806841046278,0.7296579476861167,0.0016096579476861167,0.2882414486921529,0.711758551307847,0.03652313883299799
14974,23.0,62,14536,14598,16,755,19390,5547,13843,19390,1735,0.0031975244971634864,0.7496647756575554,0.0008251676121712223,0.2860752965446106,0.7139247034553894,0.03893759669932955
14975,24.0,2337,80054,82391,144,3380,107721,31571,76150,107721,8201,0.021694934135405353,0.7431605722189731,0.0013367866989723452,0.2930812005087216,0.7069187994912784,0.03137735446198977
14976,17.0,108,5707,5815,47,225,7788,2225,5563,7788,621,0.01386748844375963,0.732794042116076,0.0060349255264509506,0.2856959424756035,0.7143040575243965,0.02889060092449923
14977,15.0,364,14432,14796,69,911,20082,5628,14454,20082,1609,0.018125684692759686,0.7186535205656807,0.0034359127576934568,0.28025097101882285,0.7197490289811772,0.04536400756896723
14978,26.0,47,11596,11643,17,1526,16506,4256,12250,16506,1177,0.0028474494123349086,0.7025324124560766,0.0010299285108445414,0.2578456318914334,0.7421543681085666,0.09245122985581
14979,17.0,3119,89859,92978,636,4092,122388,35298,87090,122388,9047,0.02548452462659738,0.7342141386410432,0.005196587900774586,0.2884106284929895,0.7115893715070105,0.03343465045592705
14980,35.0,207,4700,4907,24,283,7116,1852,5264,7116,412,0.0290893760539629,0.6604834176503653,0.003372681281618887,0.26025857223159077,0.7397414277684092,0.039769533445756046
14981,14.0,1,2435,2436,44,136,3390,919,2471,3390,281,0.0002949852507374631,0.7182890855457227,0.012979351032448377,0.2710914454277286,0.7289085545722714,0.040117994100294985
14982,15.0,232,4445,4677,24,267,6457,1793,4664,6457,460,0.03592999845129317,0.6884001858448195,0.0037168963915130866,0.2776831345826235,0.7223168654173765,0.04135047235558309
14983,,53,7348,7401,32,338,9903,2772,7131,9903,832,0.005351913561547006,0.7419973745329698,0.0032313440371604563,0.27991517721902454,0.7200848227809754,0.034131071392507324
14984,,142,2746,2888,4,400,4131,971,3160,4131,245,0.03437424352457032,0.6647300895666909,0.0009682885499878964,0.23505204550956185,0.7649479544904382,0.09682885499878964
14985,47.0,457,12654,13111,28,795,17515,5030,12485,17515,1263,0.026091921210391094,0.7224664573222952,0.0015986297459320582,0.28718241507279474,0.7128175849272053,0.04538966600057094
14986,,80,2412,2492,26,495,3833,925,2908,3833,342,0.020871380120010434,0.6292721106183147,0.006783198539003391,0.24132533263762065,0.7586746673623793,0.12914166449256456
14987,14.0,1370,1966,3336,5,418,4591,1221,3370,4591,23,0.29840993247658465,0.42822914397734696,0.0010890873448050533,0.26595512960139406,0.734044870398606,0.09104770202570246
14988,17.0,183,8695,8888,49,883,12129,3369,8760,12129,579,0.015087806084590651,0.7168769065875176,0.00403990436144777,0.27776403660648036,0.7222359633935197,0.07280072553384451
14989,17.0,559,11479,12038,38,712,16244,4639,11605,16244,1177,0.03441270622999261,0.7066609209554297,0.002339325289337602,0.28558236887466143,0.7144176311253386,0.043831568579167694
14990,34.0,232,4395,4627,49,295,6356,1728,4628,6356,448,0.03650094398993078,0.6914726242920075,0.007709251101321586,0.2718691000629327,0.7281308999370674,0.046412838263058524
14991,41.0,184,4562,4746,21,195,6244,1851,4393,6244,518,0.029468289557975657,0.730621396540679,0.0033632286995515697,0.2964445868033312,0.7035554131966688,0.031229980781550287
14992,,396,5549,5945,42,338,7879,2273,5606,7879,482,0.05026018530270339,0.704277192537124,0.005330625713923087,0.2884883868511232,0.7115116131488768,0.04289884503109532
14993,24.0,1199,58933,60132,271,1993,79718,22434,57284,79718,6038,0.015040517825334304,0.739268421184676,0.0033994831782031662,0.28141699490704736,0.7185830050929527,0.02500062721091849
14994,47.0,268,4954,5222,25,287,6709,1996,4713,6709,405,0.03994634073632434,0.7384110895811596,0.0037263377552541363,0.29751080637949023,0.7024891936205098,0.042778357430317486
14995,14.0,326,4675,5001,14,199,6510,1889,4621,6510,436,0.05007680491551459,0.7181259600614439,0.002150537634408602,0.2901689708141321,0.7098310291858679,0.030568356374807988
14996,,543,7198,7741,17,478,10751,3018,7733,10751,715,0.05050692958794531,0.6695191145009767,0.0015812482559761883,0.2807180727374198,0.7192819272625802,0.044460980373918706
14997,36.0,348,9915,10263,42,430,13329,3863,9466,13329,892,0.026108485257708754,0.7438667566959262,0.0031510240828269186,0.28981919123715205,0.710180808762848,0.032260484657513695
14998,17.0,409,9797,10206,54,731,13901,3800,10101,13901,1028,0.029422343716279404,0.7047694410474067,0.0038846126177972807,0.2733616286598086,0.7266383713401914,0.05258614488166319
14999,,350,10220,10570,25,607,14008,3990,10018,14008,1102,0.024985722444317533,0.729583095374072,0.0017846944603083952,0.28483723586521986,0.7151627641347801,0.04333238149628783
15000,16.0,114,3309,3423,19,136,4543,1334,3219,4553,364,0.02503843619591478,0.7267735558972106,0.00417307269931913,0.2929936305732484,0.7070063694267515,0.029870415110915878
15001,17.0,19,2856,2875,185,138,4133,1021,3112,4133,330,0.004597144931042826,0.691023469634648,0.044761674328574884,0.24703605129445924,0.7529639487055407,0.03338978949915316
15002,16.0,1799,59905,61704,359,4696,86320,23784,62536,86320,6666,0.020841056533827618,0.6939874884151993,0.004158943466172382,0.27553290083410564,0.7244670991658944,0.05440222428174235
15003,,981,19532,20513,203,920,26320,7933,18387,26320,1649,0.03727203647416413,0.74209726443769,0.007712765957446808,0.30140577507598787,0.6985942249240121,0.034954407294832825
15004,,915,37972,38887,69,1263,51126,15701,35425,51126,3210,0.017896960450651332,0.7427140789422212,0.0013496068536556743,0.30710401752532956,0.6928959824746704,0.024703673277784298
15005,17.0,468,12077,12545,81,1046,17091,4790,12301,17091,919,0.02738283307003686,0.7066292200573401,0.004739336492890996,0.28026446667836874,0.7197355333216313,0.06120180211807384
15006,26.0,129,1638,1767,5,205,2517,676,1841,2517,152,0.05125148986889154,0.6507747318235996,0.001986491855383393,0.2685736988478347,0.7314263011521652,0.08144616607071911
15007,23.0,2092,47462,49554,336,2335,66166,18807,47360,66167,4928,0.03161696918403434,0.7173062100442819,0.00507806006015083,0.2842353439025496,0.7157646560974504,0.035289494763250565
15008,26.0,106,4614,4720,16,215,6235,1767,4468,6235,531,0.017000801924619086,0.7400160384923817,0.002566158781074579,0.2834001603849238,0.7165998396150762,0.034482758620689655
15009,,5687,103025,108712,1293,6181,147438,42368,105070,147438,10549,0.03857214557983695,0.6987682958260422,0.008769787978675782,0.2873614671929896,0.7126385328070104,0.04192270649357696
15010,17.0,115,2413,2528,5,171,3492,967,2525,3492,218,0.03293241695303551,0.6910080183276059,0.0014318442153493699,0.27691867124856817,0.7230813287514318,0.04896907216494845
15011,,16947,297745,314692,2610,24822,430171,119243,310928,430171,29742,0.039395961141034615,0.6921549802287927,0.0060673546101434085,0.27719906734763616,0.7228009326523638,0.05770263453370869
15012,24.0,400,11426,11826,41,814,15705,4558,11147,15705,1135,0.025469595670168738,0.7275390003183699,0.0026106335561922956,0.29022604266157276,0.7097739573384273,0.05183062718879338
15013,23.0,1053,22112,23165,47,1142,31849,8987,22862,31849,2192,0.033062262551414486,0.6942761154196364,0.0014757135231875413,0.2821752645294986,0.7178247354705014,0.035856698797450466
15014,16.0,73,1397,1470,1,87,2051,554,1497,2051,171,0.035592393954168695,0.6811311555338859,0.00048756704046806434,0.27011214041930764,0.7298878595806924,0.0424183325207216
15015,17.0,1689,25809,27498,253,1573,38578,10260,28318,38578,2639,0.043781429830473326,0.6690082430400747,0.006558141946186946,0.26595468920109905,0.7340453107989009,0.040774534708901446
15016,13.0,905,12323,13228,105,771,17947,5120,12831,17951,1272,0.05041501866191299,0.6864798618461367,0.005849256308840733,0.2852208790596624,0.7147791209403376,0.04295025346777338
15017,16.0,49,1564,1613,0,52,2203,631,1572,2203,185,0.02224239673172946,0.7099409895596913,0.0,0.2864275987290059,0.7135724012709941,0.023604176123467997
15018,34.0,151,4913,5064,92,281,7050,1986,5064,7050,429,0.021418439716312056,0.6968794326241134,0.013049645390070922,0.2817021276595745,0.7182978723404255,0.03985815602836879
15019,,364,5659,6023,10,260,8308,2340,5968,8308,726,0.043813192103996146,0.6811506981222918,0.001203659123736158,0.28165623495426095,0.718343765045739,0.031295137217140105
15020,37.0,42,2412,2454,0,85,3247,1003,2244,3247,226,0.012935016938712659,0.7428395441946412,0.0,0.3089005235602094,0.6910994764397905,0.02617801047120419
15021,,44,1851,1895,12,152,2679,686,1993,2679,196,0.016424038820455393,0.6909294512877939,0.004479283314669653,0.2560656961552818,0.7439343038447181,0.05673758865248227
15022,24.0,720,3012,3732,25,226,5053,1348,3705,5053,183,0.1424896101325945,0.5960815357213537,0.004947555907381753,0.2667722145260241,0.7332277854739758,0.04472590540273105
15023,15.0,735,8416,9151,64,1193,13094,3359,9735,13094,669,0.05613257980754544,0.6427371315106155,0.004887734840384909,0.2565297082633267,0.7434702917366733,0.09111043225904995
15024,,4,5503,5507,29,323,7545,2077,5468,7545,604,0.0005301524188204108,0.7293571901921803,0.0038436050364479787,0.27528164347249834,0.7247183565275016,0.04280980781974818
15025,27.0,7,2697,2704,2,158,3609,1044,2565,3609,338,0.0019395954558049321,0.7472984206151289,0.0005541701302299807,0.2892768079800499,0.7107231920199502,0.04377944028816847
15026,17.0,312,6147,6459,36,277,8525,2451,6074,8525,698,0.03659824046920821,0.7210557184750733,0.004222873900293255,0.28750733137829915,0.7124926686217009,0.03249266862170088
15027,24.0,5683,156366,162049,549,3941,213471,62678,150793,213471,19431,0.02662188306608392,0.7324929381508495,0.002571777899574181,0.2936136524399099,0.7063863475600901,0.01846152404776293
15028,42.0,222,7918,8140,20,282,10673,3108,7565,10673,807,0.02080014991099035,0.7418720134919892,0.0018738873793685,0.2912020987538649,0.7087979012461351,0.02642181204909585
15029,24.0,540,12634,13174,49,641,17585,4943,12642,17585,1261,0.03070798976400341,0.7184532271822576,0.002786465737844754,0.28109183963605344,0.7189081603639466,0.036451521182826276
15030,15.0,2672,109060,111732,322,6343,148389,41731,106658,148389,12898,0.01800672556591122,0.7349601385547446,0.002169972167748283,0.28122704513137764,0.7187729548686224,0.042745756087041495
15031,16.0,292,9321,9613,28,294,12267,3761,8506,12267,865,0.02380370098638624,0.7598434825140621,0.0022825466699274476,0.3065949294856118,0.6934050705143882,0.0239667400342382
15032,,519,10991,11510,33,566,14855,4363,10492,14855,923,0.034937731403567825,0.7398855604173679,0.0022214742510939076,0.29370582295523395,0.706294177044766,0.03810164927633793
15033,33.0,163,3802,3965,8,129,5189,1501,3688,5189,449,0.031412603584505684,0.7327037964925804,0.0015417228753131624,0.28926575448063213,0.7107342455193679,0.024860281364424745
15034,,3118,60463,63581,417,2679,83369,24419,58957,83376,5018,0.037396852811360584,0.7251847054308194,0.005001439263097294,0.2928780464402226,0.7071219535597774,0.03213154864709269
15035,37.0,542,12979,13521,88,469,17536,5153,12384,17537,1355,0.03090608427895307,0.7400923761190625,0.005017962023151052,0.2938358898329247,0.7061641101670754,0.026743456691566404
15036,25.0,1151,29677,30828,79,2053,40741,11787,28954,40741,2578,0.028251638398664736,0.7284308190766059,0.0019390785695000124,0.2893154316290715,0.7106845683709285,0.05039149750865222
15037,14.0,169,3245,3414,5,322,4795,1311,3484,4795,292,0.03524504692387904,0.6767466110531803,0.0010427528675703858,0.2734098018769552,0.7265901981230448,0.06715328467153285
15038,,1007,26717,27724,57,1617,37065,10553,26512,37065,2717,0.027168487791717252,0.7208147848374478,0.001537838931606637,0.28471603939026036,0.7152839606097396,0.04362606232294618
15039,,867,19829,20696,63,659,27713,7916,19797,27713,2213,0.03128495651860138,0.7155125753256595,0.0022733013387218996,0.28564211741781836,0.7143578825821817,0.023779453685995742
15040,13.0,177,1976,2153,14,171,3219,785,2434,3219,207,0.05498602050326188,0.6138552345448898,0.004349176762969867,0.2438645542093818,0.7561354457906182,0.05312208760484623
15041,23.0,180,3707,3887,27,265,5410,1492,3918,5410,412,0.033271719038817,0.6852125693160813,0.004990757855822551,0.2757855822550832,0.7242144177449168,0.048983364140480594
15042,27.0,136,2587,2723,29,147,3782,1005,2777,3782,300,0.035959809624537285,0.6840296139608673,0.007667900581702803,0.26573241671073505,0.7342675832892649,0.03886832363828662
15043,15.0,74,1435,1509,0,51,2054,567,1487,2054,177,0.03602726387536514,0.698636806231743,0.0,0.27604673807205454,0.7239532619279455,0.024829600778967866
15044,27.0,110,2220,2330,4,122,3137,885,2252,3137,258,0.035065349059611096,0.7076824992030603,0.001275103602167676,0.28211667197959833,0.7178833280204017,0.03889065986611412
15045,24.0,511,22413,22924,23,885,29560,8918,20642,29560,2638,0.017286874154262517,0.7582205683355886,0.0007780784844384303,0.3016914749661705,0.6983085250338295,0.02993910690121786
15046,,512,9214,9726,11,441,12978,3756,9222,12978,846,0.0394513792572045,0.7099707196794576,0.0008475882262290029,0.28941285251964866,0.7105871474803513,0.03398058252427184
15047,24.0,168,4157,4325,21,179,5675,1684,3991,5675,432,0.02960352422907489,0.732511013215859,0.0037004405286343613,0.2967400881057269,0.7032599118942732,0.03154185022026432
15048,41.0,327,16260,16587,39,475,21186,6331,14855,21186,1676,0.015434721042197678,0.767487963749646,0.0018408382894364204,0.29882941565184556,0.7011705843481545,0.02242046634569999
15049,24.0,207,3864,4071,3,226,5402,1586,3816,5402,414,0.038319141058867086,0.7152906330988523,0.0005553498704183636,0.29359496482784153,0.7064050351721585,0.041836356904850054
15050,24.0,519,9531,10050,45,483,13401,3716,9685,13401,933,0.038728453100514884,0.7112155809267965,0.0033579583613163196,0.27729273934780985,0.7227072606521902,0.03604208641146183
15051,17.0,229,1916,2145,12,137,2895,814,2081,2895,205,0.07910189982728842,0.6618307426597582,0.004145077720207254,0.28117443868739206,0.718825561312608,0.04732297063903282
15052,,3277,85021,88298,275,5175,116008,33287,82721,116008,8354,0.028248051858492516,0.7328891110957865,0.0023705261706089237,0.28693710778566994,0.7130628922143301,0.044608992483277016
15053,,1508,27911,29419,69,2568,41845,11326,30519,41845,2653,0.03603775839407337,0.6670092006213406,0.001648942525988768,0.2706655514398375,0.7293344485601625,0.06136933922810372
15054,,1057,18594,19651,220,953,26144,7575,18569,26144,1710,0.04042992656058751,0.7112148102815178,0.008414932680538556,0.28974143206854347,0.7102585679314566,0.036451958384332926
15055,14.0,578,12360,12938,79,724,17325,4826,12499,17325,1329,0.033362193362193364,0.7134199134199134,0.00455988455988456,0.27855699855699856,0.7214430014430014,0.04178932178932179
15056,15.0,75,1904,1979,4,261,2755,710,2045,2755,149,0.02722323049001815,0.6911070780399274,0.0014519056261343012,0.2577132486388385,0.7422867513611615,0.09473684210526316
15057,14.0,4117,22861,26978,126,1288,36177,10256,25921,36177,1572,0.1138015866434475,0.6319208336788568,0.0034828758603532633,0.2834950382839926,0.7165049617160074,0.035602731016944465
15058,27.0,2219,73638,75857,184,3617,100917,28902,72015,100917,7274,0.021988366677566713,0.7296887541246767,0.001823280517653121,0.2863937691370136,0.7136062308629865,0.035841334958431184
15059,,265,5781,6046,51,467,8286,2333,5953,8286,515,0.03198165580497224,0.6976828385228095,0.006154960173787111,0.2815592565773594,0.7184407434226406,0.05636012551291335
15060,,70,8271,8341,56,530,11212,3149,8063,11212,991,0.006243310738494471,0.7376917588298252,0.0049946485907955765,0.2808597930788441,0.7191402069211559,0.047270781305743845
15061,14.0,35,1671,1706,14,206,2565,620,1945,2565,173,0.01364522417153996,0.6514619883040935,0.005458089668615985,0.24171539961013644,0.7582846003898636,0.08031189083820663
15062,,679,11250,11929,58,890,16297,4538,11759,16297,1131,0.04166410995888814,0.6903111002024912,0.0035589372277106215,0.2784561575750138,0.7215438424249861,0.05461127814935264
15063,27.0,154,4899,5053,8,255,6577,1925,4652,6577,506,0.02341493081952258,0.7448684810703968,0.0012163600425726016,0.2926866352440322,0.7073133647559677,0.03877147635700167
15064,16.0,657,4093,4750,5,28,6409,1865,4544,6409,478,0.10251209237010454,0.638633172101732,0.0007801529099703542,0.2909970354189421,0.7090029645810579,0.004368856295833983
15065,,142,4076,4218,86,160,5638,1666,3972,5638,511,0.025186236253990777,0.7229514012061015,0.015253636041149344,0.29549485633203265,0.7045051436679673,0.028378857750975522
15066,,71,2796,2867,51,243,4071,1059,3012,4071,194,0.017440432326209777,0.6868091378039793,0.012527634487840826,0.26013264554163595,0.739867354458364,0.05969049373618276
15067,26.0,212,6611,6823,37,318,9284,2590,6694,9284,653,0.022834984920292976,0.7120853080568721,0.003985351141749246,0.27897457992244723,0.7210254200775528,0.03425247738043947
15068,17.0,93,2181,2274,8,131,3062,849,2213,3062,222,0.030372305682560417,0.7122795558458523,0.002612671456564337,0.27726975832789025,0.7227302416721098,0.04278249510124102
15069,42.0,54,1595,1649,54,167,2274,568,1706,2274,131,0.023746701846965697,0.7014072119613016,0.023746701846965697,0.2497801231310466,0.7502198768689534,0.07343887423043095
15070,,71,2851,2922,10,148,3876,1100,2776,3876,329,0.018317853457172344,0.7355521155830753,0.0025799793601651187,0.2837977296181631,0.7162022703818369,0.038183694530443756
15071,23.0,627,15606,16233,94,809,21865,6181,15684,21865,1824,0.02867596615595701,0.713743425565973,0.004299108163731992,0.28268922936199403,0.717310770638006,0.03699977132403384
15072,17.0,2099,25935,28034,150,2679,38938,10795,28143,38938,2721,0.05390620987210437,0.6660588628075402,0.0038522779803790643,0.27723560532128,0.72276439467872,0.06880168472957009
15073,27.0,212,10062,10274,52,406,13335,3930,9405,13335,1018,0.015898012748406447,0.7545556805399325,0.0038995125609298836,0.29471316085489313,0.7052868391451068,0.030446194225721784
15074,,230,3905,4135,17,270,5685,1561,4124,5685,409,0.040457343887423045,0.6868953386103782,0.002990325417766051,0.27458223394898856,0.7254177660510114,0.047493403693931395
15075,15.0,114,2695,2809,10,133,3714,1074,2640,3714,280,0.030694668820678513,0.7256327409800754,0.0026925148088314485,0.28917609046849757,0.7108239095315024,0.03581044695745827
15076,,273,6981,7254,54,393,9680,2792,6888,9680,647,0.028202479338842974,0.7211776859504132,0.005578512396694215,0.2884297520661157,0.7115702479338843,0.04059917355371901
15077,,76,2221,2297,26,244,3174,867,2307,3174,194,0.023944549464398234,0.699747952110901,0.008191556395715185,0.2731568998109641,0.7268431001890359,0.07687460617517328
15078,24.0,2910,53824,56840,229,3236,76864,21792,55072,76864,5559,0.03785907577019151,0.7002497918401333,0.0029792880932556203,0.2835137385512073,0.7164862614487927,0.042100333055786844
15079,,17986,370355,388341,2041,18575,514957,146809,368148,514957,32559,0.0349271880953167,0.7191959717024916,0.003963437723926464,0.28508982303376784,0.7149101769662322,0.03607097291618523
15080,26.0,116,2045,2161,9,103,2882,835,2047,2882,198,0.040249826509368494,0.7095766828591256,0.003122831367106176,0.2897293546148508,0.7102706453851492,0.03573907009021513
15081,,453,9648,10101,56,856,13782,3878,9904,13782,1077,0.03286895951240749,0.7000435350457118,0.004063270933101147,0.2813815121172544,0.7186184878827456,0.06210999854883181
15082,24.0,203,6370,6573,8,227,8625,2500,6125,8625,620,0.02353623188405797,0.7385507246376811,0.0009275362318840579,0.2898550724637681,0.7101449275362319,0.026318840579710144
15083,27.0,956,184191,185147,618,10759,246161,70262,175899,246161,19271,0.0038836371317958573,0.7482541913625635,0.0025105520370814222,0.2854310796592474,0.7145689203407526,0.04370716726045149
15084,,227,4827,5054,14,423,6995,1908,5087,6995,488,0.032451751250893494,0.6900643316654753,0.0020014295925661185,0.2727662616154396,0.7272337383845604,0.060471765546819156
15085,,42,2467,2509,7,105,3393,974,2419,3393,343,0.01237842617152962,0.7270851753610375,0.00206307102858827,0.287061597406425,0.712938402593575,0.03094606542882405
15086,15.0,189,1989,2178,20,258,3236,824,2412,3236,165,0.058405438813349815,0.6146477132262052,0.006180469715698393,0.2546353522867738,0.7453646477132262,0.07972805933250927
15087,24.0,180,4089,4269,2,193,5635,1644,3991,5635,428,0.03194321206743567,0.7256433007985803,0.000354924578527063,0.2917480035492458,0.7082519964507542,0.03425022182786158
15088,23.0,3523,119970,123493,140,4709,161582,46483,115099,161582,12644,0.021803171145300837,0.7424713148741815,0.0008664331423054549,0.28767436966988896,0.712325630330111,0.029143097622259907
15089,,1226,25267,26493,124,1338,35425,10043,25382,35425,2309,0.03460832745236415,0.7132533521524347,0.0035003528581510233,0.283500352858151,0.716499647141849,0.03776993648553281
15090,,78,2924,3002,10,193,4138,1171,2967,4138,305,0.018849685838569358,0.7066215563073949,0.002416626389560174,0.28298695021749637,0.7170130497825036,0.04664088931851136
15091,38.0,143,3647,3790,14,159,5031,1432,3599,5031,409,0.028423772609819122,0.7249055853707016,0.0027827469687934803,0.28463526137944745,0.7153647386205526,0.031604054859868815
15092,24.0,174,2414,2588,9,165,3716,1003,2713,3716,224,0.04682454251883746,0.6496232508073198,0.0024219590958019376,0.26991388589881593,0.7300861141011841,0.04440258342303552
15093,,103,1764,1867,12,193,2546,630,1916,2546,159,0.040455616653574236,0.6928515318146111,0.004713275726630008,0.2474469756480754,0.7525530243519246,0.0758051846032993
15094,27.0,216,4230,4446,2,211,6133,1770,4363,6133,493,0.03521930539703245,0.6897113973585521,0.0003261046796021523,0.28860264144790476,0.7113973585520952,0.03440404369802707
15095,16.0,64,2515,2579,2,90,3234,999,2235,3234,226,0.019789734075448363,0.7776747062461348,0.0006184291898577613,0.30890538033395176,0.6910946196660482,0.027829313543599257
15096,13.0,81,2387,2468,21,139,3421,939,2482,3421,229,0.023677287342882197,0.6977491961414791,0.006138555977784273,0.2744811458637825,0.7255188541362175,0.040631394329143526
15097,,482,17264,17746,9,504,22644,6836,15808,22644,1818,0.021285991874227167,0.7624094682918212,0.000397456279809221,0.3018901254195372,0.6981098745804628,0.022257551669316374
15098,23.0,573,11895,12468,88,610,16942,4754,12188,16942,1220,0.03382127257702751,0.7021012867430055,0.005194191949002479,0.28060441506315664,0.7193955849368433,0.036005194191949
15099,39.0,667,13873,14540,97,771,19419,5518,13901,19419,1212,0.03434780369740975,0.7144034193315825,0.004995107884031104,0.28415469385653225,0.7158453061434678,0.039703383284412176
15100,13.0,1471,6085,7556,13,553,10695,2881,7814,10695,715,0.1375409069658719,0.5689574567554933,0.0012155212716222533,0.2693782141187471,0.7306217858812529,0.05170640486208509
15101,,155,5305,5460,12,259,7220,2073,5147,7220,528,0.02146814404432133,0.7347645429362881,0.0016620498614958448,0.2871191135734072,0.7128808864265928,0.03587257617728532
15102,23.0,116,3977,4093,3,238,5436,1580,3856,5436,473,0.021339220014716703,0.7316041206769683,0.0005518763796909492,0.29065489330389993,0.7093451066961001,0.0437821927888153
15103,16.0,209,5745,5954,20,285,7963,2255,5708,7963,641,0.026246389551676505,0.7214617606429737,0.0025116162250408136,0.28318472937335176,0.7168152706266483,0.035790531206831594
15104,,147,2670,2817,21,208,4172,1062,3110,4172,297,0.03523489932885906,0.6399808245445829,0.0050335570469798654,0.2545541706615532,0.7454458293384468,0.04985618408437201
15105,,1993,10463,12456,69,1203,17101,4451,12650,17101,931,0.11654289222852465,0.6118355651716274,0.004034851763054792,0.2602771767732881,0.7397228232267119,0.07034676334717269
15106,38.0,159,4252,4411,14,268,5858,1684,4174,5858,427,0.02714236940935473,0.7258449982929327,0.002389894161829976,0.28747012632297714,0.7125298736770229,0.045749402526459544
15107,,810,21439,22249,139,1238,29817,8409,21408,29817,2240,0.027165710836100213,0.7190193513767313,0.004661770131133246,0.28202032397625515,0.7179796760237448,0.04151993829023711
15108,,119,3093,3212,9,536,4534,1211,3323,4534,289,0.026246140273489194,0.6821790913101015,0.001985002205558006,0.26709307454786063,0.7329069254521394,0.11821790913101014
15109,,481,8950,9431,10,798,12909,3564,9345,12909,908,0.03726082578046324,0.6933147416531102,0.0007746533426291734,0.27608645131303744,0.7239135486869626,0.06181733674180804
15110,,190,4045,4235,29,354,5765,1633,4132,5765,372,0.03295750216825672,0.7016478751084129,0.005030355594102341,0.28326105810928015,0.7167389418907198,0.0614050303555941
15111,44.0,14151,236704,250855,4264,10463,324588,103428,221160,324588,16702,0.04359680579688713,0.7292444575893132,0.013136653234253885,0.318643942474768,0.681356057525232,0.0322347098475606
15112,,599,3217,3816,12,348,5894,1493,4401,5894,249,0.1016287750254496,0.5458092975907702,0.0020359687818120122,0.25330844927044455,0.7466915507295555,0.059043094672548355
15113,34.0,119,2855,2974,10,157,4044,1121,2923,4044,275,0.02942631058358061,0.7059841740850643,0.002472799208704253,0.27720079129574676,0.7227992087042532,0.038822947576656774
15114,25.0,445,10848,11293,85,594,14644,4222,10422,14644,834,0.030387872166074845,0.7407812073204043,0.005804425020486206,0.28830920513520897,0.711690794864791,0.04056268779022125
15115,25.0,706,14633,15339,23,796,19640,5784,13856,19640,1087,0.03594704684317719,0.7450610997963341,0.0011710794297352342,0.2945010183299389,0.7054989816700611,0.040529531568228104
15116,38.0,125,3328,3453,21,128,4787,1287,3500,4787,330,0.02611238771673282,0.6952162105702946,0.004386881136411114,0.2688531439314811,0.7311468560685189,0.026739085021934405
15117,,218,7101,7319,14,287,9718,2734,6984,9718,773,0.022432599300267544,0.7307059065651369,0.0014406256431364478,0.28133360773821775,0.7186663922617823,0.02953282568429718
15118,16.0,654,9403,10057,96,1028,15267,3900,11367,15267,1045,0.04283749263116526,0.6159035828912033,0.006288072312831598,0.25545293770878363,0.7445470622912164,0.06733477434990502
15119,17.0,886,37101,37987,153,1136,49675,14631,35044,49675,4474,0.017835933568193255,0.7468746854554605,0.0030800201308505285,0.29453447408152994,0.70546552591847,0.022868646200301962
15120,17.0,462,5987,6449,11,488,8748,2471,6277,8748,656,0.05281207133058985,0.6843850022862369,0.001257430269775949,0.28246456332876085,0.7175354366712391,0.055784179240969366
15121,,68,1771,1839,4,45,2408,728,1680,2408,222,0.02823920265780731,0.7354651162790697,0.0016611295681063123,0.3023255813953488,0.6976744186046512,0.018687707641196014
15122,,2269,58531,60800,428,2736,80874,23102,57772,80874,5916,0.028055988327521823,0.7237307416475011,0.005292182901797858,0.28565422756386477,0.7143457724361352,0.03383040284887603
15123,34.0,368,7266,7634,35,385,10568,2918,7650,10568,741,0.0348221044663134,0.6875473126419379,0.003311884935654807,0.2761165783497351,0.723883421650265,0.03643073429220288
15124,,99,3581,3680,1,174,4786,1404,3382,4786,398,0.020685332218972,0.748223986627664,0.0002089427496865859,0.29335562055996656,0.7066443794400334,0.03635603844546594
15125,,582,14550,15132,136,790,20215,5677,14538,20215,1481,0.02879050210239921,0.7197625525599802,0.006727677467227307,0.28083106604006924,0.7191689339599308,0.039079891169923324
15126,,286,7430,7716,25,293,10138,2986,7152,10138,683,0.028210692444269086,0.7328861708423752,0.002465969619254291,0.2945354113237325,0.7054645886762675,0.028901163937660287
15127,24.0,108,3753,3861,2,173,4993,1454,3539,4993,387,0.021630282395353494,0.751652313238534,0.0004005607850991388,0.2912076907670739,0.7087923092329261,0.03464850791107551
15128,,221,6137,6358,53,365,8631,2327,6307,8634,633,0.025596479036367848,0.7107945332406764,0.006138522121843873,0.2695158675005791,0.7304841324994209,0.04227472782024554
15129,14.0,439,3478,3917,8,585,5834,1492,4342,5834,297,0.07524854302365444,0.5961604388069934,0.0013712718546451835,0.2557422008913267,0.7442577991086733,0.10027425437092903
15130,,342,9702,10044,24,383,13167,3763,9404,13167,1160,0.025974025974025976,0.7368421052631579,0.001822738664843928,0.2857902331586542,0.7142097668413457,0.02908787119313435
15131,15.0,300,7264,7564,12,368,9892,2850,7042,9892,737,0.0303275374039628,0.7343307723412859,0.001213101496158512,0.28811160533764657,0.7118883946623534,0.0372017792155277
15132,16.0,2891,61108,63999,304,3146,84605,24417,60188,84605,6617,0.034170557295668105,0.7222740972755747,0.003593168252467348,0.28859996454110276,0.7114000354588972,0.03718456356007328
15133,27.0,167,4737,4904,16,232,6551,1931,4620,6551,449,0.02549229125324378,0.7230957105785376,0.00244237520989162,0.29476415814379486,0.7052358418562051,0.03541444054342848
15134,23.0,620,14491,15111,45,589,20300,5759,14541,20300,1581,0.030541871921182268,0.7138423645320197,0.0022167487684729066,0.28369458128078817,0.7163054187192118,0.029014778325123152
15135,17.0,271,10579,10850,236,2338,16350,4109,12241,16350,570,0.016574923547400613,0.6470336391437309,0.014434250764525994,0.2513149847094801,0.7486850152905199,0.14299694189602447
15136,14.0,147,2253,2400,2,187,3322,899,2423,3322,235,0.04425045153521975,0.6782059000602046,0.0006020469596628537,0.27062010836845274,0.7293798916315473,0.056291390728476824
15137,16.0,1244,7994,9238,29,1177,13090,3470,9620,13090,685,0.09503437738731857,0.6106951871657754,0.002215431627196333,0.26508785332314744,0.7349121466768526,0.08991596638655462
15138,34.0,3635,69919,73554,536,3208,99115,28072,71043,99115,7197,0.03667456994400444,0.7054330827826263,0.005407859557080159,0.2832265550118549,0.7167734449881451,0.03236644302073349
15139,34.0,111,5290,5401,5,171,6921,2088,4833,6921,545,0.016038144776766364,0.7643404132350816,0.0007224389539083947,0.3016905071521456,0.6983094928478544,0.0247074122236671
15140,,2804,86817,89621,164,2868,118377,34417,83961,118378,9696,0.02368683370220818,0.7333879606007873,0.001385392556049266,0.2907381439118755,0.7092618560881245,0.02422747469969082
15141,15.0,1746,50452,52198,1572,3142,71039,20403,50636,71039,4541,0.024578048677487013,0.7102014386463773,0.022128689874575936,0.28720843480341784,0.7127915651965822,0.04422922619969313
15142,17.0,966,15794,16760,60,1388,22714,6459,16255,22714,1215,0.04252883684071498,0.6953420797745884,0.002641542660913974,0.2843620674473893,0.7156379325526108,0.06110768688914326
15143,23.0,2145,23516,25661,111,1549,34889,9502,25387,34889,2616,0.06148069592135057,0.6740233311358881,0.0031815185301957635,0.27234945111639774,0.7276505488836023,0.04439794777723638
15144,,201,3910,4111,20,204,5586,1544,4042,5586,433,0.0359828141783029,0.6999641962047977,0.0035803795202291443,0.2764052989616899,0.72359470103831,0.036519871106337275
15145,24.0,1926,37748,39674,704,2693,54482,15084,39411,54495,3602,0.03534269199009083,0.6926874025139921,0.01291861638682448,0.2767960363336086,0.7232039636663914,0.04941737774107716
15146,,224,5426,5650,29,287,7852,2163,5689,7852,611,0.028527763627101375,0.6910341314314824,0.0036933265410086604,0.2754712175241977,0.7245287824758023,0.03655119714722364
15147,,285,9640,9925,12,452,12988,3863,9125,12988,1014,0.021943332306744688,0.7422235910070835,0.0009239297813366184,0.29742839544194644,0.7025716045580536,0.034801355097012626
15148,,388,7189,7577,40,320,9908,2834,7074,9908,760,0.03916027452563585,0.7255752926927735,0.004037141703673799,0.28603148970528863,0.7139685102947113,0.03229713362939039
15149,23.0,10079,195210,205289,1093,11741,277457,78249,199208,277457,18593,0.036326349668597296,0.7035684808817222,0.003939349160410442,0.28202207909694116,0.7179779209030589,0.04231646705615645
15150,,356,9615,9971,23,390,12707,3847,8860,12707,838,0.028016054143385535,0.7566695522153144,0.0018100259699378295,0.3027465176674274,0.6972534823325726,0.030691744707641456
15151,,125,3200,3325,13,157,4759,1291,3468,4759,393,0.02626602227358689,0.6724101702038243,0.0027316663164530363,0.2712754780416054,0.7287245219583947,0.03299012397562513
15152,16.0,2801,54349,57150,229,2909,75815,21625,54190,75815,5544,0.03694519554177933,0.7168634175295127,0.003020510453076568,0.28523379278506894,0.7147662072149311,0.03836971575545736
15153,26.0,179,4110,4289,5,217,5606,1639,3967,5606,424,0.031930074919728865,0.733143061006065,0.0008919015340706386,0.2923653228683553,0.7076346771316446,0.03870852657866571
15154,48.0,2927,57439,60366,292,3819,80306,23301,57005,80306,5976,0.03644808607077927,0.7152516623913531,0.003636091948297761,0.29015266605234974,0.7098473339476502,0.04755559983064777
15155,38.0,128,2355,2483,4,90,3227,940,2287,3227,232,0.039665323830182835,0.7297799814068795,0.0012395413696932136,0.29129222187790516,0.7087077781220948,0.027889680818097305
15156,,165,6068,6233,6,421,8535,2312,6223,8535,696,0.019332161687170474,0.71095489162273,0.00070298769771529,0.2708845928529584,0.7291154071470416,0.04932630345635618
15157,42.0,66,2038,2104,2,94,2684,805,1879,2684,198,0.02459016393442623,0.7593144560357675,0.0007451564828614009,0.29992548435171384,0.7000745156482862,0.03502235469448584
15158,26.0,217,5835,6052,37,263,8203,2318,5885,8203,693,0.026453736437888578,0.711325124954285,0.004510544922589297,0.28257954406924296,0.7174204559307571,0.03206144093624284
15159,25.0,463,8129,8592,42,283,10870,3241,7629,10870,725,0.04259429622815088,0.7478380864765409,0.0038638454461821527,0.2981600735970561,0.7018399264029439,0.026034958601655934
15160,15.0,57,2878,2935,11,92,3860,1100,2760,3860,363,0.014766839378238342,0.7455958549222798,0.002849740932642487,0.2849740932642487,0.7150259067357513,0.02383419689119171
15161,24.0,48,1367,1415,4,90,1933,553,1380,1933,142,0.024831867563372995,0.7071908949818935,0.0020693222969477496,0.28608380755302637,0.7139161924469736,0.04655975168132437
15162,26.0,405,14609,15014,17,685,19626,5884,13742,19626,1631,0.02063589116478141,0.7443697136451646,0.0008661979007439112,0.29980637929277487,0.7001936207072251,0.03490268011821054
15163,23.0,837,27618,28455,87,1188,37858,10677,27181,37858,2844,0.022108933382640392,0.7295155581383063,0.002298061175973374,0.28202757673411166,0.7179724232658883,0.031380421575360556
15164,13.0,197,2189,2386,26,274,3506,920,2586,3506,203,0.05618938961779806,0.6243582430119795,0.007415858528237307,0.26240730176839705,0.737592698231603,0.07815173987450086
15165,16.0,83,2036,2119,27,78,2808,799,2009,2808,233,0.02955840455840456,0.7250712250712251,0.009615384615384616,0.28454415954415957,0.7154558404558404,0.027777777777777776
15166,,79,3504,3583,18,245,4872,1364,3508,4872,390,0.016215106732348113,0.7192118226600985,0.003694581280788177,0.2799671592775041,0.7200328407224958,0.05028735632183908
15167,,126,2848,2974,3,275,4070,1070,3000,4070,277,0.03095823095823096,0.6997542997542997,0.0007371007371007371,0.2628992628992629,0.7371007371007371,0.06756756756756757
15168,,1508,41494,43002,697,2188,57206,16062,41144,57206,4384,0.026360871237282802,0.7253434954375415,0.012184036639513337,0.2807747439079817,0.7192252560920184,0.038247736251442156
15169,26.0,129,2392,2521,12,153,3517,940,2577,3517,166,0.03667898777367074,0.6801251066249645,0.0034119988626670457,0.2672732442422519,0.732726755757748,0.04350298549900483
15170,26.0,2294,87561,89855,2283,18084,137207,31681,105526,137207,7747,0.016719263594423026,0.6381671489063969,0.016639092757658135,0.2308992981407654,0.7691007018592346,0.131800855641476
15171,23.0,148,2716,2864,11,158,3862,1078,2784,3862,278,0.038322112894873125,0.703262558259969,0.0028482651475919213,0.2791299844640083,0.7208700155359917,0.04091144484722942
15172,,534,17238,17772,58,610,23121,6903,16218,23121,1632,0.02309588685610484,0.7455559880628001,0.0025085420180788027,0.29855975087582715,0.7014402491241728,0.026382941914277064
15173,,54,1643,1697,10,86,2358,670,1688,2358,158,0.022900763358778626,0.6967769296013571,0.004240882103477523,0.28413910093299405,0.7158608990670059,0.0364715860899067
15174,,257,6156,6413,39,227,8933,2271,6662,8933,527,0.02876973021381395,0.6891301914250532,0.004365834546065151,0.25422590395163996,0.74577409604836,0.025411395947609987
15175,23.0,599,57004,57603,85,3339,76941,22214,54727,76941,6610,0.007785186051649966,0.7408793751056004,0.0011047425949753708,0.28871472946803395,0.7112852705319661,0.043396888524973684
15176,25.0,110,3833,3943,2,291,5606,1494,4112,5606,470,0.01962183374955405,0.6837317160185515,0.00035676061362825543,0.2665001783803068,0.7334998216196932,0.051908669282911164
15177,27.0,2780,30140,32920,340,1981,46104,12329,33775,46104,2743,0.06029845566545202,0.6537393718549367,0.007374631268436578,0.2674171438486899,0.7325828561513101,0.04296807218462606
15178,,131,4128,4259,26,157,5742,1638,4104,5742,456,0.022814350400557296,0.7189132706374086,0.004528039010797631,0.2852664576802508,0.7147335423197492,0.027342389411354927
15179,15.0,521,12477,12998,36,707,17273,4839,12434,17273,1408,0.030162681641868812,0.7223412261911654,0.002084177618248133,0.2801482081861865,0.7198517918138134,0.040930932669484166
15180,17.0,129,4606,4735,7,123,5963,1821,4142,5963,463,0.021633406003689418,0.772429984906926,0.0011739057521381855,0.30538319637766226,0.6946168036223378,0.020627201073285258
15181,26.0,7451,129491,136942,638,7839,186706,52243,134463,186706,13713,0.0399076623140124,0.6935556436322347,0.003417137103253243,0.27981425342517113,0.7201857465748289,0.04198579585016014
15182,16.0,2260,39477,41737,297,1982,54580,15794,38786,54580,3256,0.04140710883107365,0.7232869182850861,0.005441553682667644,0.28937339684866253,0.7106266031513375,0.03631366801026017
15183,,457,10565,11022,37,595,14858,4131,10727,14858,1179,0.03075784089379459,0.7110647462646386,0.0024902409476376362,0.2780320366132723,0.7219679633867276,0.04004576659038902
15184,24.0,32,4507,4539,15,365,6108,1673,4435,6108,476,0.005239030779305829,0.7378847413228553,0.002455795677799607,0.27390307793058283,0.7260969220694171,0.059757694826457104
15185,23.0,61,2362,2423,10,80,3113,949,2164,3113,237,0.019595245743655638,0.7587536138772888,0.0032123353678123997,0.30485062640539673,0.6951493735946033,0.025698682942499197
15186,40.0,258,6309,6567,19,364,8796,2535,6261,8796,693,0.029331514324693043,0.7172578444747613,0.002160072760345612,0.2881991814461119,0.7118008185538881,0.04138244656662119
15187,26.0,235,11463,11698,44,375,15168,4461,10707,15168,1149,0.015493143459915612,0.7557357594936709,0.0029008438818565402,0.29410601265822783,0.7058939873417721,0.024723101265822785
15188,23.0,813,16896,17709,150,867,23306,6717,16589,23306,1409,0.03488372093023256,0.7249635287050545,0.006436110872736634,0.28820904488114646,0.7117909551188535,0.037200720844417744
15189,25.0,312,5678,5990,43,279,7856,2358,5498,7856,575,0.03971486761710794,0.7227596741344195,0.005473523421588595,0.30015274949083504,0.699847250509165,0.035514256619144605
15190,,369,5981,6350,25,518,8864,2394,6470,8864,490,0.04162906137184116,0.6747518050541517,0.0028203971119133576,0.2700812274368231,0.7299187725631769,0.05843862815884476
15191,,434,18220,18654,14,504,24078,7202,16876,24078,2041,0.018024752886452364,0.7567073677215715,0.0005814436414984634,0.2991112218622809,0.7008887781377191,0.02093197109394468
15192,23.0,2198,47973,50171,117,2564,66845,18959,47886,66845,5049,0.03288204054155135,0.7176752187897375,0.0017503178996185205,0.28362629964844044,0.7163737003515596,0.03835739397112724
15193,,381,36267,36648,83,2486,49358,14025,35333,49358,3840,0.007719113416264841,0.7347745046395721,0.0016815916366141254,0.2841484663073868,0.7158515336926131,0.05036670853762308
15194,,3231,48171,51402,302,3021,68930,19197,49733,68930,4656,0.04687363992456115,0.6988394022921804,0.004381256347018715,0.27849992746264324,0.7215000725373567,0.04382707094153489
15195,,238,6210,6448,35,236,8537,2422,6115,8537,721,0.027878645894342274,0.7274218109406114,0.0040998008668150406,0.2837062199836008,0.7162937800163992,0.0276443715590957
15196,23.0,993,10180,11173,166,1168,16110,3672,12438,16110,704,0.06163873370577281,0.6319056486654252,0.010304158907510862,0.22793296089385476,0.7720670391061453,0.07250155183116078
15197,,3379,31793,35172,183,2911,48922,13500,35422,48922,3190,0.06906913045255714,0.6498712235803933,0.003740648379052369,0.2759494705858305,0.7240505294141695,0.059502882138915004
15198,24.0,90,2200,2290,11,94,3080,861,2219,3080,207,0.02922077922077922,0.7142857142857143,0.0035714285714285713,0.27954545454545454,0.7204545454545455,0.03051948051948052
15199,25.0,368,9381,9749,17,635,12990,3661,9329,12990,999,0.028329484218629714,0.7221709006928406,0.001308698999230177,0.28183217859892223,0.7181678214010777,0.04888375673595073
15200,15.0,4,4064,4068,1,321,5377,1603,3774,5377,393,0.0007439092430723452,0.7558117909615027,0.0001859773107680863,0.29812162916124235,0.7018783708387577,0.0596987167565557
15201,23.0,17,2846,2863,1,138,3703,1100,2603,3703,296,0.004590872265730489,0.7685660275452336,0.00027005130974885227,0.2970564407237375,0.7029435592762625,0.037267080745341616
15202,26.0,100,4898,4998,0,134,6832,1954,4878,6832,658,0.014637002341920375,0.71692037470726,0.0,0.28600702576112413,0.7139929742388759,0.019613583138173303
15203,,17,2240,2257,7,216,3126,849,2277,3126,211,0.005438259756877799,0.7165706973768394,0.0022392834293026233,0.2715930902111324,0.7284069097888676,0.0690978886756238
15204,27.0,185,4551,4736,41,354,6282,1722,4560,6282,358,0.029449219993632602,0.724450811843362,0.0065265838904807385,0.27411652340019105,0.725883476599809,0.05635148042024833
15205,16.0,4394,51534,55928,3805,7208,87515,22100,65415,87515,4192,0.050208535679597786,0.5888590527338171,0.043478260869565216,0.25252813803347995,0.74747186196652,0.08236302348168885
15206,,118,3404,3522,22,156,4742,1345,3397,4742,324,0.02488401518346689,0.7178405735976381,0.004639392661324336,0.28363559679460143,0.7163644032053985,0.03289751159848165
15207,35.0,1201,28389,29590,125,1705,39795,11636,28159,39795,3148,0.030179670812916195,0.7133810780248775,0.0031410981279055158,0.29239854253046865,0.7076014574695314,0.04284457846463124
15208,,2261,39026,41287,337,2425,55505,15568,39937,55505,3666,0.040735068912710566,0.7031078281235925,0.006071525087829925,0.2804792361048554,0.7195207638951446,0.043689757679488336
15209,,130,70226,70356,127,1982,91224,27056,64168,91224,9147,0.0014250635797597123,0.7698193457861966,0.0013921774971498728,0.29658861703060596,0.703411382969394,0.021726738577567305
15210,24.0,532,12837,13369,186,975,18029,5022,13007,18029,1320,0.02950801486493982,0.712019524100061,0.010316711964057907,0.2785512230295635,0.7214487769704365,0.054079538521271286
15211,26.0,4276,131298,135574,482,8962,185115,52036,133079,185115,14935,0.023099154579585664,0.7092780163682035,0.0026037868352105447,0.28110093725521973,0.7188990627447803,0.048413148583313075
15212,,30,12380,12410,29,607,16769,4355,12414,16769,1186,0.0017890154451666767,0.7382670403721152,0.001729381596994454,0.25970540879002924,0.7402945912099708,0.03619774584053909
15213,25.0,39597,874383,913980,4898,39032,1195844,349484,846364,1195848,83473,0.033112067754430326,0.731182391073113,0.004095838267070731,0.29224784420762506,0.7077521557923749,0.03263959968156488
15214,23.0,74,1884,1958,7,82,2611,797,1814,2611,235,0.028341631558789736,0.721562619685944,0.002680965147453083,0.30524703178858675,0.6947529682114133,0.031405591727307544
15215,23.0,1645,78270,79915,466,4057,105357,30215,75142,105357,8112,0.0156135804929905,0.7429027022409522,0.00442305684482284,0.2867868295414638,0.7132131704585362,0.03850717085718083
15216,,2123,34344,36467,118,2436,51202,14050,37152,51202,3328,0.04146322409280887,0.6707550486309128,0.002304597476661068,0.2744033436193899,0.7255966563806101,0.04757626655208781
15217,,356,7397,7753,35,380,10626,2914,7712,10626,836,0.033502729154903065,0.6961227178618483,0.0032938076416337285,0.27423301336344813,0.7257669866365518,0.0357613401091662
15218,24.0,677,18818,19495,54,1466,25895,7421,18474,25895,1733,0.02614404325159297,0.7267039969106005,0.0020853446611314927,0.2865804209306816,0.7134195790693184,0.05661324580034756
15219,24.0,56,6129,6185,133,232,8324,2331,5993,8324,637,0.006727534839019702,0.736304661220567,0.01597789524267179,0.2800336376741951,0.7199663623258049,0.02787121576165305
15220,13.0,495,4918,5413,29,332,6991,2028,4963,6991,344,0.07080532112716349,0.7034758975826062,0.004148190530682306,0.2900872550421971,0.7099127449578029,0.0474896295236733
15221,14.0,4060,18718,22778,135,3251,33315,8477,24838,33315,1172,0.12186702686477563,0.5618490169593277,0.00405222872579919,0.2544499474711091,0.7455500525288908,0.09758367101906049
15222,,381,5148,5529,19,407,7940,2050,5890,7940,473,0.047984886649874055,0.6483627204030227,0.0023929471032745593,0.25818639798488663,0.7418136020151134,0.051259445843828716
15223,,1121,24232,25353,124,1095,33728,9599,24129,33728,2733,0.033236480075901326,0.7184535104364327,0.003676470588235294,0.2846003320683112,0.7153996679316889,0.032465607210626184
15224,,205,8196,8401,41,223,10822,3273,7549,10822,880,0.01894289410460174,0.7573461467381261,0.0037885788209203472,0.3024394751432268,0.6975605248567732,0.020606172611347257
15225,24.0,199,5334,5533,22,220,7543,2145,5398,7543,547,0.026382076097043617,0.707145697998144,0.002916611427813867,0.28436961421185203,0.715630385788148,0.029166114278138672
15226,,2019,53188,55207,105,2821,71822,21097,50725,71822,5075,0.028111163710283757,0.7405530338893376,0.0014619475926596307,0.2937400796413355,0.7062599203586645,0.03927765865612208
15227,,225,11369,11594,93,254,15899,4472,11427,15899,1207,0.014151833448644568,0.7150764199006227,0.005849424492106421,0.2812755519215045,0.7187244480784954,0.01597584753758098
15228,17.0,779,22580,23359,24,1100,30815,8856,21959,30815,2187,0.025279896154470224,0.7327600194710369,0.0007788414733084537,0.2873925036508194,0.7126074963491806,0.03569690085997079
15229,26.0,159,4199,4358,15,187,5662,1664,3998,5662,409,0.02808194984104557,0.7416107382550335,0.0026492405510420347,0.2938890851289297,0.7061109148710702,0.03302719886965737
15230,,155,2801,2956,12,327,4246,1048,3198,4246,271,0.0365049458313707,0.6596796985398021,0.002826189354686764,0.2468205369759774,0.7531794630240226,0.07701365991521432
15231,13.0,17,1803,1820,22,376,2682,691,1991,2682,83,0.00633855331841909,0.6722595078299777,0.00820283370618941,0.2576435495898583,0.7423564504101416,0.1401938851603281
15232,27.0,2372,62798,65170,101,3540,86660,24586,62074,86660,6335,0.027371336256635126,0.7246480498499884,0.001165474267251327,0.28370643895684283,0.7162935610431571,0.04084929609969998
15233,25.0,181,4083,4264,34,220,5840,1640,4200,5840,425,0.030993150684931508,0.6991438356164383,0.0058219178082191785,0.2808219178082192,0.7191780821917808,0.03767123287671233
15234,45.0,563,13435,13998,4,379,18216,5335,12881,18216,1509,0.03090689503732982,0.737538427755819,0.00021958717610891525,0.2928743961352657,0.7071256038647343,0.02080588493631972
15235,13.0,730,2036,2766,60,437,4076,1015,3061,4076,157,0.17909715407262022,0.49950932286555444,0.014720314033366046,0.24901864573110893,0.7509813542688911,0.10721295387634937
15236,34.0,909,6094,7003,55,345,9440,2640,6800,9440,602,0.09629237288135593,0.6455508474576271,0.005826271186440678,0.2796610169491525,0.7203389830508474,0.036546610169491525
15237,23.0,489,14706,15195,40,749,20442,5715,14727,20442,1692,0.02392133842089815,0.7194012327560904,0.0019567556990509735,0.27957147050190784,0.7204285294980922,0.036640250464729476
15238,,1140,23247,24387,123,1149,32536,9322,23214,32536,2458,0.03503811163019425,0.7145008605851979,0.0037804278337841162,0.28651340054093927,0.7134865994590607,0.035314728300958935
15239,27.0,133,3030,3163,15,135,4199,1196,3003,4199,276,0.03167420814479638,0.7216003810431055,0.00357227911407478,0.2848297213622291,0.7151702786377709,0.03215051202667302
15240,,170,4685,4855,13,234,6464,1838,4626,6464,465,0.02629950495049505,0.7247834158415841,0.002011138613861386,0.2843440594059406,0.7156559405940595,0.03620049504950495
15241,,1328,27525,28853,69,1784,38913,11006,27907,38913,3134,0.034127412432863054,0.7073471590471051,0.0017731863387556858,0.2828360702078997,0.7171639297921003,0.04584586128029193
15242,26.0,13,2783,2796,2,182,3870,1070,2800,3870,350,0.003359173126614987,0.7191214470284237,0.0005167958656330749,0.27648578811369506,0.7235142118863049,0.047028423772609816
15243,,1405,16985,18390,234,806,24083,7071,17012,24083,1498,0.05833990781879334,0.7052692770834198,0.009716397458788356,0.2936096001328738,0.7063903998671262,0.03346759124693768
15244,16.0,317,12266,12583,29,519,16783,4747,12036,16783,1337,0.018888160638741585,0.7308586069236728,0.0017279389858785676,0.28284573675743313,0.7171542632425669,0.030924149436930226
15245,15.0,274,1678,1952,10,85,2684,744,1940,2684,179,0.10208643815201192,0.6251862891207154,0.0037257824143070045,0.27719821162444114,0.7228017883755589,0.03166915052160954
15246,,722,14413,15135,40,1079,20839,5731,15108,20839,1350,0.03464657613129229,0.6916358750419885,0.0019194779020106532,0.2750131964105763,0.7249868035894237,0.051777916406737366
15247,17.0,15,1909,1924,41,158,2760,718,2042,2760,226,0.005434782608695652,0.6916666666666667,0.014855072463768116,0.26014492753623186,0.7398550724637681,0.0572463768115942
15248,,828,8260,9088,11,1440,12844,3269,9575,12844,694,0.06446589847399564,0.6431018374338212,0.0008564310183743382,0.254515727187792,0.7454842728122081,0.11211460604173155
15249,,262,6793,7055,14,493,10364,2773,7591,10364,699,0.02527981474334234,0.6554419143187958,0.001350829795445774,0.2675607873407951,0.732439212659205,0.04756850636819761
15250,24.0,611,9612,10223,26,428,13165,3903,9262,13165,928,0.04641093809342955,0.7301177364223319,0.001974933535890619,0.2964679073300418,0.7035320926699582,0.032510444360045576
15251,,1178,23181,24359,51,1245,32673,9223,23450,32673,2413,0.0360542343831298,0.709484895785511,0.0015609218620879625,0.28228200654975055,0.7177179934502494,0.03810485722155908
15252,46.0,1154,12963,14117,141,870,19614,5170,14444,19614,1146,0.058835525644947484,0.6609054756806363,0.007188742734781279,0.2635872336086469,0.7364127663913531,0.04435607219333129
15253,17.0,132,12053,12185,62,472,16317,4643,11674,16317,1380,0.008089722375436662,0.7386774529631672,0.0037997180854323714,0.2845498559784274,0.7154501440215726,0.028926886069743214
15254,,144,2841,2985,2,158,3948,1095,2853,3948,298,0.0364741641337386,0.7196048632218845,0.0005065856129685917,0.2773556231003039,0.7226443768996961,0.04002026342451875
15255,34.0,277,5019,5296,32,294,7252,1958,5294,7252,509,0.03819635962493105,0.6920849420849421,0.00441257584114727,0.26999448428019857,0.7300055157198014,0.04054054054054054
15256,,217,5113,5330,24,416,7259,2063,5196,7259,562,0.029893924783027964,0.7043669926987188,0.0033062405289984846,0.28419892547182807,0.7158010745281719,0.05730816916930707
15257,16.0,134,6244,6378,4,162,8360,2467,5893,8360,844,0.01602870813397129,0.74688995215311,0.0004784688995215311,0.2950956937799043,0.7049043062200957,0.019377990430622008
15258,,459,15129,15588,79,1534,21744,5877,15867,21744,1264,0.021109271523178808,0.6957781456953642,0.003633186166298749,0.27028145695364236,0.7297185430463576,0.07054819720382634
15259,15.0,1778,1676,3454,15,282,4939,1345,3594,4939,122,0.3599919011945738,0.33933994735776474,0.003037052034824863,0.27232233245596277,0.7276776675440373,0.05709657825470743
15260,,111,3298,3409,14,150,4551,1311,3240,4551,376,0.024390243902439025,0.7246758954076027,0.0030762469786860033,0.2880685563612393,0.7119314436387607,0.03295978905735003
15261,14.0,240,9427,9667,9,230,12344,3689,8655,12344,1043,0.019442644199611146,0.7636908619572261,0.000729099157485418,0.298849643551523,0.701150356448477,0.018632534024627348
15262,,336,11820,12156,59,950,16443,4603,11840,16443,1097,0.020434227330779056,0.7188469257434774,0.0035881530134403697,0.279936751201119,0.720063248798881,0.05777534513166697
15263,23.0,664,93422,94086,310,12262,135277,36003,99274,135277,8324,0.0049084471122215895,0.6905978104186226,0.0022915942843203204,0.2661428032851113,0.7338571967148887,0.09064364230430894
15264,,79,2144,2223,29,178,3249,864,2385,3249,213,0.024315173899661435,0.6598953524161281,0.008925823330255463,0.2659279778393352,0.7340720221606648,0.054786088027085254
15265,13.0,43,4331,4374,20,1194,6448,1029,5419,6448,230,0.006668734491315136,0.671681141439206,0.003101736972704715,0.15958436724565755,0.8404156327543424,0.18517369727047148
15266,24.0,502,10702,11204,64,295,14792,4216,10576,14792,1083,0.03393726338561385,0.7234991887506761,0.004326663061114116,0.2850189291508924,0.7149810708491077,0.019943212547322876
15267,23.0,1459,35306,36765,173,2174,49800,13565,36235,49800,3215,0.02929718875502008,0.7089558232931726,0.0034738955823293174,0.2723895582329317,0.7276104417670682,0.04365461847389558
15268,25.0,2009,126555,128564,481,9646,173588,48515,125073,173588,13907,0.011573380648431919,0.7290538516487315,0.0027709288660506485,0.27948360485747864,0.7205163951425214,0.05556835725971841
15269,16.0,27,2051,2078,5,230,2999,871,2128,2999,191,0.009003001000333445,0.683894631543848,0.0016672224074691564,0.29043014338112705,0.709569856618873,0.0766922307435812
15270,26.0,8894,169622,178516,756,7804,236707,68166,168546,236712,16130,0.03757308459224712,0.7165754165399304,0.00319375443577005,0.28797019162526616,0.7120298083747338,0.03296833282638818
15271,16.0,3268,89856,93124,363,5652,125744,35540,90204,125744,10941,0.025989311617254103,0.7145947321542181,0.002886817661280061,0.28263774017050514,0.7173622598294949,0.04494846672604657
15272,36.0,1744,33258,35002,518,1977,47927,13067,34878,47945,3040,0.036375013035770155,0.6936698300135572,0.010804046303055585,0.2725414537490875,0.7274585462509126,0.04123474814892064
15273,14.0,668,7515,8183,38,766,11261,3159,8102,11261,719,0.059319776218808275,0.6673474824615931,0.003374478287896279,0.28052570819643013,0.7194742918035698,0.06802237811917236
15274,17.0,5695,114867,120562,693,6596,161905,46235,115670,161905,12075,0.035174948272134895,0.7094716037182298,0.004280287823106142,0.2855686976930916,0.7144313023069083,0.0407399400883234
15275,,767,24866,25633,55,665,32697,9933,22764,32697,2279,0.023457809584977216,0.7604979050065755,0.001682111508701104,0.3037893384714194,0.6962106615285806,0.020338257332476985
15276,27.0,479,14308,14787,50,745,19726,5592,14134,19726,1526,0.024282672614823076,0.7253371185237757,0.0025347257426746425,0.28348372706073205,0.716516272939268,0.03776741356585218
15277,14.0,738,16155,16893,55,818,22556,6364,16192,22556,1766,0.03271856712183011,0.7162174144351835,0.002438375598510374,0.28214222379854587,0.7178577762014542,0.03626529526511793
15278,16.0,997,24272,25269,162,991,32482,9615,22868,32483,2118,0.030692977865344948,0.7472216236185082,0.0049872240864452175,0.29600098513068374,0.7039990148693163,0.030508265862143277
15279,23.0,178,3895,4073,8,141,5372,1559,3813,5372,424,0.033134772896500374,0.7250558451228593,0.0014892032762472078,0.2902084884586746,0.7097915115413254,0.026247207743857037
15280,,817,21518,22335,205,3572,32689,8411,24278,32689,2038,0.024993116950656185,0.6582642479121417,0.006271222735476766,0.2573036801370492,0.7426963198629508,0.10927223224938053
15281,15.0,803,28828,29631,106,1403,39838,11334,28504,39838,3417,0.02015663436919524,0.7236307043526281,0.002660776143380692,0.284502234047894,0.715497765952106,0.035217631407199156
15282,16.0,40,5411,5451,46,61,7102,2071,5031,7102,832,0.005632216277105041,0.7618980568853844,0.006477048718670797,0.2916079977471135,0.7083920022528866,0.008589129822585187
15283,26.0,110,3833,3943,2,291,5606,1494,4112,5606,470,0.01962183374955405,0.6837317160185515,0.00035676061362825543,0.2665001783803068,0.7334998216196932,0.051908669282911164
15284,,109,1990,2099,15,78,2760,785,1975,2760,235,0.03949275362318841,0.7210144927536232,0.005434782608695652,0.28442028985507245,0.7155797101449275,0.02826086956521739
15285,13.0,859,14277,15136,209,1151,20454,5669,14785,20454,1329,0.04199667546690134,0.6980052801408038,0.010218050259118022,0.2771585020044979,0.7228414979955021,0.056272611714090155
15286,,365,8102,8467,92,248,10910,3193,7717,10910,780,0.033455545371219066,0.742621448212649,0.008432630614115491,0.2926672777268561,0.7073327222731439,0.022731439046746106
15287,16.0,132,2380,2512,5,111,3491,976,2515,3491,267,0.03781151532512174,0.681753079346892,0.0014322543683758235,0.27957605270696073,0.7204239472930393,0.03179604697794328
15288,23.0,2308,46414,48722,138,2227,64853,18520,46333,64853,4438,0.03558817633725502,0.7156800764806562,0.0021278892264043297,0.2855689019783202,0.7144310980216798,0.03433919787827857
15289,,64,1824,1888,6,65,2522,708,1814,2522,212,0.025376685170499604,0.7232355273592387,0.0023790642347343376,0.28072957969865187,0.7192704203013481,0.02577319587628866
15290,17.0,187,2801,2988,36,258,4107,1144,2963,4107,273,0.04553201850499148,0.6820063306549793,0.008765522279035792,0.27854881908935963,0.7214511809106404,0.06281957633308985
15291,24.0,226,5306,5532,4,174,7385,2172,5213,7385,644,0.030602572782667568,0.7184834123222749,0.0005416384563303995,0.29410968178740693,0.7058903182125931,0.023561272850372378
15292,23.0,3323,87131,90454,556,4410,118756,33995,84761,118756,8334,0.0279817440802991,0.7336976658021489,0.004681868705581192,0.2862592205867493,0.7137407794132506,0.037134965812253694
15293,17.0,1864,46966,48830,90,2202,62188,18661,43527,62188,4210,0.029973628352736863,0.7552260886344633,0.001447224544928282,0.30007396925451857,0.6999260307454814,0.03540876053257863
15294,16.0,166,6164,6330,24,183,8412,2423,5989,8412,756,0.019733713742272944,0.7327627199239182,0.0028530670470756064,0.28804089396100807,0.7119591060389919,0.021754636233951498
15295,40.0,25476,190818,216294,14726,19219,326852,82484,244368,326852,10807,0.07794353407658512,0.5838055144224297,0.045054030570411074,0.2523588657863498,0.7476411342136502,0.0588003132916427
15296,38.0,156,3445,3601,12,151,4815,1400,3415,4815,342,0.032398753894081,0.715472481827622,0.0024922118380062306,0.29075804776739356,0.7092419522326064,0.03136033229491173
15297,14.0,88,1956,2044,11,137,2840,756,2084,2840,159,0.030985915492957747,0.6887323943661972,0.0038732394366197184,0.2661971830985915,0.7338028169014085,0.04823943661971831
15298,17.0,638,44356,44994,331,1959,61449,16932,44517,61449,5499,0.010382593695584957,0.7218343667106055,0.005386580741753324,0.2755455743787531,0.7244544256212468,0.03188009568910804
15299,16.0,678,16047,16725,71,864,21990,6259,15731,21990,1868,0.030832196452933152,0.7297407912687586,0.0032287403365165983,0.2846293769895407,0.7153706230104593,0.03929058663028649
15300,16.0,480,10180,10660,47,629,14149,3941,10208,14149,1148,0.033924658986500815,0.7194854760053714,0.003321789525761538,0.27853558555374935,0.7214644144462506,0.04445543854689377
15301,14.0,1429,27521,28950,100,1953,39267,10776,28491,39267,2970,0.03639188122341916,0.7008684136806989,0.002546667685333741,0.2744289097715639,0.7255710902284361,0.04973641989456796
15302,,142,3033,3175,0,124,4210,1219,2991,4210,313,0.033729216152019,0.7204275534441805,0.0,0.2895486935866983,0.7104513064133017,0.029453681710213776
15303,25.0,182,2741,2923,37,205,4143,1084,3059,4143,253,0.04392951967173546,0.6615978759353126,0.008930726526671495,0.26164615013275405,0.738353849867246,0.04948105237750423
15304,37.0,280,6797,7077,40,401,9537,2693,6844,9537,739,0.029359337317814826,0.7126979133899549,0.004194191045402118,0.2823739121316976,0.7176260878683024,0.042046765230156234
15305,15.0,379,6376,6755,23,423,9357,2542,6815,9357,768,0.040504435182216525,0.6814149834348616,0.0024580527946991555,0.27166826974457625,0.7283317302554237,0.045206797050336645
15306,17.0,1093,19576,20669,106,1174,28777,7834,20943,28777,1909,0.03798172151370886,0.6802654898008826,0.003683497237377072,0.2722312958265281,0.7277687041734718,0.040796469402647945
15307,33.0,274,3041,3315,21,207,5181,1219,3962,5181,261,0.052885543331403204,0.586952325805829,0.004053271569195136,0.23528276394518433,0.7647172360548157,0.039953676896352056
15308,24.0,696,11949,12645,80,918,17377,4813,12564,17377,1152,0.04005294354606664,0.6876330782068251,0.004603786614490418,0.2769753121942798,0.7230246878057202,0.05282845140127755
15309,25.0,131,3310,3441,4,239,4495,1277,3218,4495,278,0.02914349276974416,0.7363737486095662,0.0008898776418242492,0.28409343715239155,0.7159065628476085,0.053170189098998885
15310,16.0,181,1864,2045,19,190,2813,806,2007,2813,153,0.06434411660149307,0.6626377532883043,0.0067543547813722,0.286526839672947,0.713473160327053,0.067543547813722
15311,,2085,20219,22304,822,1136,30950,7990,22960,30950,1479,0.06736672051696284,0.6532794830371567,0.02655896607431341,0.25815831987075927,0.7418416801292407,0.03670436187399031
15312,38.0,569,11370,11939,95,600,16473,4594,11881,16475,1191,0.03453717754172989,0.6901365705614567,0.005766312594840668,0.2788467374810319,0.7211532625189682,0.036418816388467376
15313,23.0,1097,17269,18366,27,888,26895,6880,20015,26895,1605,0.04078825060420153,0.6420896077337795,0.001003904071388734,0.25580963004275886,0.7441903699572411,0.03301728945900725
15314,17.0,1564,31880,33444,79,2627,46816,12766,34050,46816,3391,0.033407382091592615,0.6809637730690362,0.0016874572795625427,0.2726845522898155,0.7273154477101845,0.056113294600136705
15315,27.0,2603,51916,54519,239,3094,72107,20581,51526,72107,4568,0.036099130458901355,0.7199855769897513,0.0033145187013743464,0.2854230518534955,0.7145769481465045,0.042908455489758274
15316,,676,13177,13853,81,1484,21009,5357,15652,21009,1099,0.032176686182112425,0.6272073873102004,0.0038554905040696845,0.25498595839878146,0.7450140416012185,0.0706363939264125
15317,15.0,22,4797,4819,8,214,6536,1852,4684,6536,628,0.0033659730722154224,0.7339351285189718,0.0012239902080783353,0.2833537331701346,0.7166462668298653,0.03274173806609547
15318,13.0,201,3421,3622,1,175,4844,1431,3413,4844,360,0.041494632535094965,0.7062345169281585,0.00020644095788604458,0.2954170107349298,0.7045829892650702,0.036127167630057806
15319,23.0,151,11684,11835,16,769,15613,4670,10943,15613,957,0.009671427656440147,0.748350733363223,0.001024787036443989,0.29910971626208926,0.7008902837379107,0.049253826939089224
15320,16.0,2279,41807,44086,140,3031,59177,16980,42197,59177,4472,0.03851158389239062,0.7064737989421566,0.002365784003920442,0.2869358027612079,0.7130641972387921,0.05121922368487757
15321,15.0,362,7318,7680,23,528,10448,2866,7582,10448,708,0.034647779479326186,0.7004211332312404,0.0022013782542113325,0.27431087289433387,0.7256891271056661,0.05053598774885146
15322,14.0,8,4423,4431,42,432,6226,1647,4579,6226,460,0.00128493414712496,0.7104079665917121,0.006745904272406039,0.2645358175393511,0.7354641824606489,0.06938644394474783
15323,26.0,42,3730,3772,3,155,5013,1464,3549,5013,467,0.008378216636744464,0.744065429882306,0.0005984440454817474,0.29204069419509276,0.7079593058049073,0.03091960901655695
15324,27.0,19,10038,10057,27,652,13361,3676,9685,13361,1089,0.0014220492478107926,0.7512910710276177,0.0020208068258363893,0.2751291071027618,0.7248708928972383,0.04879874260908615
15325,,1254,28632,29886,26,1586,39109,11261,27848,39109,2929,0.03206423073972743,0.7321076989951162,0.0006648086118284794,0.2879388376077118,0.7120611623922882,0.04055332532153724
15326,23.0,194,4163,4357,11,230,5908,1696,4212,5908,501,0.032836831415030465,0.7046377792823291,0.001861882193635748,0.2870683818551117,0.7129316181448883,0.038930264048747464
15327,25.0,156,3623,3779,64,86,5043,1440,3603,5043,386,0.030933967876264127,0.718421574459647,0.012690858615903232,0.2855443188578227,0.7144556811421773,0.017053341265119967
15328,35.0,2833,63222,66055,169,4352,88746,24261,64485,88746,6527,0.03192256552407996,0.7123926712189845,0.0019043111802222073,0.2733757014400649,0.726624298559935,0.049038829919094945
15329,,121,2833,2954,47,88,3953,1139,2814,3953,370,0.030609663546673414,0.7166708828737668,0.011889704022261574,0.288135593220339,0.711864406779661,0.022261573488489755
15330,15.0,193,6115,6308,1,743,8687,2008,6679,8687,498,0.022217106020490388,0.7039254057787498,0.00011511453896627144,0.23114999424427304,0.7688500057557269,0.08553010245193968
15331,14.0,252,3986,4238,75,190,5929,1582,4347,5929,405,0.04250295159386069,0.6722887502108281,0.0126496879743633,0.2668240850059032,0.7331759149940968,0.03204587620172036
15332,26.0,2089,48065,50154,258,2655,68281,18668,49613,68281,5615,0.030594162358489184,0.7039293507710783,0.0037785035368550547,0.27339962800779133,0.7266003719922086,0.03888343755949678
15333,14.0,683,21134,21817,38,1631,30406,8382,22024,30406,2388,0.022462671841083998,0.6950601854897059,0.0012497533381569427,0.2756692758008288,0.7243307241991712,0.05364072880352562
15334,23.0,127,6063,6190,36,323,8313,2384,5929,8313,668,0.015277276554793696,0.7293395885961746,0.004330566582461205,0.2867797425718754,0.7132202574281247,0.03885480572597137
15335,,1291,16517,17808,166,1241,23777,6766,17011,23777,1662,0.054296168566261516,0.694662909534424,0.006981536779240442,0.28456070992976407,0.715439290070236,0.05219329604239391
15336,14.0,449,24384,24833,342,2146,35744,8851,26893,35744,1691,0.012561548791405551,0.6821844225604298,0.0095680393912265,0.24762197851387646,0.7523780214861235,0.060038048343777975
15337,14.0,104,11998,12102,64,1421,16859,4548,12311,16859,1103,0.006168811910552227,0.7116673586808233,0.003796191944955217,0.2697668900883801,0.7302331099116199,0.0842873242778338
15338,24.0,20,2285,2305,13,52,3019,923,2096,3019,301,0.006624710168930109,0.756873136800265,0.004306061609804571,0.30573037429612454,0.6942696257038754,0.017224246439218285
15339,23.0,183,3390,3573,11,125,4709,1363,3346,4709,386,0.038861754087916756,0.7198980675302612,0.002335952431514122,0.2894457421957953,0.7105542578042047,0.02654491399447866
15340,39.0,79,2407,2486,3,89,3303,970,2333,3303,292,0.023917650620647896,0.7287314562518922,0.0009082652134423251,0.2936724190130185,0.7063275809869816,0.026945201332122314
15341,26.0,361,6831,7192,24,394,9789,2755,7034,9789,712,0.036878128511594645,0.6978240882623353,0.002451731535396874,0.2814383491674328,0.7185616508325672,0.04024925937276535
15342,25.0,896,85252,86148,393,3986,113349,33003,80346,113349,9654,0.007904789632021457,0.7521195599431844,0.003467167773866554,0.291162692216076,0.708837307783924,0.03516572709066688
15343,24.0,372,12849,13221,48,244,17134,4997,12137,17134,1605,0.02171121746235555,0.7499124547682969,0.0028014474144974905,0.29164234854674914,0.7083576514532508,0.014240691023695577
15344,,1814,41270,43084,667,2517,58551,15787,42764,58551,3363,0.030981537463066387,0.7048555959761575,0.011391778107974244,0.269628187392188,0.730371812607812,0.042988164164574474
15345,14.0,104,14744,14848,79,439,19476,5664,13812,19476,1787,0.005339905524748409,0.7570342986239474,0.00405627438899158,0.29081947011706716,0.7091805298829328,0.022540562743889915
15346,17.0,800,16258,17058,44,945,22966,6609,16357,22966,1597,0.03483410258643212,0.7079160498127667,0.0019158756422537665,0.2877732299921623,0.7122267700078376,0.04114778368022294
15347,23.0,116,3563,3679,4,236,4858,1379,3479,4858,346,0.02387813915191437,0.7334293948126801,0.0008233841086867024,0.2838616714697406,0.7161383285302594,0.04857966241251544
15348,15.0,209,7503,7712,10,391,10236,2946,7290,10236,874,0.02041813208284486,0.7330011723329426,0.0009769441187964048,0.2878077373974209,0.7121922626025792,0.03819851504493943
15349,25.0,1120,23841,24961,79,1506,33041,9569,23472,33041,2332,0.033897279138040616,0.7215580642232378,0.0023909687963439364,0.28960987863563453,0.7103901213643655,0.0455797342695439
15350,,111,3370,3481,9,174,4690,1327,3363,4690,390,0.02366737739872068,0.7185501066098081,0.0019189765458422175,0.28294243070362474,0.7170575692963753,0.03710021321961621
15351,,504,14741,15245,85,743,19969,5724,14245,19969,1444,0.02523912063698733,0.738194201011568,0.004256597726476038,0.2866442986629275,0.7133557013370725,0.03720767189143172
15352,33.0,640,19010,19650,55,906,25702,7494,18208,25702,1918,0.02490078593105595,0.7396311571083962,0.0021399112909501208,0.29157264026145824,0.7084273597385418,0.03525017508365108
15353,,132,3296,3428,12,213,4706,1295,3411,4706,382,0.02804929876753081,0.700382490437739,0.0025499362515937103,0.2751806204844879,0.7248193795155121,0.045261368465788356
15354,,178,2716,2894,9,207,3921,1166,2755,3921,187,0.04539658250446315,0.6926804386636062,0.0022953328232593728,0.2973731191022698,0.7026268808977302,0.05279265493496557
15355,15.0,987,14109,15096,328,1027,20211,5837,14374,20211,1358,0.0488347929345406,0.6980852011280986,0.016228786304487656,0.288803127010044,0.7111968729899559,0.05081391321557568
15356,26.0,190,3931,4121,14,735,6609,1564,5045,6609,351,0.028748676047813587,0.5947949765471326,0.0021183234982599486,0.23664699651989712,0.7633530034801029,0.1112119836586473
15357,26.0,97,3394,3491,8,128,4650,1282,3368,4650,356,0.02086021505376344,0.7298924731182795,0.0017204301075268817,0.2756989247311828,0.7243010752688172,0.027526881720430108
15358,26.0,81,2096,2177,0,96,2985,861,2124,2985,253,0.027135678391959798,0.702177554438861,0.0,0.2884422110552764,0.7115577889447237,0.032160804020100506
15359,39.0,1794,29446,31240,70,2023,42930,11903,31027,42930,3254,0.041788958770090846,0.6859072909387375,0.001630561378989052,0.2772653156300955,0.7227346843699045,0.0471232238527836
15360,,261,4587,4848,75,418,6851,1760,5091,6851,395,0.03809662822945555,0.6695372938257189,0.010947306962487227,0.25689680338636695,0.743103196613633,0.06101299080426215
15361,33.0,184,3645,3829,19,154,5045,1478,3567,5045,380,0.03647175421209118,0.7224975222993062,0.0037661050545094153,0.2929633300297324,0.7070366699702676,0.030525272547076314
15362,,77,3294,3371,17,185,4858,1236,3622,4858,333,0.01585014409221902,0.6780568135034993,0.003499382461918485,0.25442568958419104,0.745574310415809,0.038081515026759986
15363,,976,21075,22051,342,1057,29693,8479,21214,29693,1015,0.03286969992927626,0.7097632438621897,0.011517866163742296,0.2855555181355875,0.7144444818644125,0.03559761559963628
15364,24.0,74,2810,2884,6,176,3784,1100,2684,3784,280,0.019556025369978858,0.742600422832981,0.0015856236786469344,0.29069767441860467,0.7093023255813954,0.046511627906976744
15365,14.0,241,3858,4099,12,361,5728,1384,4344,5728,297,0.042074022346368714,0.6735335195530726,0.002094972067039106,0.24162011173184358,0.7583798882681564,0.06302374301675978
15366,26.0,1000,26325,27337,150,1470,35661,10645,25016,35661,2480,0.028041838422927005,0.7382013964835534,0.004206275763439051,0.298505370012058,0.701494629987942,0.0412215024817027
15367,16.0,205,11348,11553,28,2004,17166,4321,12845,17166,1062,0.011942211348013515,0.6610742164744262,0.0016311313060701387,0.2517185133403239,0.7482814866596761,0.11674239776301992
15368,,350,6132,6482,103,824,9442,2509,6933,9442,573,0.037068417708112686,0.6494386782461343,0.010908705782673162,0.2657276000847278,0.7342723999152722,0.0872696462613853
15369,16.0,174,2597,2771,4,200,3717,985,2732,3717,250,0.046811945117029866,0.6986817325800376,0.0010761366693570083,0.2649986548291633,0.7350013451708367,0.053806833467850416
15370,17.0,105,5938,6043,17,53,7596,2218,5378,7596,702,0.01382306477093207,0.781727224855187,0.0022380200105318587,0.29199578725645076,0.7080042127435492,0.006977356503422854
15371,15.0,223,4787,5010,6,525,7455,1928,5527,7455,493,0.029912810194500334,0.6421193829644534,0.0008048289738430583,0.2586183769282361,0.7413816230717639,0.07042253521126761
15372,24.0,1149,13928,15077,80,725,19928,5647,14281,19928,1290,0.05765756724207146,0.6989160979526294,0.004014452027298274,0.2833701324769169,0.7166298675230831,0.036380971497390606
15373,,103,4867,4970,0,279,6472,1921,4551,6472,459,0.015914709517923363,0.752008652657602,0.0,0.29681705809641534,0.7031829419035847,0.043108776266996295
15374,24.0,430,15281,15711,37,909,21017,5721,15296,21017,1779,0.020459627920255033,0.7270780796498073,0.0017604796117428748,0.2722082123994861,0.7277917876005139,0.0432507018128182
15375,,647,13219,13866,189,750,18989,5240,13749,18989,1358,0.03407235768076255,0.6961398704513139,0.009953130759913635,0.2759492337669177,0.7240507662330823,0.039496550634577916
15376,,251,2979,3230,15,272,4434,1239,3195,4434,259,0.05660802886783942,0.6718538565629228,0.0033829499323410014,0.2794316644113667,0.7205683355886333,0.06134415877311682
15377,16.0,188,7812,8000,3,310,10140,3063,7077,10140,730,0.01854043392504931,0.770414201183432,0.0002958579881656805,0.30207100591715974,0.6979289940828403,0.03057199211045365
15378,,4404,130147,134551,591,4881,175517,52400,123120,175520,14692,0.025091157702825887,0.7414938468550593,0.003367137648131267,0.29854147675478576,0.7014585232452142,0.027808796718322697
15379,15.0,400,3040,3440,85,152,4756,1275,3481,4756,301,0.08410428931875526,0.63919259882254,0.01787216148023549,0.2680824222035324,0.7319175777964676,0.031959629941127
15380,27.0,1685,47793,49478,356,2647,67318,18920,48398,67318,5098,0.02503045247927746,0.7099587034671262,0.005288332986719748,0.2810541014290383,0.7189458985709617,0.039320835437772955
15381,26.0,461,10752,11213,23,606,14778,4255,10523,14778,1012,0.031195019623765058,0.727568006496143,0.0015563675734199486,0.2879280010826905,0.7120719989173095,0.04100690215184734
15382,,63,1603,1666,13,100,2303,643,1660,2303,169,0.02735562310030395,0.6960486322188449,0.005644811115935736,0.27920104211897523,0.7207989578810248,0.04342162396873643
15383,,737,20747,21484,48,821,28061,8104,19957,28061,2296,0.026264210113680908,0.7393535511920459,0.0017105591390185668,0.2887994013043013,0.7112005986956986,0.0292576886069634
15384,23.0,290,10314,10604,0,293,13597,4006,9591,13597,1167,0.021328234169302053,0.7585496800764875,0.0,0.29462381407663457,0.7053761859233655,0.02154887107450173
15385,26.0,2018,37504,39522,258,2090,55295,15128,40167,55295,3837,0.03649516231123971,0.6782530066009584,0.004665882991228863,0.27358712360972964,0.7264128763902704,0.03779726919251288
15386,17.0,4926,143890,148816,424,5547,197456,56408,141048,197456,15412,0.024947330038084435,0.7287193096183453,0.002147313831942306,0.2856737703589661,0.714326229641034,0.02809233449477352
15387,14.0,171,2413,2584,1,282,3567,998,2569,3567,235,0.0479394449116905,0.6764788337538548,0.0002803476310625175,0.2797869358003925,0.7202130641996075,0.07905803195962995
15388,16.0,404,9121,9525,0,484,13148,3641,9507,13148,1091,0.030727106784301794,0.6937176756921205,0.0,0.2769242470337694,0.7230757529662306,0.036811682385153636
15389,,232,5137,5369,8,277,7195,2067,5128,7195,568,0.03224461431549687,0.7139680333564976,0.0011118832522585128,0.28728283530229326,0.7127171646977067,0.03849895760945101
15390,,522,18562,19084,64,949,25435,7218,18217,25435,2161,0.020522901513662276,0.72978179673678,0.002516217810104187,0.28378218989581283,0.7162178101041872,0.03731079221545115
15391,33.0,1210,22367,23577,241,1099,31033,8938,22095,31033,1996,0.03899075178036284,0.7207488802242774,0.007765926594270615,0.2880159829858538,0.7119840170141463,0.035413914220346086
15392,,60,2203,2263,2,86,2909,878,2031,2909,214,0.020625644551392232,0.757304915778618,0.0006875214850464077,0.301821931935373,0.698178068064627,0.029563423856995532
15393,14.0,293,4182,4475,102,366,6614,1568,5046,6614,387,0.04429996976111279,0.6322951315391594,0.015421832476564862,0.23707287571817356,0.7629271242818264,0.0553371635923798
15394,34.0,232,5509,5741,33,178,7566,2131,5435,7566,558,0.030663494581020353,0.7281258260639704,0.0043616177636796195,0.281654771345493,0.718345228654507,0.02352630187681734
15395,,56,2428,2484,9,79,3459,987,2472,3459,308,0.016189650187915582,0.7019369760046256,0.0026019080659150044,0.28534258456201217,0.7146574154379879,0.02283897080080948
15396,,546,7812,8358,184,712,12439,3023,9416,12439,434,0.04389420371412493,0.6280247608328644,0.014792185867031111,0.2430259667175818,0.7569740332824182,0.057239327920250826
15397,15.0,1024,21857,22881,57,1423,30666,8633,22033,30666,2292,0.03339203026152743,0.7127437552990282,0.0018587360594795538,0.2815169894997717,0.7184830105002282,0.0464031826778843
15398,25.0,468,12100,12784,82,674,17112,4783,12329,17112,1118,0.0273492286115007,0.7071061243571762,0.0047919588592800376,0.27951145395044413,0.7204885460495559,0.03938756428237494
15399,14.0,1163,18891,20054,179,2089,27303,7327,19976,27303,1451,0.04259605171592865,0.6919019887924404,0.006556056111050068,0.2683587884115299,0.7316412115884702,0.07651173863677985
15400,23.0,189,15905,16094,7,1094,21483,6398,15085,21483,1394,0.008797653958944282,0.7403528371270307,0.00032583903551645487,0.29781687846203975,0.7021831215379603,0.05092398640785738
15401,23.0,345,6739,7084,25,517,9646,2695,6951,9646,596,0.035766120671781046,0.6986315571221232,0.0025917478747667427,0.2793904208998549,0.7206095791001451,0.05359734605017624
15402,23.0,350,8902,9252,22,439,12402,3647,8755,12402,1026,0.028221254636348975,0.7177874536365102,0.0017739074342847927,0.29406547331075633,0.7059345266892437,0.035397516529592
15403,,1952,34130,36082,90,1947,48830,13676,35154,48830,3353,0.03997542494368216,0.698955560106492,0.0018431292238378046,0.2800737251689535,0.7199262748310465,0.03987302887569117
15404,23.0,368,12906,13274,42,291,16328,5151,11187,16338,1065,0.02252417676582201,0.7899375688578774,0.002570694087403599,0.3152772677194271,0.6847227322805729,0.017811237605582078
15405,24.0,17060,18486,35546,67,1236,48345,17453,30892,48345,2118,0.35288033922846207,0.3823766677008998,0.0013858723756334677,0.3610094115213569,0.6389905884786431,0.02556624263108905
15406,27.0,1815,40946,42761,140,1407,55306,16301,39005,55306,4043,0.03281741583191697,0.7403536686797093,0.0025313709181643946,0.2947419809785557,0.7052580190214444,0.025440277727552165
15407,,432,7718,8150,211,1087,11588,3218,8370,11588,736,0.03727994477045219,0.6660338280980325,0.01820849154297549,0.2777010700724888,0.7222989299275112,0.09380393510528133
15408,15.0,60,319,735,19,36,1078,141,937,1078,30,0.055658627087198514,0.29591836734693877,0.017625231910946195,0.13079777365491652,0.8692022263450835,0.03339517625231911
15409,,115,1828,1943,29,147,2857,728,2129,2857,182,0.04025201260063003,0.6398319915995799,0.010150507525376268,0.25481274063703185,0.7451872593629681,0.051452572628631434
15410,39.0,646,16130,16776,8,609,22859,6549,16310,22859,1891,0.028260203858436504,0.7056301675488866,0.00034997156481035915,0.28649547224288024,0.7135045277571197,0.026641585371188593
15411,,364,13615,13979,64,1164,18922,5031,13891,18922,1304,0.019236867138780256,0.7195328189409154,0.00338230631011521,0.2658809850967128,0.7341190149032871,0.061515696015220375
15412,27.0,20,4613,4633,16,332,6589,1783,4806,6589,565,0.0030353619669145544,0.7001062376688421,0.0024282895735316438,0.27060251935043256,0.7293974806495674,0.050387008650781606
15413,,10,3215,3225,2,33,4196,1212,2984,4196,437,0.0023832221163012394,0.7662059103908484,0.00047664442326024784,0.2888465204957102,0.7111534795042898,0.00786463298379409
15414,27.0,835,10007,10842,74,837,15344,4038,11306,15344,857,0.05441866527632951,0.6521767466110532,0.004822732012513035,0.2631647549530761,0.7368352450469239,0.05454900938477581
15415,23.0,9461,129316,138777,3597,20473,195094,51078,144016,195094,8218,0.048494571847417144,0.6628394517514634,0.018437266138374323,0.26181225460547225,0.7381877453945278,0.10493915753431679
15416,23.0,108,4681,4789,10,157,6197,1857,4340,6197,558,0.017427787639180247,0.7553654994352106,0.0016136840406648378,0.29966112635146036,0.7003388736485396,0.025334839438437954
15417,,783,20678,21461,88,983,27698,8217,19481,27698,2011,0.028269189111127156,0.7465520976243772,0.003177124702144559,0.2966640190627482,0.7033359809372518,0.03548992707054661
15418,,569,15852,16421,52,800,21348,6310,15038,21348,1639,0.026653550683904816,0.7425519955030916,0.0024358253700580853,0.295578040097433,0.704421959902567,0.03747423646243208
15419,,67,1694,1761,10,125,2357,658,1699,2357,153,0.028425965210012727,0.7187102248621129,0.004242681374628765,0.27916843445057277,0.7208315655494273,0.05303351718285957
15420,27.0,448,10389,10837,166,621,14965,4018,10947,14965,893,0.029936518543267624,0.6942198463080521,0.0110925492816572,0.2684931506849315,0.7315068493150685,0.04149682592716338
15421,16.0,87,2006,2093,11,121,2773,807,1966,2773,190,0.03137396321673278,0.723404255319149,0.003966822935448972,0.291020555355211,0.708979444644789,0.04363505228993869
15422,16.0,422,13686,14108,25,2410,19509,3860,15649,19509,1140,0.021631042083141115,0.7015223742887898,0.0012814598390486441,0.19785739914911066,0.8021426008508893,0.1235327284842893
15423,25.0,199,5728,5927,7,267,7801,2274,5527,7801,547,0.02550955005768491,0.7342648378413024,0.0008973208563004743,0.2915010896038969,0.708498910396103,0.034226381233175236
15424,17.0,641,17558,18199,143,1100,24011,6924,17087,24011,1668,0.026696097621923286,0.7312481779184541,0.005955603681645912,0.28836783141060346,0.7116321685893965,0.04581233601266086
15425,36.0,19599,417050,436649,2169,21149,578550,166361,412189,578550,41089,0.033876069484054964,0.7208538587848933,0.0037490277417682135,0.28754818079681965,0.7124518192031803,0.036555181056088494
15426,24.0,206,4425,4631,57,215,6533,1775,4758,6533,424,0.03153222103168529,0.6773304760446962,0.008724934945660493,0.2716975355885504,0.7283024644114495,0.032909842338894844
15427,,60,1813,1873,12,145,2558,698,1860,2558,161,0.023455824863174355,0.7087568412822518,0.004691164972634871,0.272869429241595,0.727130570758405,0.056684910086004694
15428,26.0,83,2935,3018,0,123,4122,1183,2939,4122,381,0.020135856380397867,0.7120329936923824,0.0,0.28699660359049006,0.7130033964095099,0.029839883551673944
15429,14.0,624,23424,24048,164,768,31784,9215,22569,31784,2850,0.019632519506670023,0.7369745784042285,0.0051598288447017365,0.2899257488044299,0.7100742511955701,0.024163100931286183
15430,17.0,17520,381333,398853,6302,23950,539305,151044,388261,539305,37939,0.03248625545841407,0.7070822632832998,0.011685409925737755,0.28007157359935475,0.7199284264006452,0.04440900788978407
15431,,1315,24145,25460,146,1204,34661,9662,24999,34661,2398,0.03793889385764981,0.6966042526182165,0.004212226998644009,0.2787571045267015,0.7212428954732986,0.03473644730388621
15432,25.0,539,16629,17168,52,887,23060,6596,16464,23060,1718,0.023373807458803124,0.7211188204683434,0.0022549869904596705,0.2860364267129228,0.7139635732870772,0.03846487424111015
15433,,6862,121498,128360,750,6910,169431,47970,121467,169437,10760,0.0404988284731198,0.7170688810590367,0.0044264239805945575,0.28311407779882786,0.7168859222011721,0.04078211960787785
15434,23.0,447,10198,10645,31,465,14018,4196,9822,14018,1107,0.03188757312027393,0.7274932229990013,0.0022114424311599373,0.2993294335853902,0.7006705664146098,0.03317163646739906
15435,,112,3619,3731,8,252,4775,1379,3396,4775,301,0.023455497382198952,0.7579057591623036,0.001675392670157068,0.2887958115183246,0.7112041884816754,0.05277486910994764
15436,23.0,6890,143928,150818,401,8215,200513,60072,140441,200513,7908,0.03436186182442036,0.7177988459601123,0.0019998703325968888,0.2995915476802003,0.7004084523197998,0.040969912175270434
15437,25.0,2785,71520,74305,203,3927,100047,28306,71741,100047,8471,0.027836916649174887,0.7148640139134607,0.002029046348216338,0.2829270242985797,0.7170729757014204,0.03925155177066779
15438,26.0,1906,52460,54366,108,1680,71594,21018,50576,71594,5985,0.026622342654412382,0.7327429672877616,0.001508506299410565,0.29357208704640053,0.7064279129535994,0.023465653546386567
15439,16.0,8,5802,5810,7,534,8004,2135,5869,8004,628,0.0009995002498750624,0.724887556221889,0.0008745627186406797,0.2667416291854073,0.7332583708145927,0.06671664167916042
15440,27.0,528,7347,7875,62,404,10425,2979,7446,10425,615,0.05064748201438849,0.704748201438849,0.005947242206235012,0.28575539568345326,0.7142446043165468,0.038752997601918464
15441,,3209,5278,8487,32,286,11319,3282,8037,11319,72,0.28350561003622227,0.46629560915275203,0.0028271048679211945,0.28995494301616753,0.7100450569838325,0.025267249757045675
15442,,3593,84613,88206,425,5317,114922,33297,81625,114922,7542,0.03126468387253963,0.7362645968569986,0.0036981604914637753,0.2897356467865161,0.7102643532134839,0.04626616313673622
15443,24.0,1101,17762,18863,87,1539,25388,7288,18100,25388,1846,0.04336694501339215,0.6996218685993383,0.0034268158184969275,0.28706475500236334,0.7129352449976367,0.06061919016858358
15444,,84,4431,4515,1,317,6076,1734,4342,6076,440,0.013824884792626729,0.7292626728110599,0.00016458196181698485,0.28538512179065173,0.7146148782093482,0.0521724818959842
15445,,492,12047,12539,96,722,18270,4564,13706,18270,1302,0.026929392446633827,0.6593869731800767,0.005254515599343186,0.24980842911877393,0.750191570881226,0.03951833607006021
15446,,161,3540,3701,108,214,5254,1461,3793,5254,397,0.030643319375713744,0.6737723639132089,0.020555767034640272,0.2780738484963837,0.7219261515036163,0.04073087171678721
15447,17.0,195,5379,5574,65,307,7445,2088,5357,7445,522,0.026192075218267292,0.7224983210208193,0.008730691739422432,0.280456682337139,0.719543317662861,0.04123572867696441
15448,24.0,70,6853,7016,60,471,9884,2535,7349,9884,622,0.007082152974504249,0.693342776203966,0.006070416835289356,0.25647511129097533,0.7435248887090247,0.04765277215702145
15449,,1251,18294,19545,229,870,25299,7391,17908,25299,1333,0.049448594806118816,0.7231115854381596,0.009051741175540536,0.2921459346219218,0.7078540653780782,0.0343887110162457
15450,40.0,391,10523,10914,47,538,14158,4166,9992,14158,913,0.027616895041672553,0.7432546969911005,0.0033196779206102556,0.2942506003672835,0.7057493996327164,0.03799971747421952
15451,26.0,101,3334,3435,10,174,4722,1317,3405,4722,357,0.021389241846675136,0.7060567556120289,0.0021177467174925877,0.2789072426937738,0.7210927573062261,0.036848792884371026
15452,,238,8853,9091,18,329,11661,3464,8197,11661,933,0.020409913386502016,0.7591973244147158,0.0015436068947774634,0.29705857130606295,0.702941428693937,0.02821370379898808
15453,35.0,1643,55896,57539,109,2484,74028,21836,52192,74028,5413,0.02219430485762144,0.7550656508348192,0.0014724158426541309,0.2949694710109688,0.7050305289890312,0.03355487112984276
15454,,645,9013,9658,173,760,13576,3652,9924,13576,847,0.047510312315851504,0.6638921626399529,0.012743076016499705,0.2690041249263406,0.7309958750736594,0.05598114319387154
15455,13.0,321,3466,3787,22,289,5216,1445,3771,5216,370,0.061541411042944784,0.6644938650306749,0.004217791411042945,0.27703220858895705,0.722967791411043,0.05540644171779141
15456,15.0,330,6664,6994,22,216,9518,2627,6891,9518,766,0.03467114940113469,0.700147089724732,0.002311409960075646,0.276003362050851,0.723996637949149,0.02269384324437907
15457,15.0,827,27551,28378,118,1574,38887,11182,27705,38887,3014,0.021266747242008898,0.7084886980224754,0.003034433101036336,0.28755110962532465,0.7124488903746753,0.040476251703654174
15458,,539,15476,16015,19,878,21633,6077,15556,21633,1481,0.02491563814542597,0.715388526787778,0.0008782878010447002,0.2809134193130865,0.7190865806869136,0.04058614154301299
15459,17.0,1153,14186,15339,61,966,20578,5521,15057,20578,1356,0.05603071241131305,0.6893770045679852,0.0029643308387598405,0.2682962387015259,0.7317037612984741,0.04694333754495092
15460,37.0,1750,41315,43065,136,1848,56232,16108,40124,56232,3991,0.03112106985346422,0.734724000569071,0.002418551714326362,0.28645611039977237,0.7135438896002276,0.03286384976525822
15461,15.0,952,10952,11904,189,873,16985,4496,12489,16985,941,0.05604945540182514,0.6448042390344422,0.011127465410656462,0.2647041507212246,0.7352958492787753,0.051398292611127466
15462,17.0,559,10160,10719,30,288,14501,4152,10349,14501,1438,0.03854906558168402,0.7006413350803393,0.0020688228398041512,0.28632508102889453,0.7136749189711055,0.019860699262119853
15463,,20751,702180,722931,3432,48241,1002739,276898,725841,1002739,77136,0.020694318262279614,0.7002619824301239,0.003422625428950106,0.2761416480260566,0.7238583519739433,0.048109228822255844
15464,26.0,863,22413,23276,77,1096,29613,9205,20408,29613,1319,0.029142606287779017,0.7568635396616351,0.0026002093675075136,0.3108432107520346,0.6891567892479654,0.0370107722959511
15465,,222,6891,7113,133,240,9545,2738,6807,9545,921,0.02325825039287585,0.7219486642221058,0.01393399685699319,0.2868517548454688,0.7131482451545311,0.025144054478784705
15466,26.0,255,8975,9230,27,329,12172,3489,8683,12172,1033,0.02094972067039106,0.7373480118304305,0.0022182057180414067,0.2866414722313506,0.7133585277686494,0.02702924745317121
15467,,206,10267,10473,29,1129,15253,3851,11402,15253,846,0.013505539893791385,0.6731134858716318,0.001901265324854127,0.2524749229659739,0.747525077034026,0.07401822592276928
15468,,258,5683,5941,20,294,7972,2242,5730,7972,686,0.03236327145007526,0.7128700451580532,0.002508780732563974,0.2812343201204215,0.7187656798795785,0.036879076768690414
15469,15.0,69,3242,3311,0,131,4158,1246,2912,4158,263,0.016594516594516596,0.7797017797017797,0.0,0.2996632996632997,0.7003367003367004,0.03150553150553151
15470,17.0,82,2764,2846,25,161,4017,1084,2933,4017,327,0.020413243714214588,0.6880756783669405,0.006223549912870301,0.26985312422205626,0.7301468757779438,0.04007966143888474
15471,26.0,2272,52650,54922,337,2703,73319,20516,52803,73319,5364,0.030987874902821917,0.7180949003668899,0.004596352923525962,0.2798183281277704,0.7201816718722296,0.036866296594334345
15472,15.0,1244,35909,37153,143,3264,50174,14079,36095,50174,3399,0.024793717861840793,0.7156894008849205,0.002850081715629609,0.2806034998206242,0.7193965001793757,0.06505361342528003
15473,27.0,373,5631,6004,34,346,8015,2197,5818,8015,519,0.04653774173424829,0.7025577043044292,0.004242046163443544,0.2741110417966313,0.7258889582033686,0.04316905801621959
15474,,118,3566,3684,26,197,4984,1388,3596,4984,356,0.023675762439807384,0.7154895666131621,0.00521669341894061,0.2784911717495987,0.7215088282504013,0.03952648475120385
15475,27.0,417,11401,11818,22,581,15927,4541,11386,15927,1272,0.02618195517046525,0.7158284673824323,0.001381302191247567,0.28511332956614555,0.7148866704338545,0.03647893514158347
15476,14.0,250,6256,6777,68,566,9654,2373,7281,9654,421,0.025896001657344105,0.6480215454733789,0.007043712450797597,0.24580484773151026,0.7541951522684898,0.058628547752227055
15477,34.0,1433,25974,27407,338,1125,36123,10414,25709,36123,2458,0.03967001633308419,0.7190432688314924,0.009356919414223624,0.2882927774548072,0.7117072225451928,0.03114359272485674
15478,26.0,83,1531,1614,2,58,2150,629,1521,2150,166,0.038604651162790694,0.7120930232558139,0.0009302325581395349,0.29255813953488374,0.7074418604651163,0.026976744186046512
15479,,291,19412,19703,90,1443,26954,7423,19531,26954,2236,0.01079617125473028,0.7201899532536915,0.0033390220375454477,0.2753951176077762,0.7246048823922238,0.05353565333531201
15480,16.0,102,17532,17634,35,991,23521,6707,16814,23521,1995,0.0043365503167382335,0.7453764720887718,0.0014880319714297861,0.2851494409251307,0.7148505590748693,0.042132562391054805
15481,,68,2210,2278,11,172,3009,848,2161,3009,177,0.022598870056497175,0.7344632768361582,0.0036556995679627785,0.2818212030574942,0.7181787969425059,0.057161847789963444
15482,24.0,92,1865,1957,1,109,2693,760,1933,2693,187,0.03416264389157074,0.6925362049758633,0.0003713330857779428,0.2822131451912365,0.7177868548087635,0.040475306349795764
15483,35.0,440,10065,10505,31,254,13475,4067,9408,13475,1085,0.0326530612244898,0.746938775510204,0.002300556586270872,0.3018181818181818,0.6981818181818182,0.018849721706864563
15484,,933,18607,19540,63,956,26023,7377,18646,26023,1962,0.03585289935826,0.7150213272873996,0.0024209353264419936,0.28347999846289823,0.7165200015371018,0.03673673289013565
15485,23.0,112,3516,3628,6,137,4726,1424,3302,4726,346,0.02369868810833686,0.7439695302581464,0.0012695725772323319,0.3013118916631401,0.6986881083368599,0.028988573846804908
15486,,550,13113,13663,217,430,17379,5208,12171,17379,1120,0.03164739052879913,0.7545313309166235,0.012486334081362564,0.29967201795270154,0.7003279820472985,0.02474250532251568
15487,25.0,1892,67491,69383,1127,3620,92599,26188,66411,92599,6734,0.020432186092722383,0.7288523634164515,0.012170757783561378,0.28281082949059927,0.7171891705094008,0.03909329474400371
15488,46.0,337,9837,10174,31,548,13542,3883,9659,13542,952,0.024885541278983903,0.726406734603456,0.0022891744203219614,0.2867375572293605,0.7132624427706394,0.040466696204401124
15489,25.0,559,12618,13177,39,715,17141,4883,12258,17141,1282,0.03261186628551426,0.7361297473893005,0.002275246485035879,0.28487252785718453,0.7151274721428155,0.04171285222565778
15490,,0,3787,3787,14,228,5128,1446,3682,5128,485,0.0,0.7384945397815913,0.002730109204368175,0.28198127925117006,0.71801872074883,0.044461778471138844
15491,27.0,2515,85984,88499,72,3276,116331,33238,83093,116331,8059,0.021619344800612048,0.739132303513251,0.0006189235887252753,0.2857191978062597,0.7142808021937402,0.028161023287000025
15492,34.0,1127,36276,37403,31,1293,48433,14028,34405,48433,3847,0.02326925856337621,0.7489934548758078,0.0006400594635888753,0.2896372308137014,0.7103627691862986,0.026696673755497283
15493,,162,6470,6632,5,415,9136,2543,6593,9136,749,0.017732049036777584,0.7081873905429071,0.0005472854640980736,0.2783493870402802,0.7216506129597198,0.04542469352014011
15494,24.0,394,9002,9396,47,254,11753,3592,8161,11753,710,0.033523355738960266,0.7659321024419298,0.003998978984089169,0.3056240959754956,0.6943759040245043,0.021611503445928697
15495,26.0,95,2275,2370,0,111,3131,865,2266,3131,254,0.030341743851804534,0.7266049185563718,0.0,0.27626956244011497,0.723730437559885,0.035451932290003194
15496,16.0,32973,432019,464992,7311,33282,630753,176377,454376,630753,39751,0.052275613433467615,0.6849257950417993,0.011590908009950012,0.27962926850922626,0.7203707314907737,0.052765504087971045
15497,23.0,485,12152,12637,63,642,17005,4827,12178,17005,1381,0.028521023228462217,0.7146133490149956,0.0037047927080270508,0.283857688915025,0.7161423110849751,0.03775360188179947
15498,25.0,807,16621,17428,104,734,22975,6632,16343,22975,1781,0.03512513601741023,0.7234385201305767,0.004526659412404788,0.28866158868335146,0.7113384113166485,0.031947769314472255
15499,14.0,2743,50927,53670,188,3063,73323,20469,52854,73323,5758,0.037409816837827146,0.6945569602989512,0.002563997654214912,0.2791620637453459,0.7208379362546541,0.041774068164150406
15500,16.0,863,19728,20591,98,1238,27691,7741,19950,27691,1973,0.031165360586472138,0.7124336426997941,0.003539056010978296,0.2795493120508468,0.7204506879491531,0.0447076667509299
15501,,2543,50700,53243,332,3297,71621,20289,51332,71621,5051,0.03550634590413426,0.7078929364292595,0.004635511930858268,0.283282836039709,0.716717163960291,0.04603398444590274
15502,36.0,1185,24315,25500,322,1006,35024,9784,25240,35024,2551,0.03383394243947008,0.6942382366377341,0.009193695751484696,0.2793513019643673,0.7206486980356327,0.028723161260849703
15503,,468,7998,8466,39,472,11246,3184,8062,11246,797,0.04161479637204339,0.7111861995376134,0.0034678996976702826,0.2831228881380046,0.7168771118619954,0.04197047839231727
15504,35.0,201,4143,4344,34,216,5772,1681,4091,5772,383,0.034823284823284825,0.7177754677754677,0.00589050589050589,0.2912335412335412,0.7087664587664587,0.037422037422037424
15505,26.0,115,2210,2325,9,96,3060,878,2182,3060,175,0.03758169934640523,0.7222222222222222,0.0029411764705882353,0.2869281045751634,0.7130718954248366,0.03137254901960784
15506,33.0,421,8297,8718,71,437,11511,3368,8143,11511,808,0.03657371210146816,0.720788810702806,0.006168013204760664,0.2925896968117453,0.7074103031882547,0.03796368690817479
15507,,789,22892,23681,32,745,30854,9034,21820,30854,2390,0.02557204900499125,0.7419459389382251,0.0010371426719388086,0.2927983405717249,0.7072016594282751,0.024145977831075388
15508,17.0,475,13090,13565,21,494,18440,5170,13270,18440,1455,0.025759219088937094,0.7098698481561823,0.00113882863340564,0.28036876355748375,0.7196312364425163,0.02678958785249458
15509,25.0,21249,419925,441174,2506,12951,582269,167879,414390,582269,46072,0.036493442034523565,0.7211872862886398,0.0043038526866448325,0.2883186293620303,0.7116813706379698,0.022242296945226347
15510,,91,2185,2276,2,114,2977,894,2083,2977,237,0.03056768558951965,0.7339603627813235,0.0006718172657037286,0.3003023177695667,0.6996976822304333,0.03829358414511253
15511,25.0,3622,76477,80099,124,3522,105910,30561,75349,105910,7386,0.03419884807855727,0.7220942309508073,0.0011708054008120101,0.28855632140496645,0.7114436785950335,0.03325465017467661
15512,25.0,555,17036,17591,61,788,23146,6750,16396,23146,1711,0.02397822517929664,0.7360235029810767,0.002635444569256027,0.2916270629914456,0.7083729370085544,0.03404475935366802
15513,,2483,58657,61140,148,2094,79677,23496,56181,79677,4979,0.03116332191222059,0.7361848463170049,0.0018574996548564831,0.2948906208818103,0.7051093791181897,0.02628110998155051
15514,24.0,111,1424,1535,6,70,2069,589,1480,2069,146,0.053649105848235866,0.6882551957467375,0.0028999516674722086,0.28467858869018847,0.7153214113098115,0.033832769453842435
15515,,111,3684,3795,3,168,5114,1413,3701,5114,402,0.021705123191239736,0.7203754399687133,0.0005866249511145874,0.27630035197497066,0.7236996480250293,0.032850997262416894
15516,,1319,14170,15489,164,632,20777,6092,14685,20777,1504,0.06348365981614285,0.6820041391923762,0.007893343601097367,0.2932088366944217,0.7067911633055782,0.030418250950570342
15517,24.0,241,7202,7443,18,361,9623,2769,6854,9623,731,0.02504416502130313,0.7484152551179466,0.0018705185493089473,0.2877481035020264,0.7122518964979736,0.037514288683362776
15518,,551,8945,9496,135,342,12185,3563,8622,12185,706,0.04521953221173574,0.7340993024210094,0.01107919573245794,0.2924086992203529,0.7075913007796472,0.028067295855560115
15519,15.0,4784,89589,94373,1230,4740,127857,35246,92611,127857,8349,0.03741680158301853,0.7006968722870082,0.009620122480583778,0.2756673471143543,0.7243326528856456,0.037072667120298455
15520,26.0,764,22457,23221,103,880,30288,8835,21453,30288,2010,0.025224511357633386,0.7414487585842577,0.003400686740623349,0.2916996830427892,0.7083003169572107,0.029054410987849975
15521,34.0,296,4938,5234,15,517,7338,1941,5397,7338,482,0.04033796674843282,0.6729354047424366,0.002044153720359771,0.2645134914145544,0.7354865085854456,0.07045516489506677
15522,17.0,556,47135,47691,288,2524,64612,17745,46867,64612,6142,0.008605212653996162,0.7295084504426422,0.004457376338760602,0.27463938587259334,0.7253606141274067,0.03906395096886028
15523,26.0,152,3763,3915,0,285,5338,1498,3840,5338,383,0.02847508430123642,0.7049456725365305,0.0,0.28062944923192207,0.7193705507680779,0.05339078306481829
15524,16.0,333,3549,3882,3,357,5354,1457,3897,5354,296,0.06219648860664923,0.6628688830780725,0.0005603287261860292,0.27213298468434816,0.7278670153156519,0.06667911841613747
15525,,17827,337555,355382,1604,15072,467236,135328,331908,467236,26192,0.03815416620294669,0.7224507529385579,0.0034329546524668477,0.28963521646448476,0.7103647835355152,0.03225778835534933
15526,,204,3630,3834,2,208,5128,1453,3675,5128,364,0.039781591263650544,0.7078783151326054,0.000390015600624025,0.2833463338533541,0.7166536661466458,0.0405616224648986
15527,,1172,9773,10945,103,900,15354,4146,11208,15354,1091,0.07633190048195909,0.6365116581998176,0.006708349615735313,0.27002735443532627,0.7299726455646737,0.05861664712778429
15528,25.0,72,1992,2064,2,166,2755,746,2009,2755,199,0.026134301270417423,0.7230490018148821,0.0007259528130671506,0.2707803992740472,0.7292196007259528,0.0602540834845735
15529,,10467,164397,175141,2884,13096,242237,66383,175874,242257,13836,0.04320618186471392,0.6786057781612089,0.01190471276371787,0.2740189137981565,0.7259810862018435,0.054058293465204306
15530,16.0,453,6930,7383,216,746,10473,2775,7698,10473,549,0.04325408192494987,0.6617015181896305,0.02062446290461186,0.26496705814952737,0.7350329418504726,0.07123078392055762
15531,17.0,210,3225,3435,186,321,4972,1292,3680,4972,222,0.042236524537409496,0.6486323411102172,0.037409493161705554,0.2598551890587289,0.7401448109412712,0.06456154465004023
15532,,101,4136,4237,61,290,5692,1576,4116,5692,420,0.017744202389318342,0.7266338721011947,0.010716795502459592,0.2768798313422347,0.7231201686577653,0.05094869992972593
15533,16.0,101,14997,15098,76,780,20760,5696,15064,20760,2041,0.004865125240847784,0.7223988439306358,0.0036608863198458576,0.274373795761079,0.725626204238921,0.03757225433526012
15534,14.0,74,5796,5870,163,916,8298,2134,6164,8298,248,0.008917811520848397,0.6984815618221258,0.019643287539166065,0.2571704025066281,0.7428295974933719,0.1103880453121234
15535,40.0,209,5505,5714,34,253,7649,2190,5459,7649,482,0.027323833180807947,0.7197019218198457,0.004445025493528566,0.2863119362008106,0.7136880637991895,0.033076219113609626
15536,23.0,8568,165457,174025,954,15847,239446,67167,172279,239446,17099,0.03578259816409545,0.6909992232069025,0.003984196854405586,0.2805100106078197,0.7194899893921802,0.06618193663707057
15537,24.0,157,9013,9170,154,361,11953,3468,8485,11953,882,0.013134777880030118,0.7540366435204551,0.012883794863214256,0.2901363674391366,0.7098636325608634,0.030201623023508744
15538,25.0,72,1409,1481,2,49,2049,623,1426,2049,180,0.03513909224011713,0.687652513421181,0.0009760858955588092,0.30405075646656904,0.6959492435334309,0.023914104441190825
15539,,71,2070,2141,6,101,2852,797,2055,2852,214,0.024894810659186535,0.7258064516129032,0.0021037868162692847,0.27945301542777,0.72054698457223,0.03541374474053296
15540,,449,9329,9778,70,456,12842,3662,9180,12842,861,0.03496340133935524,0.7264444790531069,0.005450864351347142,0.28515807506618907,0.7148419249338109,0.03550848777448996
15541,,613,13849,14462,53,800,19759,5475,14284,19759,1676,0.031023837238726655,0.700895794321575,0.00268232197985728,0.27708892150412473,0.7229110784958753,0.040487878941241964
15542,27.0,1314,31724,33038,239,1189,42326,12874,29452,42326,2818,0.031044747909086613,0.7495156641307943,0.005646647450739498,0.30416292586117283,0.6958370741388272,0.028091480413929972
15543,,1238,32280,33518,317,1100,44340,12942,31398,44340,3515,0.027920613441587732,0.7280108254397835,0.007149300857013983,0.2918809201623816,0.7081190798376183,0.02480829950383401
15544,,1526,44453,45982,142,1726,59843,17514,42337,59851,4567,0.025496650014201934,0.7427277739720305,0.002372558520325475,0.2926266896125378,0.7073733103874622,0.02883828173297021
15545,,4255,110428,114767,890,7493,154032,43391,110641,154032,10560,0.027624130050898515,0.7169159655136595,0.005778020151656798,0.28170120494442713,0.7182987950555728,0.04864573595097123
15546,23.0,305,6164,6469,13,292,8609,2559,6050,8609,732,0.035428040422813334,0.7159948890695783,0.001510047624578929,0.297247067022883,0.7027529329771169,0.0339179927982344
15547,16.0,187,5217,5404,60,321,7222,2007,5215,7222,458,0.025893104403212408,0.7223760731099419,0.008307947936859596,0.2779008584879535,0.7220991415120466,0.04444752146219884
15548,,3354,43063,46417,326,1759,60296,17586,42710,60296,4100,0.0556255804696829,0.714193312989253,0.005406660474990049,0.2916611383839724,0.7083388616160275,0.02917274777763036
15549,15.0,40,8218,8258,139,1110,11720,3185,8535,11720,384,0.0034129692832764505,0.7011945392491468,0.011860068259385665,0.2717576791808874,0.7282423208191127,0.0947098976109215
15550,46.0,63,1622,1685,2,85,2286,622,1664,2286,159,0.027559055118110236,0.7095363079615048,0.0008748906386701663,0.27209098862642167,0.7279090113735783,0.03718285214348206
15551,,460,13396,13856,7,719,18193,5037,13156,18193,1254,0.025284450063211124,0.7363271587973397,0.00038476337052712584,0.27686472819216185,0.7231352718078382,0.03952069477271478
15552,25.0,1167,29188,30662,132,1491,40032,11508,28524,40032,2714,0.02915167865707434,0.7291167066346922,0.0032973621103117505,0.28747002398081534,0.7125299760191847,0.03724520383693045
15553,,731,12510,13241,88,788,18054,4877,13177,18054,1150,0.04048964218455744,0.6929212362911267,0.004874266090617038,0.270134042317492,0.7298659576825081,0.043646837265979836
15554,14.0,67,6972,7039,55,443,10001,2731,7270,10001,675,0.0066993300669933005,0.6971302869713029,0.005499450054994501,0.27307269273072693,0.7269273072692731,0.044295570442955706
15555,35.0,1150,20856,22006,656,1004,29067,8352,20715,29067,1791,0.039563766470568,0.7175147074001444,0.02256854852581966,0.2873361544018991,0.7126638455981009,0.03454088829256545
15556,,1569,42244,43813,103,1900,56939,16699,40240,56939,4092,0.02755580533553452,0.7419167881416955,0.0018089534414022024,0.2932787720191784,0.7067212279808216,0.03336904406470082
15557,,47,1535,1582,2,68,2100,610,1490,2100,190,0.02238095238095238,0.7309523809523809,0.0009523809523809524,0.2904761904761905,0.7095238095238096,0.03238095238095238
15558,17.0,379,5413,5792,67,489,8015,2174,5841,8015,489,0.04728633811603244,0.6753587024329383,0.008359326263256394,0.27124142233312537,0.7287585776668746,0.06101060511540861
15559,37.0,354,5043,5397,51,316,7450,2033,5417,7450,404,0.047516778523489935,0.6769127516778524,0.006845637583892617,0.27288590604026847,0.7271140939597316,0.04241610738255033
15560,,2511,40780,43291,191,2879,59356,16409,42947,59356,4092,0.042304063616146644,0.6870409057214097,0.003217871824246917,0.27645056944538043,0.7235494305546196,0.04850394231417211
15561,16.0,119,3174,3293,26,213,4485,1212,3273,4485,306,0.02653288740245262,0.7076923076923077,0.005797101449275362,0.2702341137123746,0.7297658862876254,0.04749163879598662
15562,,824,21501,22325,89,1437,29623,8296,21327,29623,2057,0.02781622388009317,0.725821152482868,0.0030044222394760827,0.280052661783074,0.719947338216926,0.048509604023900345
15563,24.0,290,5141,5431,21,336,7502,2114,5388,7502,588,0.038656358304452146,0.6852839242868568,0.002799253532391362,0.28179152226073045,0.7182084777392695,0.044788056518261794
15564,,632,8847,9479,52,668,12669,3552,9117,12669,820,0.04988554739916331,0.6983187307601232,0.004104507064488121,0.2803694056358039,0.7196305943641961,0.0527271292130397
15565,14.0,1446,6353,7799,12,693,10571,2831,7740,10571,693,0.13678932929713367,0.6009838236685271,0.0011351811559928105,0.26780815438463723,0.7321918456153628,0.06555671175858481
15566,23.0,1723,38790,40513,258,2245,53939,15204,38735,53939,3899,0.031943491722130554,0.7191457016259107,0.004783181000760118,0.28187396874246834,0.7181260312575316,0.041621090491110325
15567,13.0,2346,48097,50443,97,2945,67848,19030,48844,67874,4786,0.03456404514246987,0.708621858148923,0.0014291186610484133,0.28037245484279694,0.7196275451572031,0.04338922120399564
15568,,562,18329,18891,46,802,24506,7216,17290,24506,1745,0.022933159226311922,0.7479392801762833,0.0018770913245735737,0.29445849995919365,0.7055415000408063,0.03272667918060883
15569,17.0,164,2058,2222,3,134,2915,821,2094,2915,185,0.05626072041166381,0.7060034305317324,0.0010291595197255575,0.2816466552315609,0.7183533447684392,0.045969125214408234
15570,,637,7765,8402,34,603,11578,3152,8426,11578,828,0.05501813784764208,0.6706685092416652,0.002936603903955778,0.2722404560373121,0.7277595439626878,0.0520815339436863
15571,,12,3752,3764,9,149,4880,1416,3464,4880,444,0.002459016393442623,0.7688524590163934,0.0018442622950819673,0.2901639344262295,0.7098360655737705,0.0305327868852459
15572,25.0,765,22785,23550,53,2008,31569,8387,23182,31569,2227,0.024232633279483037,0.7217523519908772,0.0016788621749184325,0.2656720200196395,0.7343279799803605,0.06360670277804174
15573,26.0,180,4743,4923,16,207,6680,1898,4782,6680,541,0.02694610778443114,0.7100299401197605,0.0023952095808383233,0.2841317365269461,0.7158682634730539,0.03098802395209581
15574,17.0,613,12842,13455,69,835,18142,5131,13011,18142,1273,0.03378899790541286,0.7078602138683717,0.0038033292911476132,0.2828243854040348,0.7171756145959651,0.04602579649432257
15575,,591,15186,15777,24,1154,21673,6042,15631,21673,1270,0.027268952152447744,0.7006874913486827,0.0011073686153278272,0.2787800489087805,0.7212199510912195,0.0532459742536797
15576,,85,1756,1841,2,97,2544,693,1851,2544,202,0.03341194968553459,0.690251572327044,0.0007861635220125787,0.27240566037735847,0.7275943396226415,0.03812893081761006
15577,14.0,141,4154,4295,7,286,5947,1720,4227,5947,295,0.023709433327728267,0.698503447116193,0.0011770640659155877,0.28922145619640155,0.7107785438035985,0.04809147469312258
15578,,452,10408,10860,50,465,14322,4113,10209,14322,1225,0.031559838011450916,0.7267141460689848,0.003491132523390588,0.28718056137410974,0.7128194386258903,0.032467532467532464
15579,15.0,1063,19034,20097,236,1143,27146,7653,19493,27146,2032,0.039158623738303984,0.7011714433065646,0.008693730199661092,0.28191998821189124,0.7180800117881088,0.04210565092462978
15580,15.0,474,4839,5313,23,849,7778,1962,5816,7778,293,0.060941115968115196,0.6221393674466443,0.002957058369760864,0.2522499357161224,0.7477500642838776,0.10915402417073798
15581,17.0,172,3906,4078,4,210,5353,1526,3827,5353,391,0.03213151503829628,0.7296842891836354,0.0007472445357743321,0.2850737903979077,0.7149262096020923,0.03923033812815244
15582,13.0,70,6331,6401,25,976,9361,2421,6940,9361,567,0.007477833564790087,0.676316632838372,0.002670654844567888,0.25862621514795425,0.7413737848520457,0.10426236513193035
15583,23.0,3326,76353,79679,206,4470,104599,30132,74482,104614,7410,0.03179306784942742,0.7298545127803162,0.0019691437092549755,0.2880302827537423,0.7119697172462577,0.04272850670082398
15584,23.0,527,6978,7505,72,661,10634,2798,7836,10634,671,0.04955802144066203,0.6561971036298665,0.006770735377092345,0.2631182997931164,0.7368817002068836,0.06215911228136167
15585,,83,2131,2214,16,62,2886,866,2020,2886,257,0.02875952875952876,0.7383922383922384,0.005544005544005544,0.30006930006930005,0.6999306999306999,0.021483021483021482
15586,,211,3312,3523,15,262,4846,1307,3539,4846,302,0.0435410647957078,0.6834502682624846,0.0030953363598844406,0.2697069748245976,0.7302930251754024,0.0540652084193149
15587,27.0,805,17307,18112,138,850,24828,6873,17955,24828,1522,0.032423070726599,0.6970758820686321,0.0055582406959884005,0.27682455292411795,0.7231754470758821,0.034235540518769134
15588,,136,2673,2809,8,159,4114,1168,2946,4114,263,0.03305785123966942,0.6497326203208557,0.0019445794846864365,0.28390860476421975,0.7160913952357802,0.038648517258142924
15589,36.0,1739,42990,44729,283,1906,58400,16940,41460,58400,3848,0.029777397260273973,0.7361301369863014,0.004845890410958904,0.29006849315068495,0.709931506849315,0.032636986301369866
15590,,222,4502,4724,43,168,6310,1817,4493,6310,526,0.03518225039619651,0.7134706814580032,0.006814580031695721,0.2879556259904913,0.7120443740095087,0.026624405705229795
15591,17.0,319,15122,15441,75,805,20634,5818,14816,20634,1665,0.015459920519530872,0.7328680818067268,0.003634777551613841,0.2819618106038577,0.7180381893961423,0.03901327905398856
15592,,4421,107856,112277,269,4476,144498,42804,101694,144498,9923,0.030595579177566473,0.7464186355520491,0.0018616174618333817,0.2962255532948553,0.7037744467051447,0.030976207283145787
15593,17.0,279,3895,4174,13,282,5694,1539,4155,5694,425,0.04899894625922023,0.6840533895328416,0.00228310502283105,0.2702845100105374,0.7297154899894626,0.04952581664910432
15594,17.0,513,7449,7962,52,884,10988,2946,8042,10988,598,0.04668729523116127,0.6779213687659265,0.004732435384055333,0.2681106661812887,0.7318893338187114,0.08045140152894066
15595,26.0,164,6200,6364,9,310,8277,2480,5797,8277,611,0.019813942249607346,0.7490636704119851,0.0010873504893077202,0.299625468164794,0.700374531835206,0.03745318352059925
15596,26.0,1409,37958,39367,579,1904,53458,14920,38538,53458,3801,0.02635714018481799,0.7100527516929178,0.010830932694825844,0.279097609338172,0.7209023906618279,0.03561674585656029
15597,,316,11082,11398,23,390,14815,4390,10425,14815,1228,0.02132973337833277,0.748025649679379,0.0015524805939925751,0.2963212959838002,0.7036787040161998,0.02632467094161323
15598,14.0,227,3061,3288,50,196,4342,1257,3085,4342,245,0.05228005527406725,0.7049746660525104,0.011515430677107323,0.28949792722247814,0.7105020727775219,0.04514048825426071
15599,14.0,116,1522,1638,11,95,2421,619,1802,2421,161,0.04791408508880628,0.6286658405617513,0.004543577034283354,0.2556794712928542,0.7443205287071458,0.039239983477901696
15600,35.0,610,12511,13121,22,730,17457,5031,12426,17457,1284,0.034943002806896946,0.7166752592083405,0.001260239445494644,0.28819384774016155,0.7118061522598385,0.04181703614595864
15601,15.0,860,10189,11049,56,390,14578,4159,10419,14578,1156,0.058993003155439705,0.6989298943613664,0.003841404856633283,0.2852929071203183,0.7147070928796817,0.026752640965838934
15602,16.0,926,18472,19398,182,1190,26311,7486,18825,26311,1897,0.03519440538177948,0.7020637756071605,0.006917258941127285,0.28451978260043326,0.7154802173995667,0.04522823153813994
15603,23.0,503,3235,3738,88,175,5120,1350,3770,5120,238,0.0982421875,0.6318359375,0.0171875,0.263671875,0.736328125,0.0341796875
15604,17.0,8063,135056,143119,2272,16359,207310,55065,152245,207310,12736,0.03889344459987459,0.6514688148183879,0.010959432733587382,0.26561670927596354,0.7343832907240365,0.07891080989822005
15605,,276,6383,6659,56,369,9211,2555,6656,9211,704,0.029964173271088915,0.6929757898165237,0.006079687330365867,0.2773857344479427,0.7226142655520573,0.04006079687330366
15606,16.0,1525,28804,30329,58,2216,41036,11575,29461,41036,3065,0.0371624914709036,0.7019202651330539,0.001413393118237645,0.28206940247587486,0.7179305975241251,0.0540013646554245
15607,,70,1351,1421,0,62,1924,540,1384,1924,163,0.036382536382536385,0.7021829521829522,0.0,0.2806652806652807,0.7193347193347194,0.032224532224532226
15608,,359,8485,8844,35,1043,12462,3410,9052,12462,766,0.02880757502808538,0.6808698443267533,0.0028085379553843687,0.2736318407960199,0.7263681592039801,0.08369443107045418
15609,,110,2335,2445,1,132,3260,914,2346,3260,286,0.03374233128834356,0.7162576687116564,0.00030674846625766873,0.2803680981595092,0.7196319018404908,0.04049079754601227
15610,,146,5633,5779,14,230,7529,2214,5315,7529,610,0.01939168548279984,0.7481737282507637,0.0018594766901314915,0.2940629565679373,0.7059370434320626,0.03054854562358879
15611,15.0,69,2098,2167,7,394,3214,812,2402,3214,237,0.021468574984443062,0.6527691350342253,0.0021779713752333543,0.2526446795270691,0.747355320472931,0.12258867454884878
15612,16.0,226,6048,6274,15,362,8427,2394,6033,8427,623,0.0268185593924291,0.7176931292274831,0.00177999288002848,0.2840868636525454,0.7159131363474546,0.04295716150468731
15613,17.0,56,1592,1648,1,86,2214,620,1594,2214,170,0.025293586269196026,0.7190605239385727,0.00045167118337850043,0.2800361336946703,0.7199638663053297,0.03884372177055104
15614,14.0,392,4445,4837,6,317,7654,1893,5761,7654,484,0.051215050953749675,0.5807420956362687,0.0007839038411288215,0.24732166187614318,0.7526783381238568,0.0414162529396394
15615,,83,2166,2249,24,62,2889,868,2021,2889,210,0.028729664243682937,0.7497403946002077,0.008307372793354102,0.30044998269297335,0.6995500173070267,0.021460713049498096
15616,17.0,953,16968,17921,117,854,25057,6838,18219,25057,1792,0.038033284112224126,0.6771760386319192,0.004669353873169174,0.27289779303188727,0.7271022069681127,0.034082292373388674
15617,23.0,123,7001,7124,9,174,9119,2855,6264,9119,817,0.01348832108783858,0.767737690536243,0.0009869503235003837,0.31308257484373286,0.6869174251562671,0.019081039587674088
15618,15.0,1002,20499,21501,94,1636,29071,8226,20845,29071,2089,0.034467338584844,0.7051357022462248,0.0032334629011729903,0.2829624023941385,0.7170375976058615,0.056276013897010764
15619,15.0,815,8125,8940,46,795,12402,3353,9049,12402,809,0.06571520722464119,0.6551362683438156,0.003709079180777294,0.27035961941622316,0.7296403805837768,0.0641025641025641
15620,17.0,193,3132,3325,10,283,4895,1202,3693,4895,257,0.039427987742594484,0.6398365679264556,0.0020429009193054137,0.24555669050051074,0.7544433094994892,0.05781409601634321
15621,15.0,139,3774,3913,0,167,5162,1508,3654,5162,421,0.026927547462223943,0.7311119721038357,0.0,0.29213483146067415,0.7078651685393258,0.03235180162727625
15622,24.0,151,3299,3454,18,242,4718,1285,3433,4718,308,0.032005086901229336,0.6992369648155998,0.0038151759220008477,0.27236116998728277,0.7276388300127172,0.05129292072912251
15623,24.0,842,10104,10946,658,654,17102,4118,12984,17102,832,0.049234007718395506,0.5908080926207461,0.03847503215998129,0.24079055081277043,0.7592094491872295,0.03824114138697229
15624,33.0,188,8240,8428,13,322,10609,3242,7367,10609,751,0.01772080309171458,0.7766990291262136,0.0012253746818738807,0.3055895937411632,0.6944104062588369,0.03035158827410689
15625,17.0,2689,65375,68064,177,5217,92647,25725,66922,92647,7581,0.029024145412155818,0.705635368657377,0.0019104774034777166,0.2776668429630749,0.7223331570369251,0.056310511943182186
15626,14.0,1688,19097,20785,320,1991,29117,7982,21135,29117,1750,0.05797300546072741,0.6558711405708005,0.010990143215303774,0.2741353848267335,0.7258646151732665,0.06837929731771818
15627,13.0,100,1656,1756,0,97,2367,665,1702,2367,173,0.04224757076468103,0.6996197718631179,0.0,0.2809463455851289,0.7190536544148711,0.0409801436417406
15628,,1288,30249,31537,105,1554,42218,11952,30266,42218,3523,0.030508313989293667,0.7164953337439007,0.002487090814344592,0.2831019944099673,0.7168980055900327,0.036808944052299966
15629,,365,11577,11942,62,291,15190,4618,10572,15190,1187,0.02402896642527979,0.7621461487820935,0.004081632653061225,0.30401579986833444,0.6959842001316656,0.019157340355497036
15630,13.0,166,6739,6905,23,248,9095,2620,6475,9095,791,0.018251786695986805,0.7409565695437054,0.0025288620120945573,0.2880703683342496,0.7119296316657504,0.027267729521715228
15631,,68,5387,5455,6,375,7344,2084,5260,7344,623,0.009259259259259259,0.7335239651416122,0.0008169934640522876,0.2837690631808279,0.7162309368191722,0.05106209150326797
15632,,203,7581,7784,23,397,10389,3000,7389,10389,798,0.01953989796900568,0.7297141207045914,0.0022138800654538456,0.28876696505919724,0.7112330349408028,0.038213495042833764
15633,26.0,299,7986,8285,21,387,11188,3156,8032,11188,879,0.02672506256703611,0.7138005005362889,0.0018770110833035395,0.2820879513764748,0.7179120486235252,0.03459063282087951
15634,14.0,2007,15508,17515,62,1028,23295,6510,16785,23295,1492,0.08615582743077914,0.665722257995278,0.00266151534664091,0.27945911139729557,0.7205408886027045,0.04412964155398154
15635,,20,6227,6247,23,484,8692,2328,6364,8692,698,0.002300966405890474,0.716405890473999,0.002646111366774045,0.26783248964565115,0.7321675103543488,0.05568338702254947
15636,,3126,77444,80570,326,2997,104191,30652,73539,104191,7512,0.03000259139465021,0.743288767743855,0.0031288690961791326,0.2941904771045484,0.7058095228954516,0.02876448061732779
15637,15.0,412,6682,7094,163,589,9838,2656,7182,9838,714,0.04187843057532019,0.6792030900589551,0.016568408213051434,0.26997357186420007,0.7300264281358,0.05986989225452328
15638,27.0,1909,30293,32202,1691,2584,46163,11443,34720,46163,2960,0.041353464896128934,0.6562181833936269,0.03663106817147933,0.24788250330351147,0.7521174966964885,0.05597556484630548
15639,14.0,754,1758,2512,8,235,3390,954,2436,3390,89,0.2224188790560472,0.5185840707964602,0.002359882005899705,0.2814159292035398,0.7185840707964601,0.06932153392330384
15640,38.0,1305,23092,24397,174,1255,32547,9178,23369,32547,1969,0.040095861369711494,0.7094970350569945,0.005346114849294866,0.28199219590131197,0.718007804098688,0.03855962147048883
15641,26.0,703,16205,16908,31,988,23551,6496,17055,23551,1788,0.029850112521761285,0.6880811855122925,0.0013162923018130864,0.27582692879283255,0.7241730712071675,0.041951509490042886
15642,17.0,372,3043,3415,15,269,4835,1314,3521,4835,301,0.07693898655635988,0.629369183040331,0.0031023784901758012,0.2717683557394002,0.7282316442605998,0.05563598759048604
15643,16.0,274,22132,22406,90,2481,30396,8408,21988,30396,1989,0.009014343992630609,0.7281221213317541,0.002960915909988156,0.2766153441242269,0.7233846558757732,0.08162258191867351
15644,15.0,6156,103112,109268,613,6913,150132,42142,107990,150132,10134,0.04100391655343298,0.6868089414648443,0.004083073561932166,0.2806996509738097,0.7193003490261903,0.046046146058135506
15645,40.0,519,14004,14523,170,750,19357,5598,13759,19357,1337,0.026812005992664152,0.7234592137211344,0.008782352637288836,0.2891977062561347,0.7108022937438653,0.03874567339980369
15646,27.0,371,3900,4271,19,203,5705,1648,4057,5705,310,0.06503067484662577,0.6836108676599474,0.0033304119193689747,0.28886941279579315,0.7111305872042069,0.03558282208588957
15647,,601,12590,13191,118,610,17076,5133,11943,17076,1116,0.035195596158350904,0.7372921058795971,0.006910283438744436,0.300597329585383,0.699402670414617,0.03572265167486531
15648,,59,2078,2137,3,135,2803,774,2029,2803,212,0.02104887620406707,0.7413485551195148,0.0010702818408847663,0.2761327149482697,0.7238672850517303,0.04816268283981449
15649,,364,5072,5436,64,394,7405,1988,5417,7405,451,0.04915597569209993,0.6849426063470628,0.00864280891289669,0.2684672518568535,0.7315327481431465,0.053207292370020254
15650,13.0,36,1508,1544,0,8,2018,566,1452,2018,212,0.017839444995044598,0.7472745292368682,0.0,0.2804757185332012,0.7195242814667988,0.003964321110009911
15651,37.0,106,2791,2897,23,131,3894,1096,2798,3894,316,0.027221366204417053,0.716743708269132,0.005906522855675398,0.2814586543400103,0.7185413456599897,0.03364149974319466
15652,16.0,872,20830,21702,380,2708,31817,7990,23827,31817,2050,0.027406732250055,0.6546814595970708,0.011943300751170758,0.2511236131627746,0.7488763868372253,0.08511173272150109
15653,27.0,457,11612,12069,29,494,16378,4632,11746,16378,1299,0.027903284894370498,0.7089998778849677,0.0017706679692270119,0.28281841494688,0.71718158505312,0.030162412993039442
15654,35.0,134,3840,3974,14,174,5278,1520,3758,5278,391,0.025388404698749527,0.7275483137552103,0.002652519893899204,0.28798787419477073,0.7120121258052292,0.03296703296703297
15655,17.0,563,7783,8346,31,501,11686,3219,8467,11686,900,0.048177306178333046,0.6660106109875065,0.002652746876604484,0.275457812767414,0.724542187232586,0.04287181242512408
15656,36.0,824,10701,11525,38,318,15420,4489,10931,15420,1542,0.053437094682230867,0.6939688715953307,0.002464332036316472,0.29111543450064853,0.7088845654993515,0.020622568093385214
15657,23.0,132,2701,2833,5,128,3881,1112,2769,3881,340,0.03401185261530534,0.6959546508631796,0.0012883277505797476,0.28652409172893584,0.7134759082710641,0.03298119041484154
15658,,111,2134,2245,53,157,3173,826,2347,3173,198,0.03498266624645446,0.6725496375669713,0.01670343523479357,0.2603214623384809,0.739678537661519,0.04947998739363379
15659,,309,7713,8022,16,575,10939,3075,7864,10939,791,0.02824755462108054,0.7050918731145442,0.0014626565499588629,0.28110430569521894,0.7188956943047811,0.05256421976414663
15660,23.0,1073,7480,8553,15,428,11238,3312,7926,11238,710,0.09547962270866703,0.6655988610072967,0.0013347570742124934,0.2947143619861185,0.7052856380138814,0.03808506851752981
15661,,131,2905,3036,5,132,4033,1147,2886,4033,278,0.03248202330771138,0.7203074634267295,0.001239771881973717,0.28440366972477066,0.7155963302752294,0.032729977684106126
15662,15.0,82,2092,2174,10,104,2898,827,2071,2898,206,0.028295376121463076,0.7218771566597654,0.003450655624568668,0.28536922015182886,0.7146307798481711,0.035886818495514144
15663,,2961,88493,91454,234,3789,120371,34803,85568,120371,9119,0.0245989482516553,0.7351687698864344,0.0019439898314378048,0.2891311030065381,0.7108688969934619,0.0314776815013583
15664,23.0,2972,58337,61309,586,4824,84789,22819,61970,84789,5511,0.035051716614183444,0.6880255693545153,0.00691127386807251,0.26912689145997715,0.7308731085400229,0.05689417259314298
15665,,2168,40739,42907,71,1995,58728,15997,42731,58728,4411,0.036915951505244515,0.6936895518321754,0.0012089633564909413,0.2723913635744449,0.7276086364255551,0.033970167552104615
15666,27.0,66,890,973,3,48,1534,348,1192,1540,89,0.04285714285714286,0.577922077922078,0.001948051948051948,0.22597402597402597,0.7740259740259741,0.03116883116883117
15667,,55,1980,2035,13,104,2708,786,1922,2708,207,0.02031019202363368,0.7311669128508124,0.0048005908419497785,0.2902511078286558,0.7097488921713442,0.03840472673559823
15668,,74,1643,1717,0,82,2389,626,1763,2389,184,0.03097530347425701,0.6877354541649225,0.0,0.26203432398493093,0.737965676015069,0.03432398493093344
15669,24.0,243,11552,11795,3,457,15374,4663,10711,15374,1090,0.015805906075191882,0.7513984649408092,0.00019513464290360347,0.30330427995316767,0.6966957200468323,0.029725510602315597
15670,,156,2900,3056,49,126,4314,1125,3189,4314,297,0.03616133518776078,0.6722299490032453,0.011358368103847936,0.260778859527121,0.739221140472879,0.02920723226703755
15671,13.0,2085,13221,15306,77,480,19923,5909,14014,19923,1204,0.10465291371781359,0.6636048787833158,0.0038648797871806456,0.29659187873312254,0.7034081212668775,0.024092757114892335
15672,,342,7824,8166,48,540,11427,3068,8359,11427,851,0.029929115253347335,0.6846941454449987,0.00420057757941717,0.2684869169510808,0.7315130830489193,0.04725649776844316
15673,38.0,145,5149,5294,3,241,6984,1993,4991,6984,567,0.020761741122565864,0.7372565864833907,0.000429553264604811,0.2853665521191294,0.7146334478808706,0.03450744558991982
15674,16.0,446,9485,9931,126,1091,15007,3766,11241,15007,888,0.029719464250016658,0.6320383820883587,0.008396081828480043,0.25094955687345905,0.7490504431265409,0.0726994069434264
15675,24.0,113,2354,2467,117,255,3573,920,2653,3573,177,0.03162608452280996,0.6588301147495103,0.0327455919395466,0.25748670584942623,0.7425132941505738,0.07136859781696053
15676,,864,9792,10656,44,825,14233,3901,10332,14233,964,0.060703997751703785,0.6879786411859763,0.003091407292910841,0.27408136021920887,0.7259186397807911,0.057963886742078266
15677,37.0,2207,42073,44280,150,3544,59927,16647,43280,59927,4089,0.036828140904767465,0.702070852870993,0.0025030453718691073,0.2777879753700335,0.7222120246299665,0.05913861865269411
15678,35.0,207,4092,4299,6,323,5909,1517,4392,5909,338,0.03503130817397191,0.6925029615840244,0.001015400236926722,0.2567270265696395,0.7432729734303605,0.05466237942122187
15679,,507,11720,12227,367,617,16873,4711,12162,16873,1210,0.030048005689563208,0.6946008415812245,0.02175072601197179,0.27920346115095124,0.7207965388490488,0.03656729686481361
15680,,140,3999,4139,25,284,5878,1620,4258,5878,395,0.023817625042531473,0.6803334467505955,0.004253147329023477,0.2756039469207213,0.7243960530792787,0.048315753657706705
15681,25.0,533,10462,11026,134,1076,15233,4180,11053,15233,991,0.03498982472264164,0.6867983982144029,0.008796691393684764,0.2744042539224053,0.7255957460775947,0.07063611895227467
15682,16.0,785,36768,37553,29,1503,48692,14404,34288,48692,3665,0.0161217448451491,0.7551137763903721,0.0005955803828144254,0.29581861496755113,0.7041813850324489,0.03086749363345108
15683,15.0,179,4302,4481,0,64,5625,1623,4002,5625,334,0.031822222222222224,0.7648,0.0,0.2885333333333333,0.7114666666666667,0.011377777777777778
15684,15.0,3094,101300,104394,439,13981,146746,38618,108128,146746,9236,0.021084049991141156,0.6903084240797024,0.002991563654205225,0.2631621986289234,0.7368378013710766,0.09527346571627165
15685,33.0,48,3030,3078,2,100,3882,1213,2669,3882,297,0.012364760432766615,0.7805255023183926,0.0005151983513652757,0.31246780010303965,0.6875321998969603,0.02575991756826378
15686,,227,9287,9514,0,290,12121,3741,8380,12121,975,0.0187278277369854,0.766190908340896,0.0,0.30863790116327033,0.6913620988367296,0.023925418694827158
15687,14.0,433,4987,5420,33,531,7720,1938,5782,7720,535,0.056088082901554405,0.6459844559585493,0.00427461139896373,0.2510362694300518,0.7489637305699481,0.06878238341968912
15688,26.0,1016,23134,24150,176,1410,31822,9096,22726,31822,2106,0.0319275972597574,0.7269813336685312,0.005530764879643014,0.2858399849160958,0.7141600150839043,0.044308968638049145
15689,24.0,628,15921,16549,53,862,22126,6053,16073,22126,1662,0.02838289794811534,0.7195606978215674,0.002395371960589352,0.27356955617825185,0.7264304438217482,0.038958691132604174
15690,,76,2349,2431,29,86,3274,914,2360,3274,277,0.023213194868662187,0.7174709835064141,0.00885766646304215,0.27916921197312156,0.7208307880268784,0.02626756261453879
15691,17.0,28446,551846,580292,3423,35999,783101,222790,560311,783101,60747,0.036324816339143993,0.7046932643426582,0.004371083678861348,0.28449714660050235,0.7155028533994976,0.04596980466121228
15692,16.0,111,1650,1761,11,81,2422,652,1770,2422,213,0.0458298926507019,0.6812551610239471,0.004541701073492981,0.26919900908340216,0.7308009909165979,0.03344343517753923
15693,,659,16931,17590,67,843,23040,6665,16375,23040,1787,0.028602430555555555,0.7348524305555556,0.002907986111111111,0.2892795138888889,0.7107204861111112,0.03658854166666667
15694,,308,7068,7376,14,309,9654,2798,6856,9654,757,0.03190387404184794,0.7321317588564326,0.00145017609281127,0.28982805054899524,0.7101719494510048,0.032007458048477315
15695,16.0,144,1836,1980,8,72,2637,765,1872,2637,197,0.05460750853242321,0.6962457337883959,0.0030337504740235114,0.2901023890784983,0.7098976109215017,0.027303754266211604
15696,16.0,138,1588,1726,0,54,2278,697,1581,2278,152,0.06057945566286216,0.6971027216856892,0.0,0.30597014925373134,0.6940298507462687,0.02370500438981563
15697,,719,16924,17643,47,1306,23982,6812,17170,23982,1522,0.02998081894754399,0.7056959386206322,0.001959803185722625,0.2840463681094154,0.7159536318905846,0.05445750979901593
15698,13.0,330,9570,9904,114,863,14047,3809,10238,14047,742,0.023492560689115115,0.6812842599843383,0.008115611874421585,0.27116110201466503,0.728838897985335,0.06143660568092831
15699,16.0,228,3338,3566,13,247,4939,1329,3610,4939,315,0.046163190929337926,0.6758453128163596,0.0026321117635148814,0.26908281028548287,0.7309171897145171,0.05001012350678275
15700,,9549,190492,200041,1235,10993,271414,75508,195906,271414,18864,0.035182415055966164,0.7018503098587398,0.004550244276271673,0.2782023034920822,0.7217976965079178,0.0405027006712992
15701,14.0,90,4789,4879,23,236,6237,1874,4363,6237,356,0.01443001443001443,0.7678371011704345,0.003687670354337021,0.3004649671316338,0.6995350328683662,0.03783870450537117
15702,25.0,6301,173004,179305,1673,8685,236731,67632,169099,236731,15812,0.02661670841588132,0.7308041616856263,0.007067093029641238,0.28569135432199416,0.7143086456780058,0.036687210378024
15703,17.0,172,5691,5863,3,216,7632,2240,5392,7632,656,0.022536687631027254,0.7456761006289309,0.00039308176100628933,0.29350104821802936,0.7064989517819706,0.02830188679245283
15704,,112,2816,2928,14,121,3830,1126,2704,3830,274,0.029242819843342035,0.7352480417754569,0.0036553524804177544,0.2939947780678851,0.7060052219321149,0.03159268929503917
15705,16.0,176,3043,3219,9,543,4600,1160,3440,4600,200,0.03826086956521739,0.6615217391304348,0.001956521739130435,0.25217391304347825,0.7478260869565218,0.11804347826086957
15706,,115,2535,2650,2,102,3451,1014,2437,3451,280,0.03332367429730513,0.7345696899449435,0.0005795421616922632,0.2938278759779774,0.7061721240220226,0.029556650246305417
15707,15.0,173,4499,4672,13,224,6250,1705,4545,6250,453,0.02768,0.71984,0.00208,0.2728,0.7272,0.03584
15708,,751,28707,29458,27,1212,38001,11012,26989,38001,2665,0.019762637825320388,0.7554274887502961,0.0007105076182205731,0.28978184784610933,0.7102181521538907,0.031893897529012394
15709,,832,13091,13923,157,638,18864,5221,13643,18864,1072,0.04410517387616624,0.6939673452078032,0.00832273112807464,0.27677056827820185,0.7232294317217981,0.033821034775233245
15710,26.0,3123,70388,73511,517,3224,95496,28028,67486,95514,6315,0.03269677743576858,0.7369390874636179,0.005412819063173985,0.29344389304185775,0.7065561069581423,0.033754214041920555
15711,13.0,321,6112,6433,38,240,8507,2414,6093,8507,701,0.037733631127306926,0.7184671447043611,0.0044669096038556485,0.2837663100975667,0.7162336899024333,0.02821206065593041
15712,16.0,832,19730,20562,43,1216,27875,7790,20085,27875,1967,0.029847533632286996,0.7078026905829596,0.0015426008968609866,0.27946188340807177,0.7205381165919282,0.04362331838565022
15713,15.0,77,3780,3857,54,415,5466,1450,4016,5466,321,0.014087083790706183,0.6915477497255763,0.009879253567508232,0.26527625320160997,0.73472374679839,0.07592389315770216
15714,26.0,1085,20542,21627,223,1464,29839,7878,21961,29839,1566,0.03636180837159422,0.6884278963772245,0.007473440798954388,0.2640168906464694,0.7359831093535306,0.04906330641107276
15715,25.0,252,3065,3394,35,175,4942,1139,3827,4966,260,0.05074506645187273,0.617196939186468,0.007047925896093436,0.2293596455900121,0.7706403544099879,0.035239629480467174
15716,17.0,503,6020,6523,3,404,9118,2495,6623,9118,627,0.0551656064926519,0.6602325071287563,0.0003290195218249616,0.2736345689844264,0.7263654310155736,0.04430796227242816
15717,,547,8348,8895,41,554,11846,3401,8445,11846,802,0.04617592436265406,0.7047104507850751,0.0034610839101806515,0.2871011311835219,0.7128988688164781,0.04676684112780685
15718,24.0,2212,58724,60936,259,3053,80561,23547,57014,80561,6140,0.027457454599620165,0.7289383200307842,0.003214955127170715,0.292287831581038,0.707712168418962,0.03789674904730577
15719,25.0,472,11154,11626,103,1089,16324,4283,12041,16324,1378,0.028914481744670425,0.683288409703504,0.006309728007841215,0.2623744180347954,0.7376255819652046,0.06671159029649595
15720,,167,5842,6009,23,308,7829,2291,5538,7829,547,0.021330949035636735,0.7462000255460467,0.0029377953761655384,0.2926299655128369,0.7073700344871631,0.03934091199386895
15721,24.0,98,3563,3661,16,260,5047,1395,3652,5047,398,0.019417475728155338,0.7059639389736477,0.0031702001188825043,0.27640182286506837,0.7235981771349317,0.0515157519318407
15722,15.0,293,39672,39965,693,1532,53635,14583,39052,53635,3206,0.005462850750442808,0.7396662627015941,0.012920667474596812,0.2718933532208446,0.7281066467791554,0.028563438053509835
15723,17.0,142,3171,3313,10,306,4473,1134,3339,4473,282,0.031746031746031744,0.7089201877934272,0.0022356360384529397,0.2535211267605634,0.7464788732394366,0.06841046277665996
15724,17.0,1153,37885,39038,451,2436,54011,14844,39167,54011,4602,0.021347503286367593,0.7014311899427894,0.008350150895188018,0.2748329044083613,0.7251670955916387,0.045101923682212886
15725,,104,9447,9551,46,544,12827,3664,9163,12827,989,0.008107897403913619,0.7364933343728074,0.0035861853901925627,0.28564746238403366,0.7143525376159663,0.04241054026662509
15726,17.0,165,2896,3061,10,224,4491,1149,3342,4491,250,0.03674014696058784,0.6448452460476508,0.00222667557336896,0.2558450233800935,0.7441549766199065,0.04987753284346471
15727,23.0,1064,20743,21807,36,959,28139,8463,19676,28139,1988,0.03781228899392303,0.73716194605352,0.0012793631614485233,0.30075695653719037,0.6992430434628096,0.034080813106364835
15728,26.0,29978,430806,460784,4373,21841,606324,173385,432939,606324,34384,0.04944221241448467,0.7105211075266689,0.007212315527671674,0.2859609713618461,0.7140390286381538,0.036021994841042085
15729,,87,2073,2160,2,86,2780,817,1963,2780,167,0.031294964028776975,0.74568345323741,0.0007194244604316547,0.29388489208633095,0.706115107913669,0.03093525179856115
15730,,286,6037,6323,1,481,8271,2387,5884,8271,436,0.03457864828920324,0.7298996493773425,0.00012090436464756378,0.28859871841373474,0.7114012815862653,0.05815499939547818
15731,16.0,1383,26754,28137,21,1667,38711,10936,27775,38711,2872,0.03572627935212214,0.6911213866859549,0.0005424814652166051,0.28250368112422825,0.7174963188757717,0.043062695357908604
15732,16.0,383,10522,10905,77,724,14872,4153,10719,14872,983,0.025753093060785368,0.7075040344271114,0.005177514792899409,0.27924959655728887,0.7207504034427111,0.0486820871436256
15733,,118,2730,2848,15,118,3731,1099,2632,3731,263,0.031626909675690165,0.7317073170731707,0.004020369874028411,0.2945590994371482,0.7054409005628518,0.031626909675690165
15734,,274,9644,9918,37,276,12617,3840,8777,12617,998,0.02171673139415075,0.764365538559087,0.002932551319648094,0.30435127209320756,0.6956487279067924,0.021875247681699295
15735,15.0,4816,97034,101850,524,4736,135543,38907,96636,135543,11539,0.03553115985333068,0.7158908980913806,0.0038659318445069092,0.287045439454638,0.712954560545362,0.03494094125111588
15736,36.0,6,6450,6456,13,291,8417,2408,6009,8417,622,0.0007128430557205655,0.766306284899608,0.0015444932873945585,0.28608767969585364,0.7139123203041464,0.03457288820244743
15737,13.0,76,1576,1652,11,84,2486,653,1833,2486,134,0.030571198712791632,0.6339501206757844,0.004424778761061947,0.26267095736122287,0.7373290426387772,0.03378921962992759
15738,,724,16776,17500,73,809,22952,6372,16580,22952,1627,0.03154409201812478,0.7309166957127919,0.003180550714534681,0.27762286510979434,0.7223771348902056,0.03524747298710352
15739,,329,8975,9304,115,479,12362,3515,8847,12362,914,0.026613816534541337,0.7260152078951626,0.009302701828183142,0.2843391037049021,0.7156608962950979,0.038747775440867174
15740,17.0,554,12353,12907,75,1350,18024,4923,13101,18024,1234,0.030736795383932536,0.685363959165557,0.004161118508655127,0.2731358189081225,0.7268641810918774,0.07490013315579228
15741,17.0,28,1852,1880,5,169,2610,687,1923,2610,151,0.010727969348659003,0.7095785440613027,0.0019157088122605363,0.2632183908045977,0.7367816091954023,0.06475095785440613
15742,25.0,1607,31288,32895,93,1791,43953,12273,31680,43953,2767,0.03656178190339681,0.7118512957022274,0.002115896525834414,0.27923008668350285,0.7207699133164972,0.04074807180397243
15743,,1994,34780,36774,139,2751,50403,14154,36249,50403,3567,0.03956113723389481,0.6900382913715454,0.0027577723548201497,0.2808166180584489,0.7191833819415511,0.054580084518778646
15744,,60,6383,6443,20,319,8569,2508,6061,8569,752,0.00700198389543704,0.7448943867429105,0.0023339946318123466,0.2926829268292683,0.7073170731707317,0.037227214377406934
15745,24.0,66,5416,5482,19,343,7270,2150,5120,7270,583,0.009078404401650619,0.7449793672627235,0.0026134800550206326,0.29573590096286106,0.7042640990371389,0.04718019257221458
15746,26.0,6084,80305,86389,774,4973,117159,32345,84814,117159,7136,0.05192942923719048,0.685436031376164,0.006606406678104115,0.27607780878976435,0.7239221912102357,0.04244658967727618
15747,27.0,705,21496,22201,81,789,28678,8500,20178,28678,2092,0.02458330427505405,0.749564125810726,0.0028244647464955716,0.2963944487063254,0.7036055512936746,0.02751237882697538
15748,24.0,114,5296,5410,13,238,7127,2082,5045,7127,484,0.015995510032271645,0.7430896590430757,0.001824049389645012,0.29212852532622424,0.7078714746737758,0.033394134979654835
15749,16.0,563,3784,4347,37,280,5913,1670,4243,5913,382,0.0952139353965838,0.6399458819550143,0.006257398951462878,0.2824285472687299,0.7175714527312701,0.04735328936242178
15750,,224,4273,4497,46,256,6465,1781,4684,6465,484,0.03464810518174787,0.6609435421500387,0.00711523588553751,0.2754833720030936,0.7245166279969064,0.03959783449342614
15751,16.0,12589,24530,37119,219,4626,53169,13810,39359,53169,1620,0.2367733077545186,0.4613590626116722,0.004118941488461322,0.2597378171490906,0.7402621828509094,0.08700558596174462
15752,26.0,239,6751,6990,33,327,9426,2642,6784,9426,767,0.025355399957564185,0.7162104816465097,0.003500954805856143,0.2802885635476342,0.7197114364523658,0.034691279439847234
15753,,793,12651,13444,50,1066,18949,5105,13844,18949,1256,0.04184917409889704,0.6676341759459602,0.00263866167080057,0.2694073565887382,0.7305926434112618,0.05625626682146815
15754,,1200,15620,16820,90,1255,22998,6522,16476,22998,1746,0.05217845030002609,0.679189494738673,0.003913383772501957,0.2835898773806418,0.7164101226193582,0.05456996260544395
15755,13.0,492,1529,2021,4,119,2780,763,2017,2780,160,0.17697841726618704,0.55,0.0014388489208633094,0.27446043165467626,0.7255395683453237,0.04280575539568345
15756,,1279,35093,36372,262,1581,48532,14010,34522,48532,3430,0.026353745982032474,0.7230899200527487,0.005398499958790077,0.2886755130635457,0.7113244869364543,0.032576444407813404
15757,15.0,432,8990,9422,10,648,12601,3544,9057,12601,868,0.03428299341322117,0.7134354416316165,0.0007935878104912309,0.2812475200380922,0.7187524799619078,0.05142449011983176
15758,16.0,63,1548,1611,4,97,2167,584,1583,2167,145,0.029072450392247345,0.7143516382095062,0.0018458698661744347,0.26949700046146746,0.7305029995385325,0.04476234425473004
15759,,82,2709,2791,0,152,3626,1064,2562,3626,234,0.022614451185879757,0.747104247104247,0.0,0.29343629343629346,0.7065637065637066,0.041919470490899065
15760,36.0,601,20781,21382,437,1091,29227,8041,21186,29227,2296,0.020563177883463922,0.71102063160776,0.014951928011769939,0.2751223184042153,0.7248776815957847,0.03732849762206179
15761,,126,2946,3072,12,139,3933,1161,2772,3933,212,0.032036613272311214,0.7490465293668955,0.0030511060259344014,0.2951945080091533,0.7048054919908466,0.03534197813374015
15762,,442,19030,19472,88,552,25818,7396,18422,25818,2205,0.017119838872104734,0.7370826555116585,0.003408474707568363,0.28646680610426833,0.7135331938957317,0.021380432256565187
15763,24.0,5,1799,1804,8,186,2548,686,1862,2548,184,0.0019623233908948193,0.7060439560439561,0.0031397174254317113,0.2692307692307692,0.7307692307692307,0.07299843014128729
15764,,60144,1125148,1185292,4741,50250,1569839,451577,1118262,1569839,115088,0.0383122090864095,0.7167282759569612,0.003020054922829666,0.2876581611235292,0.7123418388764707,0.032009651945199474
15765,,134,5724,5858,54,534,8240,2166,6074,8240,528,0.016262135922330098,0.6946601941747573,0.006553398058252427,0.26286407766990294,0.7371359223300971,0.06480582524271844
15766,26.0,93,3107,3200,10,141,4191,1220,2971,4191,307,0.02219040801717967,0.7413505130040563,0.0023860653781913625,0.29109997613934624,0.7089000238606538,0.03364352183249821
15767,40.0,104,2087,2191,10,197,3060,833,2227,3060,239,0.03398692810457516,0.6820261437908497,0.0032679738562091504,0.2722222222222222,0.7277777777777777,0.06437908496732025
15768,17.0,109,3143,3252,6,101,4284,1237,3047,4284,384,0.025443510737628384,0.7336601307189542,0.0014005602240896359,0.2887488328664799,0.7112511671335201,0.02357609710550887
15769,23.0,684,12743,13427,99,721,18544,5041,13503,18544,1240,0.036885245901639344,0.6871764452113891,0.005338654012079379,0.2718399482312338,0.7281600517687662,0.03888050043140639
15770,,236,4595,4831,12,190,6312,1835,4477,6312,500,0.037389100126742715,0.72797845373891,0.0019011406844106464,0.2907160963244613,0.7092839036755386,0.030101394169835233
15771,,1043,8202,9245,14,665,12618,3483,9135,12618,890,0.08265969250277382,0.6500237755587256,0.0011095260738627358,0.2760342368045649,0.723965763195435,0.05270248850847995
15772,,173,3388,3561,6,245,4809,1358,3451,4809,319,0.035974215013516324,0.7045123726346434,0.0012476606363069245,0.2823871906841339,0.7176128093158661,0.050946142649199416
15773,24.0,163,3617,3780,44,252,5109,1498,3611,5109,360,0.031904482286161676,0.7079663339205324,0.008612252887062048,0.2932080642004306,0.7067919357995693,0.04932472108044627
15774,17.0,702,12035,12737,146,592,16742,4859,11883,16742,1251,0.04193047425636125,0.7188507944092701,0.008720582964998207,0.29022816867757734,0.7097718313224226,0.03536017202245849
15775,25.0,120,2045,2165,24,116,2917,801,2116,2917,222,0.0411381556393555,0.70106273568735,0.0082276311278711,0.27459718889269796,0.725402811107302,0.03976688378471032
15776,,218,4466,4684,46,250,6101,1808,4293,6101,415,0.03573184723815768,0.7320111457138174,0.0075397475823635466,0.29634486149811506,0.703655138501885,0.0409768890345845
15777,,108,3127,3235,41,123,4053,1245,2808,4053,233,0.026646928201332347,0.771527263755243,0.010115963483839132,0.30717986676535897,0.692820133234641,0.030347890451517395
15778,,7442,161390,168832,641,6465,218155,63753,154402,218155,15247,0.03411335976713804,0.7397950998143522,0.0029382778299832687,0.29223717081891315,0.7077628291810868,0.029634892622218148
15779,27.0,38289,671674,709978,4855,29598,907263,275704,631795,907499,54885,0.042191782029511876,0.7401374546969198,0.005349868154124688,0.3038063953789481,0.696193604621052,0.03261491197235479
15780,27.0,193,5050,5243,4,202,6800,1987,4813,6800,529,0.02838235294117647,0.7426470588235294,0.000588235294117647,0.2922058823529412,0.7077941176470588,0.029705882352941176
15781,16.0,40,1704,1746,6,51,2346,679,1667,2346,184,0.017050298380221655,0.7263427109974424,0.0025575447570332483,0.2894288150042626,0.7105711849957375,0.021739130434782608
15782,23.0,55,5778,5833,23,361,8022,2249,5773,8022,653,0.006856145599601097,0.7202692595362753,0.0028671154325604587,0.2803540264273249,0.7196459735726751,0.0450012465719272
15783,,672,21165,21837,41,1655,29110,7868,21242,29110,2229,0.023084850566815526,0.7270697354860872,0.0014084507042253522,0.27028512538646515,0.7297148746135349,0.05685331501202336
15784,24.0,202,7058,7260,37,290,9972,2739,7233,9972,848,0.020256718812675493,0.7077817890092258,0.0037103890894504615,0.2746690734055355,0.7253309265944645,0.02908142799839551
15785,,1987,56979,58966,502,2513,77468,22511,54957,77468,6413,0.02564930035627614,0.7355166004027469,0.00648009500697062,0.29058449940620645,0.7094155005937935,0.03243920070222543
15786,,503,21337,21840,48,795,29004,8549,20455,29004,2370,0.017342435526134327,0.7356571507378292,0.0016549441456350847,0.2947524479382154,0.7052475520617846,0.027410012412081092
15787,16.0,88,2461,2549,1,151,3501,961,2540,3501,269,0.025135675521279634,0.7029420165666952,0.00028563267637817766,0.2744930019994287,0.7255069980005713,0.043130534133104824
15788,15.0,2058,42466,44524,296,2069,59269,16983,42286,59269,4569,0.034723042399905514,0.7164959759739493,0.004994179081813427,0.28654102481904536,0.7134589751809546,0.03490863689281074
15789,24.0,1055,22851,23906,144,1339,31872,8938,22934,31872,2324,0.0331011546184739,0.7169615963855421,0.004518072289156626,0.2804342369477912,0.7195657630522089,0.04201179718875502
15790,24.0,67,1797,1864,6,134,2588,716,1872,2588,187,0.0258887171561051,0.6943585780525502,0.00231839258114374,0.27666151468315303,0.723338485316847,0.0517774343122102
15791,,918,26532,27450,109,1250,36291,10289,26002,36291,3082,0.025295527816814087,0.7310903529800777,0.0030034994902317378,0.2835138188531592,0.7164861811468408,0.03444380149348323
15792,13.0,646,4638,5285,48,664,7898,2081,5817,7898,500,0.08179285895163332,0.5872372752595594,0.00607748797163839,0.26348442643707265,0.7365155735629273,0.08407191694099772
15793,17.0,21,1542,1563,6,109,2260,594,1666,2260,177,0.009292035398230088,0.6823008849557523,0.002654867256637168,0.2628318584070796,0.7371681415929203,0.048230088495575224
15794,23.0,86,4159,4245,4,224,5609,1615,3994,5609,446,0.015332501337136744,0.7414868960599037,0.0007131395970761277,0.28793011231948656,0.7120698876805135,0.03993581743626315
15795,25.0,12754,207844,220598,675,14093,296144,83296,212848,296144,19188,0.043066886379599115,0.7018342428007996,0.0022792965584310337,0.2812685720460317,0.7187314279539684,0.04758833540439786
15796,17.0,1560,42017,43577,453,2268,57529,16562,40967,57529,4619,0.027116758504406473,0.7303620782561838,0.007874289488779572,0.28788958612178206,0.7121104138782179,0.03942359505640634
15797,36.0,200,9368,9568,8,461,12426,3531,8895,12426,953,0.016095284081764045,0.7539031063898278,0.0006438113632705617,0.28416224046354416,0.7158377595364558,0.03709962980846612
15798,,15222,315662,330884,1103,33234,465012,131701,333311,465012,22835,0.032734639106087586,0.6788254926754579,0.0023719817983191833,0.28322064806929714,0.7167793519307029,0.07146912337746122
15799,,104,2585,2689,8,135,3533,997,2536,3533,259,0.02943673931502972,0.7316727993206906,0.0022643645626945937,0.28219643362581376,0.7178035663741863,0.038211151995471274
15800,24.0,117,3379,3496,5,172,4651,1357,3294,4651,324,0.025155880455815953,0.7265104278649753,0.0010750376263169211,0.2917652117824124,0.7082347882175876,0.03698129434530208
15801,17.0,253,6779,7032,6,397,9463,2617,6846,9463,745,0.02673570749233858,0.7163690161682342,0.0006340483990277925,0.2765507767092888,0.7234492232907112,0.041952869069005604
15802,27.0,80,3283,3363,2,164,4362,1286,3076,4362,304,0.018340210912425492,0.7526364053186612,0.0004585052728106373,0.2948188904172398,0.7051811095827603,0.03759743237047226
15803,39.0,232,6054,6286,13,164,8268,2386,5882,8268,652,0.028059990324141266,0.7322206095791002,0.0015723270440251573,0.28858248669569425,0.7114175133043058,0.01983551040154814
15804,,267,10489,10756,95,354,14493,4326,10167,14493,995,0.018422686814324157,0.7237286966121576,0.006554888566894363,0.2984889256882633,0.7015110743117366,0.024425584765058996
15805,25.0,730,12838,13568,103,1012,18516,5255,13261,18516,1202,0.03942536184921149,0.6933462950961331,0.005562756534888745,0.28380859796932384,0.7161914020306762,0.05465543313890689
15806,23.0,194,4819,5013,20,213,6665,1942,4723,6665,540,0.029107276819204803,0.7230307576894224,0.003000750187546887,0.2913728432108027,0.7086271567891973,0.03195798949737434
15807,,390,14810,15200,69,442,19411,5778,13633,19411,1561,0.020091700582144146,0.762969450311679,0.003554685487610118,0.2976662717016125,0.7023337282983875,0.022770593993096697
15808,26.0,170,3698,3868,5,165,5040,1453,3587,5040,368,0.03373015873015873,0.7337301587301587,0.000992063492063492,0.28829365079365077,0.7117063492063492,0.03273809523809524
15809,44.0,970,25297,26267,175,1280,36116,10025,26091,36116,2683,0.02685790231476354,0.7004374792335807,0.004845497840292391,0.27757780485103556,0.7224221951489644,0.03544135563185292
15810,27.0,111,2546,2657,0,148,3685,1009,2676,3685,304,0.03012211668928087,0.6909090909090909,0.0,0.2738127544097693,0.7261872455902306,0.04016282225237449
15811,,141,3404,3545,13,291,4956,1301,3655,4956,319,0.028450363196125907,0.6868442292171105,0.002623083131557708,0.26251008878127524,0.7374899112187248,0.05871670702179177
15812,,870,24499,25369,63,1197,33596,9693,23903,33596,2644,0.025895939992856293,0.7292237171091797,0.0018752232408620073,0.2885164900583403,0.7114835099416598,0.03562924157637814
15813,14.0,142,4729,4871,75,166,6442,1829,4613,6442,428,0.022042843837317604,0.7340887923005278,0.01164234709717479,0.2839180378764359,0.7160819621235641,0.025768394908413535
15814,26.0,1816,32806,34622,187,2132,46849,12830,34019,46849,3247,0.03876283378513949,0.7002497385216333,0.0039915473115754874,0.2738585668850989,0.7261414331149011,0.045507908386518386
15815,23.0,621,16175,16796,40,720,21808,6397,15411,21808,1584,0.028475788701393983,0.7417002934702861,0.001834189288334556,0.2933327219369039,0.7066672780630961,0.03301540719002201
15816,16.0,152,3308,3460,4,61,4535,1321,3214,4535,456,0.033517089305402425,0.7294377067254686,0.0008820286659316428,0.291289966923925,0.7087100330760749,0.013450937155457553
15817,,768,11752,12520,66,1129,17305,4840,12465,17305,1228,0.044380236925744006,0.679110083790812,0.0038139266108061253,0.27968795145911585,0.7203120485408842,0.0652412597515169
15818,25.0,66,1353,1419,0,59,1972,549,1423,1972,172,0.033468559837728194,0.686105476673428,0.0,0.2783975659229209,0.7216024340770791,0.029918864097363083
15819,13.0,1716,20036,21752,178,2761,33857,8500,25357,33857,1780,0.05068375815931713,0.5917830876923531,0.005257406149393035,0.2510559116283191,0.7489440883716809,0.08154886729479871
15820,13.0,209,3851,4060,10,334,5622,1555,4067,5622,417,0.03717538242618285,0.6849875489149769,0.0017787264318747777,0.2765919601565279,0.7234080398434721,0.05940946282461757
15821,,115,5832,5947,39,225,7482,2284,5198,7482,489,0.01537022186581128,0.7794707297514034,0.0052125100240577385,0.30526597166533015,0.6947340283346699,0.030072173215717722
15822,,156,24783,24939,63,1466,33836,9534,24302,33836,2915,0.004610474051306301,0.732444733420026,0.0018619222130275446,0.2817708949048351,0.7182291050951649,0.043326634353942545
15823,25.0,553,5718,6271,109,383,8434,2359,6075,8434,421,0.0655679392933365,0.6779701209390562,0.012923879535214608,0.27970120939056203,0.720298790609438,0.04541142992648802
15824,15.0,183,5628,5811,21,228,7507,2127,5380,7507,541,0.024377247901958173,0.7497002797389104,0.0027973891035033968,0.2833355534834155,0.7166644465165846,0.030371653123751164
15825,,4,4156,4160,5,183,5510,1577,3933,5510,443,0.0007259528130671506,0.7542649727767695,0.0009074410163339383,0.28620689655172415,0.7137931034482758,0.03321234119782214
15826,40.0,431,10618,11049,63,542,14847,4189,10658,14847,1195,0.02902943355560046,0.7151613120495723,0.004243281471004243,0.2821445409847107,0.7178554590152892,0.036505691385465076
15827,27.0,720,10980,11700,34,649,15597,4475,11122,15597,998,0.04616272360069244,0.7039815349105597,0.002179906392254921,0.2869141501570815,0.7130858498429186,0.04161056613451305
15828,,192,14981,15173,28,692,19799,5778,14021,19799,1663,0.009697459467649881,0.7566543764836607,0.0014142128390322744,0.2918329208545886,0.7081670791454114,0.03495126016465478
15829,17.0,795,17420,18215,100,1463,25047,6711,18336,25047,1679,0.03174032818301593,0.6954924741486006,0.003992494111071186,0.2679362797939873,0.7320637202060127,0.058410188844971456
15830,,72,2317,2389,14,148,3293,909,2384,3293,283,0.021864561190403888,0.7036137260856362,0.004251442453689645,0.2760400850288491,0.723959914971151,0.0449438202247191
15831,26.0,573,12482,13055,28,826,17382,4789,12593,17382,1221,0.03296513634794615,0.7180991830629386,0.0016108618110689218,0.27551490047175237,0.7244850995282476,0.0475204234265332
15832,16.0,1623,21023,22646,138,1496,31099,8633,22466,31099,2036,0.05218817325315927,0.6760024438084826,0.004437441718383227,0.27759735039711886,0.7224026496028811,0.04810444065725586
15833,15.0,78,4523,4601,14,297,6243,1736,4507,6243,500,0.012493993272465162,0.7244914304020503,0.0022425116130065674,0.27807144001281436,0.7219285599871856,0.04757328207592504
15834,16.0,913,16575,17488,112,817,23070,6542,16528,23070,1695,0.03957520589510186,0.7184655396618985,0.004854789770264413,0.2835717381881231,0.7164282618118769,0.03541395752058951
15835,24.0,47,10031,10078,16,700,13853,3896,9957,13853,1208,0.003392766909694651,0.7241030823648307,0.0011549844798960515,0.28123872085468854,0.7187612791453115,0.050530570995452245
15836,,162,7884,8046,27,443,10836,3056,7780,10836,950,0.014950166112956811,0.7275747508305648,0.0024916943521594683,0.28202288667404946,0.7179771133259505,0.040882244370616466
15837,15.0,2959,43625,46584,105,2137,62858,17973,44885,62858,4581,0.047074358076935316,0.6940246269369054,0.001670431766839543,0.2859301918610201,0.7140698081389799,0.033997263673677176
15838,27.0,3850,83026,86876,408,4137,114705,33080,81635,114715,9462,0.03356143486030597,0.7237588807043542,0.003556640369611646,0.28836682212439524,0.7116331778756048,0.03606328727716515
15839,16.0,375,6542,6917,85,744,9696,2701,6995,9696,641,0.038675742574257425,0.6747112211221122,0.008766501650165017,0.27856848184818483,0.7214315181518152,0.07673267326732673
15840,14.0,802,6596,7398,33,1150,11338,2887,8451,11338,404,0.07073557946727818,0.5817604515787617,0.002910566237431646,0.2546304462868231,0.7453695537131769,0.10142882342564827
15841,,151,4363,4514,18,282,6276,1756,4520,6276,479,0.024059910771191843,0.6951880178457617,0.0028680688336520078,0.27979604843849587,0.7202039515615042,0.044933078393881457
15842,,102,3796,3898,2,201,5268,1518,3750,5268,427,0.0193621867881549,0.7205770690964313,0.00037965072133637056,0.28815489749430523,0.7118451025056948,0.038154897494305236
15843,34.0,19,2782,2801,6,131,3831,1097,2734,3831,369,0.004959540589924301,0.7261811537457583,0.0015661707126076742,0.2863482119551031,0.7136517880448969,0.034194727225267556
15844,35.0,586,8780,9366,44,571,13439,3552,9887,13439,893,0.04360443485378376,0.6533224198229035,0.0032740531289530473,0.26430537986457325,0.7356946201354267,0.04248828037800432
15845,15.0,52,2326,2378,2,143,3281,894,2387,3281,262,0.01584882657726303,0.7089302042060347,0.0006095702529716549,0.27247790307832975,0.7275220969216702,0.043584273087473334
15846,14.0,245,4556,4801,12,430,6561,1782,4779,6561,439,0.03734186861758878,0.6944063404968754,0.001828989483310471,0.2716049382716049,0.7283950617283951,0.06553878981862521
15847,25.0,138,2241,2379,3,119,3218,931,2287,3218,220,0.04288377874456184,0.6963952765692977,0.0009322560596643878,0.28931013051584836,0.7106898694841517,0.036979490366687386
15848,26.0,2725,47807,50532,297,3219,67724,19146,48578,67724,4157,0.04023684365955939,0.7059092788376351,0.004385446813537299,0.2827062784241923,0.7172937215758077,0.047531155867934556
15849,,315,5642,5957,13,498,8166,2319,5847,8166,556,0.03857457751653196,0.6909135439627725,0.0015919666911584618,0.28398236590742104,0.716017634092579,0.06098457016899339
15850,24.0,1775,44753,46528,345,1973,61366,17627,43739,61366,4015,0.02892481178502754,0.7292800573607535,0.005622005670892677,0.2872437506110876,0.7127562493889125,0.0321513541700616
15851,,2518,32987,35505,226,1362,48434,13484,34950,48434,2026,0.05198827270099517,0.6810711483668498,0.004666143618119503,0.27839947144567867,0.7216005285543213,0.028120741627782136
15852,14.0,302,2828,3130,121,170,4264,1123,3141,4264,280,0.07082551594746717,0.6632270168855535,0.028377110694183864,0.2633677298311445,0.7366322701688556,0.039868667917448405
15853,,194,2286,2480,12,196,3400,912,2488,3400,214,0.057058823529411766,0.6723529411764706,0.0035294117647058825,0.26823529411764707,0.731764705882353,0.05764705882352941
15854,,6264,123892,130156,493,6987,173594,49982,123612,173594,13164,0.03608419645840294,0.7136882611150155,0.0028399599064483794,0.2879246978582209,0.712075302141779,0.040249086950009796
15855,,413,9438,9851,29,745,13426,3665,9761,13426,912,0.030761209593326382,0.7029643974378073,0.0021599880828243705,0.2729778042603903,0.7270221957396097,0.055489349024281244
15856,27.0,82,4338,4420,27,218,5990,1625,4365,5990,557,0.013689482470784642,0.7242070116861435,0.004507512520868113,0.27128547579298834,0.7287145242070117,0.03639398998330551
15857,14.0,174,2070,2244,5,235,3131,867,2264,3131,168,0.05557329926541041,0.6611306291919514,0.0015969338869370809,0.2769083359948898,0.7230916640051102,0.07505589268604279
15858,,869,16016,16885,261,660,23537,6472,17065,23537,1698,0.036920593108722435,0.6804605514721502,0.011088923822067383,0.274971321748736,0.7250286782512639,0.028040956791434764
15859,37.0,74,2058,2132,12,54,2760,803,1957,2760,229,0.02681159420289855,0.7456521739130435,0.004347826086956522,0.29094202898550725,0.7090579710144927,0.01956521739130435
15860,,545,14184,14729,38,717,19202,5450,13752,19202,1161,0.02838246016039996,0.7386730548901156,0.001978960524945318,0.2838246016039996,0.7161753983960004,0.03733986043120508
15861,25.0,89,1899,1988,5,89,2608,756,1852,2608,179,0.03412576687116564,0.7281441717791411,0.0019171779141104294,0.2898773006134969,0.7101226993865031,0.03412576687116564
15862,,481,10377,10858,28,511,14276,4144,10132,14276,1169,0.03369291117960213,0.7268842813112917,0.001961333706920706,0.2902773886242645,0.7097226113757354,0.03579434015130289
15863,25.0,968,31913,32881,240,1111,41722,12719,29003,41722,2793,0.023201188821245385,0.7648962178227314,0.005752360864771583,0.30485115766262405,0.695148842337376,0.026628637169838456
15864,,115,2601,2716,37,107,3648,1050,2598,3648,327,0.031524122807017545,0.7129934210526315,0.010142543859649123,0.2878289473684211,0.712171052631579,0.029331140350877194
15865,16.0,8640,171895,180535,1515,6191,246491,68146,178345,246491,15874,0.03505198972781968,0.6973682609101346,0.0061462690321350474,0.2764644550916666,0.7235355449083334,0.025116535695015235
15866,34.0,4095,97433,101528,310,2470,137601,38765,98837,137602,12586,0.02975974186421709,0.7080783709539106,0.0022528742314791936,0.2817182889783579,0.7182817110216422,0.017950320489527768
15867,17.0,373,8714,9087,42,578,12454,3488,8966,12454,1123,0.029950216797815964,0.6996948771479042,0.003372410470531556,0.28007066002890635,0.7199293399710937,0.0464107917135057
15868,,154,4582,4736,12,269,6522,1853,4669,6522,452,0.023612388837779823,0.7025452315240723,0.0018399264029438822,0.28411530205458446,0.7158846979454155,0.041245016865992024
15869,,83,2536,2619,4,116,3528,990,2538,3528,209,0.02352607709750567,0.7188208616780045,0.0011337868480725624,0.28061224489795916,0.7193877551020408,0.032879818594104306
15870,,635,13347,25501,1315,1761,37241,5487,31767,37254,1293,0.01704514951414613,0.3582702528587534,0.035298223009609705,0.1472861974553068,0.8527138025446932,0.04727009180222258
15871,,6428,113601,120029,361,7680,159927,46004,113923,159927,10969,0.040193338210558566,0.7103303382168115,0.002257279883947051,0.2876562431609422,0.7123437568390578,0.04802190999643587
15872,23.0,19,2841,2860,6,134,3755,1090,2665,3755,304,0.005059920106524634,0.7565912117177097,0.0015978695073235686,0.29027962716378164,0.7097203728362184,0.03568575233022637
15873,,279,8616,8895,36,361,11686,3428,8258,11686,885,0.023874721889440356,0.7372924867362656,0.00308060927605682,0.29334246106452166,0.7066575389354783,0.03089166524045867
15874,,215,3019,3234,25,107,4351,1214,3137,4351,406,0.04941392783268214,0.6938634796598483,0.005745805561939784,0.2790163180877959,0.7209836819122041,0.024592047805102275
15875,,223,7120,7343,26,349,10085,2801,7284,10085,785,0.02211204759543877,0.7059990084283589,0.0025780862667327716,0.27773921665840356,0.7222607833415964,0.034605850272682204
15876,14.0,26,5247,5273,7,710,7556,2010,5546,7556,440,0.003440974060349391,0.6944150344097406,0.0009264160931709899,0.2660137638962414,0.7339862361037586,0.09396506087877184
15877,16.0,61,2820,2881,25,220,3999,1053,2946,3999,276,0.015253813453363341,0.7051762940735183,0.006251562890722681,0.2633158289572393,0.7366841710427607,0.05501375343835959
15878,25.0,54,2253,2307,4,81,2949,890,2059,2949,204,0.018311291963377416,0.7639877924720244,0.0013563919972872161,0.3017972193964056,0.6982027806035944,0.027466937945066123
15879,17.0,15,1347,1362,4,29,1987,531,1456,1987,186,0.00754906894816306,0.6779063915450427,0.0020130850528434826,0.26723704076497234,0.7327629592350277,0.01459486663311525
15880,15.0,38,3213,3251,0,256,4409,1186,3223,4409,348,0.008618734406894988,0.7287366749829893,0.0,0.2689952370151962,0.7310047629848038,0.05806305284645044
15881,16.0,675,15756,16431,2,803,21661,6226,15435,21661,1635,0.031161996214394534,0.7273902405244449,9.233184063524306e-05,0.2874290198975117,0.7125709801024883,0.03707123401505009
15882,37.0,328,13199,13527,46,536,17709,5125,12584,17709,1498,0.018521655655316507,0.745327234739398,0.0025975492687334125,0.2894008696143204,0.7105991303856796,0.03026709582698063
15883,27.0,619,21682,22301,158,698,28186,8548,19638,28186,1667,0.02196125736181083,0.7692471439721847,0.005605619811253814,0.3032711275101114,0.6967288724898886,0.024764067267437736
15884,16.0,95,17087,17182,107,1763,24539,6468,18072,24540,2114,0.003871230643846781,0.6962917685411573,0.0043602281988590055,0.26356968215158927,0.7364303178484107,0.07184189079054605
15885,14.0,16,2014,2030,2,346,3079,754,2325,3079,146,0.005196492367651835,0.6541084767781747,0.0006495615459564793,0.24488470282559271,0.7551152971744073,0.11237414745047093
15886,,169,4271,4440,25,225,6039,1700,4339,6039,444,0.02798476568968372,0.7072362974002319,0.004139758238118894,0.2815035601920848,0.7184964398079152,0.037257824143070044
15887,15.0,191,1909,2100,0,133,2790,805,1985,2790,188,0.06845878136200717,0.6842293906810036,0.0,0.2885304659498208,0.7114695340501792,0.04767025089605735
15888,23.0,3287,110680,113967,1605,6483,154036,42975,111061,154036,11808,0.021339167467345297,0.7185333298709392,0.01041964216157262,0.2789932223636033,0.7210067776363966,0.04208756394609053
15889,23.0,1737,24208,25945,189,1720,35534,9691,25843,35534,2284,0.0488827601733551,0.6812630157032701,0.0053188495525412285,0.2727247143580796,0.7272752856419205,0.04840434513423763
15890,25.0,5260,107841,113101,489,5340,148611,42812,105799,148611,11115,0.035394418986481484,0.7256596079698003,0.003290469749883925,0.28808096305118736,0.7119190369488126,0.0359327371459717
15891,34.0,714,12572,13286,55,466,17704,5061,12643,17704,1301,0.0403298689561681,0.710122006326254,0.0031066425666516043,0.28586760054225036,0.7141323994577496,0.026321735201084502
15892,23.0,86,1675,1761,16,92,2356,669,1687,2356,177,0.0365025466893039,0.7109507640067911,0.006791171477079796,0.28395585738539897,0.716044142614601,0.03904923599320883
15893,,88,2466,2554,18,86,3434,990,2444,3434,227,0.0256260920209668,0.7181129877693652,0.0052417006406523005,0.28829353523587653,0.7117064647641235,0.025043680838672103
15894,47.0,7326,137278,144604,563,6241,191439,55199,136240,191439,16923,0.038268064500963754,0.7170848155287063,0.0029408845637513776,0.28833727714833446,0.7116627228516655,0.03260046281060808
15895,,492,12407,12899,27,1015,17399,4872,12527,17399,1197,0.02827748721190873,0.7130869590206333,0.0015518133226047474,0.2800160928789011,0.7199839071210989,0.058336686016437725
15896,14.0,398,1697,2095,7,222,2972,827,2145,2972,177,0.13391655450874831,0.5709959623149394,0.0023553162853297443,0.2782637954239569,0.721736204576043,0.07469717362045761
15897,,484,6577,7061,46,225,9562,2663,6899,9562,773,0.050617025726835393,0.6878268144739594,0.004810709056682703,0.2784982221292617,0.7215017778707383,0.023530642125078435
15898,15.0,115,2316,2431,4,90,3083,915,2168,3083,175,0.037301329873499836,0.7512163477132663,0.0012974375608173856,0.296788842036977,0.703211157963023,0.029192345118391177
15899,41.0,299,7504,7803,7,334,10159,2942,7217,10159,798,0.02943203071168422,0.738655379466483,0.0006890441972635102,0.289595432621321,0.710404567378679,0.03287725169800177
15900,,266,3984,4250,17,368,5795,1674,4121,5795,408,0.04590163934426229,0.6874892148403796,0.002933563416738568,0.288869715271786,0.7111302847282139,0.0635030198446937
15901,,615,8934,9549,45,724,13897,3643,10254,13897,886,0.044254155573145285,0.6428725624235446,0.003238108944376484,0.2621429085414118,0.7378570914585881,0.05209757501619054
15902,40.0,183,17081,17264,37,1830,23755,6555,17200,23755,1754,0.007703641338665544,0.7190486213428752,0.001557566828036203,0.2759419069669543,0.7240580930330457,0.07703641338665544
15903,,2687,62569,65256,131,5102,87391,24443,62948,87391,5919,0.03074687324781728,0.7159661750065797,0.001499010195557895,0.2796969939696307,0.7203030060303692,0.05838129784531588
15904,40.0,432,13412,13844,35,483,17676,5111,12565,17676,1249,0.024439918533604887,0.7587689522516406,0.0019800859923059517,0.28914912876216337,0.7108508712378366,0.027325186693822133
15905,,34,27816,27850,171,2218,37886,10418,27468,37886,3045,0.0008974291294937444,0.7342026078234705,0.004513540621865597,0.274982843266642,0.725017156733358,0.05854405321226838
15906,,1407,22524,23931,79,1750,32666,9159,23507,32666,2265,0.04307230759811425,0.6895242760056328,0.002418416702381681,0.280383273128023,0.719616726871977,0.0535725218882018
15907,,4193,101287,105480,276,4891,141658,40510,101169,141679,11309,0.029595070546799454,0.7149048200509602,0.0019480656978098378,0.28592804861694393,0.714071951383056,0.03452170046372433
15908,,1001,21765,22766,50,1070,29851,8570,21281,29851,2336,0.033533214967672774,0.729121302468929,0.0016749857626210177,0.28709255971324243,0.7129074402867576,0.03584469532008978
15909,26.0,711,24211,24922,68,895,33155,9396,23760,33156,2164,0.021444082519001085,0.7302147424297262,0.002050910845699119,0.28338762214983715,0.7166123778501629,0.026993605983833997
15910,,330,4685,5015,44,349,7073,1867,5206,7073,522,0.04665629860031104,0.6623780574013856,0.006220839813374806,0.2639615438993355,0.7360384561006645,0.049342570337904706
15911,23.0,65,2208,2273,0,104,2995,856,2139,2995,231,0.021702838063439065,0.737228714524207,0.0,0.28580968280467445,0.7141903171953256,0.0347245409015025
15912,,15,2738,2753,4,275,3771,1025,2746,3771,284,0.003977724741447892,0.7260673561389552,0.0010607265977194379,0.27181119066560594,0.728188809334394,0.07292495359321136
15913,,2333,35715,38048,314,1530,50860,14522,36338,50860,3668,0.04587101848210775,0.7022217852929611,0.006173810460086512,0.28552890287062527,0.7144710971293747,0.030082579630357844
15914,14.0,236,3303,3539,55,111,4484,1391,3093,4484,239,0.05263157894736842,0.7366190900981266,0.012265834076717217,0.31021409455842996,0.68978590544157,0.024754683318465656
15915,,3242,104858,108100,558,3566,139670,41448,98758,140206,11744,0.023123118839421992,0.7478852545540133,0.003979858208635864,0.29562215597050057,0.7043778440294994,0.02543400425088798
15916,16.0,13888,245470,259358,1062,17874,347563,98514,249055,347569,22308,0.03995753361203099,0.7062482557420253,0.0030555084026481073,0.2834372455541202,0.7165627544458798,0.051425760064907976
15917,23.0,191,3863,4054,7,151,5314,1544,3770,5314,414,0.03594279262325931,0.7269476853594279,0.0013172751223184042,0.29055325555137373,0.7094467444486263,0.02841550621001129
15918,,85,6731,6816,28,554,9366,2506,6860,9366,615,0.009075379030535981,0.7186632500533846,0.0029895366218236174,0.26756352765321373,0.7324364723467862,0.05915011744608157
15919,24.0,531,14424,14955,66,661,19562,5705,13857,19562,1449,0.02714446375626214,0.7373479194356405,0.0033738881504958595,0.29163684694816483,0.7083631530518352,0.03379000102239035
15920,15.0,142,1854,1996,7,140,2698,749,1949,2698,170,0.05263157894736842,0.687175685693106,0.0025945144551519643,0.2776130467012602,0.7223869532987398,0.05189028910303929
15921,,154,4252,4406,10,180,5898,1667,4231,5898,427,0.02611054594777891,0.7209223465581553,0.00169548999660902,0.28263818243472366,0.7173618175652764,0.030518819938962362
15922,23.0,3109,91150,94259,475,2855,124060,36593,87469,124062,9974,0.025060050619851365,0.7347132885170318,0.0038287307958923766,0.2949573600296626,0.7050426399703374,0.023012687204784704
15923,,122,2121,2243,0,124,3085,853,2232,3085,238,0.039546191247974066,0.6875202593192868,0.0,0.2764991896272285,0.7235008103727715,0.04019448946515397
15924,24.0,710,13466,14176,62,862,19829,5463,14366,19829,1451,0.03580614251853346,0.6791063593726361,0.0031267335720409502,0.27550557264612435,0.7244944273538756,0.04347168288869837
15925,16.0,215,4442,4657,0,251,6275,1856,4419,6275,419,0.034262948207171316,0.7078884462151395,0.0,0.2957768924302789,0.7042231075697211,0.04
15926,24.0,254,14278,14532,39,386,18494,5547,12947,18494,1467,0.013734184059695037,0.7720341732453769,0.0021087920406618363,0.29993511409105655,0.7000648859089434,0.020871634043473558
15927,24.0,170,10748,10918,91,580,14940,4162,10778,14940,1241,0.011378848728246318,0.7194109772423025,0.00609103078982597,0.2785809906291834,0.7214190093708166,0.038821954484605084
15928,41.0,69,2503,2572,11,65,3321,1007,2314,3321,249,0.02077687443541102,0.753688647997591,0.00331225534477567,0.3032219211081,0.6967780788919,0.019572417946401688
15929,,3043,50935,53978,182,2054,71155,20475,50680,71155,4786,0.04276579298714075,0.715831635162673,0.002557796360059026,0.2877520905066404,0.7122479094933596,0.02886655892066615
15930,17.0,153,2926,3079,8,217,4304,1124,3180,4304,339,0.03554832713754647,0.6798327137546468,0.0018587360594795538,0.2611524163568773,0.7388475836431226,0.0504182156133829
15931,15.0,2141,70242,72383,103,2731,94973,27822,67151,94973,6325,0.02254324913396439,0.7395996756973034,0.0010845187579627893,0.29294641634991,0.7070535836500901,0.028755541048508523
15932,15.0,83,3367,3450,3,210,4648,1281,3367,4648,393,0.017857142857142856,0.7243975903614458,0.0006454388984509467,0.2756024096385542,0.7243975903614458,0.045180722891566265
15933,26.0,60,6092,6152,16,264,8194,2325,5869,8194,616,0.00732243104710764,0.743470832316329,0.001952648279228704,0.28374420307542103,0.716255796924579,0.03221869660727361
15934,16.0,271,10354,10625,35,203,14037,4108,9929,14037,1276,0.01930611954121251,0.7376219990026359,0.002493410272850324,0.29265512573911806,0.707344874260882,0.01446177958253188
15935,17.0,1106,22798,24000,141,2610,33421,8956,24465,33421,2233,0.033092965500733075,0.682145956135364,0.004218904281739026,0.2679752251578349,0.7320247748421651,0.07809461117261601
15936,16.0,3230,42230,45460,138,2492,60505,17207,43298,60505,3805,0.05338401784976448,0.6979588463763325,0.0022808032394017025,0.284389719857863,0.715610280142137,0.041186678786877116
15937,15.0,306,16712,17018,36,833,22863,6392,16471,22863,1818,0.013384070331977431,0.7309626908104798,0.0015745965096444037,0.27957835804575076,0.7204216419542492,0.03643441368149412
15938,33.0,493,10246,10739,33,681,16581,4130,12451,16581,1282,0.02973282672938906,0.6179361920270189,0.001990229781074724,0.24908027260117002,0.75091972739883,0.0410711054821784
15939,17.0,96,1740,1836,11,165,2578,697,1881,2578,178,0.037238169123351435,0.6749418153607447,0.004266873545384018,0.27036462373933284,0.7296353762606672,0.06400310318076027
15940,26.0,43,1802,1845,8,106,2421,671,1750,2421,186,0.017761255679471292,0.7443205287071458,0.003304419661296985,0.2771581990912846,0.7228418009087154,0.04378356051218505
15941,17.0,124,2679,2803,19,140,4003,1144,2859,4003,147,0.030976767424431676,0.669248063952036,0.004746440169872595,0.2857856607544342,0.7142143392455659,0.03497376967274544
15942,15.0,99,7542,7641,38,316,10370,2876,7494,10370,913,0.009546769527483125,0.7272902603664416,0.0036644165863066536,0.2773384763741562,0.7226615236258438,0.0304725168756027
15943,,5235,158829,164064,692,7289,217580,62818,154762,217580,16054,0.0240601158194687,0.729979777553084,0.0031804393786193583,0.2887121978122989,0.711287802187701,0.03350032172074639
15944,13.0,63,3036,3099,11,102,4039,1175,2864,4039,359,0.01559792027729636,0.751671205743996,0.002723446397623174,0.2909135924733845,0.7090864075266154,0.025253775687051252
15945,24.0,133,3592,3725,57,128,4978,1408,3570,4978,430,0.026717557251908396,0.7215749296906389,0.011450381679389313,0.28284451586982723,0.7171554841301727,0.02571313780634793
15946,24.0,1043,28724,29767,98,2152,40680,11281,29399,40680,3128,0.02563913470993117,0.7060963618485743,0.002409046214355949,0.2773107177974435,0.7226892822025566,0.052900688298918384
15947,14.0,493,8744,9237,49,407,12077,3480,8597,12077,858,0.040821396042063425,0.7240208661091331,0.004057298998095553,0.2881510308851536,0.7118489691148464,0.033700422290303886
15948,27.0,303,9094,9397,11,1019,13236,3644,9592,13236,1027,0.022892112420670897,0.6870655787246902,0.0008310667875491085,0.2753097612571774,0.7246902387428226,0.07698700513750378
15949,27.0,468,20252,20720,51,388,25784,8043,17741,25784,2088,0.01815079118833385,0.7854483400558486,0.0019779708346261246,0.3119376357430965,0.6880623642569035,0.015048091839900713
15950,23.0,142,3262,3404,18,137,4737,1334,3403,4737,420,0.02997677855182605,0.6886214903947646,0.0037998733375554147,0.28161283512771795,0.718387164872282,0.02892125818028288
15951,,240,4111,4351,25,271,5839,1657,4182,5839,383,0.04110292858366159,0.7040589141976366,0.004281555060798082,0.28378146942969684,0.7162185305703032,0.046412056859051205
15952,15.0,97,2233,2330,3,548,3317,546,2771,3317,122,0.029243292131444075,0.6731986735001507,0.0009044317154054868,0.16460657220379862,0.8353934277962014,0.1652095266807356
15953,39.0,1994,48646,50640,24,2115,66778,20393,46385,66778,4324,0.02986013357692653,0.7284734493396029,0.0003593998023301087,0.3053850070382461,0.6946149929617539,0.03167210758034083
15954,23.0,761,10471,11232,59,605,15278,4231,11047,15278,1133,0.049810184579133394,0.6853645765152507,0.0038617620107343894,0.2769341536850373,0.7230658463149627,0.03959942400837806
15955,23.0,274,6871,7145,44,304,9350,2709,6641,9350,776,0.0293048128342246,0.7348663101604278,0.004705882352941176,0.2897326203208556,0.7102673796791444,0.03251336898395722
15956,,1613,47979,49592,231,4735,67805,20107,47698,67805,2399,0.023788806135240766,0.7076026841678342,0.003406828404984883,0.29654155298281837,0.7034584470171816,0.06983260821473343
15957,23.0,130,5002,5132,10,374,6934,1913,5021,6934,590,0.018748197288722238,0.7213729449091434,0.001442169022209403,0.27588693394865876,0.7241130660513412,0.05393712143063167
15958,15.0,243,8681,8924,105,656,11892,3668,8224,11892,769,0.020433905146316853,0.7299865455768584,0.008829465186680121,0.3084426505213589,0.6915573494786411,0.055163134880592
15959,15.0,1202,33121,34323,127,1647,44974,12997,31977,44974,3558,0.026726553119580203,0.7364477253524259,0.0028238537821852626,0.2889891937563926,0.7110108062436075,0.03662115889180415
15960,36.0,137,3695,3832,13,156,4940,1481,3459,4940,364,0.027732793522267207,0.7479757085020243,0.002631578947368421,0.2997975708502024,0.7002024291497976,0.031578947368421054
15961,24.0,624,19154,19778,203,1036,26852,7643,19209,26852,1790,0.023238492477282883,0.7133174437658275,0.0075599582898852975,0.2846342916728735,0.7153657083271264,0.03858185610010428
15962,17.0,24455,424692,449147,2402,26232,599820,171035,428785,599820,41416,0.04077056450268414,0.7080324097229169,0.0040045346937414555,0.2851438764962822,0.7148561235037177,0.043733119935980794
15963,,584,14690,15274,30,1017,21885,5646,16239,21885,1444,0.0266849440255883,0.6712360063970756,0.0013708019191226869,0.25798492117888966,0.7420150788211104,0.04647018505825908
15964,16.0,1299,62486,63785,302,3414,85519,23978,61541,85519,6739,0.015189606987920812,0.7306680386814626,0.0035313789918029912,0.2803821373028216,0.7196178626971784,0.03992095323846163
15965,23.0,333,10675,11008,45,1457,15746,4055,11691,15746,1129,0.021148228121427665,0.6779499555442652,0.0028578686650577926,0.2575257208179855,0.7424742791820145,0.09253143655531564
15966,,158,6952,7110,6,243,9201,2788,6413,9201,831,0.01717204651668297,0.7555700467340506,0.0006521030322791001,0.3030105423323552,0.6969894576676449,0.026410172807303553
15967,23.0,0,1919,1919,11,88,2575,708,1867,2575,255,0.0,0.745242718446602,0.004271844660194175,0.27495145631067963,0.7250485436893204,0.0341747572815534
15968,34.0,188,4822,5010,0,332,6535,1832,4703,6535,376,0.028768171384850803,0.7378729915837796,0.0,0.28033664881407805,0.719663351185922,0.05080336648814078
15969,,151,2998,3149,21,46,4129,1178,2951,4129,332,0.036570598207798496,0.7260837975296682,0.005085977234197142,0.28529910389924923,0.7147008961007508,0.011140712036812788
15970,25.0,458,20459,20917,45,751,26905,8009,18897,26906,2119,0.017022225525905002,0.7603880175425556,0.0016724894075670854,0.29766594811566194,0.7023340518843381,0.027911989890730692
15971,17.0,112,3590,3705,2,94,4836,1469,3367,4836,382,0.02315963606286187,0.7423490488006617,0.00041356492969396195,0.30376344086021506,0.696236559139785,0.01943755169561621
15972,41.0,3501,86686,90187,243,5297,126182,33718,92492,126210,8494,0.027739481816020917,0.6868393946596941,0.0019253624910862848,0.2671579114174788,0.7328420885825212,0.041969732984708026
15973,,108,3092,3200,0,159,4172,1173,2999,4172,299,0.02588686481303931,0.7411313518696069,0.0,0.28116011505273253,0.7188398849472675,0.03811121764141898
15974,15.0,486,14470,14956,39,984,20099,5720,14379,20099,1568,0.02418030747798398,0.7199363152395641,0.0019403950445295785,0.2845912731976715,0.7154087268023285,0.048957659585053985
15975,,16,5547,5563,4,204,7417,2108,5309,7417,690,0.0021572064176890926,0.7478764999325873,0.0005393016044222731,0.28421194553053797,0.715788054469462,0.027504381825535933
15976,33.0,65,1687,1752,4,82,2328,670,1658,2328,170,0.027920962199312716,0.7246563573883161,0.001718213058419244,0.28780068728522334,0.7121993127147767,0.0352233676975945
15977,27.0,115,4430,4545,10,87,5686,1751,3935,5686,431,0.020225114315863525,0.7791065775589167,0.0017587055926837848,0.3079493492789307,0.6920506507210693,0.015300738656348928
15978,,84,1959,2043,0,222,2791,640,2151,2791,176,0.030096739519885347,0.7018989609458975,0.0,0.22930849158007882,0.7706915084199212,0.07954138301683984
15979,,55,5681,5736,43,1077,8647,2130,6517,8647,503,0.006360587486989707,0.6569908638834278,0.004972822944373771,0.24632820631432867,0.7536717936856713,0.12455186769978027
15980,35.0,3172,62913,66085,262,4332,88629,24189,64440,88629,6272,0.03578963995983256,0.7098466641844091,0.0029561430231639756,0.27292421216531837,0.7270757878346816,0.048877906779947876
15981,24.0,90,2915,3005,9,166,4039,1165,2874,4039,363,0.022282743253280515,0.7217132953701412,0.0022282743253280515,0.2884377321119089,0.7115622678880911,0.041099282000495174
15982,26.0,52,1678,1730,0,84,2330,646,1684,2330,188,0.022317596566523604,0.7201716738197425,0.0,0.2772532188841202,0.7227467811158799,0.036051502145922745
15983,27.0,847,32173,33020,43,1071,42157,12734,29423,42157,2743,0.02009156249258723,0.7631710036292905,0.0010199966790805798,0.30206134212586283,0.6979386578741371,0.025405033565006997
15984,,130,3100,3230,28,127,4384,1179,3205,4384,330,0.029653284671532845,0.7071167883211679,0.006386861313868613,0.2689324817518248,0.7310675182481752,0.02896897810218978
15985,,515,15529,16044,95,545,20912,6066,14846,20912,1676,0.024627008416220352,0.742587987758225,0.004542846212700842,0.29007268553940324,0.7099273144605968,0.02606159143075746
15986,,583,25873,26456,121,2118,35660,9879,25781,35660,2618,0.016348850252383623,0.7255468311833988,0.003393157599551318,0.2770330902972518,0.7229669097027481,0.059394279304542906
15987,23.0,946,17571,18517,47,1252,24762,6830,17932,24762,1496,0.03820369921654147,0.7095953477102012,0.001898069622809143,0.27582586220822225,0.7241741377917778,0.05056134399483079
15988,23.0,3562,95933,99495,156,4753,129622,38893,90729,129622,6666,0.02747990310286834,0.7400981314900248,0.0012034994059650368,0.3000493743346037,0.6999506256653963,0.036668158183024484
15989,,126,2500,2626,10,142,3625,965,2660,3625,248,0.03475862068965517,0.6896551724137931,0.002758620689655172,0.26620689655172414,0.7337931034482759,0.03917241379310345
15990,14.0,267,7398,7665,55,394,10038,2858,7180,10038,763,0.026598924088463836,0.7369994022713688,0.005479179119346483,0.28471807132895,0.71528192867105,0.03925084678222754
15991,15.0,370,36705,37075,114,1923,49677,14104,35573,49677,4801,0.007448114821748495,0.7388731203575095,0.0022948245667008876,0.28391408498902915,0.7160859150109709,0.038710067033033396
15992,,1358,29227,30585,89,1240,41310,11487,29823,41310,2257,0.03287339627208908,0.7075042362624062,0.0021544420237230694,0.27806826434277415,0.7219317356572259,0.030016945049624787
15993,17.0,157,5114,5271,0,257,7019,2052,4967,7019,512,0.022367858669326116,0.7285938167830175,0.0,0.29234933751246617,0.7076506624875338,0.036614902407750394
15994,26.0,354,14232,14586,64,1461,21089,5497,15592,21089,1639,0.016786002181231923,0.6748541893878325,0.003034757456493907,0.26065721466167197,0.7393427853383281,0.06927782256152497
15995,23.0,2767,71964,74731,717,3319,94647,28635,66012,94647,5711,0.0292349466966729,0.7603410567688358,0.007575517449047513,0.3025452470759771,0.6974547529240229,0.03506714423066764
15996,,119,3952,4071,32,202,5500,1547,3953,5500,464,0.021636363636363638,0.7185454545454546,0.005818181818181818,0.2812727272727273,0.7187272727272728,0.036727272727272726
15997,16.0,298,11101,11399,38,481,14792,4422,10370,14792,1209,0.0201460248783126,0.7504732287723094,0.002568956192536506,0.29894537587885345,0.7010546241211466,0.03251757706868578
15998,,1288,34193,35481,157,1290,47835,13417,34418,47835,3993,0.026925891083934356,0.7148113306156579,0.0032821156057280232,0.28048500052262987,0.7195149994773701,0.026967701473816243
15999,24.0,76,1813,1889,15,79,2556,764,1792,2556,221,0.0297339593114241,0.7093114241001565,0.005868544600938967,0.29890453834115804,0.701095461658842,0.030907668231611892
16000,,90,4328,4418,13,125,6003,1684,4319,6003,479,0.014992503748125937,0.7209728469098784,0.002165583874729302,0.2805264034649342,0.7194735965350658,0.020822921872397135
16001,40.0,196,2632,2828,13,133,3832,1077,2755,3832,273,0.0511482254697286,0.6868475991649269,0.0033924843423799585,0.28105427974947805,0.718945720250522,0.034707724425887265
16002,,599,12263,12862,14,866,17107,4920,12187,17107,1243,0.03501490617875724,0.7168410592155258,0.0008183784415736248,0.28760156661015956,0.7123984333898404,0.05062255217162565
16003,16.0,22454,430879,453333,1380,16581,600619,173614,427005,600619,48604,0.037384764717732874,0.7173915577096296,0.0022976296121168327,0.28905845469424046,0.7109415453057596,0.027606519274282034
16004,25.0,308,7315,7623,8,356,10210,2979,7231,10210,805,0.030166503428011752,0.7164544564152792,0.0007835455435847208,0.29177277179236044,0.7082272282076396,0.034867776689520076
16005,,269,4672,4941,4,234,7158,1839,5319,7158,392,0.03758032970103381,0.6526962838781782,0.0005588153115395362,0.25691533948030176,0.7430846605196982,0.03269069572506287
16006,25.0,529,8355,8884,130,423,11771,3419,8352,11771,827,0.0449409565882253,0.7097952595361482,0.011044091411095065,0.29045960411180016,0.7095403958881998,0.035935774360717015
16007,,36,1860,1896,9,77,2485,712,1773,2485,226,0.01448692152917505,0.7484909456740443,0.0036217303822937627,0.2865191146881288,0.7134808853118713,0.030985915492957747
16008,36.0,555,10403,10958,316,1087,17405,4015,13390,17405,823,0.03188738868141339,0.597701809824763,0.018155702384372308,0.23068083883941395,0.7693191611605861,0.062453318012065495
16009,26.0,5982,141303,147285,753,6997,192788,55949,136839,192788,12442,0.031028902213830735,0.7329449965765504,0.003905844762122124,0.2902099715749943,0.7097900284250057,0.03629375272319854
16010,,83,1974,2057,10,85,2795,775,2020,2795,214,0.029695885509839,0.7062611806797854,0.0035778175313059034,0.2772808586762075,0.7227191413237924,0.03041144901610018
16011,,600,17506,18106,92,1056,24644,6839,17805,24644,2052,0.024346696964778446,0.7103554617756858,0.0037331602012660283,0.27751176757019963,0.7224882324298003,0.04285018665801006
16012,,936,25168,26104,51,1177,34324,9836,24488,34324,2323,0.02726954900361263,0.7332478732082508,0.001485840811094278,0.28656333760633956,0.7134366623936604,0.03429087518937187
16013,17.0,2369,50556,52925,194,2696,70761,20246,50515,70761,5252,0.033478893740902474,0.7144613558316022,0.002741623210525572,0.28611805938299345,0.7138819406170065,0.038100083379262586
16014,43.0,94,2600,2694,11,98,3551,1029,2522,3551,282,0.02647141650239369,0.7321881160236553,0.0030977189524077726,0.2897775274570544,0.7102224725429457,0.0275978597578147
16015,,1416,15303,16719,179,1453,23604,6113,17491,23604,1435,0.059989832231825115,0.6483223182511438,0.007583460430435519,0.2589815285544823,0.7410184714455177,0.06155736315878665
16016,,314,6847,7161,82,259,9145,2716,6429,9145,690,0.034335702569710226,0.7487151448879169,0.00896664844177146,0.29699289229086934,0.7030071077091307,0.02832148715144888
16017,25.0,747,14442,15189,305,693,19968,5718,14250,19968,1275,0.03740985576923077,0.7232572115384616,0.015274439102564102,0.2863581730769231,0.7136418269230769,0.03470552884615385
16018,,421,13269,13690,29,679,18058,5186,12872,18058,1483,0.023313766751578247,0.7347989810610256,0.0016059364270683354,0.28718573485435817,0.7128142651456418,0.037601063240668954
16019,24.0,303,7689,7992,43,558,10776,3031,7745,10776,772,0.02811804008908686,0.7135300668151447,0.003990348923533778,0.2812731997030438,0.7187268002969562,0.05178173719376392
16020,23.0,163,6266,6429,22,221,8578,2441,6137,8578,714,0.019002098391233388,0.7304733038004196,0.0025647003963627886,0.2845651667055258,0.7154348332944742,0.02576358125437165
16021,44.0,267,9530,9797,18,484,13098,3789,9309,13098,1044,0.02038479157123225,0.7275919987784395,0.001374255611543747,0.2892808062299588,0.7107191937700412,0.036952206443731865
16022,25.0,1222,24917,26139,68,1544,34909,10154,24755,34909,2780,0.03500529949296743,0.7137700879429374,0.0019479217393795296,0.29087054914205507,0.709129450857945,0.044229281847088145
16023,,114,2564,2678,53,172,3696,1039,2657,3696,294,0.030844155844155844,0.6937229437229437,0.01433982683982684,0.2811147186147186,0.7188852813852814,0.046536796536796536
16024,17.0,1209,12159,13368,67,1434,18394,4941,13453,18394,1215,0.06572795476785909,0.6610307709035556,0.003642492116994672,0.26862020223986083,0.7313797977601392,0.07796020441448298
16025,26.0,235,3759,3994,16,527,5759,1541,4218,5759,341,0.04080569543323494,0.6527174856745963,0.0027782601146032295,0.26758117728772357,0.7324188227122764,0.09150894252474388
16026,,571,10492,11063,120,1434,15654,4199,11455,15654,699,0.036476299987223716,0.6702440270857288,0.007665772326561901,0.26823814999361184,0.7317618500063882,0.09160597930241472
16027,23.0,166,2737,2903,12,158,3937,1176,2761,3937,257,0.042164084328168656,0.6951993903987808,0.003048006096012192,0.2987045974091948,0.7012954025908051,0.04013208026416053
16028,15.0,88,2576,2664,30,286,3710,987,2723,3710,152,0.02371967654986523,0.6943396226415094,0.008086253369272238,0.2660377358490566,0.7339622641509433,0.07708894878706199
16029,16.0,73,2095,2168,32,104,3009,833,2176,3009,224,0.024260551678298437,0.6962445995347292,0.010634762379528082,0.2768361581920904,0.7231638418079096,0.03456297773346627
16030,,135,3995,4130,16,129,5436,1606,3830,5436,525,0.024834437086092714,0.734915378955114,0.0029433406916850625,0.29543782192788814,0.7045621780721119,0.023730684326710817
16031,,653,5903,6556,13,274,8656,2471,6185,8656,726,0.07543900184842883,0.6819547134935305,0.0015018484288354898,0.2854667282809612,0.7145332717190388,0.0316543438077634
16032,,413,12923,13336,28,1549,18858,4985,13873,18858,1414,0.02190051967334818,0.6852794569943791,0.0014847809948032665,0.26434404496765296,0.735655955032347,0.08214020574822356
16033,16.0,172,4095,4267,9,128,5611,1680,3931,5611,514,0.030654072357868472,0.7298164320085546,0.0016039921582605597,0.29941186954197113,0.7005881304580289,0.022812332917483514
16034,,40,7450,7490,16,306,9977,2870,7107,9977,1023,0.004009221208780195,0.7467174501353112,0.0016036884835120778,0.28766162172997894,0.712338378270021,0.03067054224716849
16035,,116,3549,3665,24,196,4948,1363,3585,4948,389,0.023443815683104285,0.7172594987873888,0.004850444624090542,0.27546483427647533,0.7245351657235246,0.039611964430072755
16036,16.0,3463,83737,87200,554,4365,114877,32672,82205,114877,8845,0.03014528582745023,0.7289274615458273,0.004822549335376098,0.28440854130940046,0.7155914586905995,0.03799716218216005
16037,23.0,317,8127,8444,19,281,11004,3268,7736,11004,974,0.02880770628862232,0.7385496183206107,0.0017266448564158489,0.296982915303526,0.7030170846964741,0.02553616866593966
16038,35.0,126,2743,2869,8,195,3771,1077,2694,3771,246,0.03341288782816229,0.7273932643861045,0.0021214531954388757,0.2856006364359586,0.7143993635640413,0.05171042163882259
16039,23.0,124,4077,4201,14,149,6346,1631,4715,6346,442,0.019539867633154743,0.6424519382288055,0.002206114087614245,0.25701229120705954,0.7429877087929404,0.02347935707532304
16040,23.0,96,1681,1777,8,99,2358,656,1702,2358,139,0.04071246819338423,0.7128922815945716,0.0033927056827820186,0.2782018659881255,0.7217981340118744,0.04198473282442748
16041,,465,9451,9916,17,496,13250,3818,9432,13250,971,0.03509433962264151,0.7132830188679246,0.0012830188679245284,0.28815094339622643,0.7118490566037736,0.037433962264150945
16042,26.0,929,8091,9020,105,1048,12744,3313,9431,12744,530,0.07289704959196484,0.6348870056497176,0.008239171374764594,0.2599654739485248,0.7400345260514752,0.08223477715003139
16043,,929,13516,14445,37,835,18874,5443,13431,18874,1292,0.0492211507894458,0.7161174101939176,0.0019603687612588746,0.2883861396630285,0.7116138603369715,0.044240754477058386
16044,15.0,156,2720,2876,18,145,3784,1080,2704,3784,317,0.0412262156448203,0.718816067653277,0.0047568710359408035,0.2854122621564482,0.7145877378435518,0.038319238900634246
16045,24.0,5336,57652,62988,428,3319,84605,23745,60860,84605,6306,0.0630695585367295,0.6814254476685775,0.005058802671236925,0.2806571715619644,0.7193428284380355,0.03922935996690503
16046,37.0,953,30263,31216,248,1655,41407,11362,30061,41423,2944,0.0230065422591314,0.7305844579098568,0.005987012046447626,0.27429205996668515,0.7257079400333148,0.039953648938995244
16047,39.0,101,4623,4724,12,183,6181,1794,4387,6181,429,0.01634039799385213,0.7479372269859246,0.001941433425012134,0.29024429703931404,0.709755702960686,0.029606859731435044
16048,,1067,57388,58455,246,2795,77252,22143,55109,77252,6820,0.013811940143944493,0.7428674985760887,0.0031843835758297518,0.2866333557707244,0.7133666442292756,0.03618029306684616
16049,24.0,694,12306,13000,38,1226,17895,4882,13013,17895,1152,0.03878178262084381,0.6876781223805533,0.0021234981838502377,0.27281363509360157,0.7271863649063984,0.06851075719474714
16050,,294,5691,5985,25,358,7988,2284,5704,7988,640,0.036805207811717575,0.7124436654982473,0.003129694541812719,0.28592889334001004,0.71407110665999,0.044817225838758135
16051,24.0,3735,189645,193380,628,7740,253867,73649,180218,253867,21343,0.01471242816120252,0.7470250170364797,0.002473736247720263,0.29010860017253126,0.7098913998274687,0.030488405346106424
16052,17.0,4117,45287,49404,268,6765,71366,18892,52474,71366,5065,0.05768853515679735,0.6345738867247709,0.003755289633719138,0.26471989462769385,0.7352801053723061,0.09479303870190287
16053,,377,9707,10084,47,527,13206,3849,9357,13206,896,0.02854762986521278,0.7350446766621233,0.003558988338633954,0.2914584279872785,0.7085415720127215,0.03990610328638498
16054,,147,2485,2632,5,343,3694,1007,2687,3694,242,0.03979426096372496,0.6727125067677314,0.0013535462912831618,0.27260422306442883,0.7273957769355712,0.0928532755820249
16055,,20,1778,1798,6,37,2342,717,1625,2342,253,0.008539709649871904,0.7591801878736123,0.0025619128949615714,0.30614859094790775,0.6938514090520922,0.015798462852263023
16056,,572,10987,11559,36,598,15838,4397,11441,15838,1071,0.03611567117060235,0.6937113271877763,0.0022730142694784693,0.27762343730268974,0.7223765626973103,0.03775729258744791
16057,24.0,3541,62131,65672,234,3531,86575,24742,61833,86575,5519,0.040900952930984696,0.7176552122437193,0.002702858792954086,0.2857868899797863,0.7142131100202137,0.04078544614496102
16058,23.0,2860,71795,74655,164,3555,98733,28526,70207,98733,7470,0.028967012042579482,0.7271631572017461,0.001661045445798264,0.2889206243100078,0.7110793756899922,0.036006198535444074
16059,24.0,244,3577,3821,44,157,5497,1451,4046,5497,251,0.04438784791704566,0.6507185737675095,0.008004366017827906,0.2639621611788248,0.7360378388211752,0.028561033290885936
16060,17.0,761,9845,10606,14,653,14351,4204,10147,14351,1174,0.05302766357745105,0.6860149118528326,0.0009755417740923977,0.2929412584488886,0.7070587415511114,0.04550205560588112
16061,16.0,109,3873,3982,2,207,5227,1583,3644,5227,419,0.02085326190931701,0.7409603979338052,0.0003826286588865506,0.3028505835087048,0.6971494164912952,0.039602066194757986
16062,26.0,128,4234,4362,3,348,5819,1572,4247,5819,470,0.021996906684997423,0.7276164289396804,0.0005155525004296271,0.27014951022512457,0.7298504897748754,0.05980409004983674
16063,25.0,706,16204,16910,88,1077,23202,6414,16788,23202,1453,0.030428411343849666,0.6983880699939661,0.0037927764847857943,0.2764416860615464,0.7235583139384536,0.04641841220584433
16064,17.0,528,15730,16258,26,805,21390,6154,15236,21390,1937,0.024684431977559606,0.7353903693314633,0.0012155212716222533,0.28770453482935954,0.7122954651706405,0.03763440860215054
16065,,93,3042,3135,2,137,4109,1172,2937,4109,313,0.022633244098320758,0.7403261134095888,0.0004867364322219518,0.2852275492820638,0.7147724507179363,0.0333414456072037
16066,,153,5813,5966,1,223,7803,2308,5495,7803,633,0.0196078431372549,0.7449698833781879,0.00012815583749839805,0.2957836729463027,0.7042163270536973,0.028578751762142765
16067,,81,2729,2810,7,166,3698,1091,2607,3698,295,0.021903731746890212,0.7379664683612763,0.0018929150892374256,0.2950243374797188,0.7049756625202812,0.04488912925905895
16068,37.0,4919,112369,117288,729,6303,161085,44703,116382,161085,11289,0.03053667318496446,0.6975758140112363,0.004525561039202906,0.2775118726138374,0.7224881273861626,0.039128410466523884
16069,16.0,491,7775,8266,41,476,11066,3156,7910,11066,785,0.044370142779685526,0.7026025664196638,0.0037050424724380986,0.28519790348816193,0.714802096511838,0.043014639436110606
16070,14.0,46,22228,22274,56,1287,29855,8302,21553,29855,2367,0.0015407804387874728,0.744531904203651,0.0018757327080890973,0.2780773739742087,0.7219226260257913,0.04310835705911908
16071,,366,2366,2732,7,157,4038,1066,2972,4038,154,0.09063893016344725,0.5859336305101536,0.001733531451213472,0.26399207528479446,0.7360079247152056,0.038880633977216444
16072,24.0,177,4492,4669,35,279,6292,1786,4506,6292,496,0.028130959949141766,0.7139224411951685,0.005562619198982835,0.2838525111252384,0.7161474888747617,0.044342021614748886
16073,23.0,21,10583,10604,42,455,14145,4014,10131,14145,1383,0.0014846235418875928,0.7481795687522093,0.0029692470837751855,0.28377518557794273,0.7162248144220572,0.03216684340756451
16074,17.0,29541,539742,569283,2334,39667,771133,217022,554111,771133,53150,0.03830856674529556,0.6999337338695141,0.0030267152358931597,0.2814326452116561,0.7185673547883439,0.05143989428542158
16075,,247,5319,5566,31,330,7624,2133,5491,7624,631,0.032397691500524656,0.6976652675760755,0.00406610703043022,0.27977439664218257,0.7202256033578174,0.04328436516264428
16076,23.0,861,18448,19309,94,1336,25815,7086,18729,25815,1631,0.03335270191748983,0.7146232810381561,0.003641293821421654,0.2744915746658919,0.7255084253341081,0.051752856866163086
16077,24.0,797,17546,18343,109,1502,25089,6999,18090,25089,1719,0.03176690980110806,0.6993503128861254,0.00434453346087927,0.27896687791462393,0.7210331220853761,0.05986687392881342
16078,13.0,243,8308,8551,7,533,11616,3254,8362,11616,893,0.020919421487603305,0.7152203856749312,0.0006026170798898072,0.28013085399449034,0.7198691460055097,0.04588498622589532
16079,17.0,55,6456,6511,42,762,9058,2488,6570,9058,322,0.006071980569662177,0.7127401192316185,0.00463678516228748,0.27467432104217265,0.7253256789578273,0.08412453080150144
16080,23.0,569,23681,24250,27,1036,32018,9084,22934,32018,2553,0.017771253669810732,0.7396152164407521,0.0008432756574426885,0.283715410081829,0.716284589918171,0.03235679930039353
16081,15.0,1209,21445,22654,32,1048,29604,8744,20860,29604,2186,0.04083907580056749,0.7243953519794623,0.001080935008782597,0.2953654911498446,0.7046345088501554,0.03540062153763005
16082,23.0,2894,54453,57347,193,3003,77789,21659,56130,77789,5127,0.037203203537775266,0.7000089987016159,0.002481070588386533,0.278432683284269,0.721567316715731,0.03860442993225263
16083,,432,101037,101469,1199,6181,139633,38912,100721,139633,10041,0.0030938245257209973,0.7235896958455379,0.008586795385045082,0.2786733795019802,0.7213266204980198,0.04426604026268862
16084,13.0,47,9299,9346,62,1605,14437,3847,10590,14437,1284,0.0032555240008311976,0.6441088868878576,0.0042945210223730695,0.2664681027914387,0.7335318972085614,0.11117268130498026
16085,37.0,249,7760,8009,50,328,10374,2941,7433,10374,690,0.024002313475997687,0.7480239059186428,0.004819741661846925,0.2834972045498361,0.7165027954501638,0.03161750530171583
16086,25.0,933,26645,27578,272,2871,36966,9282,27684,36966,2022,0.02523940918682032,0.7207974895850241,0.007358112860466374,0.251095601363415,0.748904398636585,0.07766596331764324
16087,25.0,1253,94137,95390,365,7132,128373,37531,90842,128373,5970,0.00976061944489885,0.7333084059732187,0.0028432770130790742,0.2923589851448513,0.7076410148551486,0.05555685385556153
16088,16.0,5,5763,5768,32,315,7757,2125,5632,7757,604,0.0006445790898543251,0.7429418589660951,0.00412530617506768,0.2739461131880882,0.7260538868119119,0.04060848266082248
16089,24.0,286,6073,6359,7,243,8292,2377,5915,8292,524,0.034491075735648816,0.732392667631452,0.000844187168355041,0.28666184273999035,0.7133381572600096,0.02930535455861071
16090,14.0,130,2076,2206,14,155,3009,822,2187,3009,208,0.04320372216683283,0.6899302093718843,0.004652708541043536,0.2731804586241276,0.7268195413758723,0.051512130275839146
16091,27.0,8094,178317,186411,287,9242,251185,71871,179314,251185,21374,0.032223261739355455,0.7099030594979796,0.0011425841511236738,0.28612775444393573,0.7138722455560642,0.036793598343850153
16092,,84,4683,4767,12,142,6132,1845,4287,6132,506,0.0136986301369863,0.7636986301369864,0.0019569471624266144,0.300880626223092,0.699119373776908,0.023157208088714937
16093,23.0,69,8752,8821,10,565,11819,3360,8459,11819,1081,0.005838057365259328,0.7405025805905745,0.0008460952703274389,0.2842880108300195,0.7157119891699806,0.0478043827735003
16094,14.0,2568,37676,40244,67,4702,56222,15214,41008,56222,3386,0.0456760698658888,0.6701291309451816,0.0011917043150368183,0.2706058126711963,0.7293941873288037,0.08363274163138985
16095,,7018,136088,143106,780,10065,202675,55988,146687,202675,11259,0.03462686567164179,0.6714592327618107,0.003848525965215246,0.2762452201800913,0.7237547798199088,0.04966078697421981
16096,,147,2233,2380,5,202,3388,912,2476,3388,212,0.04338842975206612,0.6590909090909091,0.0014757969303423849,0.269185360094451,0.730814639905549,0.05962219598583235
16097,25.0,631,14311,14942,71,512,19626,5743,13886,19629,1636,0.03214631412705691,0.7290743287992256,0.0036170971521728057,0.2925773090834989,0.7074226909165011,0.026083855519894034
16098,,794,11936,12730,79,871,17155,4790,12365,17155,1151,0.046283882250072864,0.6957738268726319,0.0046050714077528416,0.2792188866219761,0.7207811133780239,0.05077236957155348
16099,33.0,1259,30115,31374,114,1794,42370,11802,30568,42370,3039,0.02971442058059948,0.7107623318385651,0.0026905829596412557,0.27854614113759735,0.7214538588624027,0.04234127920698608
16100,24.0,1004,28420,29424,146,1451,39690,11157,28533,39690,3110,0.02529604434366339,0.7160493827160493,0.0036785084404132025,0.28110355253212393,0.7188964474678761,0.03655832703451751
16101,,1948,30996,32944,1701,2613,47184,11726,35458,47184,3039,0.04128518141742964,0.6569175991861648,0.03605035605289929,0.2485164462529671,0.7514835537470329,0.055378942014242115
16102,,3592,51588,55180,182,4431,76330,21322,55008,76330,5229,0.047058823529411764,0.6758548408227434,0.0023843835975370102,0.27933970915760514,0.7206602908423949,0.058050569893881826
16103,25.0,106,2704,2810,0,139,3974,1097,2877,3974,321,0.026673376950176145,0.6804227478610971,0.0,0.27604428787116253,0.7239557121288375,0.03497735279315551
16104,,54,1383,1437,7,126,2018,564,1454,2018,153,0.026759167492566897,0.6853320118929633,0.003468780971258672,0.2794846382556987,0.7205153617443013,0.062438057482656094
16105,23.0,121,1900,2021,20,100,2712,778,1934,2712,182,0.044616519174041296,0.700589970501475,0.007374631268436578,0.2868731563421829,0.7131268436578171,0.03687315634218289
16106,16.0,250,7881,8131,1,433,10869,3148,7721,10869,975,0.023001196062195233,0.7250897046646425,9.200478424878094e-05,0.2896310608151624,0.7103689391848376,0.03983807157972215
16107,16.0,276,4106,4382,23,366,6083,1712,4371,6083,338,0.04537234916981753,0.6749958901857636,0.0037810290974847937,0.28144007890843337,0.7185599210915666,0.06016768042084498
16108,23.0,6,3011,3017,9,63,3769,1144,2625,3769,293,0.0015919342000530645,0.7988856460599628,0.0023879013000795966,0.3035287874767843,0.6964712125232158,0.01671530910055718
16109,33.0,1479,36246,37725,201,1890,50032,14435,35597,50032,3341,0.02956108090821874,0.7244563479373202,0.004017428845538855,0.2885153501758874,0.7114846498241125,0.037775823472977296
16110,,672,17523,18195,50,974,24493,6929,17564,24493,1921,0.02743641040297228,0.7154288980525048,0.002041399583554485,0.28289715428898055,0.7171028457110195,0.039766463887641365
16111,17.0,500,27316,27816,7,1422,37132,10776,26356,37132,3363,0.013465474523322201,0.7356458041581385,0.00018851664332651083,0.2902079069266401,0.7097920930733599,0.03829580954432834
16112,25.0,328,8172,8500,50,455,11247,3243,8004,11247,792,0.029163332444207345,0.7265937583355562,0.0044456299457633144,0.2883435582822086,0.7116564417177914,0.040455232506446163
16113,,2709,48159,50868,303,2391,69054,19590,49464,69054,4964,0.03923016769484751,0.6974107220436181,0.004387870362325137,0.2836910244156747,0.7163089755843253,0.03462507602745677
16114,,117,2049,2166,7,201,2950,842,2108,2950,178,0.03966101694915254,0.6945762711864407,0.0023728813559322033,0.2854237288135593,0.7145762711864406,0.06813559322033898
16115,,403,48675,49078,83,3522,66546,18578,47968,66546,5750,0.006055961289934782,0.7314489225498152,0.001247257536140414,0.27917530730622425,0.7208246926937757,0.052925795690199263
16116,,448,10381,10829,380,701,15030,4206,10824,15030,1071,0.02980705256154358,0.6906852960745177,0.025282767797737856,0.27984031936127746,0.7201596806387226,0.04664005322687957
16117,24.0,789,23884,24673,57,1098,32178,9424,22754,32178,2231,0.02451985828827149,0.7422462552054199,0.0017713966063770278,0.2928709055876686,0.7071290944123314,0.03412269252284169
16118,16.0,791,18995,19786,44,1032,26855,7812,19043,26855,1940,0.02945447775088438,0.7073170731707317,0.0016384285980264382,0.2908955501768758,0.7091044498231241,0.038428598026438276
16119,25.0,90,2344,2434,7,113,3174,954,2220,3174,271,0.02835538752362949,0.7385003150598614,0.002205419029615627,0.3005671077504726,0.6994328922495274,0.03560176433522369
16120,33.0,1851,57227,59078,169,2245,76638,22564,54074,76638,5731,0.024152509199091836,0.7467183381612255,0.002205172368798768,0.29442313212766513,0.7055768678723349,0.029293561940551684
16121,,2070,39828,41898,212,2028,55586,15952,39634,55586,4030,0.03723959270319865,0.716511351779225,0.003813909977332422,0.28697873565286225,0.7130212643471378,0.03648400676429317
16122,17.0,83,1638,1721,3,123,2358,651,1707,2358,165,0.035199321458863446,0.6946564885496184,0.001272264631043257,0.27608142493638677,0.7239185750636132,0.05216284987277354
16123,13.0,711,8637,9348,67,917,13153,3565,9588,13153,868,0.05405610887250057,0.6566562761347221,0.005093894928913556,0.27104082718771383,0.7289591728122862,0.06971793507184673
16124,25.0,356,17674,18030,17,863,23258,7161,16097,23258,1758,0.015306561183248775,0.7599105684065698,0.0007309312924585089,0.3078940579585519,0.6921059420414482,0.03710551208186431
16125,23.0,195,3055,3250,1,142,4357,1238,3119,4357,269,0.044755565756254306,0.7011705301813175,0.00022951572182694515,0.2841404636217581,0.715859536378242,0.03259123249942621
16126,13.0,4650,48030,52680,534,4696,77411,19727,57684,77411,4778,0.060068982444355455,0.6204544573768586,0.006898244435545336,0.25483458423221506,0.7451654157677849,0.060663213238428645
16127,,743,16226,16969,53,682,22416,6377,16039,22416,1628,0.03314596716630978,0.7238579586009993,0.002364382583868665,0.2844842969307637,0.7155157030692363,0.03042469664525339
16128,23.0,314,3895,4209,44,281,5849,1659,4190,5849,275,0.05368439049410156,0.6659257992819285,0.007522653445033339,0.28363822875705247,0.7163617712429475,0.04804240041032655
16129,15.0,201,5132,5333,20,268,7179,2059,5120,7179,552,0.027998328458002507,0.7148627942610392,0.002785903329154478,0.28680874773645354,0.7131912522635464,0.03733110461067001
16130,17.0,443,19879,20322,105,2992,28358,7436,20922,28358,1751,0.01562169405458777,0.7010014810635447,0.0037026588616968755,0.2622187742435997,0.7377812257564003,0.10550814584949574
16131,,266,7954,8220,38,347,10688,3136,7552,10688,890,0.024887724550898202,0.7441991017964071,0.003555389221556886,0.2934131736526946,0.7065868263473054,0.03246631736526946
16132,14.0,250,5500,5750,26,430,7907,2259,5648,7907,667,0.031617554066017454,0.6955861894523839,0.003288225622865815,0.28569621854053373,0.7143037814594663,0.054382192993550016
16133,40.0,279,3437,3716,16,116,4937,1472,3465,4937,264,0.05651205185335224,0.6961717642292891,0.0032408345148875837,0.2981567753696577,0.7018432246303423,0.02349605023293498
16134,37.0,505,13946,14451,481,782,20537,5397,15140,20537,1558,0.024589764814724642,0.6790670497151483,0.023421142328480304,0.26279398159419587,0.7372060184058041,0.03807761601012806
16135,,98,1604,1702,13,62,2329,659,1670,2329,192,0.0420781451266638,0.6887075998282525,0.0055817947617003,0.2829540575354229,0.7170459424645771,0.026620867325032202
16136,26.0,148,2846,3000,11,203,4111,1155,2956,4111,261,0.03600097299927025,0.6922889807832644,0.002675747993189005,0.2809535392848455,0.7190464607151544,0.049379712965215275
16137,25.0,122,4484,4606,0,48,6335,1831,4504,6335,502,0.01925808997632202,0.7078137332280978,0.0,0.2890292028413575,0.7109707971586424,0.007576953433307025
16138,,182,4932,5114,4,224,6906,1967,4939,6906,567,0.026353895163625834,0.7141615986099045,0.0005792064871126556,0.28482479003764843,0.7151752099623516,0.03243556327830872
16139,,729,20061,20790,123,945,27309,7940,19369,27309,2043,0.02669449631989454,0.7345929913215423,0.0045040096671427,0.29074664030173203,0.709253359698268,0.034603976710974406
16140,,283,9645,9928,63,344,12621,3796,8825,12621,866,0.022422945883844386,0.7642025196101735,0.004991680532445923,0.300768560335948,0.699231439664052,0.02725616036764123
16141,,667,18656,19323,101,765,25058,7400,17658,25058,1744,0.026618245670045493,0.7445127304653204,0.00403064889456461,0.2953148695027536,0.7046851304972463,0.030529172320217096
16142,,55,1507,1562,3,115,2132,566,1566,2132,142,0.025797373358348967,0.7068480300187617,0.0014071294559099437,0.2654784240150094,0.7345215759849906,0.053939962476547844
16143,17.0,943,23261,24402,184,1227,32483,9095,23388,32483,2357,0.029030569836529876,0.7160976510790259,0.005664501431518025,0.2799926115198719,0.720007388480128,0.03777360465474248
16144,27.0,145,2720,2865,33,114,3740,1107,2633,3740,284,0.03877005347593583,0.7272727272727273,0.008823529411764706,0.2959893048128342,0.7040106951871657,0.03048128342245989
16145,,107,2817,2924,1,131,3847,1138,2709,3847,239,0.02781388094619184,0.7322589030413309,0.0002599428125812321,0.29581492071744214,0.7041850792825578,0.03405250844814141
16146,,244,3913,4157,4,228,5687,1558,4129,5687,394,0.04290487075786882,0.6880604888341832,0.000703358537014243,0.27395815016704766,0.7260418498329524,0.040091436609811855
16147,45.0,5563,92117,97680,715,8401,136253,37293,98960,136253,8120,0.040828458822925,0.6760731873793605,0.005247590878732946,0.27370406523159124,0.7262959347684088,0.061657358003126536
16148,17.0,83,2824,2907,21,139,3904,1113,2791,3904,313,0.021260245901639344,0.7233606557377049,0.005379098360655738,0.2850922131147541,0.7149077868852459,0.03560450819672131
16149,27.0,313,9413,9726,60,557,12856,3767,9089,12856,1022,0.024346608587429992,0.73218730553827,0.004667081518357187,0.29301493466085876,0.7069850653391413,0.04332607342874922
16150,,274,9545,9819,86,657,13171,3730,9441,13171,983,0.020803279933186546,0.7246982005922101,0.00652949662136512,0.28319793485688255,0.7168020651431175,0.04988231721205679
16151,24.0,254,5370,5628,30,323,7926,2143,5783,7926,613,0.03204642947262175,0.6775170325510976,0.003785011355034065,0.27037597779460004,0.7296240222053999,0.0407519555892001
16152,16.0,436,6047,6483,60,438,9875,2428,7447,9875,645,0.044151898734177214,0.6123544303797468,0.0060759493670886075,0.245873417721519,0.7541265822784811,0.04435443037974684
16153,24.0,125,4178,4303,19,158,5554,1582,3972,5554,403,0.022506301764494058,0.7522506301764494,0.0034209578682030967,0.2848397551314368,0.7151602448685632,0.02844796543032049
16154,,513,15204,15717,22,706,20593,5883,14710,20593,1596,0.0249113776526004,0.738309134171806,0.0010683241878308163,0.28567959986403146,0.7143204001359685,0.03428349439129801
16155,26.0,437,14051,14488,10,618,18975,5550,13425,18975,1486,0.02303030303030303,0.7405006587615284,0.0005270092226613965,0.2924901185770751,0.7075098814229249,0.032569169960474306
16156,27.0,177,4606,4783,63,908,7783,1734,6049,7783,398,0.022741873313632276,0.5918026467942953,0.008094565077733522,0.2227932673776179,0.7772067326223822,0.11666452524733394
16157,,224,3377,3601,0,159,5053,1365,3688,5053,285,0.04433010093014051,0.6683158519691272,0.0,0.27013655254304375,0.7298634474569563,0.03146645557094795
16158,,140,2784,2924,2,151,3903,1118,2785,3903,316,0.035869843709966695,0.7132974634896234,0.0005124263387138099,0.2864463233410197,0.7135536766589803,0.03868818857289265
16159,17.0,524,2671,3396,91,858,5510,1026,4495,5521,168,0.09491034232928817,0.48378916862887156,0.016482521282376383,0.18583589929360622,0.8141641007063938,0.15540662923383444
16160,,114,1938,2052,8,189,2858,782,2076,2858,157,0.03988803358992302,0.6780965710286914,0.0027991602519244225,0.2736179146256123,0.7263820853743876,0.06613016095171449
16161,,83,2020,2103,27,82,2800,813,1987,2800,221,0.029642857142857144,0.7214285714285714,0.009642857142857142,0.29035714285714287,0.7096428571428571,0.029285714285714286
16162,15.0,58,1644,1702,1,45,2286,659,1627,2286,231,0.02537182852143482,0.7191601049868767,0.0004374453193350831,0.2882764654418198,0.7117235345581803,0.01968503937007874
16163,37.0,361,11718,12079,23,437,15444,4600,10844,15444,1065,0.023374773374773374,0.7587412587412588,0.0014892514892514892,0.2978502978502979,0.7021497021497022,0.028295778295778295
16164,14.0,384,17837,18221,16,572,22780,6975,15805,22780,1425,0.016856892010535557,0.7830114135206321,0.0007023705004389816,0.3061896400351185,0.6938103599648815,0.02510974539069359
16165,,590,8890,9480,3,604,12737,3629,9108,12737,856,0.04632173981314281,0.6979665541336264,0.00023553427023631938,0.28491795556253435,0.7150820444374657,0.047420899740912306
16166,,234,3792,4026,44,497,5590,1520,4070,5590,345,0.04186046511627907,0.6783542039355993,0.007871198568872988,0.27191413237924866,0.7280858676207513,0.0889087656529517
16167,,499,7654,8153,2,188,10489,2987,7502,10489,702,0.0475736485842311,0.7297168462198493,0.00019067594622938316,0.28477452569358375,0.7152254743064163,0.017923538945562017
16168,25.0,1408,38988,40396,213,1570,52502,15370,37132,52502,3766,0.02681802597996267,0.742600281894023,0.004056988305207421,0.29275075235229137,0.7072492476477087,0.02990362271913451
16169,27.0,1001,11900,12901,60,617,17993,4849,13144,17993,1089,0.0556327460679153,0.6613683098982938,0.003334630133940977,0.26949369199132994,0.73050630800867,0.034291113210693044
16170,16.0,385,8786,9171,30,416,12059,3504,8555,12059,913,0.03192636205323825,0.7285844597396136,0.0024877684716809022,0.2905713574923294,0.7094286425076706,0.034497056140641844
16171,15.0,281,7053,7334,16,384,9760,2699,7061,9760,712,0.028790983606557376,0.7226434426229508,0.001639344262295082,0.27653688524590164,0.7234631147540984,0.03934426229508197
16172,13.0,1205,17058,18263,70,1418,24845,6948,17897,24845,1587,0.04850070436707587,0.6865767760112699,0.002817468303481586,0.2796538538941437,0.7203461461058563,0.05707385791909841
16173,17.0,573,18193,18766,43,496,24779,7207,17572,24779,1769,0.023124419871665525,0.734210420113806,0.0017353404092174825,0.2908511239355906,0.7091488760644094,0.020016949836555147
16174,44.0,90,2639,2729,13,105,3518,1025,2493,3518,268,0.025582717453098352,0.7501421262080727,0.003695281409891984,0.29135872654917566,0.7086412734508243,0.02984650369528141
16175,16.0,713,33467,34234,351,1977,45679,12563,33116,45679,3220,0.015608923137546794,0.73265614396112,0.007684056130825981,0.275027912169706,0.724972087830294,0.043280281967643774
16176,13.0,447,8607,9054,32,585,12173,3423,8750,12173,921,0.036720611188696295,0.707056600673622,0.002628768586215395,0.281196089706728,0.718803910293272,0.04805717571675019
16177,24.0,2759,68297,71056,377,3117,92619,27082,65537,92619,6056,0.029788704261544608,0.737397294291668,0.00407043911076561,0.2924022068905948,0.7075977931094052,0.03365400187866421
16178,17.0,1092,28933,30025,21,816,38225,11451,26793,38244,2790,0.028553498588013804,0.7565369731199665,0.0005491057420771886,0.29941951678694695,0.700580483213053,0.021336680263570756
16179,,116,3022,3138,12,80,4113,1226,2887,4113,302,0.028203257962557744,0.7347434962314612,0.0029175784099197666,0.29807926088013614,0.7019207391198639,0.019450522732798445
16180,,659,17106,17765,33,929,23239,6698,16541,23239,1635,0.02835750247428891,0.7360901932096906,0.001420026679289126,0.288222384784199,0.7117776152158011,0.03997590257756358
16181,,179,4612,4791,28,320,6321,1804,4517,6321,363,0.028318304065812372,0.7296313874386964,0.004429678848283499,0.28539788008226546,0.7146021199177346,0.050624901123239995
16182,23.0,152,2933,3085,10,133,4106,1195,2911,4106,317,0.037018996590355575,0.7143205065757429,0.0024354603019970775,0.29103750608865075,0.7089624939113492,0.03239162201656113
16183,13.0,146,3604,3750,27,411,5455,1437,4018,5455,385,0.026764436296975253,0.6606782768102658,0.004949587534372136,0.2634280476626948,0.7365719523373052,0.07534372135655362
16184,23.0,759,21249,22008,4,1491,30118,8483,21635,30118,2446,0.025200876552227903,0.705524935254665,0.00013281094362175444,0.2816588086858357,0.7183411913141643,0.04950527923500896
16185,,1136,15770,16952,333,1255,23297,6380,16917,23297,1082,0.04876164313001674,0.6769111902820105,0.014293685882302442,0.2738550027900588,0.7261449972099412,0.053869596943812506
16186,23.0,1455,40550,42005,276,2366,55418,15835,39583,55418,3717,0.026255007398318236,0.7317117182142986,0.0049803313002995415,0.2857374860153741,0.7142625139846259,0.04269370962503158
16187,23.0,9,2230,2239,0,128,2973,860,2113,2973,260,0.0030272452068617556,0.7500840901446351,0.0,0.2892700975445678,0.7107299024554322,0.04305415405314497
16188,15.0,241,7331,7572,90,461,10338,2851,7487,10338,919,0.023312052621396788,0.7091313600309538,0.008705745792222866,0.2757786805958599,0.72422131940414,0.044592764557941575
16189,13.0,134,2222,2356,8,359,3445,865,2580,3445,199,0.038896952104499276,0.6449927431059507,0.0023222060957910013,0.251088534107402,0.7489114658925979,0.10420899854862119
16190,24.0,13671,332486,346157,1402,15129,454395,132127,322274,454401,32210,0.030085761254926815,0.7317017348113231,0.003085380533933684,0.2907718072803537,0.7092281927196463,0.03329438095426727
16191,,5191,28069,33260,437,4971,47605,12487,35118,47605,1381,0.10904316773448167,0.5896229387669363,0.00917970801386409,0.26230437979203863,0.7376956202079613,0.10442180443230753
16192,14.0,356,6526,6882,32,786,9523,2319,7204,9523,622,0.037383177570093455,0.6852882495012076,0.0033602856242780635,0.2435156988344009,0.7564843011655991,0.08253701564632994
16193,,60,1865,1925,25,78,2561,723,1838,2561,212,0.02342834830144475,0.7282311597032409,0.009761811792268645,0.2823115970324092,0.7176884029675907,0.030456852791878174
16194,17.0,198,3578,3776,50,557,5453,1406,4047,5453,230,0.03631028791490922,0.6561525765633596,0.009169264624977077,0.2578397212543554,0.7421602787456446,0.10214560792224464
16195,,232,13261,13493,0,516,18091,5144,12947,18091,1614,0.012824056160521806,0.7330164170029296,0.0,0.284340279697087,0.715659720302913,0.028522469736332982
16196,13.0,187,2459,2646,19,233,3672,978,2694,3672,202,0.05092592592592592,0.6696623093681917,0.0051742919389978215,0.26633986928104575,0.7336601307189542,0.06345315904139434
16197,16.0,2446,59279,61725,118,4760,84001,23763,60238,84001,5919,0.02911870096784562,0.7056939798335734,0.0014047451816049808,0.28288948941084036,0.7171105105891596,0.05666599207152296
16198,24.0,440,5753,6193,16,433,8391,2439,5952,8391,635,0.052437135025622694,0.6856155404600167,0.0019068049100226434,0.2906685734715767,0.7093314265284233,0.05160290787748779
16199,,222,9085,9307,28,712,12628,3564,9064,12628,976,0.017579980994615142,0.7194330060183719,0.0022172949002217295,0.28222996515679444,0.7177700348432056,0.05638264174849541
16200,26.0,142,4735,4877,9,160,6286,1876,4410,6286,447,0.02258988227807827,0.7532612153993,0.0014317531021317213,0.2984409799554566,0.7015590200445434,0.025453388482341712
16201,16.0,9,1898,1907,8,104,2480,730,1750,2480,186,0.0036290322580645163,0.7653225806451613,0.0032258064516129032,0.29435483870967744,0.7056451612903226,0.041935483870967745
16202,,109,3387,3496,27,188,4523,1339,3184,4523,311,0.024099049303559585,0.7488392659739112,0.0059694892770285205,0.29604244970152555,0.7039575502984745,0.041565332743754145
16203,,614,13236,13850,17,675,18711,5390,13321,18711,1562,0.03281492170381059,0.7073913740580408,0.0009085564641120197,0.2880658436213992,0.7119341563786008,0.03607503607503607
16204,,284,4194,4478,87,189,5997,1722,4275,5997,390,0.04735701183925296,0.6993496748374187,0.014507253626813406,0.28714357178589295,0.7128564282141071,0.03151575787893947
16205,,753,24875,25628,195,1465,33636,9546,24090,33636,2643,0.02238672850517303,0.7395350220002378,0.005797359971459151,0.2838030681412772,0.7161969318587228,0.04355452491378285
16206,43.0,531,15109,15640,70,403,20862,5871,14991,20862,1901,0.02545297670405522,0.7242354520180232,0.0033553829930016298,0.2814207650273224,0.7185792349726776,0.019317419231137955
16207,23.0,151,4156,4307,15,280,5938,1517,4421,5938,414,0.025429437521050858,0.6998989558773998,0.002526103065005052,0.25547322330751093,0.744526776692489,0.04715392388009431
16208,25.0,756,9890,10646,36,844,14334,3978,10362,14340,832,0.052719665271966525,0.689679218967922,0.002510460251046025,0.2774058577405858,0.7225941422594142,0.05885634588563459
16209,,89,2673,2762,7,86,3785,1056,2729,3785,349,0.023513870541611626,0.7062087186261559,0.0018494055482166448,0.278996036988111,0.7210039630118891,0.02272126816380449
16210,23.0,998,27520,28518,372,1611,38051,11035,27016,38051,2613,0.026227957215316285,0.7232398622900844,0.009776352789677012,0.29000551890883286,0.7099944810911671,0.0423379149036819
16211,,207,5778,5985,109,284,7986,2188,5798,7986,422,0.025920360631104433,0.7235161532682194,0.013648885549711996,0.2739794640621087,0.7260205359378913,0.035562233909341344
16212,,675,13814,14489,114,848,19925,5389,14536,19925,1456,0.033877038895859475,0.6932998745294856,0.005721455457967378,0.2704642409033877,0.7295357590966123,0.042559598494353826
16213,23.0,1216,23676,24892,185,1303,32576,9467,23109,32576,2102,0.03732809430255403,0.7267927308447937,0.005679027504911591,0.290612721021611,0.709387278978389,0.0399987721021611
16214,17.0,183,3953,4145,4,365,5562,1558,4004,5562,326,0.03290183387270766,0.7107155699388709,0.000719165767709457,0.2801150665228335,0.7198849334771665,0.06562387630348795
16215,25.0,2570,74835,77405,89,3218,101553,29610,71943,101553,7909,0.025306982560830305,0.7369058521166287,0.0008763896684489872,0.29157188857050015,0.7084281114294999,0.03168788711313304
16216,16.0,578,15263,15850,43,1020,21123,6080,15043,21123,1475,0.027363537376319653,0.722577285423472,0.0020356956871656487,0.2878379018131894,0.7121620981868105,0.04828859536997586
16217,14.0,330,4410,4740,19,289,6459,1770,4689,6459,448,0.05109150023223409,0.6827682303762193,0.002941631831552872,0.27403622851834647,0.7259637714816535,0.044743768385198945
16218,,355,6448,6803,58,316,9438,2554,6884,9438,522,0.03761390125026488,0.6831955922865014,0.006145369781733418,0.2706081796990888,0.7293918203009112,0.033481669845306206
16219,24.0,115,3192,3307,5,84,4418,1266,3152,4418,416,0.026029877772747848,0.7224988682661838,0.0011317338162064282,0.28655500226346764,0.7134449977365324,0.019013128112267994
16220,25.0,4000,90213,94213,394,4248,125498,35952,89546,125498,9688,0.03187301789669955,0.7188401408787392,0.0031394922628249057,0.28647468485553557,0.7135253151444645,0.03384914500629492
16221,24.0,202,5577,5779,76,254,10224,2259,7965,10224,633,0.019757433489827857,0.545481220657277,0.007433489827856025,0.22095070422535212,0.7790492957746479,0.024843505477308295
16222,13.0,2272,31181,33453,835,2766,47464,12421,35043,47464,2550,0.047867857744817124,0.6569399966290241,0.017592280465194673,0.26169307264453057,0.7383069273554694,0.058275745828417325
16223,38.0,249,2180,2429,20,145,3429,881,2548,3429,145,0.0726159230096238,0.6357538641003208,0.0058326042578011085,0.2569262175561388,0.7430737824438611,0.04228638086905803
16224,23.0,295,5976,6271,39,338,8420,2407,6013,8420,692,0.03503562945368171,0.7097387173396674,0.004631828978622327,0.2858669833729216,0.7141330166270784,0.040142517814726844
16225,25.0,5106,134630,139736,662,8098,201122,53608,147514,201122,13792,0.0253875757003212,0.6693946957568043,0.00329153449150267,0.2665446843209594,0.7334553156790405,0.04026411829635743
16226,26.0,1126,37500,38626,87,1584,51138,14965,36173,51138,3918,0.02201885095232508,0.733309867417576,0.0017012788924087763,0.29263952442410734,0.7073604755758927,0.030975008799718408
16227,13.0,531,9728,10259,45,2937,15701,3657,12044,15701,803,0.03381950194255143,0.6195783708044074,0.0028660594866569008,0.23291510094898413,0.7670848990510158,0.18705814916247374
16228,,123,6732,6855,29,480,9187,2687,6500,9187,682,0.013388483727005551,0.7327745727658648,0.0031566343746598454,0.292478502231414,0.7075214977685861,0.0522477413736802
16229,,3596,78730,82326,369,2890,109862,31226,78636,109862,7711,0.032731972838652125,0.7166263130108682,0.0033587591705958385,0.2842293058564381,0.7157706941435619,0.026305729005479603
16230,16.0,454,9335,9789,54,287,12585,3655,8930,12585,904,0.03607469209376241,0.7417560588001589,0.004290822407628129,0.29042510925705206,0.709574890742948,0.02280492649980135
16231,,2204,27227,29431,125,1741,41527,11281,30246,41527,2442,0.05307390372528716,0.6556457244684182,0.003010089821080261,0.2716545861728514,0.7283454138271486,0.041924531028005876
16232,15.0,313,6634,6947,12,423,9529,2666,6863,9529,660,0.032847098331409384,0.6961905761360059,0.001259313674047644,0.27977752125091826,0.7202224787490817,0.04439080701017945
16233,24.0,276,5500,5776,102,320,8289,2249,6040,8289,567,0.03329714078899747,0.6635299794908915,0.012305465074194716,0.27132344070454817,0.7286765592954518,0.0386053806249246
16234,,457,9928,10385,64,550,13614,3914,9700,13614,866,0.0335683854855296,0.7292493021889231,0.0047010430439253705,0.287498163655061,0.712501836344939,0.04039958865873366
16235,,86,10045,10131,46,520,13346,3884,9462,13346,977,0.00644387831560018,0.7526599730256257,0.0034467256106698635,0.2910235276487337,0.7089764723512663,0.03896298516409411
16236,16.0,1744,21532,23276,166,1702,32048,8817,23231,32048,2011,0.054418372441337994,0.6718671992011982,0.00517973040439341,0.2751185721417873,0.7248814278582126,0.05310783824263605
16237,16.0,874,18278,19152,104,668,25308,7279,18029,25308,2084,0.03453453453453453,0.7222222222222222,0.004109372530425162,0.2876165639323534,0.7123834360676466,0.02639481586850008
16238,24.0,505,5652,6157,57,358,8191,2313,5878,8191,577,0.06165303381760469,0.6900256378952508,0.006958857282383104,0.2823831034061775,0.7176168965938224,0.0437065071419851
16239,,596,23466,24062,33,1079,30983,9024,21959,30983,2137,0.019236355420714585,0.7573830810444437,0.0010651002162476197,0.2912564954975309,0.7087435045024691,0.03482554949488429
16240,,7206,185660,192866,634,8626,255802,73237,182565,255802,17429,0.028170225408714552,0.7257957326369614,0.002478479448948796,0.2863034690893738,0.7136965309106262,0.03372139389058725
16241,17.0,329,10026,10355,84,365,13474,4116,9358,13474,1011,0.0244173964672703,0.7440997476621641,0.006234228885260502,0.30547721537776457,0.6945227846222354,0.027089208846667656
16242,48.0,7047,144690,151737,1464,5622,199417,58331,141088,199419,11981,0.0353376558903615,0.7255577452499511,0.00734132655363832,0.29250472622969725,0.7074952737703027,0.02819189746212748
16243,14.0,24,1966,1990,54,192,2931,736,2195,2931,167,0.008188331627430911,0.6707608324803821,0.01842374616171955,0.2511088365745479,0.748891163425452,0.06550665301944729
16244,,332,13049,13381,49,435,17253,5116,12137,17253,1459,0.019243030197646786,0.7563322320755811,0.002840085782182809,0.2965281400336173,0.7034718599663826,0.025213006433663712
16245,17.0,156,5752,5908,36,414,8201,2274,5927,8201,614,0.01902207047920985,0.7013778807462504,0.0043897085721253505,0.2772832581392513,0.7227167418607486,0.05048164857944153
16246,16.0,316,5593,5909,6,360,8106,2263,5843,8106,520,0.038983469035282506,0.6899827288428325,0.0007401924500370096,0.2791759190722921,0.7208240809277079,0.04441154700222058
16247,27.0,2224,44926,47150,700,2269,62888,17770,45118,62888,4285,0.03536445744816181,0.7143811219946572,0.011130899376669634,0.28256583131917057,0.7174341686808294,0.03608001526523343
16248,16.0,1100,10921,12021,182,589,16453,4488,11966,16454,1070,0.06685304485231555,0.6637291843928528,0.011061140148292209,0.2727604229974474,0.7272395770025526,0.03579676674364896
16249,23.0,272,4187,4459,159,346,6282,1677,4605,6282,321,0.04329831263928685,0.6665074816937281,0.025310410697230182,0.26695319961795605,0.733046800382044,0.05507800063673989
16250,16.0,1458,11933,13391,72,1472,20037,4967,15070,20037,1094,0.07276538403952687,0.5955482357638369,0.003593352298248241,0.2478914009083196,0.7521085990916804,0.07346409143085292
16251,,554,8858,9412,77,612,13315,3568,9747,13315,893,0.041607209913631246,0.6652647390161472,0.00578295155839279,0.26796845662786334,0.7320315433721367,0.045963199399173864
16252,,37,1685,1722,2,53,2259,657,1602,2259,194,0.01637892872952634,0.7459052678176185,0.0008853474988933156,0.2908366533864542,0.7091633466135459,0.023461708720672863
16253,,26294,693155,719449,4107,35285,977699,275663,702036,977699,66620,0.02689375769025027,0.7089656428000847,0.004200679350188555,0.28195078444388305,0.718049215556117,0.03608983951093332
16254,24.0,89,2163,2252,49,111,3092,876,2216,3092,235,0.028783958602846053,0.6995472186287193,0.015847347994825355,0.2833117723156533,0.7166882276843467,0.03589909443725744
16255,,83,1729,1812,5,89,2487,693,1794,2487,165,0.03337354242058705,0.6952151186168074,0.002010454362685967,0.27864897466827504,0.721351025331725,0.03578608765581021
16256,,738,20466,21204,296,2238,30239,7803,22436,30239,1473,0.024405568967227752,0.6768080955058038,0.00978868348821059,0.25804424749495686,0.7419557525050432,0.0740103839412679
16257,23.0,31,6274,6305,43,437,8500,2349,6151,8500,643,0.0036470588235294117,0.7381176470588235,0.005058823529411765,0.2763529411764706,0.7236470588235294,0.05141176470588235
16258,,137,3893,4030,13,103,5223,1563,3660,5223,472,0.026230135937200843,0.7453570744782692,0.002488991001340226,0.29925330269959793,0.7007466973004021,0.019720467164464867
16259,15.0,266,4734,5000,20,357,6794,1935,4859,6794,511,0.039152193111569034,0.6967912864292022,0.0029437739181630853,0.2848101265822785,0.7151898734177216,0.05254636443921107
16260,33.0,3410,81358,84768,353,3996,113969,31910,82059,113969,8010,0.029920416955487895,0.7138607867051566,0.003097333485421474,0.279988417903114,0.720011582096886,0.035062166027603994
16261,17.0,265,7916,8181,13,313,10714,3123,7591,10714,858,0.024733992906477507,0.7388463692365129,0.0012133656897517268,0.2914877730072802,0.7085122269927198,0.029214112376330037
16262,17.0,185,3341,3526,28,146,4718,1398,3320,4718,317,0.03921153030945316,0.7081390419669351,0.005934718100890208,0.29631199660873253,0.7036880033912675,0.030945315811784654
16263,,83,2357,2440,10,96,3462,938,2524,3462,272,0.023974581166955517,0.6808203350664356,0.0028885037550548816,0.2709416522241479,0.7290583477758521,0.02772963604852686
16264,24.0,3162,71763,74925,230,3089,96219,28621,67618,96239,6584,0.03285570298943256,0.7456748303702241,0.002389883519155436,0.29739502696412057,0.7026049730358794,0.03209717474204844
16265,,464,10988,11452,32,458,15183,4359,10824,15183,1160,0.030560495290785746,0.7237041427912797,0.0021076203648817756,0.28709741157873936,0.7129025884212606,0.030165316472370415
16266,16.0,5604,100674,106278,3002,8674,140033,37592,102441,140033,5437,0.04001913834596131,0.7189305378018038,0.02143780394621268,0.2684510079766912,0.7315489920233088,0.06194254211507288
16267,41.0,288,7899,8187,9,312,10655,3105,7550,10655,797,0.027029563585171282,0.7413420929141248,0.0008446738620366026,0.29141248240262785,0.7085875175973722,0.02928202721726889
16268,33.0,866,9878,10744,37,302,14187,3997,10190,14187,1164,0.06104179882991471,0.6962712342285191,0.0026080214280679494,0.281736801296962,0.718263198703038,0.021287093818284347
16269,14.0,15,8404,8419,158,253,11519,3192,8327,11519,1063,0.0013021963712127789,0.7295772202448129,0.01371646844344127,0.27710738779407934,0.7228926122059206,0.02196371212778887
16270,,401,4430,4831,36,218,6381,1840,4541,6381,450,0.06284281460586115,0.6942485503839524,0.005641748942172073,0.2883560570443504,0.7116439429556496,0.03416392414981978
16271,14.0,325,4806,5131,3,582,7035,1921,5114,7035,390,0.04619758351101635,0.6831556503198294,0.00042643923240938164,0.2730632551528074,0.7269367448471926,0.08272921108742004
16272,,1858,48413,50271,283,2288,67473,19374,48099,67473,5188,0.02753694070220681,0.7175166362841433,0.004194270300712878,0.2871370770530434,0.7128629229469565,0.033909860240392456
16273,42.0,253,5349,5602,20,236,7401,2135,5266,7401,543,0.03418456965274963,0.7227401702472639,0.0027023375219564923,0.2884745304688556,0.7115254695311445,0.03188758275908661
16274,26.0,884,41830,42714,86,1626,53922,16526,37396,53922,4026,0.016394050665776493,0.7757501576351026,0.001594896331738437,0.30647972998034195,0.693520270019658,0.030154667853566262
16275,,832,14846,15678,15,855,21155,6041,15114,21155,1594,0.03932876388560624,0.7017726305837864,0.0007090522335145356,0.28555896951075393,0.714441030489246,0.040415977310328526
16276,,349,6798,7147,42,616,9930,2676,7254,9930,723,0.035146022155085596,0.6845921450151058,0.004229607250755287,0.26948640483383685,0.7305135951661631,0.06203423967774421
16277,,86,1740,1826,3,88,2458,670,1788,2458,170,0.03498779495524817,0.7078925956061839,0.0012205044751830757,0.2725793327908869,0.7274206672091131,0.03580146460537022
16278,15.0,186,3302,3488,45,156,4821,1295,3526,4821,370,0.038581207218419414,0.6849201410495748,0.009334163036714374,0.26861646961211366,0.7313835303878863,0.03235843186060983
16279,,285,6530,6815,28,2035,13039,2387,10652,13039,376,0.02185750440984738,0.5008052764782576,0.0021474039420200934,0.18306618605721298,0.816933813942787,0.15607025078610323
16280,,476,12950,13426,30,622,17783,5020,12763,17783,1338,0.02676713715346117,0.7282235843221054,0.0016870044424450318,0.28229207670246864,0.7177079232975313,0.034977225440026995
16281,16.0,760,17029,17789,222,772,23468,6702,16766,23468,1608,0.03238452360661326,0.7256263848644964,0.009459689790352822,0.2855803647520027,0.7144196352479972,0.032895858189875574
16282,,94,3456,3550,4,103,4520,1401,3119,4520,340,0.02079646017699115,0.7646017699115044,0.0008849557522123894,0.30995575221238936,0.6900442477876106,0.022787610619469028
16283,,539,9431,9970,30,700,13390,3799,9591,13390,1019,0.040253920836445106,0.7043315907393577,0.0022404779686333084,0.2837191934279313,0.7162808065720687,0.05227781926811053
16284,14.0,208,2612,2820,29,314,4018,1095,2923,4018,218,0.051767048282727726,0.6500746640119462,0.007217521154803385,0.27252364360378295,0.727476356396217,0.0781483325037332
16285,15.0,479,5583,6062,81,1030,9611,2183,7428,9611,276,0.049838726459265424,0.5808968889813755,0.008427843096451983,0.2271355738216627,0.7728644261783373,0.10716886900426595
16286,,553,13819,14377,41,736,19015,5439,13576,19015,1459,0.02908230344464896,0.7267420457533527,0.0021561924796213517,0.2860373389429398,0.7139626610570602,0.03870628451222719
16287,25.0,14167,292398,306565,1664,16000,418600,116456,302256,418712,30988,0.03383471216492482,0.6983272511893617,0.003974091977301821,0.27812911977683946,0.7218708802231606,0.03821242285867135
16288,,45,1672,1717,1,61,2288,659,1629,2288,189,0.019667832167832168,0.7307692307692307,0.00043706293706293706,0.2880244755244755,0.7119755244755245,0.02666083916083916
16289,,544,6829,7373,31,427,10111,2850,7261,10111,725,0.05380278904163782,0.6754030264068835,0.003065967757887449,0.28187122935416875,0.7181287706458312,0.042231233310256154
16290,,671,5219,5890,787,778,9179,2200,6979,9179,494,0.07310164505937466,0.5685804553872971,0.08573918727530232,0.23967752478483495,0.760322475215165,0.08475868831027344
16291,25.0,21055,385204,406631,2420,21465,537987,153341,384646,537987,36015,0.039136633413075037,0.7160098664094113,0.004498249957712733,0.28502733337422653,0.7149726666257735,0.03989873361252223
16292,,279,3544,3823,12,377,5343,1402,3941,5343,341,0.05221785513756317,0.6632977727868239,0.0022459292532285235,0.26239940108553245,0.7376005989144675,0.0705596107055961
16293,,125,1899,2024,15,125,2996,782,2214,2996,238,0.04172229639519359,0.6338451268357811,0.005006675567423231,0.26101468624833113,0.7389853137516689,0.04172229639519359
16294,,119,1724,1843,9,200,2581,689,1892,2581,155,0.046106160402944595,0.6679581557535839,0.003487020534676482,0.26695079426578844,0.7330492057342115,0.07748934521503294
16295,24.0,26,1767,1793,12,115,2411,686,1725,2411,181,0.010783907092492741,0.7328909166321028,0.004977187888842804,0.28452924097884696,0.7154707590211531,0.047698050601410205
16296,24.0,100,2602,2702,0,98,3532,1051,2481,3532,277,0.028312570781426953,0.7366930917327293,0.0,0.2975651189127973,0.7024348810872028,0.027746319365798414
16297,24.0,62,1816,1878,13,83,2465,738,1727,2465,198,0.02515212981744422,0.7367139959432049,0.005273833671399594,0.29939148073022315,0.7006085192697769,0.033671399594320486
16298,14.0,260,4405,4665,30,331,6284,1732,4552,6284,419,0.041374920432845325,0.700986632718014,0.004774029280712922,0.27562062380649266,0.7243793761935073,0.05267345639719924
16299,35.0,141,3785,3926,7,215,5292,1496,3796,5292,379,0.026643990929705215,0.7152305366591081,0.0013227513227513227,0.28269085411942557,0.7173091458805745,0.04062736205593349
16300,,288,4703,4991,15,417,7004,1903,5101,7004,428,0.041119360365505425,0.6714734437464306,0.002141633352370074,0.27170188463735007,0.7282981153626499,0.05953740719588806
16301,,742,4676,5418,126,345,8323,2061,6262,8323,187,0.08915054667788057,0.5618166526492852,0.015138772077375946,0.2476270575513637,0.7523729424486363,0.04145139973567223
16302,44.0,98,3661,3759,21,148,4875,1464,3411,4875,345,0.020102564102564103,0.7509743589743589,0.0043076923076923075,0.30030769230769233,0.6996923076923077,0.030358974358974358
16303,15.0,548,14406,14954,62,897,19934,5609,14325,19934,1413,0.02749071937393398,0.7226848600381258,0.003110263870773553,0.2813785492124009,0.7186214507875991,0.04499849503361092
16304,15.0,236,4595,4831,12,190,6312,1835,4477,6312,500,0.037389100126742715,0.72797845373891,0.0019011406844106464,0.2907160963244613,0.7092839036755386,0.030101394169835233
16305,16.0,1021,15695,16716,73,834,22376,6499,15877,22376,1643,0.04562924562030747,0.7014211655345013,0.0032624240257418664,0.2904451197711834,0.7095548802288166,0.03727207722559885
16306,27.0,76,2251,2327,14,73,3047,885,2162,3047,228,0.024942566458811946,0.7387594355103381,0.004594683295044306,0.29044962257958645,0.7095503774204135,0.02395799146701674
16307,27.0,445,13039,13484,119,406,17293,5125,12168,17293,1318,0.025732955531139766,0.7540045104955763,0.006881397097091309,0.29636269010582317,0.7036373098941768,0.023477707743017405
16308,16.0,223,5358,5581,4,263,7669,2054,5615,7669,569,0.029078106663189465,0.6986569304994132,0.0005215803885773895,0.2678315295344895,0.7321684704655105,0.03429391054896336
16309,14.0,123,2341,2464,3,223,3503,950,2553,3503,216,0.035112760491007707,0.668284327719098,0.0008564087924636027,0.2711961176134742,0.7288038823865258,0.06365972023979447
16310,,426,9827,10253,27,561,13739,3917,9822,13739,952,0.031006623480602662,0.7152631195865784,0.001965208530460732,0.2851008079190625,0.7148991920809374,0.04083266613290633
16311,36.0,222,5218,5440,19,231,7069,2084,4985,7069,545,0.031404724855000704,0.7381524968170887,0.00268779176686943,0.29480831800820484,0.7051916819917952,0.032677889376149384
16312,,99,2339,2438,23,117,3243,885,2358,3243,280,0.030527289546716005,0.721245760098674,0.0070921985815602835,0.272895467160037,0.727104532839963,0.036077705827937095
16313,34.0,323,8603,8926,20,472,11949,3434,8515,11949,1055,0.027031550757385555,0.7199765670767428,0.0016737802326554523,0.28738806594694116,0.7126119340530588,0.03950121349066867
16314,,240,9419,9659,32,480,13027,3571,9456,13027,1041,0.01842327473708452,0.7230367697858294,0.0024564366316112687,0.27412297535887004,0.7258770246411299,0.03684654947416904
16315,,665,17801,18466,93,828,24462,6939,17523,24462,1847,0.02718502166625787,0.7277001062873028,0.0038018150600932056,0.2836644591611479,0.7163355408388521,0.03384841795437822
16316,17.0,53,3078,3131,4,71,4133,1168,2965,4133,422,0.012823614807645777,0.7447374788289378,0.0009678199854827002,0.2826034357609485,0.7173965642390515,0.017178804742317928
16317,,920,31668,32588,77,1834,43333,12436,30897,43333,3549,0.021230932545634965,0.7308056215817045,0.0017769367456672745,0.28698682297556133,0.7130131770244387,0.042323402487711444
16318,,417,18408,18825,8,641,23948,7330,16618,23948,1939,0.017412727576415567,0.7686654417905462,0.00033405712376816435,0.30607983965258057,0.6939201603474194,0.02676632704192417
16319,24.0,82,2066,2148,0,73,2830,816,2014,2830,197,0.028975265017667843,0.7300353356890459,0.0,0.28833922261484096,0.711660777385159,0.025795053003533568
16320,,843,16390,17233,140,637,22945,6470,16475,22945,1644,0.03674003050773589,0.7143168446284593,0.00610154717803443,0.28197864458487687,0.7180213554151231,0.027762039660056657
16321,27.0,805,16491,17296,157,704,22501,6565,15936,22501,1626,0.03577618772499,0.7329007599662237,0.0069774676681036395,0.2917648104528688,0.7082351895471313,0.0312874983334074
16322,,1662,48699,50361,141,1721,65128,19420,45708,65128,4899,0.025518978012529173,0.7477429062768701,0.002164967448716374,0.298182041518241,0.701817958481759,0.02642488637759489
16323,,245,3714,3959,10,272,5370,1520,3850,5370,510,0.04562383612662942,0.6916201117318436,0.00186219739292365,0.28305400372439476,0.7169459962756052,0.05065176908752328
16324,23.0,2107,65931,68038,269,2552,87938,26082,61856,87938,6254,0.023960062771498102,0.7497441379153494,0.0030589733675998997,0.29659532852691667,0.7034046714730833,0.029020446223475632
16325,,763,19497,20260,142,814,26986,7751,19235,26986,1920,0.028273919810271993,0.722485733343215,0.0052619876973245385,0.2872230045208627,0.7127769954791373,0.030163788631142073
16326,,363,9038,9401,15,830,13654,3605,10049,13654,994,0.02658561593672184,0.6619305697963966,0.001098579170938919,0.2640251940823202,0.7359748059176798,0.06078804745862018
16327,,862,20078,20940,194,2041,28963,7768,21195,28963,1974,0.02976211027863136,0.6932292925456617,0.006698201153195456,0.2682042606083624,0.7317957393916376,0.07046921934882436
16328,24.0,201,2087,2288,9,130,2997,833,2164,2997,159,0.06706706706706707,0.696363029696363,0.003003003003003003,0.2779446112779446,0.7220553887220554,0.04337671004337671
16329,27.0,1657,34317,35974,354,1358,46829,13654,33175,46829,3057,0.03538405688782592,0.7328151359200495,0.007559418309167397,0.2915714621281684,0.7084285378718316,0.028999124474150633
16330,,38,1507,1545,23,141,2115,587,1528,2115,180,0.017966903073286054,0.7125295508274232,0.010874704491725768,0.27754137115839245,0.7224586288416076,0.06666666666666667
16331,,47,1673,1720,4,102,2338,665,1673,2338,158,0.020102651839178785,0.7155688622754491,0.001710863986313088,0.2844311377245509,0.7155688622754491,0.04362703165098375
16332,33.0,4949,114770,119920,1698,7257,160922,46327,114595,160922,11287,0.030754029902685772,0.7132026696163358,0.010551695852649109,0.28788481376070396,0.712115186239296,0.04509638209815936
16333,25.0,53,1857,1910,0,38,2427,762,1665,2427,203,0.021837659662134322,0.765142150803461,0.0,0.31396786155747836,0.6860321384425216,0.015657189946435928
16334,14.0,53,7045,7098,21,325,9401,2676,6725,9401,796,0.005637698117221572,0.7493883629401128,0.0022338049143708115,0.28465056908839487,0.7153494309116052,0.03457079034145304
16335,24.0,3083,59745,62828,786,2986,84192,23719,60473,84192,5797,0.03661868110984417,0.7096279931584949,0.009335803876852908,0.28172510452299504,0.718274895477005,0.03546655264158115
16336,27.0,381,9270,9651,5,963,12956,3272,9684,12956,909,0.029407224451991357,0.7154986106823094,0.0003859215807347947,0.2525470824328496,0.7474529175671504,0.07432849644952146
16337,,1227,37108,38335,37,1460,50936,14777,36159,50936,4294,0.02408905292916601,0.7285220669074918,0.0007264017590702058,0.29010915658866027,0.7098908434113397,0.028663420763310823
16338,17.0,3390,66809,70199,752,5050,108029,26414,81615,108029,6480,0.031380462653546735,0.6184357903896176,0.006961093780373789,0.2445084190356293,0.7554915809643706,0.04674670690277611
16339,25.0,114,1955,2069,3,87,2698,774,1924,2698,208,0.04225352112676056,0.7246108228317272,0.001111934766493699,0.28687916975537436,0.7131208302446257,0.03224610822831727
16340,13.0,159,5551,5710,1,436,8109,2151,5958,8109,687,0.0196078431372549,0.6845480330496979,0.00012331976815883587,0.26526082130965595,0.7347391786903441,0.05376741891725244
16341,24.0,1044,21840,22884,95,1604,29927,8772,21155,29927,1795,0.034884886557289406,0.7297757877501921,0.0031743910181441506,0.293113242222742,0.706886757777258,0.05359708624319177
16342,14.0,312,8231,8543,83,531,11690,3203,8487,11690,930,0.026689478186484174,0.7041060735671514,0.007100085543199315,0.2739948674080411,0.726005132591959,0.04542343883661249
16343,27.0,443,9731,10174,41,443,14103,3759,10344,14103,947,0.031411756363894205,0.6899950365170531,0.002907182868893143,0.2665390342480323,0.7334609657519676,0.031411756363894205
16344,25.0,72,1900,1972,5,76,2651,773,1878,2651,229,0.027159562429271974,0.7167106752168992,0.001886080724254998,0.2915880799698227,0.7084119200301773,0.028668427008675973
16345,,150,2041,2191,0,126,2967,837,2130,2967,202,0.05055611729019211,0.6879002359285473,0.0,0.282103134479272,0.717896865520728,0.042467138523761376
16346,23.0,6131,165944,172075,453,9158,225638,65566,160072,225638,18041,0.027171841622421755,0.7354434979923594,0.0020076405569983777,0.2905804873292619,0.7094195126707381,0.040587135145675815
16347,,53,1445,2945,31,130,3953,587,3366,3953,179,0.013407538578294966,0.365545155578042,0.007842145206172527,0.14849481406526688,0.8515051859347331,0.032886415380723504
16348,,23,1633,1656,9,126,2223,620,1603,2223,161,0.0103463787674314,0.7345928924876294,0.004048582995951417,0.2789023841655421,0.721097615834458,0.05668016194331984
16349,37.0,259,6242,6501,13,197,8332,2454,5878,8332,593,0.031084973595775323,0.7491598655784926,0.0015602496399423908,0.29452712433989436,0.7054728756601056,0.023643783005280843
16350,24.0,849,15147,15996,104,609,20854,6141,14713,20854,1557,0.040711614078833794,0.7263354752085931,0.00498705284357917,0.2944758799271123,0.7055241200728877,0.0292030305936511
16351,16.0,166,2030,2196,14,126,3021,841,2180,3021,190,0.05494869248593181,0.6719629261833829,0.004634227077126779,0.2783846408474015,0.7216153591525984,0.041708043694141016
16352,23.0,342,7018,7360,11,315,9543,2812,6731,9543,734,0.03583778685947815,0.7354081525725663,0.0011526773551294143,0.2946662475112648,0.7053337524887352,0.03300848789688777
16353,27.0,224,4296,4520,4,243,6341,1749,4592,6341,398,0.035325658413499446,0.6774956631446144,0.0006308153288124901,0.27582400252326134,0.7241759974767387,0.03832203122535877
16354,17.0,4010,66200,70210,912,4335,96569,26626,69943,96569,6176,0.04152471289958475,0.6855201979931448,0.00944402447990556,0.2757199515372428,0.7242800484627572,0.0448901821495511
16355,,165,4351,4516,10,167,5970,1732,4238,5970,468,0.02763819095477387,0.7288107202680068,0.0016750418760469012,0.2901172529313233,0.7098827470686767,0.02797319932998325
16356,,162,8047,8209,60,528,11212,3141,8071,11212,875,0.014448804851944346,0.7177131644666429,0.005351409204423832,0.2801462718515876,0.7198537281484124,0.047092400998929716
16357,,310,5769,6079,25,420,8218,2302,5916,8218,572,0.03772207349720127,0.70199561937211,0.003042102701387199,0.2801168167437333,0.7198831832562668,0.05110732538330494
16358,24.0,342,7293,7635,38,400,10322,2898,7424,10322,695,0.03313311373764774,0.7065491183879093,0.0036814570819608604,0.2807595427242782,0.7192404572757217,0.03875217981011432
16359,25.0,418,10631,11049,29,771,14813,4323,10490,14813,995,0.028218456760953217,0.7176804158509418,0.0019577398231283333,0.29183825018564774,0.7081617498143522,0.052048875987308445
16360,14.0,59,1534,1593,9,56,2127,611,1516,2127,200,0.02773859896567936,0.7212035731076634,0.004231311706629055,0.28725905030559473,0.7127409496944053,0.026328161730136343
16361,,419,4083,4502,18,192,6077,1647,4430,6077,400,0.06894849432285667,0.6718775711699851,0.00296198782293895,0.27102188579891395,0.728978114201086,0.03159453677801547
16362,,123,5823,5946,29,195,7735,2264,5471,7735,691,0.01590174531351002,0.7528118939883646,0.0037491919844861023,0.2926955397543633,0.7073044602456368,0.025210084033613446
16363,16.0,1765,26812,28577,394,2086,39355,10731,28624,39355,2447,0.044848176851734214,0.6812857324355228,0.010011434379367298,0.27267183331215855,0.7273281666878414,0.053004700800406555
16364,,112,2147,2259,22,144,3088,860,2228,3088,198,0.03626943005181347,0.6952720207253886,0.007124352331606218,0.27849740932642486,0.7215025906735751,0.046632124352331605
16365,17.0,18,11925,11976,77,347,16088,4445,11643,16088,1189,0.0011188463451019394,0.7412357036300348,0.004786176031824962,0.2762928891098956,0.7237071108901044,0.021568871208354053
16366,24.0,2594,62501,65095,211,4070,86817,24737,62080,86817,6433,0.029878940760450143,0.7199166061946393,0.002430399576119884,0.2849326744761971,0.7150673255238029,0.04688021931188592
16367,,386,6525,6911,22,345,9319,2631,6688,9319,739,0.04142075329971027,0.7001824230067604,0.0023607683227814145,0.28232642987445006,0.71767357012555,0.037021139607254
16368,,841,29711,30552,71,1670,41789,11556,30233,41789,2902,0.020124913254684247,0.7109765727823112,0.0016990117016439732,0.2765321017492642,0.7234678982507359,0.03996266960204838
16369,,28292,597177,625469,2795,30013,814600,236426,578174,814600,51745,0.03473115639577707,0.7330923152467469,0.0034311318438497423,0.29023569850233244,0.7097643014976676,0.03684384974220476
16370,47.0,10148,231954,242102,624,8864,312263,92412,219851,312263,23207,0.03249824667027473,0.742816151769502,0.0019983155224922583,0.2959428430521708,0.7040571569478292,0.028386328191300284
16371,,134,4848,4982,9,177,6538,1942,4596,6538,573,0.020495564392780666,0.7415111654940348,0.0013765677577240747,0.2970327317222392,0.7029672682777608,0.027072499235240136
16372,37.0,42327,797578,839908,10002,53719,1107388,325054,782334,1107388,58722,0.038222375535945846,0.7202335586081843,0.009032064642203094,0.293532167587151,0.7064678324128489,0.04850964612222636
16373,,140,2284,2424,6,185,3470,949,2521,3470,262,0.040345821325648415,0.6582132564841499,0.001729106628242075,0.2734870317002882,0.7265129682997118,0.053314121037463975
16374,,471,8548,9019,25,606,12574,3413,9161,12574,818,0.03745824717671385,0.6798154922856688,0.0019882296802926675,0.27143311595355496,0.7285668840464451,0.04819468745029426
16375,15.0,9,1762,1771,10,34,2311,665,1646,2311,242,0.0038944180008654264,0.762440501947209,0.004327131112072695,0.28775421895283426,0.7122457810471657,0.014712245781047165
16376,25.0,54,1997,2051,17,148,2801,788,2013,2801,205,0.019278828989646554,0.7129596572652624,0.006069260978222063,0.28132809710817563,0.7186719028918244,0.052838272045697965
16377,37.0,399,4711,5110,159,246,6982,1873,5109,6982,395,0.05714694929819536,0.6747350329418504,0.022772844457175593,0.26826124319679173,0.7317387568032082,0.03523345746204526
16378,24.0,398,10493,10891,20,668,14486,4126,10360,14486,955,0.027474803258318376,0.7243545492199365,0.0013806433798149939,0.28482672925583324,0.7151732707441668,0.04611348888582079
16379,26.0,342,6879,7221,44,331,9649,2657,6992,9649,584,0.035444087470204166,0.7129236190278785,0.0045600580371022905,0.2753653228313815,0.7246346771686185,0.03430407296092859
16380,14.0,279,4000,4279,9,268,5827,1637,4190,5827,388,0.0478805560322636,0.6864595846919512,0.0015445340655568904,0.28093358503518107,0.7190664149648189,0.04599279217436073
16381,17.0,188,4032,4220,4,187,5533,1577,3956,5533,385,0.033977950478944516,0.7287185975058739,0.0007229351165732876,0.28501716970901864,0.7149828302909814,0.033797216699801194
16382,,379,6097,6476,12,373,9076,2498,6578,9076,631,0.04175848391361833,0.6717717055971794,0.0013221683561040105,0.2752313794623182,0.7247686205376818,0.04109739973556633
16383,39.0,1559,56643,58202,270,1909,73003,22474,50530,73004,4422,0.021354994246890583,0.775888992383979,0.003698427483425566,0.3078461454166895,0.6921538545833105,0.026149252095775573
16384,23.0,405,7572,7977,99,314,11016,3068,7948,11016,778,0.03676470588235294,0.6873638344226579,0.008986928104575163,0.2785039941902687,0.7214960058097313,0.0285039941902687
16385,17.0,52,2867,2919,0,203,3853,1076,2777,3853,298,0.013495977160654036,0.7440955099922139,0.0,0.2792629120166104,0.7207370879833895,0.052686218531014795
16386,,216,4251,4467,15,265,6083,1677,4406,6083,491,0.03550879500246589,0.6988328127568634,0.002465888541837909,0.27568633897747824,0.7243136610225218,0.04356403090580306
16387,25.0,1639,34031,35670,9,1421,46930,13899,33031,46930,2925,0.03492435542297038,0.7251438312380141,0.00019177498401875133,0.296164500319625,0.7038354996803751,0.030279139143405073
16388,15.0,209,4090,4299,20,304,5729,1653,4076,5729,386,0.03648106126723687,0.7139116774306161,0.003491010647582475,0.28853203002269157,0.7114679699773084,0.05306336184325362
16389,,237,2771,3008,39,345,4814,1089,3725,4814,141,0.049231408392189445,0.5756127960116327,0.008101371001246365,0.22621520565018696,0.7737847943498131,0.07166597424179477
16390,15.0,146,4093,4239,38,243,5756,1571,4185,5756,500,0.025364836692147324,0.7110840861709521,0.00660180681028492,0.2729325920778318,0.7270674079221682,0.04221681723419041
16391,45.0,67,2328,2395,11,174,3228,903,2325,3228,229,0.020755885997521685,0.7211895910780669,0.0034076827757125155,0.27973977695167285,0.7202602230483272,0.05390334572490706
16392,15.0,243,2093,2336,2,167,3286,887,2399,3286,197,0.073950091296409,0.6369446135118685,0.0006086427267194157,0.26993304930006085,0.7300669506999391,0.050821667681071214
16393,16.0,106,1802,1908,6,150,2625,718,1907,2625,140,0.04038095238095238,0.6864761904761905,0.002285714285714286,0.2735238095238095,0.7264761904761905,0.05714285714285714
16394,14.0,672,21294,21966,128,1216,30211,8319,21892,30211,2536,0.022243553672503392,0.7048426069974513,0.004236867366191123,0.2753632782761246,0.7246367217238754,0.04025023997881566
16395,16.0,553,7475,8028,7,493,10708,3055,7653,10708,836,0.051643630930145686,0.6980762047067613,0.000653716847217034,0.2853007097497198,0.7146992902502801,0.0460403436682854
16396,35.0,1969,52983,54952,266,2942,73138,20769,52369,73138,5184,0.0269217096447811,0.7244250594766058,0.0036369602668927235,0.2839700292597555,0.7160299707402444,0.04022532746315185
16397,26.0,2642,50102,52744,737,5720,72452,20076,52376,72452,4659,0.036465522000772924,0.69151990283222,0.010172251973720531,0.2770938000331254,0.7229061999668747,0.07894882128857726
16398,23.0,85,3173,3258,11,220,4380,1183,3197,4380,344,0.019406392694063926,0.7244292237442922,0.002511415525114155,0.27009132420091325,0.7299086757990868,0.0502283105022831
16399,27.0,164,5557,5721,22,196,7447,2211,5236,7447,672,0.022022290855378004,0.7462065261178998,0.0029542097488921715,0.2968980797636632,0.7031019202363368,0.02631932321740298
16400,26.0,1360,27108,28468,95,1435,38026,10952,27074,38026,2735,0.03576500289275759,0.7128806606006417,0.0024982906432440962,0.28801346447167725,0.7119865355283227,0.03773733761110819
16401,,730,12065,12795,74,1117,18682,4804,13878,18682,1031,0.03907504549834065,0.645808799914356,0.003961032009420833,0.25714591585483354,0.7428540841451665,0.05979017235841987
16402,,59,1463,1522,2,100,2111,583,1528,2111,157,0.02794883941260066,0.6930364756039792,0.0009474182851729038,0.2761724301279015,0.7238275698720985,0.04737091425864519
16403,,218,3552,3770,79,144,5220,1336,3884,5220,326,0.04176245210727969,0.6804597701149425,0.015134099616858238,0.25593869731800767,0.7440613026819923,0.027586206896551724
16404,23.0,687,14928,15615,20,905,20983,6014,14969,20983,1633,0.03274079016346566,0.7114330648620312,0.0009531525520659581,0.2866129724062336,0.7133870275937664,0.043130152980984604
16405,24.0,159,3958,4117,44,239,5439,1596,3843,5439,403,0.02923331494760066,0.7277072991358705,0.008089722375436662,0.29343629343629346,0.7065637065637066,0.04394190108475823
16406,,200,3508,3708,9,205,5500,1363,4137,5500,396,0.03636363636363636,0.6378181818181818,0.0016363636363636363,0.24781818181818183,0.7521818181818182,0.03727272727272727
16407,25.0,103,19987,20090,61,1979,27387,7485,19902,27387,2057,0.0037609084602183516,0.7297988096542155,0.0022273341366341693,0.2733048526673239,0.726695147332676,0.07226056158031183
16408,24.0,207,2574,2781,16,177,3983,1054,2929,3983,254,0.051970876223951794,0.6462465478282702,0.004017072558373086,0.26462465478282704,0.735375345217173,0.04443886517700226
16409,,344,5730,6074,23,605,8267,2302,5965,8267,539,0.04161122535381638,0.6931172130156042,0.002782145881214467,0.278456513850248,0.7215434861497521,0.07318253296238054
16410,15.0,53,7741,7794,15,1131,10878,2887,7991,10878,711,0.004872219157933444,0.7116197830483545,0.0013789299503585218,0.26539805111233683,0.7346019488876632,0.10397131825703254
16411,,55,4165,4220,23,366,6040,1692,4348,6040,268,0.009105960264900662,0.6895695364238411,0.0038079470198675498,0.2801324503311258,0.7198675496688741,0.06059602649006623
16412,,946,30286,31232,212,894,40552,12121,28431,40552,3101,0.02332807259814559,0.7468435588873545,0.005227855592819097,0.2989001775498126,0.7010998224501874,0.02204576839613336
16413,16.0,1163,18696,19859,92,1231,27214,7569,19645,27214,2004,0.04273535680164621,0.686999338575733,0.0033806129198206804,0.2781289042404645,0.7218710957595356,0.04523407069890498
16414,23.0,450,16435,16885,92,536,22152,6553,15599,22152,1793,0.020314192849404118,0.7419194655110148,0.004153123871433731,0.2958197905381004,0.7041802094618996,0.024196460816179127
16415,,256,3864,4120,41,262,5698,1556,4142,5698,474,0.044928044928044926,0.6781326781326781,0.007195507195507196,0.2730782730782731,0.726921726921727,0.04598104598104598
16416,14.0,259,9707,9966,12,454,13218,3843,9375,13218,1127,0.019594492358904526,0.7343773642003328,0.0009078529278256923,0.29073990013617795,0.7092600998638221,0.03434710243607202
16417,15.0,27,15370,15397,98,1060,20965,5831,15134,20965,1518,0.0012878607202480325,0.733126639637491,0.004674457429048414,0.27813021702838064,0.7218697829716194,0.05056045790603387
16418,,1849,44973,46822,244,2670,62516,17427,45089,62516,4600,0.029576428434320814,0.7193838377375392,0.0039030008317870626,0.2787606372768571,0.7212393627231429,0.04270906647898138
16419,17.0,656,14464,15120,44,850,22315,5722,16593,22315,1400,0.029397266412726865,0.6481738740757338,0.001971767869146314,0.2564194488012548,0.7435805511987452,0.03809097019941743
16420,13.0,405,6801,7206,5,391,9706,2715,6991,9706,761,0.04172676694827941,0.7007005975685143,0.0005151452709664126,0.279723882134762,0.720276117865238,0.04028436018957346
16421,,9741,164000,173741,661,9735,242540,65817,176723,242540,17712,0.04016244743135153,0.6761771254226107,0.0027253236579533272,0.2713655479508535,0.7286344520491466,0.04013770924383607
16422,24.0,195,2807,3002,7,226,4192,1148,3044,4192,249,0.04651717557251908,0.6696087786259542,0.0016698473282442748,0.2738549618320611,0.726145038167939,0.053912213740458015
16423,,6642,129559,136201,708,7180,185176,52157,133023,185180,13593,0.03586780429852036,0.6996381898693164,0.0038233070525974726,0.28165568635921806,0.718344313640782,0.0387730856463981
16424,27.0,174,4664,4838,3,163,6691,1842,4849,6691,452,0.026005081452697653,0.6970557465251831,0.00044836347332237334,0.27529517261993725,0.7247048273800628,0.02436108205051562
16425,16.0,250,7094,7344,20,301,9632,2771,6861,9632,851,0.02595514950166113,0.7365033222591362,0.0020764119601328905,0.28768687707641194,0.7123131229235881,0.03125
16426,15.0,3344,56235,59579,969,5584,81510,22325,59185,81510,4357,0.041025641025641026,0.6899153478100847,0.011888111888111888,0.2738927738927739,0.7261072261072261,0.0685069316648264
16427,34.0,776,18979,19755,44,1344,26678,7494,19184,26678,1961,0.02908763775395457,0.7114101506859585,0.0016492990479046404,0.28090561511357676,0.7190943848864233,0.05037858909963266
16428,,234,8506,8740,19,286,11296,3306,7990,11296,918,0.02071529745042493,0.7530099150141643,0.0016820113314447592,0.2926699716713881,0.7073300283286119,0.02531869688385269
16429,15.0,937,14414,15351,74,1041,21053,5748,15305,21053,1409,0.04450672113238018,0.684653018572175,0.0035149384885764497,0.27302522205861396,0.726974777941386,0.04944663468389303
16430,13.0,404,13473,13877,113,1072,19115,5300,13815,19115,1515,0.021135234109338215,0.7048391315720638,0.005911587758304996,0.2772691603452786,0.7227308396547214,0.05608161130002616
16431,14.0,156,3963,4119,41,160,5453,1580,3873,5453,422,0.02860810562992848,0.7267559141756831,0.007518796992481203,0.28974876214927564,0.7102512378507244,0.029341646799926645
16432,,721,26465,27186,197,828,35502,10258,25244,35502,3071,0.02030871500197172,0.7454509605092671,0.005548983155878542,0.288941468086305,0.7110585319136951,0.023322629711002196
16433,36.0,103,2567,2670,5,139,3666,1035,2631,3666,245,0.028096017457719585,0.7002182214948173,0.001363884342607747,0.2823240589198036,0.7176759410801964,0.03791598472449536
16434,,1185,11243,12428,102,1171,16884,4687,12197,16884,975,0.07018479033404407,0.6658967069414831,0.006041222459132907,0.2776000947642739,0.7223999052357262,0.0693556029376925
16435,16.0,105,2694,2799,27,102,3724,1104,2620,3724,240,0.02819548872180451,0.7234156820622986,0.007250268528464017,0.2964554242749731,0.7035445757250268,0.027389903329752954
16436,23.0,1798,35484,37282,51,2171,49974,14326,35648,49974,3688,0.0359787089286429,0.7100492255973107,0.0010205306759514948,0.286669067915316,0.713330932084684,0.043442590146876375
16437,23.0,213,5302,5515,19,298,7302,2090,5212,7302,550,0.029170090386195564,0.7261024376883046,0.0026020268419611066,0.2862229526157217,0.7137770473842783,0.040810736784442615
16438,23.0,53,2434,2487,7,123,3237,905,2332,3237,213,0.016373185047883845,0.7519308001235712,0.002162496138399753,0.2795798578931109,0.7204201421068891,0.037998146431881374
16439,,563,21488,22051,65,843,28455,8625,19830,28455,2317,0.019785626427692847,0.7551572658583728,0.002284308557371288,0.30311017395888246,0.6968898260411176,0.02962572482867686
16440,,117,2492,2609,4,93,3474,999,2475,3474,299,0.03367875647668394,0.717328727691422,0.0011514104778353484,0.28756476683937826,0.7124352331606217,0.02677029360967185
16441,14.0,193,4418,4611,9,235,6307,1784,4523,6307,549,0.03060091961312827,0.7004915173616616,0.0014269858886951008,0.28286031393689554,0.7171396860631045,0.037260187093705405
16442,23.0,410,39286,39696,222,3199,53417,15296,38121,53417,4275,0.00767545912350001,0.7354587490873692,0.004155980305895127,0.28635078720257595,0.713649212797424,0.05988730179530861
16443,,950,11064,12014,58,580,16738,4519,12219,16738,1007,0.056757079698888754,0.6610108734615844,0.003465169076353208,0.2699844664834508,0.7300155335165491,0.034651690763532084
16444,15.0,894,19511,20405,60,1866,27744,7810,19934,27744,1887,0.03222318339100346,0.7032511534025375,0.0021626297577854673,0.281502306805075,0.7184976931949251,0.06725778546712803
16445,27.0,156,4682,4838,4,183,6471,1835,4636,6471,535,0.02410755679184052,0.7235357749961366,0.0006181424818420646,0.2835728635450471,0.7164271364549528,0.028280018544274456
16446,,6327,120874,127201,651,6848,168302,47186,121116,168302,11777,0.0375931361481147,0.7181970505401005,0.0038680467255291086,0.2803650580504094,0.7196349419495907,0.04068876186854583
16447,17.0,136,3477,3613,16,338,5141,1374,3767,5141,376,0.026453997276794396,0.6763275627309862,0.0031122349737405172,0.26726317836996694,0.7327368216300331,0.06574596382026843
16448,17.0,9839,192677,202516,1452,10687,276471,76574,199897,276471,19703,0.03558781933729035,0.6969157705509801,0.0052519070716277655,0.27696937472646316,0.7230306252735368,0.03865504881162943
16449,,539,10278,10817,36,801,14861,4131,10730,14861,1204,0.03626943005181347,0.6916089092254896,0.0024224480183029405,0.27797591010026246,0.7220240898997375,0.05389946840724043
16450,26.0,5243,94568,99811,1649,5071,133952,37738,96214,133952,8191,0.039140886287625416,0.7059842331581462,0.01231037983755375,0.2817277830864787,0.7182722169135213,0.03785684424271381
16451,,47,3589,3636,12,154,4759,1377,3382,4759,430,0.00987602437486867,0.7541500315192268,0.002521538138264341,0.2893465013658332,0.7106534986341668,0.03235973944105905
16452,,785,14940,15725,45,792,20772,5870,14902,20772,1234,0.037791257461968035,0.7192374350086655,0.002166377816291161,0.28259195070286924,0.7174080492971308,0.038128249566724434
16453,37.0,125,3934,4059,0,172,5226,1516,3710,5226,387,0.023918867202449293,0.7527745885954841,0.0,0.290088021431305,0.709911978568695,0.03291236127057023
16454,,135,2281,2416,5,102,3231,927,2304,3231,255,0.04178272980501393,0.7059733828536057,0.0015475085112968121,0.28690807799442897,0.713091922005571,0.031569173630454965
16455,17.0,269,4968,5237,11,308,6991,1966,5025,6991,474,0.03847804319839794,0.7106279502217137,0.0015734515806036333,0.2812187097697039,0.7187812902302961,0.04405664425690173
16456,,311,11035,11346,45,481,14673,4372,10301,14673,1082,0.021195392898521095,0.752061609759422,0.003066857493355142,0.29796224357663736,0.7020377564233626,0.03278129898452941
16457,17.0,88,3507,3595,27,193,4718,1370,3348,4718,316,0.018651971174226366,0.7433234421364985,0.0057227638830012716,0.2903772785078423,0.7096227214921577,0.04090716405256464
16458,16.0,719,21518,22237,27,1301,29454,8527,20927,29454,2157,0.024410945881713858,0.7305629116588579,0.000916683642289672,0.2895022747334827,0.7104977252665173,0.0441705710599579
16459,13.0,452,7482,7934,16,322,10714,2986,7728,10714,819,0.042187791674444655,0.698338622363263,0.0014933731566175099,0.2787007653537428,0.7212992346462572,0.030054134776927383
16460,,350,8376,8726,28,546,11645,3308,8337,11645,828,0.030055817947617004,0.7192786603692571,0.00240446543580936,0.284070416487763,0.715929583512237,0.046887075998282526
16461,,289,5081,5370,22,281,7078,2072,5006,7078,448,0.04083074314778186,0.7178581520203448,0.0031082226617688614,0.29273806159932186,0.7072619384006782,0.03970048036168409
16462,16.0,777,13617,14394,371,753,21250,5491,15759,21250,1246,0.036564705882352944,0.6408,0.017458823529411766,0.2584,0.7416,0.03543529411764706
16463,23.0,1073,24205,25278,97,1125,34226,9484,24742,34226,2599,0.031350435341553205,0.7072108923040963,0.0028341027289195348,0.2770992812481739,0.722900718751826,0.03286974814468533
16464,,576,14975,15551,45,1074,21065,5998,15067,21065,1497,0.027343935437930216,0.7108948492760503,0.002136244956088298,0.2847377165915025,0.7152622834084975,0.05098504628530738
16465,26.0,126,3114,3240,19,172,4375,1266,3109,4375,371,0.0288,0.7117714285714286,0.004342857142857143,0.28937142857142856,0.7106285714285714,0.03931428571428571
16466,23.0,346,5462,5808,54,349,7961,2191,5770,7961,529,0.04346187664866223,0.6860947117196332,0.0067830674538374575,0.275216681321442,0.7247833186785579,0.043838713729430975
16467,24.0,170,6557,6727,14,249,8700,2571,6129,8700,659,0.01954022988505747,0.7536781609195402,0.0016091954022988506,0.29551724137931035,0.7044827586206897,0.028620689655172414
16468,23.0,2573,61871,64444,257,3837,85022,24554,60468,85022,6178,0.030262755522100164,0.727705770271224,0.0030227470537037473,0.28879584107642725,0.7112041589235727,0.04512949589518007
16469,,191,4279,4470,4,236,5856,1671,4185,5856,408,0.032616120218579236,0.7307035519125683,0.0006830601092896175,0.2853483606557377,0.7146516393442623,0.040300546448087435
16470,24.0,484,9716,10200,71,454,13546,3827,9719,13546,1088,0.035730104827993506,0.7172597076627787,0.005241399675180865,0.28251882474531226,0.7174811752546877,0.033515428908902994
16471,27.0,125,3514,3639,31,152,4919,1386,3533,4919,353,0.025411669038422444,0.7143728400081317,0.006302093921528766,0.28176458629802803,0.718235413701972,0.030900589550721693
16472,47.0,385,10257,10642,56,493,14030,4047,9983,14030,1072,0.02744119743406985,0.7310762651461155,0.003991446899501069,0.28845331432644333,0.7115466856735566,0.035138987883107625
16473,17.0,276,15730,16006,66,881,21651,6088,15563,21651,1685,0.012747679091035056,0.7265253337028312,0.003048358043508383,0.2811879358921066,0.7188120641078934,0.040690961156528566
16474,35.0,37060,486253,523313,1333,32900,715069,195193,519876,715069,44977,0.05182716632940318,0.6800085026759656,0.0018641557667861423,0.2729708601547543,0.7270291398452458,0.046009545931931045
16475,,279,5904,6183,13,301,8202,2406,5796,8202,625,0.03401609363569861,0.719824433065106,0.0015849792733479639,0.29334308705193857,0.7066569129480614,0.03669836625213362
16476,,57,6865,6922,29,319,9183,2596,6587,9183,772,0.006207121855602744,0.7475770445388218,0.0031580093651312206,0.2826962866165741,0.7173037133834259,0.03473810301644343
16477,24.0,322,7837,8159,10,371,11192,3157,8035,11192,873,0.028770550393137955,0.7002323087919943,0.0008934953538241601,0.28207648320228734,0.7179235167977126,0.03314867762687634
16478,,460,7548,8008,106,399,11119,2990,8129,11119,843,0.041370626854933,0.6788380250022484,0.00953323140570195,0.2689090745570645,0.7310909254429355,0.03588452198938753
16479,23.0,398,8970,9368,92,860,12979,3590,9389,12979,947,0.030664920255797826,0.6911164188304184,0.0070883735264658295,0.27660066260882965,0.7233993373911703,0.06626088296478927
16480,16.0,82,2422,2580,35,396,3801,934,2867,3801,267,0.02157327019205472,0.6372007366482505,0.009208103130755065,0.24572480926072085,0.7542751907392792,0.10418310970797158
16481,36.0,227,5561,5788,15,247,7669,2154,5515,7669,526,0.029599687051766854,0.7251271352197157,0.0019559264571652104,0.28087103924892426,0.7191289607510758,0.0322075889946538
16482,27.0,12687,315164,327851,1012,14409,426053,123924,302129,426053,27719,0.029777985368017595,0.7397295641622051,0.0023752913369932847,0.29086522099363227,0.7091347790063678,0.03381973604222949
16483,16.0,704,16126,16830,53,818,22504,6372,16132,22504,1548,0.031283327408460716,0.7165837184500533,0.002355136864557412,0.2831496622822609,0.7168503377177391,0.03634909349448987
16484,,110,1740,1850,3,161,3304,600,2704,3304,137,0.033292978208232446,0.5266343825665859,0.0009079903147699758,0.18159806295399517,0.8184019370460048,0.048728813559322036
16485,23.0,904,27909,28813,32,1209,37423,11048,26375,37423,3185,0.02415626753600727,0.7457713171044544,0.0008550891163188413,0.29521951740908,0.7047804825909201,0.03230633567592123
16486,35.0,6143,129625,135768,725,5575,182299,52196,130103,182299,15574,0.03369738725939254,0.711057109473996,0.003976982868803449,0.2863208245793998,0.7136791754206002,0.03058162688769549
16487,,242,7021,7263,25,307,9493,2761,6732,9493,765,0.02549246813441483,0.7395975982302749,0.002633519435373433,0.2908458864426419,0.709154113557358,0.03233961866638576
16488,17.0,140,3445,3585,21,214,4737,1360,3377,4737,336,0.02955457040320878,0.7272535359932447,0.004433185560481318,0.28710154105974245,0.7128984589402575,0.04517627190204771
16489,,877,15857,16734,28,1229,22885,6654,16231,22885,1072,0.03832204500764693,0.6928992790037142,0.00122350884859078,0.2907581385186804,0.7092418614813196,0.053703299104216735
16490,24.0,1664,111615,113279,438,6281,153874,43044,110830,153874,11368,0.010814042658278851,0.7253662087162224,0.0028464847862536883,0.2797353678984104,0.7202646321015896,0.04081911174077492
16491,17.0,1354,21588,22942,99,1229,32089,8733,23356,32089,2254,0.0421951447536539,0.6727539032067064,0.0030851693726822275,0.27214933466296864,0.7278506653370314,0.038299728879055125
16492,13.0,2272,31181,33453,835,2766,47464,12421,35043,47464,2550,0.047867857744817124,0.6569399966290241,0.017592280465194673,0.26169307264453057,0.7383069273554694,0.058275745828417325
16493,14.0,178,3776,3954,16,223,5239,1513,3726,5239,357,0.033975949608703954,0.7207482343958771,0.003054017942355411,0.28879557167398356,0.7112044283260164,0.042565375071578544
16494,,822,22502,23324,96,897,30216,8992,21224,30216,2278,0.027204130262112786,0.7447047921630924,0.003177124702144559,0.29759068043420706,0.702409319565793,0.029686258935663224
16495,,63,1584,1647,2,71,2172,629,1543,2172,182,0.029005524861878452,0.7292817679558011,0.0009208103130755065,0.2895948434622468,0.7104051565377533,0.03268876611418048
16496,16.0,487,7496,7983,20,424,10972,3031,7941,10972,809,0.044385709077652206,0.6831935836675174,0.0018228217280349982,0.276248632883704,0.7237513671162961,0.03864382063434196
16497,17.0,1596,19020,20616,124,1076,27049,7846,19203,27049,1669,0.05900402972383452,0.703168324152464,0.004584272986062331,0.2900661761987504,0.7099338238012496,0.03977965913712152
16498,16.0,3,2526,2529,26,151,3449,979,2470,3449,316,0.0008698173383589446,0.7323861988982314,0.007538416932444187,0.2838503914178023,0.7161496085821978,0.043780806030733546
16499,24.0,123,3128,3251,14,90,4472,1234,3238,4472,389,0.027504472271914132,0.6994633273703041,0.0031305903398926656,0.2759391771019678,0.7240608228980322,0.020125223613595707
16500,27.0,124,3314,3438,1,236,4525,1213,3312,4525,317,0.02740331491712707,0.7323756906077348,0.00022099447513812155,0.2680662983425414,0.7319337016574585,0.052154696132596684
16501,13.0,38,2438,2476,9,46,3362,938,2424,3362,352,0.011302795954788817,0.7251635930993456,0.002676977989292088,0.27900059488399764,0.7209994051160024,0.013682331945270671
16502,,817,18735,19552,51,1065,26693,7454,19239,26693,2048,0.03060727531562582,0.701869403963586,0.001910613269396471,0.27924924137414303,0.7207507586258569,0.03989810062563219
16503,26.0,225,7069,7294,26,831,10352,2644,7708,10352,522,0.021734930448222566,0.6828632148377125,0.002511591962905719,0.2554095826893354,0.7445904173106646,0.08027434312210201
16504,26.0,618,16209,16827,38,907,22755,6336,16419,22755,1619,0.027158866183256428,0.7123269611074489,0.0016699626455724016,0.27844429795649306,0.7215557020435069,0.03985937156668864
16505,,572,16525,17097,21,708,22401,6452,15949,22401,1553,0.025534574349359403,0.7376902816838534,0.0009374581491897683,0.2880228561224945,0.7119771438775054,0.03160573188696933
16506,,68,11851,11919,38,1504,17077,4401,12676,17077,1053,0.003981964045207003,0.6939743514668852,0.0022252152017333254,0.2577150553375886,0.7422849446624115,0.08807167535281372
16507,13.0,3565,40431,43996,178,4454,61042,16591,44451,61042,3432,0.05840241145440844,0.6623472363290849,0.002916025031945218,0.27179646800563545,0.7282035319943645,0.07296615445103372
16508,,352,11624,11976,12,512,15679,4530,11149,15679,1156,0.022450411378276677,0.7413738121053639,0.0007653549333503412,0.2889214873397538,0.7110785126602462,0.032655143822947895
16509,39.0,624,12333,12957,46,490,16889,4949,11940,16889,1157,0.03694712534785955,0.730238616851205,0.0027236662916691337,0.2930309669015335,0.7069690330984665,0.029012967019953817
16510,,535,12710,13245,54,554,17307,5079,12228,17307,1288,0.030912347605015312,0.7343849309527937,0.0031201248049922,0.2934650719362108,0.7065349280637893,0.032010169295660716
16511,45.0,23,5147,5170,40,254,6732,1994,4738,6732,522,0.0034165181224004755,0.7645573380867499,0.0059417706476530005,0.29619726678550207,0.7038027332144979,0.03773024361259655
16512,15.0,181,3170,3351,35,302,4611,1247,3364,4611,318,0.03925395792669703,0.687486445456517,0.007590544350466276,0.27044025157232704,0.7295597484276729,0.06549555410973758
16513,16.0,113,3778,3891,70,162,5123,1507,3616,5123,354,0.022057388249072808,0.7374585203982041,0.013663868826859263,0.29416357602967014,0.7058364239703299,0.031622096427874294
16514,,2161,33541,35702,285,1780,46813,13811,33002,46813,2902,0.04616239078888343,0.7164890094631833,0.006088052464059129,0.2950248862495461,0.704975113750454,0.038023625915878066
16515,,250,25124,25374,94,1435,34473,9692,24781,34473,3047,0.007252052330809619,0.7288022510370434,0.0027267716763844166,0.2811475647608273,0.7188524352391726,0.04162678037884721
16516,,105,2789,2894,22,115,3937,1086,2851,3937,314,0.02667005334010668,0.7084074168148337,0.0055880111760223524,0.2758445516891034,0.7241554483108966,0.02921005842011684
16517,,537,3866,4403,43,177,5571,1679,3892,5571,183,0.09639203015616586,0.693950816729492,0.007718542451983486,0.3013821576018668,0.6986178423981332,0.031771674744211095
16518,26.0,8759,288642,297401,180,9802,388363,115160,273203,388363,32440,0.022553641824787633,0.7432273414305688,0.00046348390552138075,0.2965267031102345,0.7034732968897655,0.025239273566225413
16519,,787,17730,18517,94,907,25131,7054,18077,25131,1873,0.03131590465958378,0.70550316342366,0.0037404003024153437,0.2806891886514663,0.7193108113485337,0.036090883769050175
16520,,471,7706,8177,67,581,11788,3088,8700,11788,822,0.03995588734306074,0.653715643026807,0.005683746182558534,0.2619613165931456,0.7380386834068544,0.04928741092636579
16521,,276,7635,7911,3,282,10345,3124,7221,10345,866,0.026679555340744322,0.7380376993716772,0.0002899951667472209,0.30198163363943936,0.6980183663605607,0.02725954567423876
16522,24.0,184,6158,6342,59,276,8591,2440,6151,8591,728,0.02141776277499709,0.7167966476545222,0.006867652194156675,0.2840181585380049,0.7159818414619951,0.03212664416249564
16523,26.0,223,3927,4150,118,174,5320,1633,3687,5320,248,0.04191729323308271,0.7381578947368421,0.02218045112781955,0.3069548872180451,0.6930451127819549,0.03270676691729323
16524,24.0,148,2076,2224,2,119,2971,842,2129,2971,266,0.049814877145742176,0.6987546280713565,0.0006731740154830024,0.283406260518344,0.7165937394816561,0.04005385392123864
16525,26.0,346,10887,11233,54,838,14948,4180,10768,14948,1202,0.023146909285523147,0.7283248595129783,0.0036125234145036127,0.27963607171527965,0.7203639282847204,0.05606101150655606
16526,25.0,4051,87065,91116,130,4646,121000,34590,86410,121000,9076,0.03347933884297521,0.7195454545454546,0.0010743801652892562,0.2858677685950413,0.7141322314049586,0.038396694214876036
16527,33.0,126,2338,2464,53,141,3450,922,2528,3450,230,0.036521739130434785,0.6776811594202898,0.01536231884057971,0.2672463768115942,0.7327536231884058,0.0408695652173913
16528,13.0,407,12266,12673,41,1038,17399,4818,12581,17399,1355,0.023392148974078972,0.7049830450025864,0.002356457267659061,0.2769124662336916,0.7230875337663084,0.059658601069026956
16529,37.0,7300,77553,84853,780,5144,119819,31928,87893,119821,6059,0.060924211949491325,0.6472404670299864,0.0065097103178908535,0.2664641423456656,0.7335358576543344,0.0429307049682443
16530,16.0,2190,52947,55137,173,3004,71920,21344,50576,71920,4996,0.030450500556173526,0.7361929922135706,0.0024054505005561737,0.2967741935483871,0.7032258064516129,0.04176863181312569
16531,13.0,216,5010,5226,55,165,6969,1949,5020,6969,576,0.030994403788204908,0.7188979767541972,0.007892093557181805,0.27966709714449706,0.7203329028555029,0.023676280671545414
16532,,237,6769,7006,60,164,9627,2701,6926,9627,769,0.024618261140542226,0.7031266230393685,0.0062324711748208165,0.2805650773865171,0.719434922613483,0.017035421211176897
16533,16.0,1243,21073,22316,194,1167,31390,8336,23054,31390,2290,0.039598598279706916,0.6713284485504938,0.006180312201338006,0.2655622809812042,0.7344377190187958,0.03717744504619305
16534,15.0,2429,51741,54170,74,2525,71685,20472,51213,71685,4783,0.0338843551649578,0.7217827997489015,0.0010322940643091303,0.28558275789914206,0.7144172421008579,0.03522354746460208
16535,,1154,21385,22539,264,1349,30624,8643,21981,30624,2058,0.0376828631138976,0.6983085161964472,0.008620689655172414,0.28222962382445144,0.7177703761755486,0.04405041797283177
16536,14.0,579,5958,6537,140,1035,9780,2461,7319,9780,367,0.05920245398773006,0.6092024539877301,0.014314928425357873,0.2516359918200409,0.7483640081799591,0.1058282208588957
16537,,77,4294,4371,55,381,6106,1614,4492,6106,480,0.01261054700294792,0.7032427120864724,0.009007533573534229,0.26433016704880447,0.7356698329511956,0.06239764166393711
16538,14.0,981,19260,20241,455,882,26966,7400,19566,26966,1877,0.0363791441073945,0.7142327375213231,0.016873099458577467,0.2744196395460951,0.725580360453905,0.03270785433508863
16539,39.0,179,3437,3616,45,204,4855,1335,3520,4855,253,0.0368692070030896,0.7079299691040165,0.009268795056642637,0.2749742533470649,0.7250257466529351,0.042018537590113286
16540,24.0,1000,23871,24871,116,1405,32722,9478,23244,32722,2175,0.03056047918831367,0.7295091987042357,0.003545015585844386,0.28965222174683697,0.710347778253163,0.04293747325958071
16541,17.0,482,8861,9343,35,510,12472,3750,8722,12472,496,0.03864656831302117,0.7104714560615779,0.002806286080821039,0.30067350865939707,0.699326491340603,0.040891597177678
16542,27.0,2068,63781,65849,364,2583,85970,24991,60979,85970,6366,0.024054902873095266,0.7418983366290567,0.004234035128533209,0.290694428288938,0.709305571711062,0.03004536466209143
16543,41.0,776,19481,20257,91,1260,28703,7606,21097,28703,2100,0.027035501515521025,0.6787095425565272,0.0031704003065881614,0.26498972232867646,0.7350102776713235,0.04389785039891301
16544,,183,3131,3314,20,292,4622,1234,3388,4622,311,0.03959324967546517,0.6774123755949806,0.004327131112072695,0.26698398961488534,0.7330160103851147,0.06317611423626136
16545,23.0,1464,20214,21678,73,773,28394,8396,19998,28394,2186,0.05156018877227583,0.7119109671057265,0.002570965696978235,0.29569627386067476,0.7043037261393252,0.02722406142142706
16546,17.0,101,1583,1684,40,166,2476,647,1829,2476,139,0.04079159935379645,0.6393376413570274,0.01615508885298869,0.2613085621970921,0.7386914378029079,0.06704361873990307
16547,24.0,382,10577,10959,96,448,14314,4192,10122,14314,1079,0.02668715942433981,0.7389269246891156,0.006706720693027805,0.2928601369288808,0.7071398630711192,0.03129802990079642
16548,,229,3527,3756,8,206,5063,1440,3623,5063,365,0.04523010073079202,0.6966225557969583,0.0015800908552241755,0.2844163539403516,0.7155836460596484,0.04068733952202252
16549,16.0,174,4942,5116,0,255,6749,1985,4764,6749,586,0.025781597273670173,0.7322566306119425,0.0,0.29411764705882354,0.7058823529411765,0.037783375314861464
16550,25.0,237,6645,6882,24,307,9539,2611,6928,9539,745,0.024845371632246566,0.6966139008281791,0.0025159870007338296,0.2737184191215012,0.7262815808784988,0.03218366705105357
16551,,59,5166,5225,69,235,7258,1983,5275,7258,448,0.008128961146321301,0.7117663268117939,0.00950675117112152,0.2732157619178837,0.7267842380821163,0.032378065582805184
16552,17.0,50,3721,3771,1,452,5070,1462,3608,5070,343,0.009861932938856016,0.7339250493096647,0.0001972386587771203,0.2883629191321499,0.71163708086785,0.08915187376725839
16553,,419,9542,9961,50,615,13455,3670,9785,13455,1084,0.03114083983649201,0.7091787439613526,0.0037160906726124115,0.27276105536975104,0.727238944630249,0.045707915273132664
16554,,2882,66421,69303,200,3289,93153,26849,66304,93153,7313,0.03093834873809754,0.7130312496645304,0.0021470054641289063,0.288224748531985,0.711775251468015,0.03530750485759986
16555,36.0,1030,33409,34439,231,1397,44327,12987,31340,44327,3274,0.02323640219279446,0.7536941367563788,0.005211270783044194,0.2929817041532249,0.7070182958467751,0.0315157804498387
16556,,80,2691,2771,11,134,3623,1043,2580,3623,266,0.022081148219707424,0.7427546232404085,0.003036157880209771,0.28788296991443557,0.7121170300855645,0.03698592326800994
16557,,301,6942,7243,12,367,9607,2798,6809,9607,749,0.03133132091183512,0.7225981055480379,0.0012490892057874466,0.29124596648277296,0.708754033517227,0.03820131154366608
16558,24.0,249,8416,8665,12,256,11242,3296,7946,11242,939,0.02214908379291941,0.7486212417719267,0.0010674257249599715,0.29318626578900553,0.7068137342109945,0.02277174879914606
16559,17.0,392,4436,4828,7,334,6530,1793,4737,6530,481,0.06003062787136294,0.6793261868300153,0.0010719754977029097,0.2745788667687596,0.7254211332312405,0.05114854517611026
16560,17.0,335,6694,7029,47,379,9603,2631,6972,9603,759,0.034884931792148285,0.6970738310944496,0.004894303863376029,0.2739768822243049,0.7260231177756951,0.039466833281266274
16561,15.0,716,11859,12575,52,1398,16956,4210,12746,16956,1038,0.042226940316112294,0.6993984430290163,0.003066761028544468,0.2482896909648502,0.7517103090351498,0.0824486907289455
16562,,500,22467,22967,84,1083,30218,8514,21704,30218,2094,0.016546429280561256,0.7434972532927394,0.0027798001191342908,0.28175259778939704,0.7182474022106029,0.03583956582169568
16563,16.0,155,1569,1724,52,97,2414,676,1738,2414,185,0.06420878210439106,0.6499585749792874,0.021541010770505385,0.28003314001657,0.71996685998343,0.04018227009113504
16564,15.0,1605,15954,17559,45,1523,24304,6707,17597,24304,1778,0.06603851217906517,0.656435154707044,0.0018515470704410797,0.27596280447662935,0.7240371955233706,0.06266458196181698
16565,,2687,75099,77786,289,3266,100251,29999,70263,100262,7563,0.026799784564441164,0.7490275478246993,0.002882447986275957,0.29920608007021604,0.700793919929784,0.032574654405457704
16566,,429,16106,16535,839,2552,24416,5763,18653,24416,100,0.017570445609436436,0.6596494102228048,0.0343627129750983,0.23603374836173002,0.76396625163827,0.104521625163827
16567,23.0,496,11043,11539,82,837,15835,4286,11549,15835,1324,0.031323018629617935,0.697379223239659,0.005178402273444901,0.27066624565835173,0.7293337543416483,0.05285759393748027
16568,15.0,943,20008,20951,4,1103,27692,8118,19574,27692,2196,0.0340531561461794,0.7225191391015455,0.0001444460494005489,0.29315325725841396,0.706846742741586,0.03983099812220136
16569,26.0,121,2123,2244,12,108,3019,837,2182,3019,225,0.040079496522027164,0.7032129844319311,0.003974826101358066,0.2772441205697251,0.722755879430275,0.03577343491222259
16570,14.0,343,4983,5326,43,613,7788,1972,5816,7788,520,0.04404211607601438,0.6398305084745762,0.005521314843348742,0.2532100667693888,0.7467899332306112,0.07871083718541345
16571,23.0,10954,89775,100729,2697,5118,141155,37582,103573,141155,8531,0.07760263540080053,0.6360029754525167,0.01910665580390351,0.2662463249619213,0.7337536750380788,0.03625801423966562
16572,,239,6745,6984,13,236,8737,2655,6082,8737,610,0.027354927320590593,0.7720041204074625,0.0014879249170195719,0.30388005036053567,0.6961199496394643,0.027011560032047615
16573,,157,4354,4511,7,198,5847,1694,4153,5847,426,0.02685137677441423,0.7446553788267488,0.0011971951428082776,0.2897212245596032,0.7102787754403967,0.03386351975371986
16574,16.0,332,3236,3568,6,432,5029,1371,3658,5029,349,0.06601710081527143,0.6434678862596938,0.0011930801352157488,0.27261881089679857,0.7273811891032015,0.0859017697355339
16575,23.0,99,3013,3112,20,222,4141,1200,2941,4141,314,0.023907268775658054,0.7276020284955325,0.004829751267809708,0.28978507606858245,0.7102149239314175,0.053610239072687756
16576,,235,5935,6170,26,216,8352,2350,6002,8352,635,0.02813697318007663,0.7106082375478927,0.0031130268199233715,0.2813697318007663,0.7186302681992337,0.02586206896551724
16577,33.0,128,3358,3486,0,76,4490,1306,3184,4490,338,0.028507795100222718,0.7478841870824053,0.0,0.29086859688195993,0.7091314031180401,0.016926503340757237
16578,,558,7513,8071,36,561,10866,3127,7739,10866,763,0.05135284373274434,0.6914227866740291,0.0033130866924351186,0.28777839131235045,0.7122216086876495,0.051628934290447265
16579,,22,2877,2899,6,146,3857,1154,2703,3857,351,0.005703914959813326,0.7459165154264973,0.00155561317085818,0.29919626652838993,0.7008037334716101,0.03785325382421571
16580,27.0,585,7307,7892,31,391,10495,2966,7529,10495,724,0.05574082896617437,0.6962363030014292,0.0029537875178656504,0.28261076703191995,0.71738923296808,0.03725583611243449
16581,,183,8362,8545,39,341,11719,3209,8510,11719,942,0.01561566686577353,0.7135421111016298,0.003327929004181244,0.273828824985067,0.726171175014933,0.029098045908353954
16582,40.0,17488,357511,374999,2674,17575,493173,143581,349592,493173,33934,0.03546017320494026,0.724920058478465,0.0054220324308102835,0.29113718715339243,0.7088628128466076,0.035636581889113964
16583,15.0,512,7311,7823,132,741,11128,2909,8219,11128,608,0.04601006470165349,0.6569913731128685,0.01186196980589504,0.26141265276779296,0.7385873472322071,0.06658878504672897
16584,,751,19317,20068,141,744,25932,7541,18391,25932,1656,0.02896035785901589,0.744909763998149,0.005437297547431745,0.2907990128027148,0.7092009871972852,0.02869042110134197
16585,15.0,222,8510,8732,64,681,11663,3210,8453,11663,628,0.01903455371688245,0.7296578924804938,0.005487438909371517,0.27522935779816515,0.7247706422018348,0.058389779645031295
16586,,167,3651,3818,5,211,5171,1426,3745,5171,485,0.03229549410172114,0.7060529878166699,0.0009669309611293754,0.27576871011409787,0.7242312898859021,0.04080448655965964
16587,24.0,1354,31379,32733,143,2705,44705,12466,32239,44705,3073,0.030287439883681915,0.7019125377474555,0.003198747343697573,0.27885024046527235,0.7211497595347277,0.06050777317973381
16588,,279,7636,7915,39,315,10341,3262,7079,10341,534,0.026979982593559618,0.7384198820230152,0.0037713954163040323,0.31544338071753214,0.6845566192824678,0.030461270670147953
16589,26.0,112,2758,2870,17,110,3778,1093,2685,3778,329,0.029645314981471677,0.7300158814187401,0.004499735309687666,0.28930651138168345,0.7106934886183166,0.029115934356802542
16590,16.0,227,3524,3764,115,234,5289,1357,3932,5289,281,0.04291926640196635,0.6662885233503498,0.021743240688220835,0.2565702401210059,0.7434297598789942,0.04424276800907544
16591,17.0,61,1746,1807,0,109,2314,681,1633,2314,147,0.026361279170267933,0.7545375972342264,0.0,0.29429559204840106,0.7057044079515989,0.04710458081244598
16592,,331,7020,7351,26,331,9854,2855,6999,9854,797,0.03359042013395575,0.712401055408971,0.002638522427440633,0.28973005885934644,0.7102699411406536,0.03359042013395575
16593,,220,6906,7126,29,222,9430,2719,6711,9430,703,0.02332979851537646,0.7323435843054082,0.0030752916224814422,0.2883351007423118,0.7116648992576883,0.02354188759278897
16594,34.0,499,12835,13334,2,655,18189,5130,13059,18189,1193,0.02743416350541536,0.7056462697234592,0.00010995656715597339,0.28203859475507176,0.7179614052449282,0.03601077574358129
16595,13.0,601,18226,18827,568,1727,26734,7299,19435,26734,1976,0.022480736141243362,0.6817535722301189,0.021246352958779084,0.273023116630508,0.7269768833694921,0.06459938654896387
16596,,180,4535,4715,4,149,6181,1788,4393,6181,472,0.029121501375182008,0.7337000485358356,0.0006471444750040447,0.28927358032680794,0.7107264196731921,0.024106131693900662
16597,23.0,1117,34570,35687,66,1416,46089,13503,32586,46089,3307,0.024235717850246263,0.7500705157412831,0.0014320119768274425,0.2929766321681963,0.7070233678318036,0.03072316604829786
16598,,303,6001,6304,0,251,8527,2484,6043,8527,705,0.0355341855283218,0.7037645127242875,0.0,0.2913099566084203,0.7086900433915797,0.029435909464055353
16599,27.0,398,11702,12100,62,374,15508,4634,10874,15508,1193,0.02566417332989425,0.7545782821769409,0.003997936548877998,0.2988135156048491,0.7011864843951509,0.024116584988393086
16600,26.0,1330,34319,35649,89,1406,47256,13682,33574,47256,3991,0.028144574233959708,0.7262358219062129,0.001883358726934146,0.28952937193160655,0.7104706280683935,0.029752835618757405
16601,,382,8362,8744,24,411,11821,3282,8539,11821,850,0.03231537095000423,0.7073851619998308,0.00203028508586414,0.27764148549192114,0.7223585145080789,0.0347686320954234
16602,,609,12465,13074,53,860,17531,4850,12681,17531,1434,0.0347384632935942,0.7110261821915465,0.003023216017340711,0.276652786492499,0.723347213507501,0.04905595801722663
16603,35.0,180,3493,3673,15,176,4929,1420,3509,4929,404,0.036518563603164945,0.7086630148103064,0.0030432136335970784,0.2880908906471901,0.7119091093528099,0.03570703996753905
16604,16.0,810,14901,15711,130,804,21205,5996,15209,21205,1561,0.03819853808064136,0.7027116246168357,0.0061306295684979955,0.28276349917472293,0.717236500825277,0.037915585946710684
16605,14.0,108,3861,3969,42,164,5317,1483,3834,5317,433,0.020312206131277037,0.726161369193154,0.007899191273274403,0.2789166823396652,0.7210833176603347,0.030844461162309572
16606,25.0,238,7923,8161,18,296,10565,3104,7461,10565,847,0.02252721249408424,0.7499290108849976,0.0017037387600567914,0.29380028395646,0.70619971604354,0.028017037387600568
16607,,448,11656,12104,216,740,16682,4558,12124,16682,1328,0.026855293130320104,0.6987171801942214,0.012948087759261479,0.27322862966071215,0.7267713703392878,0.04435918954561803
16608,27.0,952,19468,20420,141,998,28126,7664,20462,28126,2146,0.033847685415629665,0.6921709450330655,0.0050131550878191,0.27248808931238,0.72751191068762,0.035483182820166395
16609,25.0,66,1799,1865,5,119,2562,730,1832,2562,159,0.02576112412177986,0.7021857923497268,0.00195160031225605,0.2849336455893833,0.7150663544106167,0.04644808743169399
16610,,317,9816,10133,22,509,14308,3809,10499,14308,877,0.022155437517472742,0.6860497623707017,0.0015376013419066256,0.26621470506010625,0.7337852949398938,0.035574503774112386
16611,,260,10961,11221,77,506,15081,4154,10927,15081,1273,0.0172402360586168,0.7268085670711492,0.005105762217359592,0.27544592533651613,0.7245540746634839,0.03355215171407731
16612,,1441,26630,28071,125,1846,37953,10589,27364,37953,2443,0.03796801306879562,0.7016573129923853,0.003293547282164783,0.27900297736674307,0.7209970226332569,0.04863910626300951
16613,,257,2283,2540,4,273,3502,974,2528,3502,207,0.07338663620788122,0.6519131924614506,0.001142204454597373,0.2781267846944603,0.7218732153055397,0.0779554540262707
16614,15.0,615,13756,14371,24,762,19056,5497,13559,19056,1493,0.03227329974811083,0.7218723761544921,0.0012594458438287153,0.2884655751469353,0.7115344248530646,0.039987405541561716
16615,16.0,1008,21779,22787,269,1760,31478,8542,22936,31478,2288,0.03202236482622784,0.6918800432047779,0.008545650930808819,0.27136412732702203,0.7286358726729779,0.055912065569604166
16616,47.0,902,3431,4333,8,283,6141,1602,4539,6141,295,0.14688161537208924,0.5587037941703306,0.0013027194268034523,0.2608695652173913,0.7391304347826086,0.046083699723172125
16617,23.0,1624,27537,29161,98,1828,40664,11048,29616,40664,2719,0.039937045052134565,0.6771837497540822,0.002409994097973638,0.27168994688176273,0.7283100531182373,0.044953767460161324
16618,27.0,472,11657,12129,120,931,16803,4578,12225,16803,1183,0.028090221984169494,0.6937451645539487,0.007141581860382075,0.2724513479735762,0.7275486520264238,0.05540677260013093
16619,,210,6175,6385,15,275,8560,2476,6084,8560,730,0.02453271028037383,0.7213785046728972,0.0017523364485981308,0.28925233644859816,0.7107476635514018,0.03212616822429906
16620,16.0,809,16086,16895,30,1200,22931,6343,16588,22931,1549,0.0352797523003794,0.701495791722995,0.0013082726440190135,0.27661244603375346,0.7233875539662465,0.05233090576076054
16621,24.0,6611,96272,102883,226,5483,137068,39899,97169,137068,10276,0.048231534712697345,0.7023667084950536,0.0016488166457524732,0.2910890944640616,0.7089109055359384,0.040002042781685
16622,17.0,587,35918,36505,178,2235,48989,13840,35149,48989,3804,0.011982281736716406,0.7331850007144461,0.0036334687378799324,0.2825124007430239,0.717487599256976,0.045622486680683416
16623,43.0,366,7252,7618,38,254,9751,2999,6752,9751,654,0.03753461183468362,0.7437185929648241,0.0038970362014152395,0.30755819915906063,0.6924418008409394,0.02604861039893344
16624,17.0,59,8427,8486,4,964,11791,3239,8552,11791,907,0.0050038164701891276,0.7146976507505725,0.00033924179458909336,0.27470104316851834,0.7252989568314816,0.0817572724959715
16625,41.0,1611,44835,46446,128,1461,61016,17810,43206,61016,4360,0.026402910711944408,0.734807263668546,0.0020978104103841614,0.2918906516323587,0.7081093483676413,0.02394453913727547
16626,,383,20107,20490,24,1472,26940,6955,19985,26940,2042,0.014216778025241277,0.746362286562732,0.0008908685968819599,0.25816629547141795,0.741833704528582,0.05463994060876021
16627,15.0,1285,22848,24133,75,1248,32248,9022,23226,32248,2428,0.03984743239890846,0.7085090548251054,0.0023257256263954354,0.27976928801786155,0.7202307119821384,0.03870007442322004
16628,,184,4536,4720,1,245,6155,1811,4344,6155,433,0.02989439480097482,0.736961819658814,0.00016246953696181965,0.2942323314378554,0.7057676685621446,0.039805036555645816
16629,,4305,68193,72498,72,3191,98142,27985,70157,98142,6856,0.043865011921501496,0.6948401296081188,0.0007336308614049031,0.28514805078355854,0.7148519492164415,0.03251411220476452
16630,,131,3454,3585,40,135,4830,1331,3499,4830,383,0.027122153209109733,0.7151138716356108,0.008281573498964804,0.27556935817805384,0.7244306418219462,0.027950310559006212
16631,14.0,410,7000,7410,111,897,10621,2778,7843,10621,751,0.03860276810093211,0.6590716505037191,0.010450993315130401,0.26155729215704737,0.7384427078429526,0.08445532435740515
16632,,96,3501,3597,15,118,4546,1397,3149,4546,326,0.02111746590409151,0.7701275846898372,0.0032996040475142983,0.307303123625165,0.692696876374835,0.025956885173779146
16633,,781,11527,12308,34,984,16859,4655,12204,16859,1159,0.04632540482828163,0.6837297585859184,0.0020167269707574587,0.2761136484963521,0.7238863515036479,0.05836645115368646
16634,,109,1750,1859,19,150,2532,675,1857,2532,166,0.043048973143759876,0.6911532385466035,0.007503949447077409,0.2665876777251185,0.7334123222748815,0.05924170616113744
16635,13.0,11832,153291,165161,454,14402,225220,62341,162879,225220,14320,0.052535298818932596,0.6806278305656691,0.002015806766716988,0.2768004617707131,0.723199538229287,0.06394636355563449
16636,34.0,116,4358,4474,2,212,5787,1784,4003,5787,390,0.02004492828754104,0.7530672196302056,0.0003456022118541559,0.30827717297390705,0.691722827026093,0.036633834456540525
16637,,1113,30363,31476,192,2054,42684,12470,30214,42684,2721,0.02607534439134102,0.7113438290694405,0.004498172617374192,0.29214694030550087,0.7078530596944991,0.04812107581295099
16638,26.0,14125,281899,296024,1641,15855,401139,113026,288113,401139,31336,0.03521223316605965,0.7027464295418795,0.004090851300920628,0.28176268076651734,0.7182373192334827,0.039524952697194735
16639,17.0,2575,59543,62118,108,3184,83333,23994,59339,83333,6806,0.030900123600494402,0.7145188580754323,0.0012960051840207362,0.2879291517166069,0.7120708482833932,0.03820815283261133
16640,27.0,190,4812,5002,21,325,7185,1898,5287,7185,436,0.026443980514961725,0.6697286012526096,0.0029227557411273487,0.2641614474599861,0.735838552540014,0.04523312456506611
16641,,171,3129,3300,8,141,4487,1278,3209,4487,298,0.038110095832404725,0.6973478939157566,0.0017829284599955428,0.28482282148428795,0.715177178515712,0.03142411410742144
16642,26.0,85,3843,3928,53,271,5666,1507,4159,5666,421,0.015001764913519237,0.6782562654429933,0.009354041651959053,0.2659724673490999,0.7340275326509001,0.047829156371337805
16643,,29,2188,2217,4,124,3119,853,2266,3119,263,0.009297851875601153,0.7015068932350113,0.0012824623276691247,0.27348509137544086,0.7265149086245591,0.039756332157742866
16644,,308,3815,5061,249,720,7849,1580,6269,7849,326,0.039240667600968275,0.48604917823926613,0.03172378646961396,0.20129952860236972,0.7987004713976302,0.09173143075551025
16645,,159,4780,4939,11,269,6642,1874,4768,6642,488,0.023938572719060525,0.7196627521830774,0.001656127672387835,0.2821439325504366,0.7178560674495634,0.04049984944293887
16646,,81,2090,2171,3,119,2916,818,2098,2916,209,0.027777777777777776,0.7167352537722909,0.00102880658436214,0.28052126200274347,0.7194787379972565,0.04080932784636488
16647,,804,21193,21997,90,746,28349,8346,20003,28349,2073,0.028360788740343576,0.7475748703657977,0.0031747151575011465,0.29440191893893963,0.7055980810610604,0.02631486119439839
16648,17.0,5,2756,2761,2,174,3689,1078,2611,3689,329,0.0013553808620222283,0.7470859311466522,0.0005421523448088912,0.2922201138519924,0.7077798861480076,0.04716725399837354
16649,43.0,1744,33258,35002,518,1977,47927,13067,34878,47945,3040,0.036375013035770155,0.6936698300135572,0.010804046303055585,0.2725414537490875,0.7274585462509126,0.04123474814892064
16650,,5045,133314,138359,653,8023,199174,53064,146110,199174,13661,0.025329611294646892,0.6693343508690893,0.0032785403717352666,0.26642031590468634,0.7335796840953136,0.04028136202516393
16651,33.0,161,4352,4513,35,143,5723,1758,3965,5723,378,0.02813209854971169,0.760440328499039,0.006115673597763411,0.3071815481390879,0.6928184518609121,0.02498689498514765
16652,35.0,69,2257,2326,8,130,3162,920,2242,3162,274,0.021821631878557873,0.7137887413029728,0.002530044275774826,0.290955091714105,0.709044908285895,0.041113219481340925
16653,25.0,1615,41700,43315,132,1891,57430,16399,41031,57430,4332,0.028121191015148875,0.7261013407626676,0.002298450287306286,0.2855476231934529,0.714452376806547,0.032927041615880205
16654,14.0,4700,73950,78650,969,5599,111363,30132,81231,111363,7662,0.04220432280021192,0.6640446108671642,0.00870127421136284,0.2705746073651033,0.7294253926348967,0.05027702199114607
16655,,380,7118,7498,23,527,10312,2885,7427,10312,781,0.036850271528316526,0.6902637703646237,0.002230411171450737,0.2797711404189294,0.7202288595810706,0.05110550814584949
16656,25.0,190,5878,6068,17,282,7959,2328,5631,7959,568,0.02387234577208192,0.7385349918331449,0.0021359467269757505,0.2924990576705616,0.7075009423294384,0.035431586882774216
16657,27.0,1068,21410,22478,573,1569,29800,8553,21247,29800,1756,0.035838926174496646,0.7184563758389262,0.019228187919463086,0.28701342281879194,0.7129865771812081,0.0526510067114094
16658,,10587,276351,286938,1093,12754,386369,109178,277191,386369,22985,0.027401266664768654,0.7152514823911856,0.002828901904655912,0.28257443014320505,0.717425569856795,0.033009894686167884
16659,40.0,121,2404,2525,8,81,3660,921,2739,3660,243,0.03306010928961749,0.6568306010928961,0.002185792349726776,0.25163934426229506,0.7483606557377049,0.022131147540983605
16660,23.0,521,10093,10614,136,440,14443,3983,10460,14443,722,0.03607283805303607,0.6988160354496988,0.009416326248009416,0.2757737312192758,0.7242262687807243,0.030464584920030464
16661,,4671,105005,109676,424,7135,146301,42237,104064,146301,10603,0.03192732790616606,0.7177326197360236,0.002898134667568916,0.288699325363463,0.711300674636537,0.048769318049774094
16662,17.0,5895,93743,99638,325,6493,136242,38401,97841,136242,9082,0.04326859558726384,0.6880624183438293,0.0023854611646922388,0.2818587513395282,0.7181412486604718,0.04765784413029756
16663,25.0,856,23239,24095,15,1182,31533,9202,22331,31533,2413,0.02714616433577522,0.7369739637839724,0.0004756921320521359,0.29182126660958363,0.7081787333904164,0.037484540005708306
16664,35.0,324,5788,6112,28,375,8434,2285,6149,8434,584,0.03841593549917002,0.6862698600901115,0.003319895660422101,0.270927199430875,0.7290728005691249,0.04446288830922457
16665,39.0,16977,368379,385356,4512,20655,521680,146006,375674,521680,38888,0.03254293819966263,0.7061397791749732,0.008648980217758012,0.27987655267596995,0.7201234473240301,0.03959323723355314
16666,24.0,146,4661,4807,18,405,6556,1781,4775,6556,483,0.022269676632092738,0.7109517998779744,0.002745576571079927,0.2716595485051861,0.7283404514948139,0.06177547284929835
16667,24.0,295,7952,8247,24,537,11332,3217,8115,11332,878,0.02603247440875397,0.7017296152488528,0.002117896223085069,0.2838863395693611,0.716113660430639,0.04738792799152842
16668,16.0,783,15080,15863,168,1274,21663,6033,15630,21663,1437,0.03614457831325301,0.6961178045515395,0.007755158565295665,0.2784932834787426,0.7215067165212574,0.05880995245349213
16669,25.0,418,5318,5736,21,379,7901,2182,5719,7901,476,0.052904695608150865,0.6730793570434123,0.00265789140615112,0.27616757372484496,0.7238324262751551,0.047968611568155926
16670,,148,4199,4347,9,108,5828,1652,4176,5828,449,0.02539464653397392,0.720487302676733,0.0015442690459849004,0.2834591626630062,0.7165408373369938,0.018531228551818806
16671,,1921,48296,50217,414,2239,65231,19008,46223,65231,3880,0.029449188269381123,0.7403841731691987,0.006346675660345541,0.29139519553586485,0.7086048044641351,0.03432417102297987
16672,27.0,890,29315,30205,106,2026,38993,11168,27825,38993,2588,0.022824609545303003,0.7518016054163568,0.00271843664247429,0.2864103813504988,0.7135896186495012,0.05195804375144256
16673,,164,10837,11001,167,1166,15555,4019,11536,15555,977,0.01054323368691739,0.6966891674702668,0.010736097717775634,0.25837351333976216,0.7416264866602379,0.0749598199935712
16674,15.0,19,2063,2082,19,77,2736,768,1968,2736,241,0.006944444444444444,0.7540204678362573,0.006944444444444444,0.2807017543859649,0.7192982456140351,0.028143274853801168
16675,17.0,728,5820,6548,18,893,9608,2655,6953,9608,538,0.07577019150707744,0.6057452123230641,0.0018734388009991674,0.2763322231473772,0.7236677768526228,0.09294338051623648
16676,23.0,181,7718,7899,19,317,10340,3085,7255,10340,823,0.017504835589941974,0.74642166344294,0.0018375241779497098,0.29835589941972923,0.7016441005802708,0.03065764023210832
16677,,6292,130558,136850,527,5745,188358,52194,136164,188358,14521,0.033404474458212555,0.6931375359687404,0.0027978636426379553,0.2770999904437295,0.7229000095562705,0.030500430032172777
16678,23.0,121,3134,3255,1,170,4413,1266,3147,4413,303,0.027418989349648766,0.7101744844776796,0.00022660321776569228,0.2868796736913664,0.7131203263086335,0.038522547020167684
16679,,948,13301,14249,85,565,18957,5355,13602,18957,1343,0.05000791264440576,0.7016405549401277,0.004483831829930896,0.28248140528564647,0.7175185947143535,0.029804293928364194
16680,24.0,94,5149,5243,23,182,7470,1971,5499,7470,678,0.012583668005354752,0.6892904953145917,0.003078982597054886,0.26385542168674697,0.736144578313253,0.02436412315930388
16681,14.0,30,1912,1942,13,112,2689,726,1963,2689,270,0.011156563778356266,0.7110449981405726,0.004834510970621049,0.26998884343622165,0.7300111565637784,0.04165117143919673
16682,33.0,113,3366,3479,15,105,4514,1346,3168,4514,437,0.02503322995126274,0.745680106335844,0.003322995126273815,0.2981834293309703,0.7018165706690297,0.023260965883916705
16683,,109,3301,3410,12,142,4524,1289,3235,4524,382,0.024093722369584437,0.7296640141467727,0.002652519893899204,0.2849248452696729,0.7150751547303271,0.03138815207780725
16684,25.0,152,3447,3599,13,198,4887,1412,3475,4887,395,0.03110292613055044,0.7053406998158379,0.0026601186822181296,0.28892981379169225,0.7110701862083078,0.040515653775322284
16685,36.0,65,2172,2237,2,72,3010,843,2167,3010,262,0.02159468438538206,0.7215946843853821,0.000664451827242525,0.2800664451827243,0.7199335548172757,0.023920265780730896
16686,,3045,31138,34183,588,2667,47205,13062,34143,47205,2695,0.06450587861455355,0.6596335133990043,0.012456307594534477,0.2767079758500159,0.7232920241499841,0.05649825230378138
16687,17.0,7136,132575,139711,316,8969,188456,53946,134511,188457,14678,0.03786540165661132,0.7034761245270804,0.0016767750733589094,0.2862509750234802,0.7137490249765198,0.047591758332139425
16688,15.0,111,1599,1710,6,107,2348,642,1706,2348,180,0.04727427597955707,0.6810051107325383,0.002555366269165247,0.2734241908006814,0.7265758091993185,0.04557069846678024
16689,25.0,893,30182,31075,62,1143,39809,11932,27877,39809,3138,0.02243211334120425,0.758170263005853,0.001557436760531538,0.29973121655906954,0.7002687834409305,0.02871210027883142
16690,17.0,1493,20119,21612,137,1764,29554,8223,21331,29554,1876,0.050517696420112335,0.680753874264059,0.004635582323881708,0.2782364485348853,0.7217635514651147,0.05968735196589294
16691,,102,2059,2161,10,55,2820,830,1990,2820,225,0.036170212765957444,0.7301418439716312,0.0035460992907801418,0.29432624113475175,0.7056737588652482,0.01950354609929078
16692,16.0,7639,15932,23571,117,1876,31740,8966,22774,31740,576,0.24067422810333963,0.5019533711405167,0.0036862003780718335,0.2824826717076244,0.7175173282923756,0.059105229993698806
16693,24.0,270,8205,8475,10,304,11308,3286,8022,11308,951,0.023876901308807923,0.7255925008843297,0.0008843296781039972,0.29059073222497345,0.7094092677750266,0.026883622214361514
16694,14.0,45,2111,2156,8,74,2851,786,2065,2851,226,0.01578393546124167,0.7404419501929148,0.0028060329708874078,0.2756927393896878,0.7243072606103121,0.025955804980708524
16695,35.0,202,5931,6133,0,245,7929,2363,5566,7929,649,0.02547610039096986,0.7480136208853575,0.0,0.29801992685080086,0.7019800731491992,0.030899230672215915
16696,15.0,166,4224,4390,33,240,5867,1705,4162,5867,406,0.028293846940514743,0.7199590932333391,0.0056246804158854614,0.29060848815408213,0.7093915118459179,0.040906766660985174
16697,15.0,66,1735,1801,9,148,2643,689,1954,2643,216,0.024971623155505107,0.6564510026485055,0.00340522133938706,0.26068861142640937,0.7393113885735906,0.05599697313658721
16698,,450,13537,13987,11,570,17905,5259,12646,17905,1380,0.02513264451270595,0.7560457972633343,0.0006143535325328121,0.29371683887182354,0.7062831611281765,0.031834683049427534
16699,44.0,69,1887,1956,0,139,2701,762,1939,2701,161,0.025546094039244724,0.6986301369863014,0.0,0.28211773417252867,0.7178822658274713,0.05146242132543503
16700,23.0,271,4926,5197,6,249,6856,1968,4888,6856,519,0.03952742123687281,0.7184947491248541,0.0008751458576429405,0.2870478413068845,0.7129521586931156,0.03631855309218203
16701,23.0,105,2366,2471,0,121,3448,949,2499,3448,299,0.030452436194895592,0.6861948955916474,0.0,0.27523201856148494,0.7247679814385151,0.03509280742459397
16702,26.0,137,3073,3210,8,133,4143,1209,2934,4143,312,0.033067825247405265,0.7417330436881486,0.0019309678976587015,0.29181752353367124,0.7081824764663287,0.032102341298575914
16703,17.0,91,2361,2452,16,103,3323,915,2408,3323,260,0.02738489316882335,0.7105025579295817,0.004814926271441469,0.275353596148059,0.724646403851941,0.030996087872404453
16704,,262,8673,8935,18,430,11621,3382,8239,11621,743,0.022545391962825918,0.7463213148610275,0.0015489200585147578,0.2910248687720506,0.7089751312279494,0.03700197917563033
16705,15.0,381,5496,5877,38,347,7992,2238,5754,7992,464,0.047672672672672674,0.6876876876876877,0.004754754754754755,0.28003003003003,0.71996996996997,0.04341841841841842
16706,,134,2188,2322,24,150,3283,889,2394,3283,184,0.04081632653061224,0.6664636003655193,0.007310386841303686,0.27078891257995735,0.7292110874200426,0.045689917758148034
16707,25.0,313,9824,10137,17,400,14317,3905,10412,14317,1001,0.0218621219529231,0.6861772717748131,0.001187399594887197,0.2727526716490885,0.7272473283509115,0.027938813997345813
16708,,161,3374,3535,27,301,5072,1289,3783,5072,258,0.03174290220820189,0.6652208201892744,0.0053233438485804415,0.2541403785488959,0.7458596214511041,0.059345425867507885
16709,,5262,130012,135274,685,9847,184906,51434,133472,184906,14097,0.028457702832790716,0.7031248309952084,0.0037045850323948384,0.2781629584761987,0.7218370415238012,0.0532540858598423
16710,,302,5402,5704,61,298,7936,2183,5753,7936,562,0.03805443548387097,0.680695564516129,0.007686491935483871,0.2750756048387097,0.7249243951612904,0.03755040322580645
16711,25.0,12043,315883,327926,3187,15966,438813,124289,314534,438823,32432,0.027443866889383647,0.7198414850634538,0.007262609298054113,0.2832326473316121,0.716767352668388,0.036383690007132714
16712,26.0,1853,44419,46272,126,1930,60655,17341,43314,60655,4185,0.030549831011458247,0.7323221498639848,0.00207732256203116,0.2858956392712884,0.7141043607287115,0.03181930591047729
16713,17.0,160,5676,5836,18,632,7977,2165,5812,7977,516,0.020057665789143787,0.7115456938698759,0.0022564874012786762,0.2714052902093519,0.7285947097906481,0.07922777986711796
16714,27.0,6495,117078,123573,411,6037,164608,47035,117573,164608,12488,0.039457377527216175,0.7112534020217729,0.0024968409797822707,0.28573945373250387,0.7142605462674961,0.036675009720062206
16715,,190,3147,3337,5,255,4555,1266,3289,4555,282,0.04171240395170143,0.6908891328210758,0.0010976948408342481,0.2779363336992316,0.7220636663007683,0.05598243688254665
16716,25.0,477,6668,8142,37,489,10887,2704,8183,10887,570,0.04381372278864701,0.612473592357858,0.003398548727840544,0.24836961513731973,0.7516303848626803,0.04491595480848719
16717,24.0,4033,94736,98769,85,2812,130115,37939,92176,130115,11118,0.03099565768743035,0.7280943780501864,0.0006532682626906967,0.2915805249202628,0.7084194750797371,0.021611651231602812
16718,26.0,818,22930,23748,44,1097,31231,9797,21434,31231,1258,0.02619192469021165,0.7342063974896738,0.0014088565848035606,0.3136947263936473,0.6863052736063526,0.03512535621657968
16719,,22,2041,2063,38,142,2922,803,2119,2922,216,0.007529089664613279,0.6984941820670774,0.013004791238877482,0.27481177275838464,0.7251882272416154,0.0485968514715948
16720,25.0,1260,23923,25183,62,1654,34284,9058,25226,34284,2295,0.036751837591879596,0.6977890561194726,0.0018084237545210593,0.2642048769105122,0.7357951230894878,0.0482440788706102
16721,,2100,52124,54224,98,1968,70668,20599,50069,70668,4822,0.029716420444897265,0.7375898567951548,0.001386766287428539,0.29148978321163754,0.7085102167883625,0.027848531159789438
16722,,611,20703,21314,33,943,27555,8129,19426,27555,1932,0.022173834149882055,0.7513336962438759,0.0011976047904191617,0.2950099800399202,0.7049900199600798,0.03422246416258392
16723,16.0,320,3771,4091,4,424,5925,1571,4354,5925,316,0.0540084388185654,0.6364556962025316,0.0006751054852320675,0.2651476793248945,0.7348523206751055,0.07156118143459915
16724,44.0,710,6108,6818,449,431,9541,2607,6934,9541,562,0.07441567969814485,0.6401844670369983,0.0470600565978409,0.27324179855361075,0.7267582014463893,0.04517346190126821
16725,38.0,1775,47959,49734,203,2127,66662,19063,47599,66662,5028,0.026626863880471634,0.7194353604752333,0.0030452131649215445,0.2859650175512286,0.7140349824487714,0.031907233506345445
16726,,1066,27985,29051,137,1336,38458,10816,27642,38458,2697,0.02771855010660981,0.7276769462790577,0.0035623277341515418,0.28124187425243125,0.7187581257475688,0.034739196006032556
16727,14.0,351,6333,6684,182,421,9267,2463,6804,9267,585,0.03787633538361929,0.683392683716413,0.019639581310024818,0.2657818064098414,0.7342181935901586,0.04543002050285961
16728,35.0,1387,28146,29533,222,1940,40249,11294,28955,40249,2657,0.03446048349027305,0.699296876941042,0.0055156649854654774,0.2806032448011131,0.7193967551988869,0.04819995527839201
16729,33.0,10988,274298,285286,1040,11519,368496,108743,259781,368524,25776,0.02981623991924542,0.7443151599353095,0.002822068576266403,0.29507711845090145,0.7049228815490985,0.031257123009627595
16730,16.0,92,10339,10431,94,649,14452,3695,10757,14452,880,0.006365900913368392,0.7154027124273457,0.006504290063659009,0.2556739551619153,0.7443260448380847,0.04490727926930529
16731,,99,4118,4217,6,602,6039,1535,4504,6039,444,0.01639344262295082,0.6819009769829442,0.0009935419771485345,0.2541811558205001,0.7458188441795,0.09968537837390297
16732,,94,2406,2500,3,113,3407,930,2477,3407,244,0.027590255356618725,0.7061931317874963,0.0008805400645729381,0.2729674200176108,0.7270325799823892,0.033167009098914
16733,23.0,188,5562,5750,16,265,7866,2215,5651,7866,576,0.023900330536486145,0.7070938215102975,0.0020340706839562673,0.2815916603101958,0.7184083396898042,0.03368929570302568
16734,26.0,206,7510,7716,22,412,10223,2913,7310,10223,848,0.02015064071211973,0.7346180181942679,0.0021520101731390003,0.28494571065245033,0.7150542893475497,0.04030128142423946
16735,15.0,682,16722,17404,45,1014,22936,6560,16376,22936,1886,0.02973491454482037,0.7290722009068713,0.001961981164980816,0.286013254272759,0.713986745727241,0.04420997558423439
16736,38.0,620,22895,23515,69,1713,32150,9189,22961,32150,2831,0.019284603421461897,0.7121306376360809,0.002146189735614308,0.28581648522550546,0.7141835147744946,0.05328149300155521
16737,,76,2146,2222,1,78,2836,839,1997,2836,193,0.02679830747531735,0.7566995768688294,0.0003526093088857546,0.2958392101551481,0.7041607898448519,0.027503526093088856
16738,,117,3125,3242,20,138,4231,1253,2978,4231,305,0.02765303710706689,0.7385960765776413,0.004727014890096904,0.29614748286457104,0.703852517135429,0.03261640274166864
16739,14.0,141,3036,3177,0,147,4165,1235,2930,4165,286,0.03385354141656663,0.7289315726290516,0.0,0.2965186074429772,0.7034813925570228,0.03529411764705882
16740,23.0,3083,61857,64940,714,2077,84826,25595,59231,84826,4415,0.03634498856482682,0.7292221724471271,0.008417230566100017,0.3017353170018626,0.6982646829981374,0.024485417206988422
16741,27.0,2502,42298,44800,357,2725,61382,17146,44236,61382,4253,0.04076113518621094,0.6890945228242807,0.005816037274771106,0.2793327033983904,0.7206672966016096,0.04439412205532567
16742,15.0,25,4556,4581,7,1016,6742,1682,5060,6742,330,0.003708098487095817,0.6757638682883418,0.0010382675763868287,0.2494808662118066,0.7505191337881935,0.15069712251557402
16743,,573,23236,23809,76,891,30775,9134,21641,30775,2476,0.018619008935824532,0.7550284321689683,0.0024695369618196587,0.29679935012185216,0.7032006498781479,0.028952071486596263
16744,,27,9603,9630,70,599,13121,3660,9461,13121,1129,0.0020577699870436704,0.7318801920585322,0.0053349592256687756,0.2789421537992531,0.7210578462007469,0.04565200823107995
16745,23.0,1175,29798,30973,260,1864,41790,11827,29963,41790,2837,0.028116774347930126,0.713041397463508,0.006221584111031347,0.2830102895429529,0.7169897104570472,0.0446039722421632
16746,16.0,1420,32542,33962,7,1317,45662,12818,32844,45662,3570,0.031098068415750513,0.7126713678770094,0.00015330033726074197,0.28071481757259864,0.7192851824274014,0.0288423634531996
16747,,1159,25504,26663,129,1219,35074,10047,25027,35074,2614,0.03304442036836403,0.7271483149911615,0.0036779380737868507,0.2864515025374922,0.7135484974625078,0.034755089239892796
16748,,201,5262,5463,281,457,7998,2085,5913,7998,435,0.025131282820705175,0.6579144786196549,0.03513378344586147,0.26069017254313576,0.7393098274568642,0.057139284821205304
16749,,593,13025,13618,54,728,17930,5245,12685,17930,1232,0.03307306190741774,0.72643614054657,0.003011712214166202,0.29252649191299496,0.707473508087005,0.04060234244283324
16750,23.0,82,2815,2897,3,89,3753,1067,2686,3753,326,0.021849187316813217,0.7500666133759659,0.0007993605115907274,0.2843058886224354,0.7156941113775647,0.023714361843858247
16751,,4484,150145,154629,717,5587,198078,58942,139136,198078,14613,0.022637546824988135,0.7580094710164682,0.0036197861448520278,0.29756964428154564,0.7024303557184544,0.02820606023889579
16752,14.0,175,2743,2918,13,168,4084,1146,2938,4084,270,0.04285014691478942,0.671645445641528,0.0031831537708129284,0.28060724779627816,0.7193927522037218,0.04113614103819784
16753,,203,3293,3496,8,157,4871,1310,3561,4871,373,0.04167522069390269,0.6760418805173476,0.001642373229316362,0.2689386163005543,0.7310613836994457,0.03223157462533361
16754,25.0,620,16910,17530,26,892,23402,6636,16766,23402,1838,0.026493462097256646,0.7225878130074352,0.0011110161524656012,0.283565507221605,0.716434492778395,0.03811640030766601
16755,24.0,10571,240370,250941,1317,12321,333395,94962,238433,333395,22596,0.03170713418017667,0.7209766193254248,0.003950269200197963,0.28483330583841987,0.7151666941615801,0.036956163109824684
16756,,9379,188303,197682,1284,10701,273214,76307,196907,273214,20135,0.03432840191205429,0.6892143155182384,0.0046996127577649755,0.2792938868432804,0.7207061131567196,0.039167099782588005
16757,,94,1784,1878,26,79,2613,708,1905,2613,194,0.035973976272483735,0.6827401454267126,0.009950248756218905,0.2709529276693456,0.7290470723306545,0.030233448143895905
16758,37.0,99,2066,2165,24,199,3052,809,2243,3052,212,0.032437745740498035,0.6769331585845347,0.007863695937090432,0.2650720838794233,0.7349279161205766,0.06520314547837483
16759,39.0,594,16325,16919,156,741,22265,6646,15619,22265,1457,0.02667864361104873,0.7332135638895126,0.007006512463507747,0.2984953963620031,0.7015046036379968,0.0332809342016618
16760,,99,3885,3984,10,284,5658,1505,4153,5658,453,0.017497348886532343,0.6866383881230117,0.0017674089784376105,0.2659950512548604,0.7340049487451397,0.05019441498762814
16761,,2151,48665,50816,18,1081,65620,19358,46262,65620,4998,0.03277964035355075,0.7416184090216398,0.00027430661383724475,0.29500152392563245,0.7049984760743676,0.016473636086558975
16762,25.0,101,3264,3365,3,178,4514,1250,3264,4514,323,0.022374833850243685,0.7230837394771821,0.000664599025254763,0.2769162605228179,0.7230837394771821,0.03943287549844927
16763,,199,3327,3526,31,145,4698,1367,3331,4698,355,0.042358450404427414,0.7081736909323116,0.00659855257556407,0.29097488292890594,0.7090251170710941,0.030864197530864196
16764,23.0,784,10992,11776,44,553,15288,4396,10892,15288,1001,0.05128205128205128,0.7189952904238619,0.0028780743066457353,0.2875457875457875,0.7124542124542125,0.036172161172161175
16765,,591,14978,15569,65,576,20376,5917,14459,20376,1606,0.029004711425206126,0.7350804868472713,0.0031900274833137022,0.29039065567334116,0.7096093443266588,0.028268551236749116
16766,13.0,669,9657,10326,48,738,13831,3928,9903,13831,853,0.04836960451160437,0.6982141566047285,0.003470464897693587,0.28399971079459185,0.7160002892054081,0.053358397802038895
16767,16.0,27,3108,3135,18,236,4503,1235,3268,4503,366,0.005996002664890073,0.6902065289806796,0.003997335109926716,0.2742616033755274,0.7257383966244726,0.05240950477459472
16768,23.0,7907,266389,274296,1978,16064,371489,106345,265145,371490,28741,0.02128455678483943,0.7170825594228647,0.005324504024334437,0.2862661175267167,0.7137338824732833,0.04324207919459474
16769,17.0,179,2478,2657,3,171,3609,1037,2572,3609,240,0.049598226655583263,0.686616791354946,0.0008312551953449709,0.28733721252424493,0.7126627874757551,0.04738154613466334
16770,15.0,1279,13509,14788,25,656,19976,5791,14185,19976,1406,0.06402683219863836,0.67626151381658,0.0012515018021625952,0.28989787745294354,0.7101021225470565,0.03283940728874649
16771,,776,42072,42848,149,3049,58521,16060,42461,58521,4315,0.013260197194169614,0.718921412826165,0.0025460945643444232,0.27443140069376804,0.725568599306232,0.0521009552126587
16772,,2624,34294,36918,308,2470,49967,13900,36067,49967,3180,0.05251465967538575,0.686332979766646,0.006164068285068145,0.27818360117677665,0.7218163988232233,0.04943262553285168
16773,15.0,275,11514,11789,52,1191,16694,4456,12238,16694,1211,0.01647298430573859,0.6897088774409967,0.0031148915778123876,0.2669222475140769,0.7330777524859231,0.07134299748412604
16774,25.0,563,11922,12485,30,715,16470,4681,11789,16470,1170,0.034183363691560414,0.7238615664845173,0.0018214936247723133,0.28421372191863997,0.7157862780813601,0.043412264723740136
16775,,977,33785,34762,182,1940,46464,13026,33438,46464,3672,0.02102703168044077,0.7271220730027548,0.003917011019283746,0.2803460743801653,0.7196539256198347,0.04175275482093664
16776,,713,20095,20808,99,867,27509,8008,19501,27509,2183,0.025918790214111746,0.7304882038605547,0.0035988222036424443,0.29110472936129994,0.7088952706387001,0.03151695808644444
16777,15.0,1722,28966,30688,6,1856,41554,11988,29566,41554,3133,0.04144005390576118,0.697068874235934,0.00014439043172739086,0.28849208259132697,0.711507917408673,0.044664773547672905
16778,,541,12478,13019,106,607,18114,4947,13167,18114,1603,0.02986640167825991,0.6888594457325825,0.005851827315888263,0.27310367671414376,0.7268963232858563,0.03350999227117147
16779,15.0,4,5046,5050,25,283,6770,1959,4811,6770,696,0.0005908419497784342,0.7453471196454948,0.003692762186115214,0.28936484490398817,0.7106351550960118,0.04180206794682422
16780,34.0,1796,39743,41539,181,1872,55516,15512,40004,55516,4385,0.032351033936162545,0.7158837092009511,0.003260321348800346,0.2794149434397291,0.7205850565602709,0.03372000864615606
16781,27.0,395,8659,9054,29,412,11828,3408,8420,11828,815,0.03339533310787961,0.7320764288129862,0.002451809266148123,0.28812986134595875,0.7118701386540413,0.03483260060872506
16782,16.0,2392,85561,87953,432,6595,121406,32414,88992,121406,9288,0.019702485873844787,0.7047510007742616,0.0035583084855773193,0.2669884519710723,0.7330115480289278,0.054321862181440785
16783,13.0,126,2519,2645,0,224,3602,1016,2586,3602,250,0.03498056635202665,0.6993337034980567,0.0,0.28206551915602446,0.7179344808439756,0.06218767351471405
16784,,522,5299,5821,12,812,8763,2324,6439,8763,428,0.059568640876412185,0.6047015862147667,0.0013693940431359123,0.2652059796873217,0.7347940203126783,0.09266233025219674
16785,,193,8466,8659,2,1007,12185,3445,8740,12185,946,0.01583914649158802,0.6947886745999179,0.00016413623307345098,0.2827246614690193,0.7172753385309807,0.08264259335248256
16786,,2568,24152,26720,70,1450,36230,10199,26031,36230,2710,0.07088048578526084,0.6666298647529671,0.0019321004692243997,0.28150703836599505,0.718492961634005,0.04002208114821971
16787,48.0,310,8527,8837,28,286,11422,3366,8056,11422,996,0.02714060584836281,0.7465417615128699,0.002451409560497286,0.2946944493083523,0.7053055506916477,0.02503939765365085
16788,,3368,16630,19998,264,2684,29058,7561,21497,29058,1310,0.11590611879688897,0.5723036685250189,0.009085277720421227,0.2602037304700943,0.7397962695299057,0.0923669901576158
16789,15.0,951,10577,11528,273,1360,16562,4489,12073,16562,898,0.057420601376645335,0.6386306001690617,0.016483516483516484,0.2710421446685183,0.7289578553314817,0.0821156865112909
16790,15.0,249,7840,8089,0,467,10805,3064,7741,10805,767,0.023044886626561775,0.7255900046274872,0.0,0.2835724201758445,0.7164275798241555,0.043220731142989355
16791,,1287,11981,13268,271,1588,19475,5096,14379,19475,1221,0.06608472400513479,0.615198973042362,0.013915275994865212,0.2616688061617458,0.7383311938382542,0.08154043645699614
16792,27.0,288,4848,5136,28,169,6820,1881,4939,6820,646,0.04222873900293255,0.7108504398826979,0.004105571847507331,0.27580645161290324,0.7241935483870968,0.024780058651026393
16793,23.0,550,10473,11023,39,790,14742,4147,10595,14742,932,0.037308370641703975,0.7104192104192104,0.0026455026455026454,0.281305114638448,0.718694885361552,0.05358838692172026
16794,14.0,201,1708,1909,6,208,2629,741,1888,2629,140,0.07645492582731077,0.6496766831494865,0.002282236591860023,0.2818562190947128,0.7181437809052872,0.0791175351844808
16795,27.0,124,2462,2586,6,147,3624,983,2641,3624,223,0.03421633554083885,0.6793598233995585,0.0016556291390728477,0.27124724061810157,0.7287527593818984,0.04056291390728477
16796,,89,1940,2029,19,149,2749,747,2002,2749,177,0.032375409239723534,0.7057111676973445,0.006911604219716261,0.27173517642779194,0.7282648235722081,0.0542015278283012
16797,,143,3230,3373,83,167,4734,1268,3466,4734,318,0.030207013096746938,0.6822982678495987,0.01753274186734263,0.2678495986480777,0.7321504013519222,0.03527672158850866
16798,,119,3963,4082,8,255,5410,1504,3906,5410,416,0.021996303142329022,0.732532347504621,0.0014787430683918669,0.27800369685767096,0.721996303142329,0.04713493530499076
16799,27.0,177,3927,4104,25,201,5524,1583,3941,5524,379,0.03204199855177408,0.7108979000724113,0.004525706010137582,0.28656770456191166,0.7134322954380884,0.036386676321506155
16800,23.0,1711,40510,42221,278,1732,56150,16253,39897,56150,4367,0.03047195013357079,0.721460373998219,0.004951024042742653,0.2894568121104185,0.7105431878895815,0.03084594835262689
16801,24.0,146,3394,3540,4,264,4872,1351,3521,4872,385,0.029967159277504107,0.6966338259441708,0.0008210180623973727,0.27729885057471265,0.7227011494252874,0.054187192118226604
16802,,6069,4685,10754,24,544,14276,4133,10143,14276,422,0.42511908097506307,0.32817315774726813,0.0016811431773606051,0.2895068646679742,0.7104931353320257,0.038105912020173716
16803,,728,9900,10628,113,1164,15342,3995,11347,15342,779,0.04745144049015774,0.6452874462260462,0.007365402163994264,0.260396297744753,0.7396037022552471,0.07587016034415331
16804,17.0,255,4932,5187,12,413,7155,1955,5200,7155,514,0.03563941299790356,0.6893081761006289,0.0016771488469601676,0.273235499650594,0.726764500349406,0.05772187281621244
16805,24.0,3326,91291,94617,409,3585,122333,36107,86226,122333,9206,0.027188084981157986,0.7462499897819885,0.003343333360581364,0.2951533927885362,0.7048466072114637,0.029305256962553032
16806,17.0,71,6954,7025,62,804,9558,2626,6932,9558,516,0.007428332287089349,0.7275580665411174,0.006486712701401967,0.27474367022389623,0.7252563297761038,0.08411801632140616
16807,33.0,345,6920,7265,29,377,9859,2722,7138,9860,663,0.03498985801217039,0.7018255578093306,0.0029411764705882353,0.27606490872210954,0.7239350912778905,0.03823529411764706
16808,,285,3132,3417,4,263,4853,1312,3541,4853,265,0.05872656089017103,0.6453739954667216,0.00082423243354626,0.2703482382031733,0.7296517617968267,0.0541932825056666
16809,16.0,162,2240,2402,40,349,3698,898,2800,3698,199,0.043807463493780424,0.6057328285559762,0.01081665765278529,0.24283396430502974,0.7571660356949702,0.09437533802055165
16810,26.0,280,4370,4650,23,110,6021,1858,4163,6021,456,0.04650390300614516,0.7257930576316226,0.0038199634612190664,0.30858661351934896,0.6914133864806511,0.018269390466699884
16811,15.0,114,13081,13195,16,758,17643,5006,12637,17643,1565,0.006461486141812617,0.7414271949214987,0.0009068752479737006,0.2837385932097716,0.7162614067902284,0.04296321487275407
16812,,77,1503,1580,6,60,2167,593,1574,2167,171,0.03553299492385787,0.6935856022150438,0.0027688047992616522,0.27365020766035997,0.72634979233964,0.02768804799261652
16813,,262,6849,7111,29,250,9170,2639,6531,9170,626,0.02857142857142857,0.7468920392584515,0.0031624863685932388,0.2877862595419847,0.7122137404580152,0.027262813522355506
16814,,142,2734,2876,8,133,3783,1101,2682,3783,313,0.03753634681469733,0.7227068464181866,0.0021147237642083,0.29103885804916735,0.7089611419508327,0.03515728257996299
16815,27.0,229,6643,6872,7,259,8896,2652,6244,8896,634,0.025741906474820143,0.7467401079136691,0.0007868705035971223,0.2981115107913669,0.7018884892086331,0.029114208633093525
16816,16.0,1962,30191,32153,178,1987,43511,12484,31027,43511,3015,0.04509204568959573,0.6938705155018271,0.004090919537588196,0.2869159522879272,0.7130840477120728,0.045666613040380596
16817,15.0,4,3555,3559,21,370,4886,1296,3590,4886,282,0.0008186655751125665,0.7275890298812935,0.004297994269340974,0.2652476463364716,0.7347523536635284,0.0757265656979124
16818,27.0,208,3615,3823,75,228,5101,1457,3649,5106,230,0.040736388562475516,0.7079905992949471,0.014688601645123384,0.2853505679592636,0.7146494320407364,0.04465334900117509
16819,27.0,69,626,1277,39,171,2315,270,2045,2315,58,0.029805615550755938,0.27041036717062633,0.016846652267818573,0.11663066954643629,0.8833693304535637,0.07386609071274298
16820,24.0,431,10542,10973,30,651,15027,4187,10840,15027,1049,0.028681706262061624,0.7015372329806349,0.0019964064683569574,0.2786317961003527,0.7213682038996473,0.043322020363345974
16821,,1478,57074,58552,172,1933,76021,23337,52684,76021,4022,0.019441996290498677,0.7507662356454138,0.0022625327212217675,0.3069809657857697,0.6930190342142303,0.02542718459373068
16822,23.0,892,20184,21076,67,1006,28287,7985,20302,28287,2272,0.031533920175345564,0.7135433237883126,0.002368579205995687,0.2822851486548591,0.7177148513451409,0.035564040018383
16823,,238,5131,5369,22,289,7074,2034,5040,7074,503,0.03364433135425502,0.725332202431439,0.0031099802092168505,0.2875318066157761,0.712468193384224,0.040853830930166805
16824,23.0,130,4435,4565,12,138,5888,1740,4148,5888,443,0.022078804347826088,0.7532269021739131,0.0020380434782608695,0.2955163043478261,0.704483695652174,0.0234375
16825,23.0,2276,55996,58272,174,2339,77154,22360,54794,77154,5969,0.02949944267309537,0.7257692407393006,0.00225522980013998,0.2898099904087928,0.7101900095912071,0.030315991393835704
16826,27.0,137,2329,2466,51,46,3241,926,2315,3241,269,0.042270904041962355,0.7186053687133601,0.01573588398642394,0.2857142857142857,0.7142857142857143,0.014193150262264732
16827,,116,9622,9738,43,609,13175,3608,9567,13175,997,0.008804554079696394,0.7303225806451613,0.003263757115749526,0.2738519924098672,0.7261480075901329,0.046223908918406074
16828,15.0,290,5288,5578,31,272,7425,2142,5283,7425,507,0.039057239057239054,0.7121885521885521,0.004175084175084175,0.2884848484848485,0.7115151515151515,0.036632996632996635
16829,17.0,683,18140,18823,95,1165,25289,7066,18223,25289,1822,0.027007789948198822,0.7173079204397169,0.003756574004507889,0.279410020166871,0.720589979833129,0.04606746016054411
16830,,236,5818,6054,12,282,8174,2423,5751,8174,627,0.028872033276241743,0.71176902373379,0.0014680694886224615,0.29642769757768533,0.7035723024223146,0.03449963298262784
16831,,3683,63907,67590,737,4137,88953,25992,63155,89147,5989,0.04131378509652596,0.716872132545122,0.008267243990263273,0.2915633728560692,0.7084366271439309,0.0464064971339473
16832,23.0,439,11049,11488,35,668,15494,4346,11148,15494,1155,0.02833354847037563,0.7131147540983607,0.0022589389441073963,0.28049567574544987,0.7195043242545501,0.04311346327610688
16833,,262,2462,2724,26,96,3573,1035,2538,3573,183,0.07332773579624965,0.6890568150013994,0.007276798208788134,0.28967254408060455,0.7103274559193955,0.02686817800167926
16834,,71,2068,2139,15,224,3065,818,2247,3065,208,0.023164763458401304,0.6747145187601957,0.004893964110929853,0.266884176182708,0.733115823817292,0.0730831973898858
16835,16.0,1785,64485,66270,377,7389,92122,24479,67643,92122,5669,0.019376479016955776,0.6999956579318729,0.004092399209743601,0.2657237142050759,0.7342762857949241,0.08020885347691105
16836,15.0,55,4061,4116,17,96,5332,1557,3775,5332,493,0.010315078769692423,0.7616279069767442,0.003188297074268567,0.2920105026256564,0.7079894973743436,0.01800450112528132
16837,15.0,2456,83234,85690,263,6707,118428,32786,85642,118428,8555,0.020738338906339717,0.7028236565677036,0.0022207586043840985,0.27684331408112944,0.7231566859188705,0.056633566386327557
16838,,75,3533,3608,2,79,4503,1352,3151,4503,337,0.016655562958027982,0.7845880524095048,0.00044414834554741284,0.30024428159005107,0.6997557184099489,0.017543859649122806
16839,,66,2237,2303,4,108,2995,901,2094,2995,241,0.022036727879799666,0.7469115191986644,0.001335559265442404,0.3008347245409015,0.6991652754590985,0.03606010016694491
16840,34.0,2475,45178,47653,206,2240,64145,18049,46096,64145,4220,0.03858445708940681,0.7043105464182711,0.0032114740042092135,0.2813781276794762,0.7186218723205238,0.03492088237586718
16841,23.0,1060,20170,21230,71,1086,28989,8012,20977,28989,2382,0.03656559384594157,0.6957811583704163,0.002449204870813067,0.2763806961261168,0.7236193038738832,0.03746248577046466
16842,26.0,1505,54901,56406,165,2423,72126,21439,50688,72127,5198,0.020865972520692666,0.7611712673478725,0.0022876315388134817,0.2972395912764984,0.7027604087235017,0.03359352253663676
16843,,1779,40452,42231,240,1859,55197,15932,39274,55206,3492,0.032224758178458865,0.7327464406042822,0.004347353548527334,0.2885918197297395,0.7114081802702604,0.033673876027967974
16844,16.0,63,3122,3185,7,91,4130,1197,2933,4130,367,0.015254237288135594,0.7559322033898305,0.001694915254237288,0.28983050847457625,0.7101694915254237,0.022033898305084745
16845,14.0,381,7654,8035,67,549,11379,3100,8279,11379,858,0.03348273134721856,0.6726425872220757,0.005888039370770718,0.27243167237894367,0.7275683276210563,0.04824677036646454
16846,,4159,92112,96271,94,6301,127736,36124,91612,127736,9086,0.03255934114110352,0.7211122941065948,0.0007358927788563913,0.2828020291851945,0.7171979708148055,0.049328302123128956
16847,26.0,77,1781,1858,1,66,2369,725,1644,2369,161,0.032503165892781766,0.7517940059096665,0.00042211903756859433,0.3060363022372309,0.6939636977627691,0.027859856479527226
16848,,1177,29922,31099,52,1745,40687,11664,29023,40687,3096,0.02892815887138398,0.7354191756580726,0.001278049499840244,0.2866763339641655,0.7133236660358345,0.04288839186963895
16849,,102,3143,3245,0,191,4419,1258,3161,4419,310,0.02308214528173795,0.7112468884362978,0.0,0.2846797918081014,0.7153202081918986,0.0432224485177642
16850,17.0,1687,33804,35491,146,2142,47020,13454,33566,47020,3368,0.035878349638451726,0.7189281156954488,0.003105061675882603,0.2861335601871544,0.7138664398128456,0.045555082943428325
16851,17.0,735,23827,24562,232,3225,34522,9146,25376,34522,1523,0.02129077110248537,0.6901975551822026,0.006720352239151845,0.26493250680725333,0.7350674931927467,0.09341868953131337
16852,17.0,146,9330,9476,28,227,12325,3538,8787,12325,1252,0.011845841784989857,0.7569979716024341,0.0022718052738336715,0.28705882352941176,0.7129411764705882,0.01841784989858012
16853,,261,4438,4699,32,183,6219,1807,4412,6219,456,0.041968162083936326,0.7136195529827947,0.005145521788068821,0.29056118347001125,0.7094388165299887,0.02942595272551857
16854,27.0,22991,528180,551171,2773,30947,727812,209599,518213,727812,48607,0.031589201607008406,0.7257093864899177,0.0038100498480376803,0.28798508406016937,0.7120149159398306,0.042520595978082255
16855,25.0,13,1914,1927,0,73,3038,747,2291,3038,235,0.004279131007241606,0.6300197498354181,0.0,0.24588545095457537,0.7541145490454246,0.02402896642527979
16856,,845,7200,8045,14,756,10773,2684,8089,10773,468,0.07843683282279773,0.6683375104427736,0.001299545159194282,0.24914137194838948,0.7508586280516105,0.07017543859649122
16857,16.0,1345,14881,16226,66,1904,22985,5677,17308,22985,984,0.05851642375462258,0.6474222318903633,0.0028714378942788776,0.24698716554274527,0.7530128344572548,0.08283663258646944
16858,40.0,2606,63835,66441,274,3161,86557,25176,61385,86561,6186,0.030105936853779415,0.7374568223564885,0.003165397811947644,0.2908469172028974,0.7091530827971027,0.036517600304987234
16859,,469,11553,12022,30,595,15859,4572,11287,15859,1174,0.02957311305883095,0.7284822498265969,0.0018916703449145596,0.28829056056497887,0.7117094394350211,0.0375181285074721
16860,16.0,559,7820,8379,83,1149,11767,3152,8615,11767,680,0.04750573638140563,0.6645704087702898,0.007053624543214073,0.2678677657856718,0.7321322342143282,0.09764595903798759
16861,24.0,128,7179,7307,12,351,9527,2844,6683,9527,701,0.013435499107798888,0.7535425632413142,0.0012595780413561456,0.29851999580140653,0.7014800041985935,0.03684265770966726
16862,13.0,112,2941,3053,7,275,4376,1154,3222,4376,317,0.025594149908592323,0.6720749542961609,0.0015996343692870202,0.26371115173674586,0.7362888482632541,0.06284277879341865
16863,,215,5158,5373,15,331,7209,2008,5201,7209,508,0.029823831321958663,0.7154945207379664,0.0020807324178110697,0.2785407129976418,0.7214592870023582,0.04591482868636427
16864,,5196,85407,90603,430,6194,124641,34487,90154,124641,8015,0.04168772715238164,0.6852239632223747,0.0034499081361670718,0.2766906555627763,0.7233093444372237,0.0496947232451601
16865,,4096,77678,81774,913,7194,115088,30007,85081,115088,7100,0.03559015709717781,0.6749443903795357,0.00793305991936605,0.26073091894897815,0.7392690810510218,0.06250868900319756
16866,26.0,1798,41338,43136,127,2309,57077,16702,40375,57077,3348,0.031501305254305584,0.7242496977766877,0.0022250643867056785,0.29262224713982865,0.7073777528601713,0.040454123377192217
16867,,152,8046,8198,42,502,10989,3046,7943,10989,1004,0.013832013832013832,0.7321867321867321,0.003822003822003822,0.2771862771862772,0.7228137228137228,0.04568204568204568
16868,15.0,272,7690,7962,24,250,10389,3044,7345,10389,858,0.026181538165367214,0.7402059871017422,0.002310135720473578,0.2930022138800655,0.7069977861199346,0.0240639137549331
16869,37.0,528,6832,7360,14,363,10557,2864,7693,10557,671,0.05001420858198352,0.6471535474093019,0.0013261343184616842,0.27128919200530455,0.7287108079946955,0.03438476840011367
16870,17.0,716,22871,23587,68,945,30920,9004,21916,30920,2269,0.02315653298835705,0.7396830530401035,0.0021992238033635187,0.29120310478654593,0.7087968952134541,0.0305627425614489
16871,24.0,55,1536,1591,3,116,2165,624,1541,2165,157,0.025404157043879907,0.7094688221709007,0.0013856812933025404,0.2882217090069284,0.7117782909930715,0.0535796766743649
16872,23.0,777,22875,23657,37,1445,31297,8992,22305,31297,2366,0.024826660702303736,0.7309007253091351,0.0011822219382049397,0.2873118829280762,0.7126881170719238,0.04617055947854427
16873,24.0,1102,39921,41023,18,2317,53446,15483,37963,53446,4013,0.020618942484002544,0.7469408374808217,0.0003367885342214572,0.2896942708528234,0.7103057291471766,0.0433521685439509
16874,42.0,132,7775,7907,10,780,10615,3083,7532,10615,811,0.012435233160621761,0.7324540744229864,0.0009420631182289214,0.29043805934997646,0.7095619406500235,0.07348092322185587
16875,34.0,135,2190,2325,18,146,3367,857,2510,3367,223,0.04009504009504009,0.6504306504306504,0.005346005346005346,0.2545292545292545,0.7454707454707454,0.04336204336204336
16876,,74,4506,4580,7,528,6017,1501,4516,6017,358,0.012298487618414492,0.7488781784942663,0.00116337045039056,0.24945986371946152,0.7505401362805385,0.08775137111517367
16877,33.0,1537,30887,32424,130,1535,43192,12396,30796,43192,2825,0.03558529357288387,0.715109279496203,0.003009816632709761,0.28699759214669385,0.7130024078533062,0.03553898870161141
16878,,177,3600,3777,11,140,4984,1437,3547,4984,320,0.035513643659711075,0.7223113964686998,0.0022070626003210273,0.288322632423756,0.711677367576244,0.028089887640449437
16879,25.0,164,3816,3980,50,199,5374,1565,3809,5374,372,0.030517305545217716,0.7100855973204317,0.009304056568663937,0.2912169705991812,0.7087830294008187,0.03703014514328247
16880,23.0,252,6002,6254,32,635,8647,2353,6294,8647,593,0.02914305539493466,0.6941135653984041,0.00370070544697583,0.2721174973979415,0.7278825026020586,0.07343587371342662
16881,16.0,165,3200,3365,15,97,4413,1294,3119,4413,371,0.037389530931339225,0.7251302968502152,0.003399048266485384,0.2932245637888058,0.7067754362111942,0.02198051212327215
16882,24.0,679,28447,29126,34,1558,38436,11094,27342,38436,3362,0.017665730044749715,0.7401134353210532,0.0008845873660110313,0.28863565407430536,0.7113643459256946,0.04053491518368196
16883,,62,2453,2515,0,102,3370,1007,2363,3370,302,0.018397626112759646,0.7278931750741839,0.0,0.298813056379822,0.7011869436201781,0.030267062314540058
16884,13.0,539,3380,3919,30,224,5295,1473,3822,5295,353,0.10179414542020775,0.6383380547686497,0.0056657223796034,0.2781869688385269,0.7218130311614731,0.04230406043437205
16885,23.0,73,1823,1896,4,82,2514,724,1790,2514,170,0.02903739061256961,0.7251392203659507,0.0015910898965791568,0.28798727128082735,0.7120127287191726,0.03261734287987271
16886,27.0,1020,21172,22192,111,907,28970,8313,20657,28970,1822,0.035208836727649295,0.7308249913703831,0.0038315498791853643,0.28695201933034176,0.7130479806696582,0.03130824991370383
16887,,2609,19694,22303,253,2132,32148,8381,23767,32148,2070,0.08115590394425781,0.6126042055493344,0.007869851934801542,0.26070051014059975,0.7392994898594003,0.06631827796441458
16888,33.0,168,3961,4129,21,110,5272,1565,3707,5272,424,0.03186646433990895,0.7513277693474962,0.003983308042488619,0.2968512898330804,0.7031487101669196,0.0208649468892261
16889,,95,1789,1884,16,58,2806,737,2069,2806,215,0.033856022808267994,0.6375623663578047,0.005702066999287242,0.2626514611546686,0.7373485388453315,0.020669992872416252
16890,,2323,40978,43301,717,3765,59904,16859,43045,59904,4829,0.03877871260683761,0.6840611645299145,0.011969150641025642,0.28143362713675213,0.7185663728632479,0.0628505608974359
16891,23.0,2454,37373,39827,245,1646,53711,14847,38865,53712,3305,0.04568811438784629,0.6958035448316949,0.004561364313375037,0.2764186773905273,0.7235813226094727,0.03064492106047066
16892,,1930,48257,50187,181,3101,65325,18173,47152,65325,4331,0.029544584768465366,0.7387217757367011,0.002770761576731726,0.278193647148871,0.7218063528511289,0.04747034060466896
16893,16.0,579,9787,10366,47,462,13554,3908,9646,13554,954,0.04271801682160248,0.72207466430574,0.0034676110373321528,0.28832816880625645,0.7116718311937436,0.03408587870739265
16894,,163,18153,18316,41,1946,25081,6980,18101,25081,1616,0.00649894342330848,0.7237749691001156,0.0016347035604640963,0.27829831346437545,0.7217016865356246,0.07758861289422272
16895,,1297,37690,38987,168,1530,50989,15316,35673,50989,4044,0.025436858930357527,0.7391790386161721,0.003294828296299202,0.30037851301261054,0.6996214869873895,0.030006471984153446
16896,24.0,2112,60246,62358,68,3393,82296,23795,58501,82296,6107,0.025663458734324875,0.7320647419072616,0.0008262856031884903,0.28913920482161953,0.7108607951783805,0.041229221347331584
16897,,1839,48971,50810,306,3661,67719,18311,49408,67719,5113,0.027156337217029196,0.7231500760495577,0.004518672750631285,0.27039678672159956,0.7296032132784005,0.05406163705902332
16898,,12191,249232,261423,1233,13029,343937,99779,244160,343939,24964,0.03544523883595638,0.7246401251384693,0.003584938026801264,0.29010667589310896,0.7098933241068911,0.03788171739756178
16899,37.0,137,1989,2126,14,98,2792,826,1967,2793,187,0.04905119942713928,0.7121374865735768,0.005012531328320802,0.2957393483709273,0.7042606516290727,0.03508771929824561
16900,24.0,262,5994,6256,13,231,8197,2365,5832,8197,655,0.031962913260949126,0.7312431377333171,0.0015859460778333537,0.2885201903135293,0.7114798096864706,0.028181041844577284
16901,33.0,62,1729,1791,6,82,2391,665,1726,2391,175,0.025930572982015895,0.7231283981597658,0.002509410288582183,0.2781263069845253,0.7218736930154747,0.034295273943956504
16902,27.0,74,1973,2047,0,109,2807,805,2002,2807,214,0.026362664766654793,0.702885643035269,0.0,0.286783042394015,0.713216957605985,0.03883149269682935
16903,17.0,3573,54434,58007,918,3082,80136,22460,57676,80136,5887,0.04458670260557053,0.6792702405909953,0.011455525606469003,0.2802735349905161,0.7197264650094839,0.038459618648297896
16904,,212,4244,4456,31,148,5935,1697,4238,5935,496,0.03572030328559393,0.7150800336983993,0.005223251895534962,0.2859309182813816,0.7140690817186184,0.02493681550126369
16905,17.0,308,5532,5840,5,296,7959,2215,5744,7959,716,0.03869832893579595,0.6950621937429325,0.0006282196255811032,0.2783012941324287,0.7216987058675713,0.03719060183440131
16906,,1238,19331,20569,114,1308,27804,7838,19966,27804,1787,0.04452596748669256,0.6952596748669256,0.004100129477772983,0.28190188462091786,0.7180981153790822,0.04704359085023738
16907,17.0,168,5567,5735,13,215,7397,2198,5199,7397,561,0.0227119102338786,0.7526024063809652,0.0017574692442882249,0.2971474922265783,0.7028525077734217,0.029065837501689874
16908,25.0,395,14490,14885,112,761,19635,5711,13924,19635,1240,0.020117137764196588,0.7379679144385026,0.00570409982174688,0.29085816144639676,0.7091418385536032,0.03875732111026229
16909,14.0,1805,59136,60941,225,2571,79879,23042,56837,79879,6664,0.022596677474680454,0.7403197335970656,0.0028167603500294197,0.2884612977127906,0.7115387022872094,0.0321861815996695
16910,23.0,1564,39987,41551,136,1493,53641,16018,37623,53641,4030,0.02915680170019202,0.7454559012695513,0.0025353740608862626,0.2986148654946776,0.7013851345053225,0.027833187300758747
16911,14.0,238,8247,8485,21,600,11694,3237,8457,11694,844,0.020352317427740723,0.7052334530528476,0.0017957927142124167,0.27680861980502824,0.7231913801949718,0.051308363263211906
16912,,2850,50605,53455,274,3070,75359,20227,55132,75359,4838,0.03781897318170358,0.6715189957403893,0.0036359293515041335,0.2684085510688836,0.7315914489311164,0.040738332515028064
16913,35.0,776,11455,12231,31,599,16296,4620,11676,16296,1156,0.047619047619047616,0.7029332351497299,0.0019023073146784487,0.28350515463917525,0.7164948453608248,0.03675748649975454
16914,25.0,14911,199529,214440,1651,13451,295719,80945,214774,295719,19199,0.050422867654766855,0.6747249923068859,0.00558300278304742,0.2737226894450475,0.7262773105549525,0.04548574829483395
16915,23.0,342,7563,7905,7,250,10981,3047,7934,10981,1036,0.0311447044895729,0.6887350878790638,0.0006374647117748838,0.2774792823968673,0.7225207176031326,0.022766596849102996
16916,23.0,349,2336,2826,83,462,4751,700,4086,4786,164,0.07292101964061846,0.4880902632678646,0.01734224822398663,0.14625992478061012,0.8537400752193899,0.09653155035520268
16917,26.0,137,3409,3546,9,133,4633,1411,3222,4633,348,0.0295704726958774,0.7358083315346428,0.0019425857975393912,0.3045542844808979,0.6954457155191021,0.028707101230304337
16918,23.0,1265,71573,72838,161,5198,96175,28046,68129,96175,8235,0.013153106316610345,0.7441954769950611,0.001674031713023135,0.29161424486612947,0.7083857551338706,0.05404730959188978
16919,15.0,131,3496,3627,121,216,4858,1399,3459,4858,312,0.026965829559489504,0.7196377109921779,0.024907369287772745,0.28797859201317416,0.7120214079868259,0.044462741869081925
16920,16.0,40,3261,3301,9,47,4334,1256,3078,4334,451,0.009229349330872173,0.752422704199354,0.002076603599446239,0.28980156898938625,0.7101984310106138,0.010844485463774804
16921,,6309,79281,85590,565,3598,114893,32231,82662,114893,8299,0.054911961564238033,0.6900420391146546,0.004917619002027974,0.28053058062719227,0.7194694193728077,0.03131609410494982
16922,,1235,27520,28755,69,1783,39084,10895,28189,39084,2866,0.031598608126087405,0.7041244499027736,0.0017654283082591342,0.2787585712823662,0.7212414287176339,0.045619690922116464
16923,15.0,119,1434,1553,38,202,2230,603,1627,2230,118,0.05336322869955157,0.6430493273542601,0.017040358744394617,0.2704035874439462,0.7295964125560538,0.09058295964125561
16924,35.0,1356,29618,30974,124,1575,40910,11726,29184,40910,2745,0.033145930090442435,0.7239794671229528,0.0030310437545832316,0.2866291860180885,0.7133708139819115,0.03849914446345637
16925,27.0,565,16901,17466,48,661,22878,6607,16271,22878,1903,0.024696214704082526,0.7387446455109712,0.002098085496984002,0.2887927266369438,0.7112072733630562,0.02889238569805053
16926,25.0,859,20111,20970,44,754,27238,8033,19205,27238,2051,0.031536823555327116,0.738343490711506,0.0016153902636023203,0.2949188633526691,0.705081136647331,0.02768191497173067
16927,,9469,190924,200393,623,9338,260806,76392,184414,260806,19061,0.03630668006104154,0.7320537104207725,0.0023887487251060173,0.2929073717629196,0.7070926282370804,0.03580439100327446
16928,42.0,669,25648,26317,368,1054,35222,10257,24965,35222,2576,0.018993810686502754,0.7281812503548918,0.010448015444892397,0.29121003918005794,0.708789960819942,0.02992447901879507
16929,39.0,1564,38165,39729,201,1759,51770,14966,36804,51770,3437,0.030210546648638207,0.7372030133281824,0.0038825574657137337,0.28908634344214795,0.710913656557852,0.033977206876569445
16930,,120,3316,3436,3,138,4534,1340,3194,4534,334,0.02646669607410675,0.7313630348478165,0.0006616674018526688,0.29554477282752534,0.7044552271724747,0.030436700485222762
16931,,838,30260,31098,238,2756,43660,11530,32130,43660,3230,0.01919377004122767,0.6930829134218964,0.005451213925790197,0.26408612001832343,0.7359138799816766,0.06312414109024278
16932,25.0,781,16739,17520,140,1239,23467,6570,16897,23467,1648,0.03328077726168662,0.7132995269953551,0.005965824349085951,0.27996761409639065,0.7200323859036093,0.05279754548941066
16933,17.0,92,2430,2522,8,208,3358,886,2472,3358,244,0.0273972602739726,0.7236450268016676,0.0023823704586063135,0.26384752829064917,0.7361524717093508,0.061941631923764146
16934,24.0,102,3370,3472,5,132,4488,1300,3188,4488,340,0.022727272727272728,0.7508912655971479,0.0011140819964349377,0.2896613190730838,0.7103386809269162,0.029411764705882353
16935,,6382,123934,130316,1966,4805,169166,49833,119333,169166,8608,0.037726257049288864,0.7326176654883368,0.011621720676731732,0.29458047125308867,0.7054195287469113,0.02840405282385349
16936,41.0,71,1833,1904,13,106,2593,658,1935,2593,209,0.027381411492479753,0.7069032009255688,0.005013497878904744,0.2537601234091786,0.7462398765908215,0.040879290397223295
16937,40.0,2985,26685,29670,230,1278,38581,11122,27459,38581,1573,0.0773696897436562,0.6916616987636401,0.005961483631839506,0.28827661284051737,0.7117233871594827,0.033125113397786475
16938,16.0,437,7507,7944,41,404,10628,3022,7606,10628,827,0.04111780203236733,0.7063417388031614,0.0038577342867896123,0.2843432442604441,0.7156567557395559,0.03801279638690252
16939,24.0,8126,139836,148425,792,13644,205086,56381,148717,205098,11455,0.03962008405737745,0.6818008951818155,0.003861568615978703,0.27489785370895864,0.7251021462910413,0.0665242957025422
16940,,147,13151,13298,155,1939,18816,4972,13844,18816,887,0.0078125,0.6989264455782312,0.008237670068027211,0.26424319727891155,0.7357568027210885,0.10305059523809523
16941,,18,1831,1849,1,111,2473,707,1766,2473,213,0.007278608976951072,0.7403962798220785,0.0004043671653861706,0.28588758592802266,0.7141124140719773,0.044884755357864944
16942,,50,7658,8041,7,975,11169,2944,8225,11169,752,0.004476676515355001,0.6856477750917719,0.0006267347121497001,0.26358671322410243,0.7364132867758976,0.08729519204942252
16943,48.0,511,10880,11391,39,421,14946,4234,10712,14946,925,0.03418974976582363,0.7279539676167537,0.002609393817743878,0.28328649805968154,0.7167135019403185,0.02816807172487622
16944,,622,7718,8340,83,682,11894,3181,8713,11894,735,0.0522952749285354,0.6488986043383218,0.0069783083907852695,0.26744577097696315,0.7325542290230368,0.057339835211030775
16945,,3597,83469,87066,541,4401,115786,33540,82246,115786,8368,0.03106593197795934,0.7208902630715285,0.004672412899659717,0.2896723265334324,0.7103276734665677,0.03800977665693607
16946,15.0,950,22607,23557,66,1527,31661,8942,22719,31661,2225,0.030005369381889392,0.7140330374909194,0.0020845835570575785,0.28242948738195256,0.7175705126180474,0.048229683206468525
16947,,109,7756,7865,54,152,10405,2954,7451,10405,1063,0.01047573282075925,0.745410860163383,0.005189812590100913,0.28390197020663144,0.7160980297933686,0.014608361364728496
16948,,81,1757,1838,2,172,2494,680,1814,2494,192,0.03247794707297514,0.7044907778668805,0.0008019246190858059,0.272654370489174,0.7273456295108259,0.06896551724137931
16949,16.0,777,11849,12626,41,961,17177,4798,12379,17177,1185,0.04523490714327298,0.6898177795889853,0.0023869127321418174,0.2793270070443034,0.7206729929556965,0.05594690574605577
16950,,1374,38876,40250,159,1788,51847,15793,36054,51847,3359,0.02650105116978803,0.7498215904488206,0.0030667155283815844,0.304607788300191,0.695392211699809,0.034486084055008005
16951,14.0,43,1693,1736,0,52,2293,672,1621,2293,190,0.01875272568687309,0.7383340601831662,0.0,0.2930658525948539,0.7069341474051462,0.0226777147841256
16952,,409,10682,11091,25,466,13981,4250,9731,13981,933,0.029253987554538303,0.7640369072312424,0.0017881410485659109,0.3039839782562048,0.6960160217437952,0.03333094914526858
16953,,469,11950,12419,32,670,16993,4783,12210,16993,1226,0.02759959983522627,0.7032307420702643,0.0018831283469663979,0.2814688401106338,0.7185311598893662,0.03942799976460896
16954,26.0,1189,36798,37987,160,1690,49895,14345,35550,49895,3733,0.023830043090490027,0.7375087684136687,0.003206734141697565,0.2875037578915723,0.7124962421084277,0.033871129371680526
16955,15.0,385,19668,20053,30,929,26561,7699,18862,26561,2304,0.014494936184631603,0.7404841685177516,0.0011294755468544105,0.2898610745077369,0.7101389254922631,0.03497609276759158
16956,,371,8029,8400,28,504,10957,3216,7742,10958,838,0.0338565431648111,0.7327066983026099,0.0025552108048914036,0.2934842124475269,0.7065157875524731,0.04599379448804526
16957,,131,2937,3068,5,106,4003,1159,2844,4003,300,0.03272545590806895,0.7336997252060954,0.0012490632025980515,0.2895328503622283,0.7104671496377717,0.02648013989507869
16958,,480,11837,12317,11,868,16623,4793,11830,16623,1488,0.028875654214040786,0.712085664440835,0.0006617337424051013,0.28833543884978646,0.7116645611502136,0.05221680803705709
16959,,3893,92311,96204,511,3448,128246,36693,91553,128246,8962,0.03035572259563651,0.719796328930337,0.003984529731921463,0.28611418679724904,0.713885813202751,0.026885828797779267
16960,,247,4838,5085,23,264,6816,1875,4941,6816,520,0.036238262910798125,0.7098004694835681,0.0033744131455399062,0.27508802816901406,0.7249119718309859,0.03873239436619718
16961,15.0,153,2396,2549,2,234,3632,987,2645,3632,232,0.04212555066079295,0.6596916299559471,0.0005506607929515419,0.2717511013215859,0.7282488986784141,0.0644273127753304
16962,15.0,3233,84166,87399,665,8502,120023,33112,86911,120023,8196,0.02693650383676462,0.7012489272889363,0.00554060471742916,0.2758804562458862,0.7241195437541138,0.07083642301892137
16963,,430,22331,22761,84,2383,31159,8663,22496,31159,2486,0.013800186142045636,0.7166789691581886,0.002695850316120543,0.2780256105780031,0.7219743894219969,0.07647870599184826
16964,,181,4044,4225,11,175,5645,1679,3966,5645,497,0.032063773250664306,0.7163861824623561,0.0019486271036315323,0.2974313551815766,0.7025686448184234,0.03100088573959256
16965,,270,5376,5646,4,314,7555,2129,5426,7555,574,0.0357379219060225,0.7115817339510259,0.0005294506949040371,0.2818001323626737,0.7181998676373262,0.04156187954996691
16966,23.0,138,2087,2225,9,110,2966,861,2105,2966,227,0.04652730950775455,0.7036412677006069,0.0030343897505057315,0.29028995279838166,0.7097100472016183,0.037086985839514496
16967,27.0,313,9739,10052,316,493,13755,3800,9955,13755,1102,0.022755361686659398,0.7080334423845874,0.022973464194838242,0.2762631770265358,0.7237368229734642,0.03584151217739004
16968,,602,16120,16722,134,809,22523,6294,16229,22523,1426,0.026728233361452736,0.7157128268880699,0.005949473871153931,0.279447675709275,0.720552324290725,0.035918838520623365
16969,,222,18181,18403,139,1408,25093,6894,18199,25093,1903,0.008847088829554059,0.7245446937392899,0.005539393456342407,0.27473797473398953,0.7252620252660105,0.05611126609014466
16970,17.0,540,16468,17008,45,792,22100,6424,15676,22100,1783,0.024434389140271493,0.745158371040724,0.0020361990950226246,0.2906787330316742,0.7093212669683258,0.03583710407239819
16971,,387,10994,11381,5,641,15410,4251,11160,15411,1126,0.02511193303484524,0.7133865420803323,0.0003244435792615664,0.2758419310881838,0.7241580689118162,0.04159366686133281
16972,23.0,693,20889,21582,145,831,27495,8095,19400,27495,1551,0.025204582651391163,0.7597381342062193,0.005273686124749955,0.2944171667575923,0.7055828332424077,0.03022367703218767
16973,27.0,57,1611,1668,2,57,2200,642,1558,2200,195,0.02590909090909091,0.7322727272727273,0.0009090909090909091,0.2918181818181818,0.7081818181818181,0.02590909090909091
16974,,183,6255,6438,10,223,8349,2495,5854,8349,670,0.021918792669780814,0.7491915199425081,0.001197748233321356,0.2988381842136783,0.7011618157863218,0.026709785603066236
16975,35.0,6229,119801,126030,607,7134,169403,47580,121823,169403,12663,0.03677030513036959,0.7071952680885226,0.0035831714904694723,0.28086869772081957,0.7191313022791804,0.0421125954085819
16976,,923,21235,22158,130,700,28181,8400,19781,28181,1696,0.03275256378410986,0.7535218764415741,0.00461303715269153,0.2980731698662219,0.7019268301337781,0.02483943082218516
16977,38.0,146,5531,5677,11,158,7285,2204,5081,7285,537,0.02004118050789293,0.7592312971859986,0.0015099519560741249,0.30253946465339737,0.6974605353466026,0.02168840082361016
16978,15.0,119,1954,2073,6,207,2943,783,2160,2943,186,0.04043493034318722,0.6639483520217465,0.0020387359836901123,0.26605504587155965,0.7339449541284404,0.07033639143730887
16979,,58,8062,8120,32,423,10830,3062,7768,10830,876,0.005355493998153278,0.7444136657433056,0.0029547553093259462,0.2827331486611265,0.7172668513388735,0.03905817174515235
16980,17.0,8141,21600,29741,364,5708,45800,11172,34628,45800,5,0.17775109170305678,0.47161572052401746,0.00794759825327511,0.2439301310043668,0.7560698689956332,0.12462882096069869
16981,17.0,331,18373,18704,90,1173,25187,6979,18208,25187,1980,0.013141700083376345,0.729463612180887,0.003573271925993568,0.2770873863501012,0.7229126136498988,0.04657164410211617
16982,24.0,143,3730,3873,3,205,5243,1455,3788,5243,407,0.027274461186343697,0.7114247568186153,0.0005721914934197979,0.27751287430860194,0.7224871256913981,0.03909975205035285
16983,17.0,1988,109955,111943,142,6519,150536,42803,107733,150536,12894,0.01320614338098528,0.7304232874528352,0.0009432959557846628,0.28433730137641494,0.715662698623585,0.04330525588563533
16984,,200,4812,5012,0,285,6887,1895,4992,6887,427,0.029040220705677362,0.6987077101785973,0.0,0.27515609118629303,0.724843908813707,0.04138231450559024
16985,24.0,13069,308552,321621,1498,12815,426609,123344,303265,426609,35682,0.03063460920890089,0.7232665039884297,0.003511412089290193,0.28912657726395835,0.7108734227360417,0.030039216237819643
16986,27.0,502,12493,12995,98,495,16601,5003,11598,16601,1216,0.03023914222034817,0.7525450274079875,0.005903258839828926,0.3013673875067767,0.6986326124932233,0.029817480874646106
16987,25.0,98,2249,2347,2,141,3101,830,2271,3101,254,0.03160270880361174,0.7252499193808449,0.0006449532408900354,0.2676555949693647,0.7323444050306352,0.0454692034827475
16988,24.0,19,4173,4192,0,249,5783,1635,4148,5783,494,0.0032854919591907314,0.7215977866159433,0.0,0.282725229119834,0.717274770880166,0.04305723672834169
16989,,297,7332,7629,20,475,10338,2791,7547,10338,826,0.028728961114335462,0.7092280905397562,0.001934610176049526,0.2699748500677114,0.7300251499322886,0.04594699168117624
16990,14.0,310,4665,4975,44,545,7094,1932,5162,7094,401,0.04369890047927826,0.6575979701155906,0.006202424584155625,0.2723428249224697,0.7276571750775304,0.07682548632647307
16991,,420,9921,10341,39,658,14204,3967,10237,14204,1035,0.029569135454801464,0.6984652210644888,0.0027457054350887074,0.2792875246409462,0.7207124753590538,0.04632497887918896
16992,16.0,138,2014,2152,10,159,3027,794,2233,3027,237,0.04558969276511397,0.6653452262966634,0.003303600925008259,0.2623059134456558,0.7376940865543442,0.05252725470763132
16993,24.0,1115,26520,27635,121,1794,37514,10608,26906,37514,3133,0.029722237031508236,0.7069360771978461,0.003225462494002239,0.28277443087913845,0.7172255691208616,0.04782214639867783
16994,23.0,108,3569,3677,41,120,5146,1394,3752,5146,419,0.02098717450446949,0.6935483870967742,0.007967353284104159,0.2708900116595414,0.7291099883404586,0.023319082782743878
16995,27.0,567,13106,13673,46,667,18490,5222,13268,18490,1441,0.030665224445646296,0.70881557598702,0.0024878312601406168,0.2824229313142239,0.7175770686857761,0.03607355327203894
16996,15.0,396,7973,8369,48,363,11324,3179,8145,11324,769,0.03496997527375486,0.7040798304486048,0.0042387848816672555,0.2807311903920876,0.7192688096079124,0.03205581066760862
16997,26.0,125,2932,3057,20,165,4243,1160,3083,4243,304,0.029460287532406315,0.6910205043601225,0.0047136460051850106,0.27339146830073063,0.7266085316992694,0.038887579542776336
16998,14.0,461,9305,9766,22,535,13240,3644,9596,13240,1021,0.034818731117824776,0.7027945619335347,0.001661631419939577,0.27522658610271905,0.724773413897281,0.040407854984894256
16999,,401,10081,10482,126,455,13826,4031,9795,13826,918,0.029003327064950093,0.7291335165629973,0.009113264863301027,0.29155214812671776,0.7084478518732822,0.03290901200636482
17000,16.0,1119,20564,21683,72,1238,29201,8155,21046,29201,2200,0.03832060545871717,0.7042224581349954,0.0024656689839389063,0.2792712578336358,0.7207287421663642,0.04239580836272731
17001,27.0,592,13745,14337,62,1053,19393,5205,14188,19393,1194,0.030526478626308463,0.7087608931057598,0.0031970298561336563,0.2683958129221884,0.7316041870778116,0.054297942556592586
17002,24.0,2107,52793,54900,348,2964,73258,20912,52346,73258,5055,0.02876136394659969,0.7206448442490923,0.004750334434464495,0.28545687842965956,0.7145431215703404,0.0404597450107838
17003,,211,6795,7006,30,221,9028,2689,6339,9028,671,0.02337173238812583,0.752658396101019,0.003322995126273815,0.29785112981834294,0.7021488701816571,0.0244793974302171
17004,14.0,259,4331,4590,100,322,6241,1746,4495,6241,388,0.04149975965390162,0.6939593013940074,0.01602307322544464,0.2797628585162634,0.7202371414837366,0.05159429578593174
17005,,11,3536,3547,19,232,5129,1340,3789,5129,342,0.0021446675765256387,0.6894131409631508,0.00370442581399883,0.2612595047767596,0.7387404952232404,0.04523298888672256
17006,24.0,120,3291,3411,27,197,4586,1268,3318,4586,345,0.026166593981683386,0.7176188399476668,0.005887483645878762,0.27649367640645445,0.7235063235935456,0.04295682511993022
17007,,103,4398,4501,20,237,5974,1685,4289,5974,498,0.017241379310344827,0.7361901573485102,0.0033478406427854034,0.28205557415467025,0.7179444258453298,0.03967191161700703
17008,26.0,677,8312,8989,267,440,12804,3287,9517,12804,404,0.05287410184317401,0.6491721337082161,0.02085285848172446,0.25671665104654795,0.743283348953452,0.03436426116838488
17009,,894,19960,20898,115,1600,29232,8060,21172,29232,1928,0.030582922824302135,0.6828133552271484,0.0039340448823207445,0.27572523262178433,0.7242747673782156,0.05473453749315818
17010,,4028,85681,89709,465,3907,117735,33983,83752,117735,7992,0.03421242621140697,0.7277445109780439,0.003949547713084469,0.2886397417930097,0.7113602582069902,0.033184694440905424
17011,26.0,311,7116,7427,37,385,10001,2833,7168,10001,728,0.031096890310968902,0.7115288471152885,0.0036996300369963003,0.2832716728327167,0.7167283271672833,0.03849615038496151
17012,,16,2119,2135,19,84,2870,832,2038,2870,296,0.005574912891986063,0.7383275261324042,0.00662020905923345,0.2898954703832753,0.7101045296167248,0.02926829268292683
17013,36.0,989,22181,23170,141,1023,31116,8482,22634,31116,2344,0.03178429103997943,0.7128486952050392,0.004531430775163903,0.2725928782619874,0.7274071217380126,0.03287697647512534
17014,16.0,23,2817,2840,19,97,3736,1089,2647,3736,368,0.006156316916488222,0.7540149892933619,0.005085653104925054,0.2914882226980728,0.7085117773019272,0.025963597430406854
17015,,1314,3363,4677,138,338,6797,1806,5011,6817,281,0.19275341059116913,0.4933255097550242,0.020243508874871644,0.26492592049288544,0.7350740795071146,0.04958192753410591
17016,,1739,51333,53072,70,2373,69213,20423,48790,69213,5545,0.025125337725571784,0.7416670278704868,0.0010113706962564836,0.2950746247092309,0.704925375290769,0.0342854666030948
17017,36.0,2728,48515,51243,145,3054,71539,19402,52137,71539,6019,0.038133046310404116,0.6781615622248005,0.0020268664644459665,0.2712087113322803,0.7287912886677197,0.04269000125805505
17018,27.0,86,3100,3186,6,100,4021,1224,2797,4021,315,0.021387714498880876,0.7709524993782642,0.0014921661278288984,0.3044018900770952,0.6955981099229047,0.02486943546381497
17019,,318,8263,8581,33,417,11465,3284,8181,11465,873,0.02773658962058439,0.7207152202354994,0.002878325337985172,0.2864369821194941,0.7135630178805059,0.0363715656345399
17020,25.0,2340,43596,45936,418,2284,61522,17341,44181,61522,4429,0.03803517440915445,0.708624557069016,0.0067943174799258805,0.28186664932869543,0.7181333506713046,0.03712493091902084
17021,27.0,395,8996,9391,42,414,12411,3543,8868,12411,861,0.031826605430666344,0.7248408669728467,0.00338409475465313,0.2854725646603819,0.714527435339618,0.03335750543872371
17022,16.0,85,2572,2657,8,464,3888,1011,2877,3888,207,0.021862139917695474,0.661522633744856,0.00205761316872428,0.26003086419753085,0.7399691358024691,0.11934156378600823
17023,14.0,593,13025,13618,52,514,17616,5227,12389,17616,1103,0.033662579473206174,0.7393846503178928,0.0029518619436875566,0.2967188919164396,0.7032811080835604,0.029178019981834696
17024,33.0,808,19649,20457,38,1709,28487,7980,20524,28504,2055,0.028346898680886894,0.6893418467583498,0.0013331462250912153,0.27996070726915523,0.7200392927308448,0.05995649733370755
17025,26.0,180,6252,6432,37,279,8316,2530,5786,8316,598,0.021645021645021644,0.7518037518037518,0.004449254449254449,0.30423280423280424,0.6957671957671958,0.03354978354978355
17026,13.0,322,8010,8332,46,610,11274,3342,7932,11274,832,0.028561291467092426,0.7104843001596594,0.004080184495298918,0.2964342735497605,0.7035657264502395,0.054106794394181305
17027,43.0,349,8969,9318,10,410,12149,3515,8634,12149,878,0.0287266441682443,0.738250061733476,0.0008231130134167421,0.28932422421598486,0.7106757757840152,0.03374763355008643
17028,34.0,41,1900,1941,20,125,2950,696,2254,2950,169,0.013898305084745762,0.6440677966101694,0.006779661016949152,0.2359322033898305,0.7640677966101694,0.0423728813559322
17029,16.0,52,11471,11523,21,646,15232,4370,10862,15232,1338,0.0034138655462184874,0.7530856092436975,0.0013786764705882354,0.2868960084033613,0.7131039915966386,0.04241071428571429
17030,37.0,66,2435,2501,0,84,3194,972,2222,3194,253,0.020663744520976832,0.7623669380087664,0.0,0.30432060112711334,0.6956793988728867,0.026299311208515967
17031,,540,12359,12899,40,531,16993,4948,12045,16993,1194,0.03177779085505796,0.7272994762549285,0.0023539104337079973,0.29117872064967926,0.7088212793503207,0.031248161007473664
17032,24.0,512,10190,10702,24,589,14384,4066,10318,14384,1077,0.035595105672969966,0.7084260289210234,0.0016685205784204673,0.28267519466073415,0.7173248053392659,0.040948275862068964
17033,16.0,694,15697,16391,98,935,21613,6252,15361,21613,1540,0.032110303983713506,0.7262758524961829,0.004534308055337066,0.28927034655068706,0.7107296534493129,0.04326100032387915
17034,46.0,171,3992,4163,42,156,5483,1559,3924,5483,423,0.031187306219223054,0.7280685755973008,0.007660040124019697,0.2843333941273026,0.7156666058726975,0.028451577603501733
17035,,56,3803,3859,6,71,5128,1448,3680,5128,472,0.0109204368174727,0.7416146645865834,0.001170046801872075,0.2823712948517941,0.717628705148206,0.013845553822152886
17036,16.0,659,13877,14536,34,1049,20480,5372,15108,20480,1174,0.032177734375,0.677587890625,0.00166015625,0.2623046875,0.7376953125,0.051220703125
17037,34.0,318,7641,7959,35,698,10988,2968,8020,10988,941,0.028940662540953767,0.6953949763378231,0.0031852930469603202,0.27011285038223515,0.7298871496177648,0.06352384419366582
17038,17.0,442,12827,13269,40,1494,19299,4884,14415,19299,1121,0.022902741074667082,0.6646458365718431,0.0020726462511010935,0.2530701072594435,0.7469298927405565,0.07741333747862583
17039,,1108,34883,35991,68,1587,46804,13475,33329,46804,3952,0.023673190325613196,0.7452995470472609,0.0014528672763011708,0.2879027433552688,0.7120972566447312,0.033907358345440564
17040,27.0,574,17374,17948,123,918,23441,6791,16650,23441,1726,0.024487009939848984,0.7411799837890874,0.0052472164156819245,0.2897060705601297,0.7102939294398704,0.03916215178533339
17041,17.0,389,12497,12886,12,413,16207,4875,11332,16207,1125,0.0240019744554822,0.7710865675325477,0.0007404208058246437,0.3007959523662615,0.6992040476337386,0.025482816067131486
17042,,49,3056,3105,69,106,4162,1204,2958,4162,275,0.011773185968284479,0.7342623738587217,0.016578567996155695,0.2892839980778472,0.7107160019221528,0.025468524747717443
17043,,15,3923,3938,15,584,5567,1452,4115,5567,326,0.0026944494341656186,0.7046883420154482,0.0026944494341656186,0.2608227052272319,0.7391772947727681,0.10490389797018143
17044,25.0,411,10762,11173,42,636,14649,4248,10401,14649,1142,0.028056522629531025,0.7346576558126835,0.0028670899037476962,0.28998566455048125,0.7100143354495188,0.0434159328281794
17045,17.0,1902,38157,40059,325,3097,54075,15239,38836,54075,3831,0.03517337031900139,0.705631067961165,0.006010171058714748,0.28181229773462785,0.7181877022653722,0.057272306981044845
17046,24.0,142,3221,3363,38,188,4426,1273,3153,4426,311,0.032083145051965654,0.727745142340714,0.00858563036601898,0.2876186172616358,0.7123813827383643,0.042476276547672845
17047,41.0,904,15648,16552,127,842,22332,6185,16147,22332,1486,0.04048002865842737,0.7006985491671145,0.005686906680995881,0.27695683324377574,0.7230431667562243,0.037703743507075047
17048,34.0,446,8191,8637,97,222,10705,3419,7286,10705,619,0.041662774404483884,0.7651564689397478,0.009061186361513311,0.31938346567024756,0.6806165343297524,0.02073797290985521
17049,27.0,2739,58655,61394,299,2656,81563,23317,58246,81563,5346,0.033581403332393366,0.7191373539472555,0.0036658779103269866,0.2858771746993122,0.7141228253006878,0.03256378504959356
17050,,1782,2870,4652,169,223,6537,1755,4782,6537,276,0.27260211106011933,0.4390393146703381,0.025852837693131406,0.2684717760440569,0.7315282239559431,0.03411350772525623
17051,,1972,18274,20246,3416,3150,34742,7219,27523,34742,1518,0.05676126878130217,0.5259915951873813,0.09832479419722526,0.2077888434747568,0.7922111565252432,0.09066835530481837
17052,,165,17550,17715,70,616,24260,6750,17510,24260,2345,0.0068013190436933225,0.7234130255564716,0.0028854080791426216,0.2782357790601814,0.7217642209398186,0.02539159109645507
17053,,0,4892,4892,3,619,6970,1733,5237,6970,380,0.0,0.7018651362984218,0.000430416068866571,0.24863701578192252,0.7513629842180775,0.08880918220946915
17054,,89,1659,1748,1,99,2337,665,1672,2337,187,0.03808301240907146,0.7098844672657253,0.0004278990158322636,0.2845528455284553,0.7154471544715447,0.04236200256739409
17055,16.0,1946,43248,45194,94,3111,62000,17003,45003,62006,5227,0.03138405960713479,0.6974808889462311,0.0015159823242911975,0.27421539850982163,0.7257846014901783,0.05017256394542464
17056,,3385,72743,76128,341,3296,99866,29122,70744,99866,6965,0.033895419862615905,0.7284060641259288,0.0034145755312118236,0.2916107584162778,0.7083892415837222,0.0330042256623876
17057,16.0,171,4890,5061,8,197,6958,1907,5051,6958,605,0.024576027594136247,0.7027881575165278,0.0011497556769186547,0.27407300948548435,0.7259269905145157,0.028312733544121876
17058,27.0,4940,96958,101898,469,5355,137430,38862,98568,137430,10334,0.03594557229134832,0.7055082587499091,0.003412646438186713,0.2827766863130321,0.7172233136869679,0.0389652914210871
17059,,10239,244309,254548,1508,9147,340002,97478,242524,340002,23152,0.030114528738066245,0.7185516555784967,0.00443526802783513,0.2866983135393321,0.7133016864606678,0.026902782924806325
17060,15.0,362,11505,11867,45,1762,17042,4574,12468,17042,1311,0.02124163830536322,0.6750968196221101,0.002640535148456754,0.2683957282009154,0.7316042717990846,0.10339162070179557
17061,15.0,455,32093,32548,194,5112,47231,11846,35385,47231,3469,0.0096335034193644,0.6794901653574983,0.004107471787597129,0.2508098494632762,0.7491901505367238,0.10823399885668311
17062,,88,1868,1956,12,72,2807,741,2066,2807,184,0.031350195938724616,0.6654791592447453,0.004275026718916993,0.26398289989312435,0.7360171001068757,0.02565016031350196
17063,,112,4434,4546,30,263,6026,1703,4323,6026,391,0.018586126783936275,0.7358114835711915,0.004978426817125788,0.2826086956521739,0.717391304347826,0.043644208430136076
17064,14.0,158,1860,2018,14,114,2672,760,1912,2672,148,0.05913173652694611,0.6961077844311377,0.005239520958083832,0.2844311377245509,0.7155688622754491,0.04266467065868264
17065,27.0,514,13938,14452,175,884,19206,5401,13805,19206,1236,0.026762470061439135,0.7257107154014371,0.009111735915859627,0.28121420389461627,0.7187857961053837,0.0460272831406852
17066,,717,17207,17924,31,989,23527,6779,16748,23527,1738,0.030475623751434523,0.731372465677732,0.0013176350575934033,0.2881370340459897,0.7118629659540103,0.04203680877289922
17067,33.0,1314,28834,30148,144,1384,39507,11383,28124,39507,2092,0.03325992862024452,0.7298453438631128,0.003644923684410358,0.28812615485863263,0.7118738451413673,0.03503176652238844
17068,34.0,98,2530,2628,20,160,3503,1006,2497,3503,252,0.02797602055381102,0.7222380816443049,0.005709391949757351,0.28718241507279474,0.7128175849272053,0.04567513559805881
17069,17.0,2430,102915,105345,407,5370,142148,39854,102294,142148,12112,0.017094858879477728,0.7239989306919549,0.00286321298927878,0.2803697554661339,0.7196302445338661,0.037777527647240905
17070,27.0,229,4486,4715,28,196,6943,1706,5237,6943,439,0.03298286043497047,0.6461183926256662,0.004032838830476739,0.24571510874261845,0.7542848912573815,0.028229871813337176
17071,25.0,8951,107389,116340,550,6329,155338,44504,110834,155338,10731,0.05762273236426373,0.6913247241499182,0.0035406661602441127,0.28649783053728,0.71350216946272,0.040743411142154524
17072,,1037,12932,14486,83,1151,19792,5309,14483,19792,1258,0.05239490703314471,0.6533953112368633,0.004193613581244948,0.2682396928051738,0.7317603071948262,0.058154810024252226
17073,13.0,95,3529,3624,12,211,4812,1323,3489,4812,343,0.01974231088944306,0.7333748960931006,0.0024937655860349127,0.27493765586034913,0.7250623441396509,0.043848711554447216
17074,,677,12712,13389,102,920,18239,5053,13186,18239,1315,0.03711826306266791,0.6969680355282636,0.005592411864685564,0.2770436975711388,0.7229563024288612,0.05044136191677175
17075,25.0,4156,112751,116907,272,3938,149564,44557,105007,149564,10687,0.02778743547912599,0.7538645663394935,0.0018186194538792758,0.29791259928859887,0.7020874007114012,0.02632986547564922
17076,17.0,137,3002,3139,2,76,4191,1164,3027,4191,401,0.032689095681221664,0.716296826533047,0.0004772130756382725,0.2777380100214746,0.7222619899785254,0.018134096874254355
17077,17.0,167,3765,3932,16,242,5453,1458,3995,5453,379,0.030625343847423436,0.6904456262607739,0.0029341646799926646,0.26737575646433154,0.7326242435356685,0.04437924078488905
17078,,47,2248,2295,0,68,3162,871,2291,3162,284,0.014864010120177103,0.7109424414927261,0.0,0.2754585705249842,0.7245414294750158,0.021505376344086023
17079,,409,8630,9039,22,593,12037,3505,8532,12037,898,0.03397856608789566,0.7169560521724683,0.0018276979313782504,0.2911855113400349,0.7088144886599651,0.04926476696851375
17080,45.0,587,19383,19970,19,434,25503,7781,17722,25503,2222,0.023016899972552247,0.7600282319727091,0.0007450103909343999,0.30510136062424026,0.6948986393757597,0.017017605771869976
17081,27.0,121,2065,2186,28,146,3015,803,2212,3015,144,0.040132669983416254,0.6849087893864013,0.009286898839137645,0.266334991708126,0.733665008291874,0.048424543946932005
17082,,105,2653,2758,6,89,3585,1047,2538,3585,263,0.029288702928870293,0.7400278940027895,0.0016736401673640166,0.2920502092050209,0.7079497907949791,0.02482566248256625
17083,,905,13308,14213,182,594,18251,5403,12848,18251,1185,0.04958632403703907,0.7291655251767026,0.009972056325680784,0.2960385732288642,0.7039614267711358,0.03254616185414498
17084,16.0,1939,21612,23551,365,1603,31795,8813,22982,31795,2083,0.06098443151438906,0.6797295172196887,0.011479792420191854,0.27718194684698855,0.7228180531530115,0.050416732190596
17085,15.0,85,1730,1815,3,154,2475,696,1779,2475,189,0.03434343434343434,0.6989898989898989,0.0012121212121212121,0.2812121212121212,0.7187878787878788,0.06222222222222222
17086,27.0,269,9994,10263,7,382,13228,3901,9327,13228,1006,0.020335651648019353,0.7555185969156335,0.0005291805261566374,0.29490474750529183,0.7050952524947082,0.02887813728454793
17087,17.0,861,23837,24698,171,1094,32930,9401,23529,32930,2617,0.026146371090191314,0.7238688126328576,0.005192833282720923,0.2854843607652596,0.7145156392347404,0.033221986030974794
17088,,1656,23641,25297,103,2873,35346,9231,26115,35346,2260,0.046851128840604314,0.6688451309907769,0.0029140496803032874,0.2611610931930063,0.7388389068069937,0.08128218185933345
17089,,403,7873,8276,11,533,11226,3126,8100,11226,826,0.03589880634241938,0.7013183680741136,0.0009798681631925886,0.2784607161945484,0.7215392838054516,0.04747906645287725
17090,,639,14370,15009,12,958,20146,5696,14450,20146,1542,0.031718455276481684,0.713292961381912,0.0005956517422813462,0.282736027002879,0.717263972997121,0.04755286409212747
17091,17.0,289,8405,8694,19,356,11817,3364,8453,11817,871,0.024456291783024456,0.7112634340357112,0.001607853093001608,0.2846746213082847,0.7153253786917153,0.030126089532030127
17092,,1515,45215,46730,23,1917,60381,17857,42524,60381,4812,0.025090674218711185,0.7488282737947367,0.000380914526092645,0.2957387257581027,0.7042612742418973,0.03174839767476524
17093,17.0,1475,27844,29319,191,2323,41673,11022,30651,41673,2747,0.035394620017757304,0.6681544405250401,0.0045833033378926405,0.2644877978547261,0.7355122021452739,0.05574352698389845
17094,,533,16384,16917,50,773,22612,6392,16220,22612,1906,0.023571554926587652,0.7245710242349195,0.0022112152839200423,0.2826817618963382,0.7173182381036618,0.03418538828940386
17095,25.0,15640,283996,299636,2317,14878,400496,112224,288272,400496,27718,0.03905157604570333,0.7091107027286165,0.005785326195517558,0.28021253645479605,0.719787463545204,0.03714893532020295
17096,,64,2956,3020,6,117,3940,1177,2763,3940,306,0.016243654822335026,0.750253807106599,0.0015228426395939086,0.2987309644670051,0.7012690355329949,0.02969543147208122
17097,15.0,63,1816,1879,4,118,2537,716,1821,2537,174,0.024832479306267245,0.7158060701616082,0.0015766653527788726,0.2822230981474182,0.7177769018525818,0.046511627906976744
17098,23.0,78,3818,3896,5,146,4968,1481,3487,4968,382,0.01570048309178744,0.7685185185185185,0.001006441223832528,0.29810789049919484,0.7018921095008052,0.02938808373590982
17099,26.0,571,11245,11816,97,588,15404,4478,10926,15404,938,0.03706829394962347,0.7300051934562451,0.006297065697221501,0.29070371332121525,0.7092962866787847,0.03817190340171384
17100,,155,11937,12092,18,497,15727,4579,11148,15727,1448,0.009855662236917404,0.7590131620779551,0.0011445285178355695,0.29115533795383736,0.7088446620461627,0.03160170407579322
17101,,130,1846,1976,6,223,3123,738,2385,3123,113,0.041626641050272174,0.5910983029138649,0.0019212295869356388,0.23631123919308358,0.7636887608069164,0.07140569964777457
17102,26.0,10006,203208,213214,2164,10823,274124,79320,194809,274129,16972,0.03650106336797639,0.7412860368658551,0.00789409365663611,0.2893528229410241,0.7106471770589758,0.03948141203593929
17103,27.0,324,3294,3618,20,197,5295,1349,3946,5295,317,0.06118980169971672,0.6220963172804532,0.003777148253068933,0.2547686496694995,0.7452313503305005,0.03720491029272899
17104,48.0,1706,32503,34212,163,944,44098,12927,31175,44102,2666,0.03868305292276994,0.7369960546006984,0.003695977506689039,0.29311595845993377,0.7068840415400662,0.021404924946714435
17105,15.0,336,3965,4301,7,434,6225,1647,4578,6225,330,0.05397590361445783,0.6369477911646586,0.0011244979919678715,0.26457831325301207,0.7354216867469879,0.06971887550200803
17106,17.0,361,16167,16528,135,1346,22686,6105,16581,22686,1614,0.015912897822445562,0.7126421581592172,0.005950806664903465,0.2691087014017456,0.7308912985982544,0.059331746451556026
17107,,103,1917,2020,16,89,2727,794,1933,2727,225,0.03777044371103777,0.7029702970297029,0.005867253392005867,0.2911624495782912,0.7088375504217088,0.03263659699303264
17108,,183,3626,3809,12,206,5169,1403,3766,5169,338,0.035403366221706326,0.7014896498355582,0.0023215322112594312,0.2714258076997485,0.7285741923002514,0.03985296962662024
17109,24.0,623,11908,12531,46,643,16830,4790,12040,16830,1076,0.0370172311348782,0.7075460487225194,0.00273321449792038,0.2846108140225787,0.7153891859774213,0.038205585264408794
17110,,68,3042,3110,2,223,4031,1097,2934,4031,289,0.016869263210121558,0.7546514512527909,0.0004961548002976929,0.27214090796328455,0.7278590920367155,0.055321260233192754
17111,16.0,10745,204864,215609,1788,16163,295223,81897,213326,295223,20068,0.036396215741998424,0.6939296735010484,0.006056438692107322,0.27740724808026473,0.7225927519197353,0.05474844439626994
17112,,160,4888,5048,8,284,6862,1897,4965,6862,607,0.023316817254444767,0.7123287671232876,0.0011658408627222385,0.27645001457301077,0.7235499854269892,0.041387350626639466
17113,24.0,610,14864,15474,40,666,20381,5864,14517,20381,1626,0.02992983661253128,0.7293067072273196,0.001962612236887297,0.2877189539276777,0.7122810460723222,0.032677493744173496
17114,23.0,2208,52812,55020,207,2843,71761,20866,50895,71761,4789,0.030768801995512882,0.7359429216426749,0.002884575187079333,0.29077075291592924,0.7092292470840708,0.039617619598389095
17115,13.0,531,6946,7477,15,506,10192,2818,7374,10192,625,0.05209968602825746,0.6815149136577708,0.0014717425431711147,0.27649136577708006,0.7235086342229199,0.04964678178963893
17116,,7095,84239,91334,867,6269,123233,34840,88393,123233,8087,0.05757386414353298,0.6835750164322868,0.007035453165953925,0.2827164801635925,0.7172835198364075,0.05087111406847192
17117,,25,1885,1910,11,226,2651,689,1962,2651,193,0.00943040362127499,0.7110524330441342,0.004149377593360996,0.25990192380233873,0.7400980761976612,0.08525084873632592
17118,17.0,81,6977,7058,31,407,9567,2712,6855,9567,813,0.008466603951081843,0.7292777255147904,0.0032403052158461376,0.2834744433991847,0.7165255566008153,0.04254207170481865
17119,26.0,336,7238,7574,27,497,10345,2940,7405,10345,828,0.03247945867568874,0.6996616723054616,0.002609956500724988,0.28419526341227647,0.7158047365877236,0.048042532624456256
17120,25.0,13,2359,2372,0,275,3299,894,2405,3299,262,0.003940588056986966,0.7150651712640194,0.0,0.27099120945741134,0.7290087905425887,0.08335859351318581
17121,,100,8876,8976,9,453,11914,3543,8371,11914,983,0.008393486654356219,0.745005875440658,0.0007554137988920597,0.2973812321638409,0.7026187678361592,0.038022494544233676
17122,23.0,425,20808,21233,61,1484,28291,7790,20501,28291,2057,0.015022445300625641,0.7354989219186314,0.0021561627372662685,0.27535258562793824,0.7246474143720618,0.05245484429677282
17123,14.0,92,1996,2088,3,90,2745,814,1931,2745,187,0.03351548269581057,0.7271402550091075,0.001092896174863388,0.29653916211293263,0.7034608378870674,0.03278688524590164
17124,25.0,217,5388,5605,25,423,7625,2079,5546,7625,478,0.028459016393442622,0.7066229508196721,0.003278688524590164,0.272655737704918,0.727344262295082,0.055475409836065574
17125,36.0,1484,32398,33882,213,1706,45136,13018,32118,45136,3324,0.03287841191066997,0.7177862460120524,0.004719071251329316,0.28841722793335695,0.711582772066643,0.037796880538816024
17126,17.0,7701,149804,157505,735,9138,209627,59290,150337,209627,14893,0.03673667991241586,0.7146216851836834,0.0035062277282983585,0.28283570341606756,0.7171642965839324,0.04359171289957878
17127,34.0,187,4949,5136,2,198,6863,1972,4891,6863,551,0.02724755937636602,0.7211132157948419,0.0002914177473408131,0.2873378988780417,0.7126621011219584,0.028850356986740492
17128,26.0,13087,263210,276297,2213,14019,369829,105063,264766,369829,25586,0.03538662462922053,0.711707302564158,0.005983846588558496,0.2840853475525175,0.7159146524474825,0.03790670823542772
17129,26.0,268,7150,7418,106,547,9972,2727,7245,9972,602,0.026875250701965503,0.7170076213397513,0.010629763337344564,0.27346570397111913,0.7265342960288809,0.05485359005214601
17130,25.0,590,14076,14666,138,586,19046,5654,13392,19046,1332,0.0309776330988134,0.7390528194896566,0.0072456158773495745,0.2968602331198152,0.7031397668801849,0.03076761524729602
17131,48.0,240,7380,7620,20,338,9904,2898,7006,9904,751,0.024232633279483037,0.7451534733441034,0.0020193861066235864,0.2926090468497577,0.7073909531502424,0.03412762520193861
17132,,320,9587,9907,250,634,13967,3674,10293,13967,937,0.022911147705305362,0.6864036657836329,0.017899334144769814,0.2630486145915372,0.7369513854084628,0.04539271139113625
17133,25.0,6579,80034,86613,1001,4824,117935,33655,84280,117935,5661,0.05578496629499301,0.6786280578284648,0.008487726289905457,0.2853690592275406,0.7146309407724594,0.040903887734769155
17134,27.0,60,1701,1761,17,90,2338,691,1647,2338,194,0.02566295979469632,0.7275449101796407,0.007271171941830625,0.29555175363558595,0.704448246364414,0.03849443969204448
17135,17.0,62,2016,2078,4,150,2923,802,2121,2923,216,0.021211084502223743,0.6897023605884366,0.0013684570646595963,0.27437564146424903,0.7256243585357509,0.05131713992473486
17136,,396,12084,12480,20,753,16619,4876,11743,16619,1407,0.02382814850472351,0.7271195619471689,0.0012034418436729045,0.2933991214874541,0.7066008785125458,0.045309585414284856
17137,25.0,719,16102,16821,42,919,22657,6330,16327,22657,1649,0.031734121904930045,0.7106854393785585,0.001853731738535552,0.27938385487928674,0.7206161451207133,0.04056141589795648
17138,23.0,2722,64900,67622,225,3191,89685,25677,64008,89685,6572,0.0303506717957295,0.7236438646373418,0.002508780732563974,0.2863020572002007,0.7136979427997993,0.035580085856051734
17139,,359,7884,8243,27,402,10929,3213,7716,10929,764,0.03284838503065239,0.721383475157837,0.0024704913532802636,0.29398847104035136,0.7060115289596487,0.03678287125995059
17140,,1849,33160,35638,736,2267,48588,13082,35506,48588,2866,0.038054663702971926,0.6824730386103565,0.015147773112702725,0.2692434345929036,0.7307565654070964,0.046657610932740595
17141,25.0,429,7414,7843,63,453,10970,2979,7991,10970,724,0.03910665451230629,0.6758432087511395,0.005742935278030993,0.2715587967183227,0.7284412032816773,0.04129443938012762
17142,,435,8955,9390,10,467,12501,3581,8920,12501,972,0.03479721622270218,0.7163426925845933,0.0007999360051195904,0.2864570834333253,0.7135429165666747,0.037357011439084875
17143,23.0,50,1362,1412,2,116,1993,542,1451,1993,151,0.025087807325639738,0.6833918715504265,0.0010035122930255895,0.2719518314099348,0.7280481685900653,0.05820371299548419
17144,24.0,710,13921,14631,73,714,19460,5629,13831,19460,1475,0.03648509763617677,0.7153648509763618,0.003751284686536485,0.28926002055498456,0.7107399794450154,0.03669064748201439
17145,25.0,2681,55157,57838,432,3446,79949,21779,58170,79949,5396,0.033533877847127545,0.6899023127243618,0.005403444695993696,0.27241116211584887,0.7275888378841512,0.04310247782961638
17146,,102,6500,6602,98,781,9593,2464,7129,9593,552,0.0106327530490983,0.6775774001876368,0.010215782341290525,0.2568539560095903,0.7431460439904096,0.08141353069946836
17147,13.0,71,3514,3585,43,581,5444,1354,4090,5444,233,0.013041880969875092,0.6454812637766348,0.00789860396767083,0.24871418074944893,0.751285819250551,0.10672299779573843
17148,24.0,213,6176,6389,24,332,8295,2431,5864,8295,619,0.025678119349005425,0.744544906570223,0.0028933092224231465,0.29306811332127786,0.7069318866787221,0.04002411091018686
17149,17.0,219,7686,7905,50,404,10442,2904,7538,10442,845,0.02097299367937177,0.7360658877609654,0.004788354721317755,0.2781076422141352,0.7218923577858648,0.03868990614824746
17150,,61,1740,1801,2,101,2353,689,1664,2353,155,0.02592435189120272,0.7394815129621759,0.0008499787505312367,0.292817679558011,0.7071823204419889,0.042923926901827454
17151,,135,3551,3686,1,103,4818,1420,3398,4818,386,0.028019925280199254,0.7370278123702781,0.00020755500207555002,0.294728102947281,0.705271897052719,0.021378165213781653
17152,25.0,1997,22884,24881,533,1490,34530,9325,25205,34530,2124,0.05783376773819867,0.6627280625543006,0.015435852881552274,0.27005502461627573,0.7299449753837243,0.04315088328989285
17153,,1719,27106,28825,221,2275,39245,10978,28267,39245,2468,0.04380175818575615,0.690686711683017,0.005631290610268824,0.279729901898331,0.720270098101669,0.057969168046884956
17154,,9439,303633,313072,1015,13540,406097,119662,286435,406097,30379,0.02324321529092803,0.7476858977042431,0.0024994028520279638,0.2946635902259805,0.7053364097740195,0.03334178779946663
17155,,612,13031,13643,68,877,18492,5186,13306,18492,1529,0.03309539260220636,0.7046831062080899,0.0036772658446895955,0.2804455980964741,0.7195544019035258,0.04742591390871728
17156,27.0,267,9710,9977,0,294,12672,3784,8888,12672,967,0.021070075757575756,0.7662563131313131,0.0,0.2986111111111111,0.7013888888888888,0.023200757575757576
17157,,200,7676,7876,25,533,10710,2885,7825,10710,703,0.018674136321195144,0.7167133520074697,0.002334267040149393,0.26937441643323995,0.73062558356676,0.04976657329598506
17158,33.0,71,1673,1744,17,46,2294,691,1603,2294,214,0.03095030514385353,0.7292938099389712,0.0074106364428945075,0.3012205754141238,0.6987794245858762,0.02005231037489102
17159,23.0,665,18729,19394,47,1259,25846,7358,18488,25846,2072,0.025729319817379866,0.724638241894297,0.0018184632051381259,0.28468621837034747,0.7153137816296525,0.04871159947380639
17160,40.0,244,5647,5891,16,136,7489,2246,5243,7489,558,0.03258111897449593,0.7540392575777808,0.002136466817999733,0.2999065295767125,0.7000934704232875,0.01815996795299773
17161,17.0,709,16779,17488,22,1240,23838,6624,17214,23838,1625,0.02974242805604497,0.7038761641077271,0.0009228962161255138,0.2778756607097911,0.7221243392902089,0.05201778672707442
17162,27.0,947,26857,27804,58,1407,36257,10352,25905,36257,2705,0.02611909424387015,0.7407397192266321,0.0015996910941335465,0.28551727942190475,0.7144827205780953,0.03880629947320517
17163,27.0,81,3160,3241,8,234,4419,1209,3210,4419,197,0.018329938900203666,0.7150939126499208,0.0018103643358225842,0.27359131025118805,0.7264086897488119,0.05295315682281059
17164,17.0,408,11019,11427,36,690,15274,4333,10941,15274,1268,0.026712059709309937,0.7214220243551133,0.0023569464449391124,0.2836846929422548,0.7163153070577452,0.04517480686133298
17165,,1234,12034,13268,205,816,18453,4926,13527,18453,892,0.06687259524196608,0.6521432829350241,0.011109304720099713,0.2669484636644448,0.7330515363355552,0.04422045195903105
17166,,1645,46860,48505,122,1804,63613,18170,45443,63613,5451,0.02585949412855863,0.7366418813764483,0.0019178469809630107,0.2856334397057205,0.7143665602942795,0.028358983226698945
17167,16.0,21250,504889,526139,3946,19384,712011,201099,510912,712011,46659,0.029845044528806437,0.7091028088049202,0.005542049209913892,0.28243805222110335,0.7175619477788967,0.027224298501006303
17168,,703,20799,21502,124,1009,28098,8171,19927,28098,1928,0.025019574346928607,0.7402306213965407,0.004413125489358673,0.2908036159157235,0.7091963840842764,0.035910029183571786
17169,,993,26287,27280,167,1100,34676,10495,24181,34676,2312,0.028636520936670896,0.7580747491060099,0.004816011073941631,0.3026588995270504,0.6973411004729496,0.03172222863075326
17170,16.0,2432,46674,49106,316,2368,63917,18955,44962,63917,4832,0.03804934524461411,0.7302282647808878,0.004943911635402162,0.29655647167420246,0.7034435283257975,0.037048046685545316
17171,14.0,1588,32463,34051,98,3475,47332,12952,34380,47332,3279,0.033550240851854984,0.6858573480943125,0.0020704808586157358,0.27364151102847967,0.7263584889715203,0.07341756105805797
17172,15.0,1345,17190,18535,256,1156,24777,7221,17556,24777,1747,0.05428421519958026,0.6937885942608064,0.01033216289300561,0.29143964160309965,0.7085603583969003,0.046656173063728455
17173,,621,27691,28312,4,739,36251,10868,25383,36251,3078,0.017130561915533363,0.7638685829356432,0.0001103417836749331,0.29979862624479325,0.7002013737552067,0.02038564453394389
17174,25.0,133,4244,4377,2,246,5849,1687,4162,5849,464,0.022738929731578046,0.7255941186527611,0.00034193879295606086,0.28842537185843736,0.7115746281415627,0.04205847153359549
17175,,689,17701,18390,71,790,24240,7028,17212,24240,2039,0.028424092409240924,0.7302392739273927,0.002929042904290429,0.28993399339933995,0.7100660066006601,0.03259075907590759
17176,17.0,1244,21682,22926,52,2017,31662,8735,22927,31662,1775,0.03929000063167203,0.6847956540963932,0.0016423472932853263,0.27588276167014086,0.7241172383298592,0.06370412481839428
17177,27.0,710,16317,17027,156,720,22097,6399,15698,22097,1394,0.032131058514730505,0.7384260306828981,0.0070597818708421954,0.28958682174050776,0.7104131782594922,0.032583608634656286
17178,27.0,9310,138424,147734,1251,8559,204432,55981,148451,204432,13867,0.0455408155279017,0.6771151287469672,0.006119394223996244,0.27383677702121,0.72616322297879,0.04186722235266494
17179,47.0,218,7024,7242,8,264,9458,2721,6737,9458,704,0.023049270458870796,0.7426517234087545,0.0008458447874814971,0.2876929583421442,0.7123070416578557,0.027912877986889406
17180,16.0,3425,11342,14767,27,2171,21291,5763,15528,21291,676,0.16086609365459584,0.5327133530599784,0.0012681414682260109,0.270677751162463,0.7293222488375369,0.10196796768587667
17181,23.0,72,2152,2224,0,106,2943,841,2102,2943,209,0.024464831804281346,0.7312266394835202,0.0,0.2857628270472307,0.7142371729527692,0.036017669045191984
17182,23.0,119,2660,2779,15,180,3780,1062,2718,3780,272,0.03148148148148148,0.7037037037037037,0.003968253968253968,0.28095238095238095,0.719047619047619,0.047619047619047616
17183,23.0,265,6799,7064,37,246,9400,2730,6670,9400,711,0.028191489361702127,0.7232978723404255,0.003936170212765958,0.2904255319148936,0.7095744680851064,0.02617021276595745
17184,15.0,197,2547,2744,24,156,3732,1036,2696,3732,281,0.05278670953912112,0.682475884244373,0.006430868167202572,0.27759914255091106,0.722400857449089,0.04180064308681672
17185,37.0,75,3099,3174,0,82,4111,1317,2794,4111,197,0.01824373631719776,0.7538311846266116,0.0,0.3203600097299927,0.6796399902700073,0.01994648504013622
17186,17.0,315,17699,18014,13,990,23369,6946,16423,23369,1950,0.013479395780735162,0.7573708759467671,0.0005562925242843082,0.29723137489836965,0.7027686251016304,0.04236381531088194
17187,,532,9892,10424,42,345,13236,3989,9247,13236,745,0.04019341190692052,0.7473556965850711,0.003173164097914778,0.3013750377757631,0.698624962224237,0.026065276518585676
17188,17.0,1879,40853,42732,269,1766,56143,16237,39906,56143,3868,0.0334681082236432,0.7276597260566767,0.004791336408813209,0.2892079155014873,0.7107920844985127,0.031455390698751404
17189,16.0,2410,71498,73908,323,2870,96579,28446,68139,96585,7061,0.024952114717606253,0.7402598747217477,0.003344204586633535,0.29451778226432673,0.7054822177356732,0.029714759020551845
17190,13.0,13,1735,1748,8,140,2416,630,1786,2416,162,0.005380794701986755,0.7181291390728477,0.0033112582781456954,0.26076158940397354,0.7392384105960265,0.057947019867549666
17191,,83,3713,3796,0,114,4821,1492,3329,4821,380,0.017216345156606513,0.770172163451566,0.0,0.3094793611283966,0.6905206388716034,0.023646546359676415
17192,,73,3441,3514,7,100,4769,1348,3421,4769,461,0.015307192283497589,0.7215349129796603,0.0014678129586915495,0.28265883833088695,0.717341161669113,0.020968756552736424
17193,,11753,165515,177268,1208,10956,239682,66390,173292,239682,16369,0.04903580577598651,0.6905608264283509,0.005040011348369924,0.2769920144191053,0.7230079855808947,0.045710566500613316
17194,23.0,970,27873,28843,67,2680,40444,10974,29470,40444,2540,0.023983780041538918,0.6891751557709426,0.0016566116111166058,0.2713381465730393,0.7286618534269608,0.06626446444466423
17195,25.0,79,2934,3013,7,152,4047,1150,2897,4047,322,0.01952063256733383,0.7249814677538917,0.001729676303434643,0.2841611069928342,0.7158388930071659,0.03755868544600939
17196,16.0,126,2979,3105,13,139,4469,1128,3341,4469,314,0.028194226896397404,0.6665920787648243,0.002908928171850526,0.25240545983441487,0.7475945401655851,0.03110315506824793
17197,14.0,134,2589,2723,52,231,3830,1097,2733,3830,254,0.03498694516971279,0.6759791122715405,0.013577023498694517,0.2864229765013055,0.7135770234986946,0.06031331592689295
17198,16.0,316,9549,9865,19,542,13230,3735,9495,13230,1072,0.023885109599395313,0.7217687074829932,0.001436130007558579,0.282312925170068,0.717687074829932,0.04096749811035525
17199,17.0,314,16448,16762,77,1334,22967,6175,16792,22967,1728,0.01367178995950712,0.7161579657769843,0.0033526363913441025,0.26886402229285494,0.731135977707145,0.0580833369617277
17200,24.0,561,28148,28709,213,1932,38306,10715,27591,38306,2512,0.014645225291077115,0.7348196105048818,0.005560486607842113,0.27972119250248,0.7202788074975199,0.05043596303451157
17201,17.0,443,8785,9228,178,664,12617,3588,9029,12617,816,0.035111357692002854,0.6962827930569866,0.01410794959182056,0.28437821986209083,0.7156217801379092,0.052627407466117146
17202,23.0,19107,399694,418801,2082,24728,567445,158692,408753,567445,37027,0.03367198583122594,0.7043748733357418,0.003669078060428764,0.2796605838451304,0.7203394161548696,0.04357779168025095
17203,24.0,2330,74878,77208,102,2982,99572,28617,70955,99572,7578,0.023400152653356366,0.7519985538103081,0.0010243843650825533,0.2874000723094846,0.7125999276905154,0.02994817820270759
17204,25.0,648,9344,9992,83,454,13175,3870,9305,13175,658,0.04918406072106262,0.7092220113851992,0.006299810246679317,0.2937381404174573,0.7062618595825427,0.03445920303605313
17205,23.0,5705,136567,142277,520,8000,188826,53530,135296,188826,13705,0.030213000328344612,0.7232425619353267,0.002753858049209325,0.2834885026426445,0.7165114973573554,0.04236704691091269
17206,34.0,124,1506,1630,18,108,2321,616,1705,2321,144,0.05342524773804395,0.6488582507539854,0.007755277897457992,0.26540284360189575,0.7345971563981043,0.046531667384747954
17207,,293,9243,9536,38,373,12270,3591,8679,12270,810,0.023879380603096984,0.7533007334963325,0.0030969845150774244,0.29266503667481664,0.7073349633251834,0.030399348003259982
17208,16.0,877,15168,16045,53,1060,21648,6130,15518,21648,1535,0.04051182557280118,0.7006651884700665,0.002448263118994826,0.2831670362158167,0.7168329637841833,0.048965262379896526
17209,23.0,756,18684,19440,168,732,25769,7393,18376,25769,1961,0.029337576157398425,0.725057239318561,0.006519461368310761,0.286895106523342,0.713104893476658,0.02840622453335403
17210,,162,2705,2867,10,159,4055,1089,2966,4055,276,0.03995067817509248,0.6670776818742293,0.002466091245376079,0.268557336621455,0.731442663378545,0.03921085080147965
17211,17.0,391,8379,8770,25,690,12057,3251,8806,12057,793,0.03242929418595007,0.6949489922866384,0.0020734842829891347,0.26963589615990713,0.7303641038400929,0.05722816621050012
17212,26.0,7852,159588,167440,734,8781,219133,63690,155443,219133,14444,0.03583212021922759,0.7282700460450959,0.0033495639634377296,0.29064540712717846,0.7093545928728215,0.04007155471791104
17213,27.0,69,2161,2230,7,55,2928,873,2055,2928,251,0.0235655737704918,0.7380464480874317,0.0023907103825136613,0.29815573770491804,0.701844262295082,0.01878415300546448
17214,,922,28901,29823,138,2247,39317,11102,28215,39317,2552,0.023450415850649844,0.735076430042984,0.0035099320904443372,0.28237149324719585,0.7176285067528041,0.05715085077701758
17215,24.0,154,14570,14724,43,868,19328,5553,13775,19328,1573,0.00796771523178808,0.753828642384106,0.002224751655629139,0.2873033940397351,0.7126966059602649,0.044908940397350994
17216,14.0,186,2701,2887,49,250,4917,1098,3819,4917,331,0.037827943868212324,0.5493186902582876,0.009965426072808623,0.22330689444783405,0.776693105552166,0.0508440105755542
17217,16.0,2064,32207,34271,750,2291,46292,13113,33179,46292,2988,0.044586537630692126,0.6957357642789251,0.016201503499524757,0.2832670871856908,0.7167329128143092,0.04949019268988162
17218,,821,21476,22297,135,943,29089,8476,20613,29089,2238,0.028223727182096325,0.7382859500154698,0.004640929561002441,0.2913816219189384,0.7086183780810615,0.032417752415002235
17219,14.0,266,8459,8725,62,1116,12144,3223,8921,12144,772,0.021903820816864296,0.6965579710144928,0.005105401844532279,0.2653985507246377,0.7346014492753623,0.09189723320158102
17220,15.0,302,6415,6717,44,1152,9899,2501,7398,9899,455,0.030508132134559045,0.6480452570966765,0.004444893423578139,0.2526517830083847,0.7473482169916154,0.11637539145368218
17221,27.0,417,8482,8899,10,504,12019,3322,8697,12019,827,0.03469506614526999,0.7057159497462351,0.0008320159747067144,0.27639570679757053,0.7236042932024295,0.041933605125218404
17222,23.0,122,2412,2534,4,83,3298,989,2309,3298,212,0.03699211643420255,0.7313523347483323,0.001212856276531231,0.29987871437234687,0.7001212856276531,0.025166767738023045
17223,15.0,1366,25313,26679,89,1147,35526,10190,25336,35526,2802,0.03845071215447841,0.7125204075888082,0.002505207453695885,0.28683217924900073,0.7131678207509993,0.03228621291448516
17224,,168,7277,7445,4,355,9929,2840,7089,9929,857,0.0169201329439017,0.7329036156712659,0.00040286030818813577,0.2860308188135764,0.7139691811864236,0.03575385235169705
17225,23.0,1532,32046,33578,180,1962,44943,12661,32282,44943,3124,0.03408762209910331,0.7130365129163607,0.004005073092583939,0.28171239125114034,0.7182876087488597,0.043655296709164945
17226,24.0,521,12652,13173,59,741,17574,5014,12560,17574,1211,0.02964606805508137,0.7199271651303061,0.003357232274951633,0.2853078411289405,0.7146921588710595,0.042164561283714576
17227,,2084,55839,57923,96,3645,76013,22150,53863,76013,5472,0.027416362990541093,0.7345980292844645,0.0012629418652072672,0.2913975241077184,0.7086024758922815,0.047952323944588426
17228,17.0,600,17469,18069,83,1373,24769,6828,17941,24769,1725,0.024223828172312164,0.7052767572368687,0.0033509628971698496,0.27566716460091245,0.7243328353990875,0.055432193467641
17229,23.0,1943,41439,43382,169,2451,58768,16390,42378,58768,4583,0.033062210726926215,0.705128641437517,0.0028757146746528723,0.2788932752518377,0.7211067247481623,0.04170637081404846
17230,16.0,20744,349932,370676,1157,22500,494423,142665,351758,494423,35635,0.041955976967090934,0.7077583364851554,0.0023401014920422392,0.2885484696302559,0.7114515303697442,0.04550759167757163
17231,,479,6006,6485,0,595,9163,2532,6631,9163,625,0.052275455636800174,0.6554621848739496,0.0,0.2763287133035032,0.7236712866964968,0.06493506493506493
17232,,38,1150,2374,40,230,3722,426,3315,3741,86,0.010157711841753542,0.30740443731622563,0.010692328254477412,0.11387329591018444,0.8861267040898155,0.06148088746324512
17233,17.0,686,15627,16313,58,845,22365,6254,16111,22365,1721,0.030672926447574335,0.6987256874580818,0.0025933378046054103,0.2796333556896937,0.7203666443103063,0.03778224904985469
17234,26.0,2675,41399,44074,1077,1930,62941,16430,46515,62945,3043,0.04249741838112638,0.6577011676860751,0.017110175550083408,0.26102152672968465,0.7389784732703154,0.03066168877591548
17235,,955,32804,33759,271,4380,48417,12950,35467,48417,2541,0.019724476939917798,0.6775306194105376,0.005597207592374579,0.26746803808579633,0.7325319619142037,0.09046409319040832
17236,23.0,902,38177,39083,99,1601,50803,14608,36195,50803,3925,0.017754856996634056,0.751471369800996,0.001948703816703738,0.28754207428695155,0.7124579257130484,0.03151388697517863
17237,24.0,400,13121,13521,29,589,17751,5178,12573,17751,1516,0.02253394174976058,0.7391696242465213,0.0016337107768576418,0.29170187595065067,0.7082981240493493,0.033181229226522446
17238,,291,5901,6192,27,246,8129,2360,5769,8129,673,0.0357977611022266,0.7259195472997909,0.0033214417517529833,0.29031861237544593,0.709681387624554,0.030262024849304958
17239,,330,2570,2900,25,460,4261,1095,3166,4261,242,0.07744660877728232,0.6031448016897442,0.005867167331612298,0.25698192912461865,0.7430180708753814,0.10795587890166627
17240,15.0,22,2766,2788,120,251,3874,1033,2841,3874,282,0.005678884873515746,0.7139907072792979,0.030975735673722252,0.2666494579246257,0.7333505420753743,0.06479091378420238
17241,,70,6455,6525,46,246,8431,2510,5921,8431,682,0.008302692444549875,0.7656268532795635,0.0054560550349899185,0.29771082908314556,0.7022891709168545,0.02917803344798956
17242,41.0,1187,51047,52234,94,2054,68903,19585,49318,68903,6336,0.017227116380999375,0.7408530833200296,0.0013642366805509194,0.28424016370840166,0.7157598362915983,0.029810022785655196
17243,16.0,245,10181,10426,17,622,13802,3905,9897,13802,1043,0.017751050572380814,0.7376467178669758,0.0012317055499203014,0.2829300101434575,0.7170699898565426,0.04506593247355456
17244,,519,18700,19219,24,727,24881,7230,17651,24881,2080,0.02085929022145412,0.7515775089425666,0.0009645914553273583,0.29058317591736665,0.7094168240826333,0.029219082834291227
17245,23.0,2958,50119,53077,241,2701,71449,20084,51365,71449,5062,0.041400159554367454,0.7014653809010623,0.0033730353119007963,0.28109560665649624,0.7189043933435038,0.03780318828814959
17246,24.0,658,13661,14319,34,571,18592,5367,13225,18592,1389,0.035391566265060244,0.7347783993115319,0.0018287435456110154,0.2886725473321859,0.7113274526678142,0.03071213425129088
17247,,476,8801,9277,108,263,11961,3606,8355,11961,741,0.03979600367862219,0.7358080428057855,0.009029345372460496,0.3014798093804866,0.6985201906195134,0.02198812808293621
17248,23.0,429,12837,13266,29,1041,18404,5089,13315,18404,1495,0.023310149967398393,0.6975114105629211,0.0015757444033905673,0.27651597478808954,0.7234840252119105,0.05656379048033036
17249,,12197,194381,206578,3629,12280,277253,77277,199976,277253,17809,0.043992310272566934,0.7010961107724714,0.013089127980580914,0.27872376493671847,0.7212762350632815,0.044291675833985564
17250,27.0,1150,21588,22738,128,1821,30770,8343,22427,30770,1719,0.03737406564835879,0.7015924601884953,0.004159896002599935,0.27114072148196294,0.728859278518037,0.05918102047448814
17251,23.0,83,2695,2778,9,222,3828,1033,2795,3828,302,0.02168234064785789,0.7040229885057471,0.0023510971786833857,0.26985370950888193,0.7301462904911181,0.05799373040752351
17252,36.0,2058,54141,56199,349,2745,76173,21342,54831,76173,5831,0.02701744712693474,0.7107636564136899,0.004581675921914589,0.28017801583238156,0.7198219841676184,0.036036390847150566
17253,16.0,882,8971,9853,145,630,13633,3630,10003,13633,885,0.06469595833638964,0.6580356487933691,0.01063595686936111,0.26626567886745395,0.733734321132546,0.04621139881170689
17254,,4592,92272,96864,445,5683,129423,36434,92989,129423,9141,0.035480556006274,0.7129490121539448,0.003438337853395455,0.28151101427103375,0.7184889857289662,0.043910278698531174
17255,17.0,305,6502,6807,19,357,9193,2626,6567,9193,707,0.03317741760034809,0.7072772761884042,0.002066789948874143,0.285652126618079,0.7143478733819211,0.03883389535516154
17256,,255,6312,6567,82,267,8942,2537,6405,8942,733,0.028517110266159697,0.7058823529411765,0.009170208007157236,0.28371728919704764,0.7162827108029524,0.02985909192574368
17257,,155,3039,3194,16,176,4216,1234,2982,4216,350,0.03676470588235294,0.7208254269449715,0.003795066413662239,0.2926944971537002,0.7073055028462998,0.04174573055028463
17258,24.0,126,6430,6556,17,319,8715,2542,6173,8715,841,0.014457831325301205,0.7378083763625932,0.0019506597819850832,0.2916810097532989,0.7083189902467011,0.036603557085484795
17259,,100,2345,2445,5,292,3399,906,2493,3399,230,0.029420417769932334,0.6899087967049132,0.0014710208884966167,0.26654898499558694,0.733451015004413,0.08590761988820242
17260,,151,1970,2121,5,523,3944,825,3119,3944,145,0.03828600405679513,0.49949290060851925,0.0012677484787018255,0.2091784989858012,0.7908215010141988,0.13260649087221096
17261,,257,3844,4101,99,321,5876,1558,4318,5876,345,0.04373723621511232,0.6541865214431586,0.016848196051735875,0.26514635806671205,0.734853641933288,0.05462899931926481
17262,13.0,456,10747,11203,25,692,14697,4125,10572,14697,1063,0.031026740151051235,0.7312376675512009,0.0017010274205620194,0.28066952439273324,0.7193304756072668,0.0470844390011567
17263,25.0,1336,30689,32025,173,2295,43266,12494,30772,43266,2367,0.03087875005778209,0.7093098506910738,0.003998520778440345,0.2887717838487496,0.7112282161512504,0.05304396061572597
17264,,2307,48003,50310,270,1917,66655,19124,47531,66655,5441,0.03461105693496362,0.7201710299302377,0.0040507088740529594,0.28691020928662514,0.7130897907133749,0.028760033005776012
17265,16.0,6159,98258,104417,625,10840,146756,39977,106786,146763,8694,0.04196561803724372,0.6695011685506566,0.0042585665324366495,0.2723915428275519,0.727608457172448,0.07386057793858125
17266,16.0,520,17241,17761,22,933,25246,6710,18536,25246,1877,0.02059732234809475,0.6829200665451953,0.000871425176265547,0.2657846787609918,0.7342153212390081,0.03695634952071615
17267,17.0,92,2133,2225,2,127,2949,845,2104,2949,217,0.031197015937605967,0.7232960325534079,0.0006781959986436081,0.28653780942692436,0.7134621905730756,0.043065445913869106
17268,39.0,6175,141090,147265,1938,6604,189459,56330,133129,189459,11798,0.03259280372006608,0.744699380868684,0.010229126090605355,0.2973202645427243,0.7026797354572757,0.034857145873249624
17269,27.0,98,2452,2550,26,88,3438,972,2466,3438,281,0.028504944735311226,0.7132053519488074,0.0075625363583478765,0.28272251308900526,0.7172774869109948,0.025596276905177427
17270,,1556,10790,12346,307,1118,16750,4644,12106,16750,321,0.0928955223880597,0.644179104477612,0.018328358208955224,0.27725373134328357,0.7227462686567164,0.06674626865671641
17271,,341,1887,2228,67,178,3079,865,2214,3079,163,0.11075024358557974,0.6128613186099383,0.021760311789542058,0.28093536862617735,0.7190646313738227,0.05781097759012666
17272,,348,8022,8370,61,330,11173,3217,7956,11173,851,0.031146513917479638,0.7179808466839703,0.005459590083236374,0.28792625078313794,0.7120737492168621,0.029535487335541035
17273,24.0,397,7328,7725,11,450,10422,2925,7497,10422,756,0.03809249664171944,0.703127998464786,0.0010554596046824026,0.28065630397236613,0.7193436960276338,0.04317789291882556
17274,25.0,304,9999,10303,15,527,13648,3917,9731,13648,1012,0.022274325908558032,0.7326348182883939,0.0010990621336459555,0.28700175849941384,0.7129982415005862,0.038613716295427904
17275,,208,8740,8948,26,708,11873,3166,8707,11873,760,0.017518739998315505,0.7361239787753727,0.002189842499789438,0.2666554367051293,0.7333445632948707,0.05963109576349701
17276,23.0,69,1970,2039,0,53,2676,770,1906,2676,217,0.0257847533632287,0.7361733931240658,0.0,0.28774289985052315,0.7122571001494769,0.019805680119581465
17277,16.0,559,3369,3928,16,268,5968,1443,4525,5968,291,0.0936662198391421,0.5645107238605898,0.002680965147453083,0.24178954423592494,0.7582104557640751,0.044906166219839144
17278,15.0,3257,26788,30045,181,2158,41485,11401,30084,41485,2229,0.07851030492949258,0.6457273713390382,0.004363022779317826,0.27482222490056646,0.7251777750994335,0.052018801976618054
17279,13.0,101,2059,2160,2,79,2905,828,2077,2905,241,0.03476764199655766,0.7087779690189329,0.0006884681583476765,0.28502581755593803,0.714974182444062,0.027194492254733218
17280,13.0,109,1651,1760,28,76,2601,652,1949,2601,162,0.041906958861976165,0.6347558631295656,0.010765090349865437,0.2506728181468666,0.7493271818531334,0.029219530949634757
17281,,525,16951,17476,33,714,22893,6687,16206,22893,1713,0.022932774210457346,0.7404446774123095,0.0014414886646573189,0.2920980212291967,0.7079019787708033,0.03118857292622199
17282,,27,4007,4034,10,299,5539,1544,3995,5539,490,0.004874526087741469,0.723415779021484,0.0018053800324968406,0.27875067701751216,0.7212493229824878,0.05398086297165553
17283,23.0,1658,37286,38944,377,1380,51142,14931,36214,51145,3627,0.03241763613256428,0.7290253201681494,0.007371199530745919,0.29193469547365336,0.7080653045263466,0.02698210968814156
17284,33.0,320,7185,7505,20,414,10105,2851,7254,10105,827,0.03166749134092034,0.7110341415141019,0.0019792182088075212,0.28213755566551213,0.7178624443344879,0.04096981692231569
17285,15.0,149,2715,2864,13,161,3912,1100,2812,3912,267,0.0380879345603272,0.6940184049079755,0.0033231083844580778,0.28118609406952966,0.7188139059304703,0.04115541922290389
17286,24.0,4645,104131,109263,737,6254,146396,41124,105272,146396,10127,0.031729008989316645,0.7112967567419874,0.005034290554386732,0.2809093144621438,0.7190906855378563,0.0427197464411596
17287,23.0,142,2936,3078,16,155,4090,1167,2923,4090,252,0.03471882640586797,0.7178484107579463,0.003911980440097799,0.28533007334963323,0.7146699266503668,0.037897310513447434
17288,16.0,54,1510,1564,4,94,2131,586,1545,2131,166,0.025340215861098078,0.7085875175973722,0.0018770530267480056,0.2749882684185828,0.7250117315814172,0.044110746128578134
17289,,398,9729,10127,87,520,13914,3903,10011,13914,1044,0.028604283455512435,0.6992238033635187,0.006252695127210005,0.2805088400172488,0.7194911599827511,0.037372430645393126
17290,24.0,71,1442,1513,0,112,2122,556,1566,2122,163,0.03345900094250707,0.6795475966069745,0.0,0.26201696512723843,0.7379830348727615,0.0527803958529689
17291,39.0,357,9418,9775,33,418,12948,3685,9263,12948,1038,0.02757182576459685,0.7273710225517455,0.0025486561631139944,0.28459993821439605,0.715400061785604,0.03228297806611059
17292,25.0,5104,176154,181258,864,8439,239241,69124,170117,239241,19167,0.021334135871359843,0.7363035600085269,0.003611421119289754,0.28893040908539924,0.7110695909146008,0.0352740541963961
17293,23.0,162,30577,30739,43,1756,40784,11760,29024,40784,3169,0.003972145939584151,0.7497302863868184,0.0010543350333464103,0.2883483719105532,0.7116516280894468,0.04305610043154178
17294,,989,19655,20644,147,957,27275,7807,19468,27275,1923,0.03626031164069661,0.7206232813932172,0.00538955087076077,0.2862328139321723,0.7137671860678276,0.03508707607699359
17295,,156,3674,3830,15,184,5215,1470,3745,5215,376,0.0299137104506232,0.7045062320230105,0.0028763183125599234,0.28187919463087246,0.7181208053691275,0.035282837967401726
17296,,1667,38032,39699,251,2199,53381,14922,38459,53381,3743,0.031228339671418668,0.7124632359828403,0.00470204754500665,0.27953766321350293,0.7204623367864971,0.041194432475974596
17297,,9153,210980,220133,1034,9287,288787,83987,204810,288797,18431,0.03169354252294865,0.730547754997455,0.003580369602177308,0.2908167328607984,0.7091832671392015,0.0321575362624958
17298,,561,13827,14388,59,775,19336,5456,13880,19336,1347,0.02901323955316508,0.7150910219280099,0.0030513032685146875,0.282167976830782,0.717832023169218,0.04008067852709971
17299,,24797,499139,523936,2305,24757,699663,199587,500076,699663,53962,0.03544134819191525,0.7133991650265914,0.003294443181931873,0.2852616188079118,0.7147383811920882,0.03538417781131773
17300,40.0,492,6659,7151,38,396,9610,2711,6899,9610,677,0.051196670135275756,0.6929240374609782,0.003954214360041623,0.28210197710718005,0.71789802289282,0.04120707596253902
17301,23.0,2783,45613,48396,176,2809,65553,18473,47081,65554,4489,0.04245354974524819,0.6958080361228911,0.0026848094700552215,0.2817982121609665,0.7182017878390334,0.042850169326051804
17302,24.0,429,5665,6094,0,165,7930,2244,5686,7930,506,0.054098360655737705,0.71437578814628,0.0,0.28297604035308954,0.7170239596469105,0.02080706179066835
17303,34.0,606,11647,12253,70,653,16793,4773,12020,16793,1241,0.036086464598344546,0.6935627940213184,0.004168403501458941,0.2842255701780504,0.7157744298219496,0.03888524980646698
17304,26.0,56,1709,1765,3,66,2307,702,1605,2307,171,0.024273948851322065,0.740788903337668,0.0013003901170351106,0.30429128738621586,0.6957087126137841,0.02860858257477243
17305,17.0,1248,33984,35232,125,1171,45071,13499,31579,45078,3298,0.027685345401304406,0.7538932516970585,0.0027729712942011625,0.2994587160033719,0.7005412839966281,0.02597719508407649
17306,16.0,164,3608,3772,14,235,5055,1409,3646,5055,360,0.0324431256181998,0.7137487636003956,0.0027695351137487635,0.2787339268051434,0.7212660731948566,0.04648862512363996
17307,16.0,428,19066,19494,62,1358,25734,7469,18265,25734,1864,0.016631693479443536,0.7408875417735292,0.0024092640087044377,0.29023859485505554,0.7097614051449445,0.052770653610010106
17308,24.0,26356,693982,720338,4122,35345,979007,275979,703028,979007,66681,0.026921155824217804,0.7088631644104689,0.00421038868976422,0.2818968607987481,0.7181031392012519,0.036102908355098585
17309,24.0,297,6364,6661,39,772,9029,2459,6570,9029,242,0.03289400819581349,0.7048399601284749,0.004319415217632075,0.2723446671835198,0.7276553328164802,0.08550227046184516
17310,25.0,3092,104182,107274,611,6388,141139,40778,100361,141139,10104,0.021907481277322356,0.7381517511106073,0.004329065672847335,0.2889208510758897,0.7110791489241103,0.04526034618354955
17311,39.0,269,3540,3809,28,125,5120,1454,3666,5120,195,0.0525390625,0.69140625,0.00546875,0.283984375,0.716015625,0.0244140625
17312,16.0,132,4345,4477,21,253,5922,1673,4249,5922,442,0.022289766970618033,0.7337048294495103,0.0035460992907801418,0.28250591016548465,0.7174940898345153,0.04272205336035123
17313,16.0,180,5768,5948,30,545,8561,2314,6247,8561,644,0.021025581123700503,0.6737530662305805,0.0035042635206167503,0.270295526223572,0.729704473776428,0.0636607872912043
17314,24.0,555,4880,5435,41,263,8407,2083,6324,8407,318,0.06601641489235162,0.5804686570714881,0.004876888307362912,0.24776971571309622,0.7522302842869037,0.031283454264303553
17315,16.0,167,4297,4464,10,124,5909,1686,4223,5909,467,0.028261973261127095,0.7271958030123541,0.0016923337282112032,0.2853274665764089,0.7146725334235912,0.02098493822981892
17316,13.0,1406,19238,20644,75,1255,28026,7843,20183,28026,1824,0.0501677014201099,0.6864340255477057,0.002676086491115393,0.27984728466424036,0.7201527153357596,0.04477984728466424
17317,15.0,73,2455,2528,1,149,3374,948,2426,3374,249,0.021636040308239478,0.7276229994072317,0.0002963841138114997,0.2809721398933017,0.7190278601066983,0.04416123295791346
17318,25.0,2508,57243,59751,245,2939,79352,22662,56690,79352,5084,0.031606008670228856,0.7213806835366469,0.0030875088214537758,0.2855882649460631,0.7144117350539368,0.037037503780623045
17319,,1553,33006,34559,175,1580,44860,13067,31793,44860,2953,0.034618814088274635,0.7357556843513152,0.003901025412394115,0.2912839946500223,0.7087160053499777,0.03522068658047258
17320,43.0,159,2452,2611,44,108,3423,969,2454,3423,162,0.04645048203330412,0.7163307040607654,0.012854221443178498,0.28308501314636286,0.7169149868536372,0.03155127081507449
17321,,88,1729,1817,12,104,2431,678,1753,2431,204,0.03619909502262444,0.7112299465240641,0.0049362402303578775,0.27889757301522006,0.7211024269847799,0.0427807486631016
17322,33.0,126,2606,2732,3,147,3801,1055,2746,3801,263,0.03314917127071823,0.6856090502499342,0.0007892659826361484,0.2775585372270455,0.7224414627729545,0.03867403314917127
17323,15.0,886,20538,21424,98,1221,28233,8078,20155,28233,1917,0.031381716431126694,0.7274466050366593,0.003471115361456452,0.28611908050862467,0.7138809194913753,0.04324726384018702
17324,25.0,242,7864,8106,9,327,10503,3180,7323,10503,790,0.02304103589450633,0.7487384556793297,0.000856898029134533,0.3027706369608683,0.6972293630391316,0.031133961725221364
17325,,864,23856,24720,173,1474,32847,9240,23607,32847,2428,0.026303772033975707,0.7262763722714403,0.005266843242914117,0.28130422869668464,0.7186957713033154,0.044874722196852075
17326,14.0,2057,35343,37400,96,3404,53532,13983,39549,53532,3411,0.038425614585668386,0.660221923335575,0.0017933198834342075,0.2612082492714638,0.7387917507285362,0.0635881342001046
17327,14.0,21,5281,5302,39,39,6996,1961,5035,6996,767,0.003001715265866209,0.7548599199542596,0.005574614065180103,0.2803030303030303,0.7196969696969697,0.005574614065180103
17328,16.0,73,14166,14239,166,2374,20290,5396,14894,20290,851,0.003597831444061114,0.6981764415968458,0.008181370133070479,0.2659438146870379,0.734056185312962,0.11700344997535732
17329,,1128,4346,5474,51,311,7438,2075,5373,7448,541,0.1514500537056928,0.5835123523093448,0.006847475832438239,0.2785982814178303,0.7214017185821697,0.04175617615467239
17330,24.0,30,4789,4819,10,289,6485,1870,4615,6485,558,0.004626060138781804,0.738473400154202,0.0015420200462606013,0.28835774865073244,0.7116422513492675,0.04456437933693138
17331,17.0,283,6499,6782,0,239,9045,2579,6466,9045,753,0.03128800442233278,0.7185185185185186,0.0,0.2851299060254284,0.7148700939745716,0.02642343836373687
17332,15.0,313,20809,21351,101,1704,29080,7991,21089,29080,1697,0.010763411279229711,0.7155777166437414,0.0034731774415405776,0.2747936726272352,0.7252063273727648,0.05859697386519945
17333,42.0,32,12789,12821,43,382,16689,4922,11767,16689,1665,0.0019174306429384624,0.7663131403918749,0.002576547426448559,0.29492480076697225,0.7050751992330277,0.022889328300077897
17334,24.0,2953,46903,49856,353,2731,66736,18685,48051,66736,4122,0.04424898105969791,0.7028140733637017,0.005289498921122033,0.2799838168304963,0.7200161831695037,0.04092244066171182
17335,,280,6748,7028,2,367,9435,2735,6700,9435,663,0.0296767355590885,0.7152093269740328,0.00021197668256491787,0.2898781134075252,0.7101218865924749,0.038897721250662425
17336,33.0,98,2897,2995,12,173,4062,1115,2947,4062,313,0.0241260462826194,0.7131954702117184,0.0029542097488921715,0.27449532250123093,0.7255046774987691,0.04258985721319547
17337,,5970,120359,126329,61,9134,167663,47062,120601,167663,12015,0.03560714051400726,0.7178626172739364,0.0003638250538282149,0.2806940112010402,0.7193059887989598,0.054478328551916644
17338,,21,5606,5627,4,216,7794,2167,5627,7794,699,0.0026943802925327174,0.7192712342827816,0.0005132152938157557,0.27803438542468567,0.7219656145753144,0.02771362586605081
17339,16.0,932,11422,12354,183,903,16678,4719,11959,16678,1025,0.05588200023983691,0.6848542990766279,0.010972538673701883,0.28294759563496824,0.7170524043650318,0.05414318263580765
17340,25.0,387,9172,9559,50,478,12689,3740,8949,12689,903,0.030498857277957286,0.7228307983292616,0.003940420836945385,0.29474347860351485,0.7052565213964851,0.037670423201197886
17341,23.0,202,2670,2872,4,245,3944,1092,2852,3944,271,0.051217038539553755,0.6769776876267748,0.0010141987829614604,0.2768762677484787,0.7231237322515213,0.06211967545638945
17342,17.0,98,1538,1636,0,138,2339,641,1698,2339,154,0.04189824711415135,0.6575459598118855,0.0,0.2740487387772552,0.7259512612227448,0.058999572466866185
17343,33.0,4679,63809,68488,245,4400,91681,25893,65788,91681,6097,0.05103565624284203,0.6959893543918587,0.002672309420708762,0.28242492992004886,0.7175750700799511,0.04799249571885123
17344,24.0,206,4116,4322,16,137,5716,1672,4044,5716,459,0.03603918824352694,0.7200839748075577,0.0027991602519244225,0.2925122463261022,0.7074877536738978,0.02396780965710287
17345,25.0,121,2843,2978,18,192,4276,1135,3141,4276,247,0.028297474275023386,0.6648737137511693,0.00420954162768943,0.2654349859681946,0.7345650140318054,0.04490177736202058
17346,17.0,391,7709,8100,17,429,10969,3106,7863,10969,840,0.035645911204303035,0.7027987966086243,0.001549822226274045,0.28316163734159905,0.716838362658401,0.03911021971009208
17347,13.0,398,7140,8345,48,754,11466,2904,8562,11466,547,0.03471132042560614,0.6227106227106227,0.004186289900575615,0.2532705389848247,0.7467294610151753,0.06575963718820861
17348,17.0,2112,55592,57704,243,2369,75843,21607,54236,75843,6210,0.02784699972311222,0.7329878828632833,0.003203987184051264,0.28489115673166937,0.7151088432683307,0.031235578761388657
17349,23.0,1746,52698,54444,215,2657,73929,20892,53037,73929,5412,0.02361725439272816,0.7128190561214138,0.002908195701280959,0.282595463214706,0.717404536785294,0.0359398882711791
17350,,88,2345,2433,4,94,3155,938,2217,3155,258,0.027892234548335976,0.7432646592709984,0.0012678288431061807,0.29730586370839934,0.7026941362916006,0.029793977812995247
17351,,587,14591,15178,22,436,20440,5781,14659,20440,1757,0.028718199608610568,0.7138454011741683,0.001076320939334638,0.2828277886497065,0.7171722113502935,0.0213307240704501
17352,,1315,23981,25296,4,1860,42135,7946,34189,42135,1369,0.031209208496499347,0.5691467900795063,9.493295360151892e-05,0.18858431232941736,0.8114156876705827,0.044143823424706304
17353,23.0,236,7459,7695,41,440,10472,2921,7551,10472,784,0.022536287242169595,0.7122803666921314,0.00391520244461421,0.2789343009931245,0.7210656990068754,0.04201680672268908
17354,25.0,1483,25326,26809,90,2382,36684,10080,26604,36684,2742,0.04042634391015156,0.6903827281648676,0.0024533856722276743,0.2747791952894995,0.7252208047105005,0.06493294079162577
17355,,465,13888,14353,101,577,18653,5435,13218,18653,1384,0.02492896584999732,0.7445451133865866,0.005414678603977912,0.29137404170910847,0.7086259582908916,0.0309333619256956
17356,,155,4204,4359,11,270,5798,1677,4121,5798,386,0.026733356329768886,0.7250776129699896,0.0018972059330803726,0.289237668161435,0.7107623318385651,0.04656778199379096
17357,,337,11406,11743,86,644,15854,4374,11480,15854,1138,0.021256465245363947,0.7194398889870064,0.005424498549262016,0.2758925192380472,0.7241074807619529,0.04062066355493882
17358,,49,6605,6654,20,349,8778,2504,6274,8778,777,0.005582137161084529,0.752449305080884,0.00227842333105491,0.2852586010480747,0.7147413989519252,0.03975848712690818
17359,,3231,57178,60409,79,3233,79488,23035,56453,79488,6203,0.04064764492753623,0.7193287037037037,0.0009938607085346217,0.2897921698872786,0.7102078301127214,0.040672805958132045
17360,26.0,135,4219,4354,28,102,5785,1659,4126,5785,504,0.023336214347450302,0.7292999135695765,0.0048401037165082105,0.2867761452031115,0.7132238547968885,0.01763180639585134
17361,,1772,56259,58031,155,1274,73639,22074,51565,73639,5606,0.02406333600401961,0.7639837586061734,0.002104862912315485,0.2997596382351743,0.7002403617648257,0.017300615163160823
17362,15.0,299,8018,8317,23,287,10945,3148,7797,10945,803,0.027318410232983096,0.7325719506624029,0.0021014161717679307,0.28761991777067153,0.7123800822293285,0.026222019186843307
17363,25.0,1925,44445,46370,399,2726,63917,17569,46349,63918,3977,0.030116712037297787,0.6953440345442599,0.006242373040458087,0.27486779936794015,0.7251322006320599,0.042648393253856505
17364,35.0,157,4630,4787,30,178,6560,1849,4711,6560,543,0.023932926829268293,0.7057926829268293,0.004573170731707317,0.281859756097561,0.718140243902439,0.027134146341463414
17365,,480,10404,10884,33,442,14421,4140,10281,14421,1133,0.03328479301019347,0.7214478884959434,0.002288329519450801,0.28708133971291866,0.7129186602870813,0.030649746896886484
17366,25.0,976,24832,25808,78,1248,33522,9944,23578,33522,2582,0.029115207923154942,0.7407672573235488,0.0023268301413996778,0.29664101187279995,0.7033589881272001,0.037229282262394844
17367,17.0,872,24221,25093,88,1145,33712,9480,24232,33712,2882,0.025866160417655434,0.7184682012339819,0.0026103464641670624,0.28120550545799716,0.7187944945420028,0.03396416706217371
17368,17.0,198,2015,2213,20,148,3087,802,2285,3087,188,0.0641399416909621,0.6527372853903466,0.00647878198898607,0.25979915775834145,0.7402008422416586,0.04794298671849692
17369,24.0,3400,80605,84005,343,3235,114017,32131,81886,114017,8699,0.02982011454432234,0.7069559802485594,0.0030083233202066358,0.2818088530657709,0.7181911469342291,0.028372961926730226
17370,15.0,194,10023,10217,42,794,13954,3940,10014,13954,1146,0.013902823563136019,0.7182886627490326,0.0030098896373799626,0.2823563136018346,0.7176436863981654,0.056901246954278346
17371,27.0,1145,19814,20959,48,1182,28147,7864,20283,28147,2264,0.04067929086581163,0.7039471346857569,0.001705332717518741,0.2793903435534871,0.720609656446513,0.041993818168898994
17372,26.0,81,2321,2402,10,125,3114,925,2189,3114,153,0.02601156069364162,0.7453436095054592,0.0032113037893384713,0.2970456005138086,0.7029543994861914,0.040141297366730895
17373,15.0,922,3609,4531,31,476,6549,1716,4833,6549,293,0.14078485264925944,0.5510765002290426,0.004733547106428463,0.2620247366010078,0.7379752633989922,0.07268285234386929
17374,36.0,115,3271,3386,5,83,4235,1279,2956,4235,252,0.02715466351829988,0.7723730814639905,0.0011806375442739079,0.30200708382526564,0.6979929161747344,0.01959858323494687
17375,16.0,3546,63943,67489,403,6878,93971,25669,68302,93971,7107,0.03773504591842164,0.6804546083366145,0.004288557108043971,0.2731587404624831,0.7268412595375169,0.07319279352140554
17376,17.0,2712,84031,86743,533,7025,119364,32778,86586,119364,9562,0.022720418216547703,0.7039894775644248,0.004465332931202037,0.2746054086659294,0.7253945913340706,0.058853590697362686
17377,16.0,103,3475,3578,12,117,4680,1374,3306,4680,421,0.02200854700854701,0.7425213675213675,0.002564102564102564,0.2935897435897436,0.7064102564102565,0.025
17378,41.0,704,20355,21059,38,986,27524,7995,19529,27524,2071,0.02557767766313036,0.7395364045923558,0.0013806132829530591,0.2904737683476239,0.7095262316523762,0.035823281499782006
17379,13.0,248,3322,3570,20,271,4919,1377,3542,4919,352,0.05041675137223013,0.6753405163651148,0.004065867046147591,0.27993494612726166,0.7200650538727383,0.05509249847529986
17380,,64,1750,1814,7,85,2450,684,1766,2450,168,0.026122448979591838,0.7142857142857143,0.002857142857142857,0.27918367346938777,0.7208163265306122,0.03469387755102041
17381,27.0,131,2487,2618,1,58,3411,1018,2393,3411,212,0.03840515977719144,0.7291116974494283,0.0002931691586045148,0.2984462034593961,0.7015537965406039,0.017003811199061858
17382,17.0,928,23213,24141,138,1041,31009,9099,21910,31009,2063,0.02992679544648328,0.7485891192879487,0.004450320874584798,0.29343093940468895,0.706569060595311,0.03357089877132446
17383,13.0,305,6184,6489,47,581,9088,2406,6682,9088,669,0.03356073943661972,0.6804577464788732,0.005171654929577465,0.26474471830985913,0.7352552816901409,0.06393045774647887
17384,,437,8017,8454,184,506,12158,3225,8933,12158,650,0.03594341174535286,0.6594012173054778,0.015134068103306465,0.26525744365849646,0.7347425563415035,0.04161868728409278
17385,,3102,39435,42537,340,3441,60424,16460,43964,60424,3956,0.0513372169998676,0.6526380246259764,0.005626903217264663,0.2724083145769893,0.7275916854230107,0.05694757050178737
17386,37.0,430,10816,11246,46,564,14795,4234,10561,14795,1095,0.029063872930043935,0.7310577897938493,0.003109158499493072,0.2861777627576884,0.7138222372423116,0.038120986819871576
17387,26.0,10762,257333,268095,1101,12957,351991,100946,251045,351991,23049,0.030574645374455596,0.7310783514351219,0.0031279208843407926,0.28678574168089527,0.7132142583191048,0.036810600271029656
17388,,556,16767,17323,56,633,22445,6692,15753,22445,1663,0.024771664067721095,0.7470260637112943,0.002494987747828024,0.2981510358654489,0.7018489641345511,0.02820227222098463
17389,34.0,74,2163,2237,19,77,2980,866,2116,2982,175,0.02481556002682763,0.7253521126760564,0.006371562709590879,0.2904091213950369,0.7095908786049631,0.025821596244131457
17390,,511,15621,16132,54,839,21227,6176,15051,21227,1736,0.024073114429735715,0.7359023884675178,0.0025439299005982946,0.2909502049276864,0.7090497950723136,0.03952513308522165
17391,24.0,2446,59132,61578,382,4052,81644,22703,58941,81644,4988,0.029959335652344325,0.7242663269805497,0.004678849639900054,0.2780730978394003,0.7219269021605996,0.04963010141590319
17392,,370,9881,10251,13,580,13489,3888,9601,13489,1053,0.027429757580250576,0.7325227963525835,0.0009637482393061013,0.2882348580324709,0.711765141967529,0.04299799836904144
17393,27.0,788,26259,27047,68,1132,34979,11330,23649,34979,1825,0.022527802395723148,0.7507075673975814,0.0019440235569913376,0.3239086308928214,0.6760913691071786,0.03236227450756168
17394,34.0,1041,17285,18326,65,1618,25200,6848,18352,25200,1707,0.04130952380952381,0.6859126984126984,0.0025793650793650793,0.27174603174603174,0.7282539682539683,0.06420634920634921
17395,,412,6952,7364,18,322,9534,2757,6777,9534,644,0.04321376127543528,0.7291797776379274,0.0018879798615481435,0.28917558212712396,0.710824417872876,0.033773861967694566
17396,41.0,143,2612,2755,13,109,3903,984,2919,3903,229,0.03663848321803741,0.6692287983602357,0.003330771201639764,0.2521137586471945,0.7478862413528056,0.02792723545990264
17397,24.0,382,11719,12101,56,465,16018,4463,11555,16018,1344,0.023848170807841178,0.7316144337620177,0.0034960669247097015,0.27862404794606066,0.7213759520539393,0.029029841428393058
17398,25.0,345,7520,7865,22,418,10391,3028,7363,10391,755,0.03320180925801174,0.7237032046963718,0.002117216822250024,0.2914060244442306,0.7085939755557694,0.040227119622750454
17399,27.0,93,2285,2378,2,128,3257,909,2348,3257,222,0.02855388394227817,0.7015658581516733,0.0006140620202640467,0.2790911882100092,0.7209088117899908,0.03929996929689899
17400,,488,10499,10987,7,632,14644,4158,10486,14644,1157,0.03332422835290904,0.7169489210598197,0.0004780114722753346,0.28393881453154873,0.7160611854684512,0.0431576072111445
17401,14.0,3965,45420,49385,233,5211,70780,18965,51815,70780,4828,0.056018649335970616,0.6417066968070076,0.0032918903645097483,0.26794292172930206,0.732057078270698,0.07362249222944335
17402,,27662,421934,449596,1728,16663,581839,172589,409250,581839,37248,0.047542361374882054,0.7251731148994826,0.0029698937334898486,0.2966267300748145,0.7033732699251855,0.02863850652843828
17403,,18,2744,2762,0,109,3736,1015,2721,3736,355,0.004817987152034261,0.734475374732334,0.0,0.2716809421841542,0.7283190578158458,0.02917558886509636
17404,27.0,78,3257,3335,19,233,4499,1241,3258,4499,315,0.01733718604134252,0.7239386530340075,0.004223160702378307,0.2758390753500778,0.7241609246499222,0.05178928650811292
17405,,28,4445,4473,7,172,5713,1737,3976,5713,525,0.004901102748118327,0.7780500612637844,0.0012252756870295817,0.3040434097671976,0.6959565902328024,0.030106774024155434
17406,,602,2581,3183,13,725,4825,1023,3802,4825,149,0.12476683937823835,0.5349222797927461,0.002694300518134715,0.21202072538860103,0.7879792746113989,0.15025906735751296
17407,24.0,452,13023,13475,104,680,17672,5228,12444,17672,1274,0.02557718424626528,0.7369284744228157,0.005885015844273427,0.29583521955636033,0.7041647804436396,0.03847894975101856
17408,,281,10574,10855,20,848,14831,4146,10685,14831,1188,0.018946800620322297,0.7129660845526262,0.0013485267345425124,0.2795495920706628,0.7204504079293372,0.05717753354460252
17409,23.0,187,2091,2278,37,175,3252,811,2441,3252,177,0.057503075030750306,0.6429889298892989,0.011377613776137762,0.2493849938499385,0.7506150061500615,0.053813038130381304
17410,17.0,292,13171,13463,41,581,17654,5299,12355,17654,1461,0.016540160870057777,0.7460632151353801,0.002322419848193044,0.3001586042823156,0.6998413957176843,0.032910388580491674
17411,27.0,458,13229,13687,27,828,18212,5197,13015,18212,1215,0.02514825389852844,0.7263891939380628,0.0014825389852844279,0.28536130024159895,0.7146386997584011,0.04546452888205579
17412,40.0,136,5217,5353,31,168,7089,2050,5039,7089,660,0.019184652278177457,0.735928903935675,0.004372972210466921,0.2891804203695867,0.7108195796304133,0.02369868810833686
17413,,192,1564,1756,6,98,2940,685,2255,2940,165,0.0653061224489796,0.5319727891156463,0.0020408163265306124,0.23299319727891157,0.7670068027210885,0.03333333333333333
17414,25.0,357,6954,7311,38,232,9794,2820,6974,9794,823,0.036450888298958546,0.7100265468654278,0.003879926485603431,0.28793138656320194,0.7120686134367981,0.02368797222789463
17415,15.0,619,8226,8845,57,586,12007,3379,8628,12007,772,0.051553260597984506,0.6851003581244274,0.004747230782043808,0.2814191721495794,0.7185808278504205,0.04880486382943283
17416,,1491,216486,217977,529,9088,284928,83101,201827,284928,25783,0.005232900943396226,0.7597919474393531,0.0018566093890386344,0.2916561376909254,0.7083438623090745,0.03189577717879605
17417,,163,4853,5016,17,707,7101,1894,5207,7101,426,0.022954513448810027,0.6834248697366568,0.0023940290099985916,0.26672299676101957,0.7332770032389804,0.09956344176876496
17418,24.0,2252,45537,47789,362,2953,66813,18256,48557,66813,4520,0.03370601529642435,0.6815589780431952,0.005418107254576205,0.27324023767829614,0.7267597623217038,0.044197985421998716
17419,37.0,663,16611,17274,59,881,22944,6595,16349,22944,1891,0.028896443514644352,0.7239801255230126,0.0025714783821478384,0.2874389818688982,0.7125610181311018,0.03839783821478382
17420,,248,5464,5712,7,262,7659,2203,5456,7659,569,0.03238020629324977,0.7134090612351482,0.0009139574356965661,0.287635461548505,0.7123645384514949,0.034208121164642905
17421,,279,5247,5526,40,325,7480,2060,5420,7480,559,0.03729946524064171,0.7014705882352941,0.0053475935828877,0.27540106951871657,0.7245989304812834,0.04344919786096257
17422,24.0,78,1727,1805,6,93,2404,706,1698,2404,165,0.0324459234608985,0.7183860232945092,0.0024958402662229617,0.29367720465890185,0.7063227953410982,0.03868552412645591
17423,24.0,71,1625,1696,13,48,2239,635,1604,2239,175,0.03171058508262617,0.7257704332291202,0.005806163465832961,0.2836087539079946,0.7163912460920053,0.021438142027690933
17424,,3734,66150,69884,597,5047,95177,26290,68887,95177,6032,0.03923216743540982,0.6950208558790464,0.006272523824033117,0.2762221965390798,0.7237778034609201,0.05302751715225317
17425,17.0,305,19274,19579,94,1047,27359,7003,20356,27359,1700,0.011148068277349318,0.7044848130414123,0.0034357980920355275,0.2559669578566468,0.7440330421433532,0.03826894257831061
17426,24.0,285,5366,5651,19,290,7881,2162,5719,7881,545,0.03616292348686715,0.6808780611597512,0.0024108615657911434,0.2743306686968659,0.7256693313031342,0.03679736074102271
17427,13.0,160,4394,4554,58,229,6239,1725,4514,6239,497,0.025645135438371533,0.7042795319762782,0.009296361596409682,0.2764866164449431,0.7235133835550569,0.03670460009616926
17428,,4646,123434,128080,596,7421,184144,49074,135070,184144,12614,0.025230254583369537,0.6703123642366844,0.0032365974454774526,0.26649795811973237,0.7335020418802676,0.040299982622295595
17429,37.0,68,1994,2062,12,73,2721,773,1948,2721,223,0.024990812201396546,0.7328188166115399,0.004410143329658214,0.28408673281881663,0.7159132671811834,0.02682837192208747
17430,,139,1618,1757,12,127,2447,663,1784,2447,160,0.056804250102165915,0.6612178177360033,0.004903964037597058,0.2709440130772374,0.7290559869227625,0.05190028606456886
17431,,57,2719,2776,26,156,3656,1050,2606,3656,248,0.015590809628008753,0.7437089715536105,0.007111597374179431,0.287199124726477,0.712800875273523,0.04266958424507659
17432,,4454,236070,240524,1436,22477,334679,89939,244740,334679,23553,0.013308274495860212,0.7053624517821554,0.004290678530771277,0.26873212839765864,0.7312678716023413,0.06715987558227436
17433,,1348,26562,27910,695,6021,42610,10666,31944,42610,2249,0.031635766252053506,0.6233747946491434,0.016310725181882188,0.2503168270359071,0.7496831729640929,0.1413048580145506
17434,,175,4196,4371,59,156,5591,1637,3954,5591,360,0.03130030406009658,0.7504918619209444,0.010552673940261133,0.2927919871221606,0.7072080128778394,0.027901985333571813
17435,48.0,155,4353,4508,20,454,6256,1531,4725,6256,435,0.02477621483375959,0.6958120204603581,0.00319693094629156,0.24472506393861893,0.7552749360613811,0.07257033248081841
17436,,454,55874,56328,211,5074,78101,21524,56577,78101,5364,0.005812985749222161,0.7154069730221124,0.0027016299407177885,0.2755918618199511,0.7244081381800489,0.06496715791091023
17437,17.0,1782,49336,51118,121,1943,67256,19517,47739,67256,5353,0.026495777328416795,0.7335553705245629,0.0017990959914357084,0.29018972285000594,0.709810277149994,0.028889615796360176
17438,26.0,371,8044,8415,81,647,11604,3193,8411,11604,750,0.031971733884867286,0.6932092381937263,0.006980351602895553,0.27516373664253707,0.724836263357463,0.05575663564288177
17439,,86,2544,2630,7,122,3431,990,2441,3431,228,0.025065578548528127,0.7414747886913436,0.0020402215097639173,0.288545613523754,0.711454386476246,0.03555814631302827
17440,15.0,412,15448,15860,31,552,20688,6000,14688,20688,1792,0.01991492652745553,0.7467130703789636,0.0014984532095901006,0.2900232018561485,0.7099767981438515,0.02668213457076566
17441,25.0,173,4053,4226,5,191,5683,1632,4051,5683,456,0.03044166813302833,0.7131796586310047,0.0008798169980644026,0.287172268168221,0.7128277318317789,0.03360900932606018
17442,15.0,17,2181,2198,11,181,3002,857,2145,3002,198,0.005662891405729514,0.7265156562291806,0.0036642238507661557,0.2854763491005996,0.7145236508994004,0.06029313790806129
17443,17.0,1021,23580,24601,219,2391,34177,9267,24910,34177,2248,0.02987389179857799,0.6899376773853761,0.006407818123299295,0.2711472627790619,0.728852737220938,0.06995932937355531
17444,14.0,339,6844,7183,0,164,9707,2820,6887,9707,700,0.034923251261975895,0.70505820541877,0.0,0.29051200164829505,0.709487998351705,0.016895024209333472
17445,15.0,535,6266,6801,26,546,9884,2544,7340,9884,606,0.05412788344799676,0.6339538648320518,0.002630513961958721,0.2573856738162687,0.7426143261837312,0.05524079320113314
17446,24.0,2323,47391,49714,329,2192,66725,19003,47722,66725,4549,0.034814537279880105,0.7102435369052079,0.0049306856500562005,0.2847958036717872,0.7152041963282129,0.032851255151742226
17447,27.0,366,13041,13407,4,399,17003,5188,11815,17003,1340,0.02152561312709522,0.7669822972416632,0.00023525260248191495,0.3051226254190437,0.6948773745809563,0.023466447097571015
17448,,1184,36622,37806,143,2099,49655,14686,34969,49655,2709,0.0238445272379418,0.7375289497532977,0.0028798711106635786,0.2957607491692679,0.704239250830732,0.042271674554425535
17449,25.0,756,36295,37051,163,3028,50529,14013,36516,50529,3987,0.014961705159413407,0.7183003819588751,0.003225870292307388,0.2773258920619842,0.7226741079380158,0.05992598309881454
17450,23.0,214,6936,7150,21,174,9066,2728,6352,9080,666,0.02356828193832599,0.7638766519823789,0.002312775330396476,0.3004405286343612,0.6995594713656388,0.019162995594713655
17451,25.0,909,20673,21582,62,1242,28786,8610,20176,28786,1068,0.031577850343917184,0.7181616063364136,0.002153824775932745,0.29910373098033766,0.7008962690196623,0.043145973737233376
17452,25.0,121,3940,4061,7,194,5274,1553,3721,5274,360,0.022942737959802808,0.7470610542282897,0.0013272658323852863,0.2944634053849071,0.7055365946150929,0.03678422449753508
17453,16.0,791,15837,16628,50,904,22450,6287,16163,22450,1719,0.03523385300668151,0.7054342984409799,0.0022271714922048997,0.2800445434298441,0.7199554565701559,0.04026726057906459
17454,25.0,176,4207,4383,42,327,5772,1526,4246,5772,369,0.030492030492030493,0.7288634788634789,0.007276507276507277,0.2643797643797644,0.7356202356202356,0.056652806652806656
17455,15.0,131,6855,6986,36,274,9842,2659,7183,9842,814,0.013310302783986995,0.6965047754521438,0.003657793131477342,0.270168664905507,0.7298313350944929,0.027839869945133103
17456,24.0,496,64478,64974,433,5562,90015,24791,65246,90037,7389,0.005508846363161811,0.7161278141208615,0.004809134022679565,0.2753423592523074,0.7246576407476926,0.06177460377400402
17457,,278,5381,5659,110,345,8169,2114,6055,8169,551,0.034031093157057164,0.6587097563961317,0.013465540457828376,0.258783204798629,0.7412167952013711,0.04223283143591627
17458,15.0,126,2660,2786,0,238,3821,1081,2740,3821,291,0.0329756608217744,0.696152839570793,0.0,0.2829102329233185,0.7170897670766815,0.06228735933001832
17459,26.0,155,4850,5005,14,214,6598,1931,4667,6598,496,0.02349196726280691,0.735071233707184,0.002121855107608366,0.29266444377083967,0.7073355562291603,0.03243407093058503
17460,23.0,226,3029,3255,41,234,4608,1208,3400,4608,238,0.04904513888888889,0.6573350694444444,0.008897569444444444,0.2621527777777778,0.7378472222222222,0.05078125
17461,38.0,119,4671,4790,12,177,6228,1824,4404,6228,517,0.019107257546563904,0.75,0.0019267822736030828,0.2928709055876686,0.7071290944123314,0.02842003853564547
17462,16.0,926,17236,18162,57,1126,24933,7013,17920,24933,1870,0.03713953395098865,0.6912926643404324,0.002286126819877271,0.2812738138210404,0.7187261861789596,0.04516103156459311
17463,13.0,17,1815,1832,0,211,2660,725,1935,2660,190,0.006390977443609023,0.6823308270676691,0.0,0.2725563909774436,0.7274436090225563,0.0793233082706767
17464,27.0,246,8405,8651,53,311,11088,3268,7820,11088,805,0.022186147186147188,0.7580266955266955,0.00477994227994228,0.29473304473304474,0.7052669552669553,0.028048340548340548
17465,13.0,227,12964,13191,62,573,17509,5001,12508,17509,1303,0.012964760980067394,0.7404192129761836,0.0035410360386087156,0.28562453595293846,0.7143754640470615,0.032726026614883774
17466,17.0,352,13586,13938,23,586,18351,5283,13068,18351,1460,0.01918151599367882,0.7403411258242057,0.0012533376927687865,0.28788621873467385,0.7121137812653261,0.03193286469402212
17467,,4,1543,1547,0,264,2299,591,1708,2299,110,0.0017398869073510222,0.6711613745106568,0.0,0.2570682905611135,0.7429317094388864,0.11483253588516747
17468,,2,2830,2832,5,186,3714,1050,2664,3714,243,0.0005385029617662897,0.7619816908992999,0.0013462574044157242,0.2827140549273021,0.7172859450726979,0.050080775444264945
17469,27.0,3057,76421,79478,467,2642,99949,30503,69446,99949,5910,0.03058559865531421,0.764599945972446,0.004672382915286796,0.30518564467878617,0.6948143553212138,0.026433481075348427
17470,,144,4659,4803,121,391,7247,1829,5418,7247,440,0.019870291154960674,0.6428867117427901,0.01669656409548779,0.25238029529460465,0.7476197047053953,0.05395336001103905
17471,,13,2269,2282,14,103,3054,869,2185,3054,269,0.004256712508185986,0.7429600523903078,0.0045841519318926,0.28454485920104783,0.7154551407989522,0.03372626064178127
17472,33.0,419,11255,11674,11,409,15574,4473,11101,15574,1234,0.02690381404905612,0.7226788236804931,0.0007063053807628098,0.2872094516501862,0.7127905483498138,0.026261718248362657
17473,13.0,2,2077,2079,9,247,2862,750,2112,2862,163,0.0006988120195667365,0.7257162823200559,0.0031446540880503146,0.2620545073375262,0.7379454926624738,0.08630328441649196
17474,23.0,29,2084,2113,10,47,2832,831,2001,2832,247,0.010240112994350282,0.7358757062146892,0.0035310734463276836,0.2934322033898305,0.7065677966101694,0.016596045197740113
17475,17.0,1505,1882,3387,48,357,4809,1225,3584,4809,33,0.3129548762736536,0.39134955292160534,0.009981285090455396,0.2547307132459971,0.745269286754003,0.07423580786026202
17476,33.0,8030,184252,192282,549,10210,250869,72950,177919,250869,17514,0.03200873762800505,0.7344550343007705,0.0021883931454264975,0.29078921668281055,0.7092107833171895,0.04069853190310481
17477,,354,8401,8755,25,538,11483,3287,8196,11483,771,0.030828180788992424,0.7316032395715405,0.0021771314116520073,0.2862492380040059,0.7137507619959941,0.0468518679787512
17478,16.0,257,5993,6250,13,68,8088,2347,5741,8088,717,0.03177546983184965,0.7409742828882295,0.0016073194856577645,0.29018298714144414,0.7098170128585559,0.008407517309594461
17479,,9195,159519,168714,475,9451,226354,64314,162040,226354,17642,0.04062221122666266,0.704732410295378,0.0020984829073044877,0.2841301677902754,0.7158698322097246,0.04175318306723098
17480,14.0,551,4602,5153,32,295,6912,1994,4918,6912,415,0.07971643518518519,0.6657986111111112,0.004629629629629629,0.2884837962962963,0.7115162037037037,0.04267939814814815
17481,25.0,111,3540,3651,5,172,4743,1398,3345,4743,324,0.02340290955091714,0.7463630613535737,0.0010541851149061775,0.2947501581277672,0.7052498418722327,0.03626396795277251
17482,24.0,125,2726,2851,18,155,3782,1073,2709,3782,269,0.03305129561078794,0.7207826546800634,0.004759386567953464,0.2837123215230037,0.7162876784769963,0.040983606557377046
17483,33.0,4736,79873,84609,475,5821,116054,32183,83871,116054,8593,0.04080858910507178,0.688239957261275,0.0040929222603270895,0.2773105623244352,0.7226894376755648,0.05015768521550313
17484,17.0,297,8247,8544,54,405,11370,3272,8098,11370,912,0.02612137203166227,0.7253298153034301,0.00474934036939314,0.28777484608619175,0.7122251539138083,0.03562005277044855
17485,,296,8125,8421,82,445,11250,3089,8161,11250,805,0.02631111111111111,0.7222222222222222,0.007288888888888889,0.27457777777777775,0.7254222222222222,0.03955555555555555
17486,17.0,337,24919,25256,205,2531,34990,9380,25610,34990,2318,0.00963132323521006,0.7121749071163189,0.005858816804801372,0.268076593312375,0.731923406687625,0.07233495284366961
17487,17.0,1365,22614,23979,100,1100,31874,9241,22633,31874,2354,0.042824872937190187,0.7094810817594277,0.003137353328731882,0.2899228211081132,0.7100771788918868,0.0345108866160507
17488,23.0,6,2243,2249,6,165,3083,863,2220,3083,282,0.0019461563412260785,0.727538112228349,0.0019461563412260785,0.27992215374635093,0.720077846253649,0.05351929938371716
17489,14.0,815,19082,19897,29,1738,27008,7538,19470,27008,1691,0.030176244075829382,0.7065313981042654,0.0010737559241706161,0.2791024881516588,0.7208975118483413,0.06435130331753554
17490,,174,4692,4866,34,327,6796,1798,4998,6796,468,0.025603296056503827,0.6904061212477928,0.005002942907592701,0.26456739258387285,0.7354326074161271,0.04811653914067098
17491,,177,7203,7380,26,335,9796,2753,7043,9796,808,0.0180685994283381,0.7353001224989791,0.002654144548795427,0.2810330747243773,0.7189669252756227,0.034197631686402614
17492,24.0,1323,22333,23656,114,1267,31490,8993,22497,31490,2226,0.04201333756748174,0.7092092727850111,0.0036201968879009208,0.28558272467449985,0.7144172753255001,0.04023499523658304
17493,24.0,651,18989,19640,40,976,26057,7368,18689,26057,1978,0.024983689603561423,0.7287485128756188,0.0015350961353954792,0.2827647081398473,0.7172352918601528,0.03745634570364969
17494,,87,1966,2053,15,87,2821,793,2028,2821,217,0.030840127614321162,0.6969159872385678,0.005317263381779511,0.28110599078341014,0.7188940092165899,0.030840127614321162
17495,16.0,309,4072,4381,43,219,5934,1691,4243,5934,360,0.052072800808897875,0.6862150320188742,0.007246376811594203,0.2849679811257162,0.7150320188742838,0.036905965621840245
17496,34.0,244,5654,5898,35,404,7952,2075,5877,7952,449,0.0306841046277666,0.7110160965794768,0.0044014084507042256,0.26094064386317906,0.7390593561368209,0.05080482897384306
17497,27.0,216,7087,7303,29,389,9831,2864,6967,9831,813,0.02197131522734208,0.7208829213711728,0.0029498525073746312,0.29132336486623944,0.7086766351337606,0.03956871121961143
17498,33.0,443,9436,9879,37,462,12958,3715,9243,12958,954,0.03418737459484488,0.7281987961105109,0.0028553789164994597,0.2866954776971755,0.7133045223028245,0.035653650254668934
17499,14.0,613,9084,9697,190,685,13576,3651,9925,13576,783,0.04515321154979375,0.6691219799646435,0.013995285798467885,0.2689304655274013,0.7310695344725987,0.050456688273423686
17500,23.0,212,4108,4320,3,192,5708,1633,4075,5708,406,0.03714085494043448,0.7196916608269096,0.0005255781359495446,0.2860896986685354,0.7139103013314646,0.03363700070077085
17501,14.0,144,2643,2787,17,211,3863,1026,2837,3863,246,0.037276727931659336,0.684183277245664,0.004400724825265338,0.2655966865130727,0.7344033134869272,0.054620761066528606
17502,26.0,180,3018,3198,30,152,4292,1221,3071,4292,361,0.04193849021435228,0.7031686859273066,0.006989748369058714,0.28448275862068967,0.7155172413793104,0.035414725069897485
17503,,450,7718,8168,28,651,11566,3173,8393,11566,856,0.0389071416219955,0.6673007089745807,0.0024208888120352758,0.27433857859242605,0.725661421407574,0.05628566487982016
17504,16.0,153,5619,5772,27,403,7765,2063,5702,7765,448,0.019703799098518996,0.7236316806181584,0.0034771410173857053,0.26567933032839663,0.7343206696716034,0.051899549259497746
17505,17.0,1660,30856,32516,235,1690,44452,12351,32101,44452,3312,0.03734365157923153,0.6941419958607037,0.005286601277782777,0.2778502654548727,0.7221497345451273,0.03801853684873571
17506,15.0,1398,45985,47383,59,2621,64067,18362,45705,64067,5560,0.021820906238781277,0.7177642155868076,0.0009209109213791812,0.28660620912482243,0.7133937908751775,0.040910297032793794
17507,,88,5226,5314,22,312,7093,2050,5043,7093,626,0.01240659805441985,0.7367827435499789,0.0031016495136049625,0.28901734104046245,0.7109826589595376,0.04398702946567038
17508,17.0,236,6158,6394,16,353,8410,2432,5978,8410,592,0.02806183115338882,0.7322235434007134,0.0019024970273483948,0.289179548156956,0.710820451843044,0.04197384066587396
17509,36.0,4137,57468,61605,370,3193,82244,23375,58869,82244,5108,0.05030154175380575,0.6987500607947085,0.0044988084237148,0.2842152619036039,0.7157847380963961,0.038823500802490155
17510,27.0,733,15843,16576,92,934,22347,6251,16096,22347,1633,0.032800823376739605,0.7089542220432273,0.00411688369803553,0.27972434778717503,0.720275652212825,0.04179531928223028
17511,24.0,81,1775,1856,2,85,2454,703,1751,2454,173,0.03300733496332518,0.7233088834555828,0.0008149959250203749,0.2864710676446618,0.7135289323553382,0.03463732681336593
17512,16.0,602,29380,29982,211,4424,44334,11316,33018,44334,3297,0.013578743176794333,0.6626968015518564,0.0047593269274146255,0.2552442820408716,0.7447557179591284,0.09978797311318627
17513,,91,2202,2293,9,234,3234,791,2443,3234,197,0.02813852813852814,0.6808905380333952,0.0027829313543599257,0.24458874458874458,0.7554112554112554,0.07235621521335807
17514,34.0,336,8113,8449,40,543,11305,3207,8098,11305,742,0.029721362229102165,0.7176470588235294,0.0035382574082264487,0.2836797877045555,0.7163202122954445,0.04803184431667404
17515,,4,1533,1537,24,100,2192,569,1623,2192,142,0.0018248175182481751,0.6993613138686131,0.010948905109489052,0.2595802919708029,0.7404197080291971,0.04562043795620438
17516,15.0,1735,53643,55378,246,3961,74593,21086,53507,74593,5669,0.023259555186143473,0.7191425468877777,0.0032978965854704866,0.28268068049280765,0.7173193195071924,0.05310149745954714
17517,23.0,2342,58106,60448,154,4649,80195,22013,58182,80195,5129,0.02920381569923312,0.7245588877112039,0.001920319221896627,0.27449342228318474,0.7255065777168153,0.05797119521167155
17518,,433,12098,12531,47,1065,17024,4645,12379,17024,1105,0.02543468045112782,0.7106437969924813,0.0027608082706766916,0.2728500939849624,0.7271499060150376,0.06255874060150377
17519,43.0,92,3484,3576,19,180,4749,1330,3419,4749,330,0.019372499473573383,0.733628132238366,0.004000842282585807,0.28005895978100653,0.7199410402189935,0.03790271636133923
17520,17.0,3750,44125,47875,306,3403,65236,17939,47297,65236,4542,0.05748359801336685,0.67639033662395,0.004690661597890735,0.27498620393647677,0.7250137960635232,0.05216444907719664
17521,,129,3910,4039,4,118,5208,1545,3663,5208,437,0.02476958525345622,0.750768049155146,0.0007680491551459293,0.2966589861751152,0.7033410138248848,0.022657450076804916
17522,16.0,497,3915,4412,59,566,6274,1769,4505,6274,481,0.07921581128466688,0.6240038253108064,0.00940388906598661,0.2819572840293274,0.7180427159706726,0.09021357985336309
17523,23.0,229,10129,10358,37,321,13613,3940,9673,13613,1140,0.016822155292734887,0.744068170131492,0.002717990156468082,0.2894292220671417,0.7105707779328583,0.023580401087196064
17524,14.0,40,8663,8703,112,1132,12321,3282,9039,12321,756,0.0032464897329762196,0.7031085139193247,0.009090171252333414,0.2663744825906988,0.7336255174093012,0.09187565944322701
17525,36.0,283,7339,7622,26,230,10110,2991,7119,10110,850,0.027992087042532147,0.7259149357072205,0.0025717111770524235,0.2958456973293769,0.7041543026706232,0.02274975272007913
17526,,657,13545,14202,34,795,19119,5226,13893,19119,1391,0.034363721951984935,0.7084575553114703,0.001778335687012919,0.27334065589204454,0.7266593441079554,0.04158167268162561
17527,17.0,62,1978,2040,11,233,2828,758,2070,2828,207,0.021923620933521924,0.6994342291371994,0.0038896746817538895,0.268033946251768,0.731966053748232,0.08239038189533239
17528,15.0,372,3923,4295,29,222,6268,1638,4630,6268,438,0.059349074664964904,0.625877472878111,0.004626675175494576,0.26132737715379706,0.7386726228462029,0.03541799617102744
17529,,1239,16306,17545,125,907,23544,6641,16903,23544,1645,0.05262487257900102,0.6925756031260618,0.005309208290859667,0.28206761807679237,0.7179323819232076,0.038523615358477745
17530,,705,15395,16100,92,746,21235,5983,15252,21235,1809,0.033199905815870026,0.7249823404756298,0.004332469978808571,0.28175182481751826,0.7182481751824817,0.035130680480339065
17531,24.0,4961,89428,94389,1521,4787,126676,35707,90969,126676,7740,0.03916290378603682,0.7059585083204395,0.012007010009788752,0.28187659856642144,0.7181234014335786,0.03778932078688939
17532,,243,5890,6133,23,317,8031,2356,5675,8031,596,0.030257751214045572,0.7334080438301581,0.002863902378284149,0.29336321753206324,0.7066367824679367,0.03947204582243805
17533,26.0,1267,40933,42200,141,1620,55398,16035,39363,55398,4156,0.022870861763962597,0.7388894905953284,0.002545218238925593,0.2894508827033467,0.7105491172966533,0.029242932957868516
17534,14.0,98,2330,2428,15,163,3434,905,2529,3434,247,0.028538147932440302,0.6785090273733255,0.004368083867210251,0.26354105998835176,0.7364589400116482,0.04746651135701806
17535,,218,1395,1613,0,505,2905,588,2317,2905,101,0.07504302925989673,0.4802065404475043,0.0,0.20240963855421687,0.7975903614457831,0.1738382099827883
17536,26.0,2079,42940,45019,223,1960,57562,17010,40552,57562,4046,0.0361175775685348,0.7459782495396269,0.0038740835968173446,0.2955074528334665,0.7044925471665334,0.034050241478753344
17537,16.0,716,11702,12418,47,583,16558,4602,11956,16558,1242,0.04324193743205701,0.7067278656842614,0.0028385070660707813,0.27793211740548374,0.7220678825945163,0.035209566372750335
17538,15.0,617,11854,12471,36,948,17147,4580,12567,17147,1261,0.035982970782061,0.6913162652359013,0.002099492622616201,0.2671021169883945,0.7328978830116055,0.055286639062226625
17539,14.0,93,8888,8981,38,589,12208,3363,8845,12208,929,0.007617955439056356,0.7280471821756226,0.003112712975098296,0.2754750982961992,0.7245249017038008,0.04824705111402359
17540,,1027,57129,58156,108,2801,77465,21990,55475,77465,6759,0.013257600206544892,0.7374814432324276,0.0013941780158781385,0.2838701348996321,0.7161298651003679,0.036158265022913576
17541,,163,2671,2834,13,166,3786,1068,2718,3786,255,0.04305335446381405,0.7054939249867934,0.003433703116745906,0.2820919175911252,0.7179080824088748,0.04384574749075541
17542,14.0,75642,899412,975054,53050,68498,1364051,371606,992445,1364051,80043,0.05545393830582581,0.6593683080764575,0.038891507722218596,0.27242823032276653,0.7275717696772335,0.05021659747326163
17543,33.0,633,14734,15367,52,667,20456,5938,14518,20456,1344,0.030944466171294486,0.7202776691435275,0.0025420414548298787,0.290281579976535,0.709718420023465,0.032606570199452484
17544,,67,1978,2045,0,60,2634,749,1885,2634,185,0.025436598329536826,0.7509491268033409,0.0,0.2843583902809415,0.7156416097190584,0.022779043280182234
17545,27.0,1848,42946,44794,198,2469,59603,16979,42624,59603,3946,0.031005150747445597,0.7205342012985924,0.003321980437226314,0.28486821133164436,0.7151317886683556,0.04142408939147359
17546,,218,2182,2400,4,565,3619,927,2692,3619,256,0.060237634705719814,0.6029289859077093,0.0011052777010223818,0.256148107211937,0.743851892788063,0.15612047526941145
17547,14.0,1691,35558,37249,100,2566,50729,13590,37139,50729,3759,0.03333399041968105,0.700940290563583,0.0019712590431508604,0.26789410396420194,0.732105896035798,0.05058250704725108
17548,16.0,72,17023,17095,93,1714,23754,6480,17274,23754,1977,0.0030310684516291994,0.7166371979456092,0.003915130083354383,0.2727961606466279,0.7272038393533721,0.07215626841795066
17549,17.0,146,2431,2577,8,187,3522,1001,2521,3522,229,0.04145371947756956,0.6902328222600795,0.002271436683702442,0.28421351504826803,0.7157864849517319,0.05309483248154458
17550,14.0,169,2515,2684,20,173,3962,1020,2942,3962,234,0.04265522463402322,0.6347804139323574,0.005047955577990914,0.2574457344775366,0.7425542655224634,0.0436648157496214
17551,16.0,5718,79950,85668,1011,5491,118692,32748,85944,118692,6429,0.04817510868466283,0.6735921544838742,0.008517844505105652,0.2759073905570721,0.7240926094429279,0.04626259562565295
17552,,414,9323,9737,53,580,12857,3653,9204,12857,852,0.03220035778175313,0.7251302792253247,0.00412226802520028,0.28412537917087965,0.7158746208291203,0.045111612351248345
17553,,485,7260,7745,29,514,10618,3007,7611,10618,835,0.045677152006027504,0.6837445846675457,0.002731211150875871,0.2831983424373705,0.7168016575626295,0.048408363156903375
17554,39.0,325,4400,4725,21,219,6308,1791,4517,6308,457,0.051521876981610655,0.6975269499048827,0.0033291058972733036,0.2839251743817375,0.7160748256182625,0.034717818642993024
17555,,54,1439,1493,0,156,2079,562,1517,2079,146,0.025974025974025976,0.6921596921596922,0.0,0.2703222703222703,0.7296777296777297,0.07503607503607504
17556,13.0,26,2347,2373,21,194,3219,916,2303,3219,235,0.00807704255980118,0.7291084187635912,0.0065237651444548,0.28456042249145697,0.715439577508543,0.060267163715439574
17557,,433,6656,7089,201,234,9140,2643,6497,9140,578,0.04737417943107221,0.7282275711159737,0.021991247264770242,0.28916849015317286,0.7108315098468271,0.025601750547045953
17558,,4088,6516,10604,89,1190,14422,4064,10358,14422,181,0.2834558313687422,0.4518097351268895,0.006171127444182499,0.2817917071141312,0.7182082928858688,0.08251282762446263
17559,,6451,142432,148883,647,7229,196855,56184,140671,196855,12945,0.03277031317467171,0.7235376292194763,0.0032866830916156563,0.28540804145183,0.7145919585481699,0.03672246069441975
17560,,178,119296,119474,150,6303,158959,45609,113350,158959,14765,0.0011197856050931371,0.7504828289055668,0.0009436395548537673,0.2869230430488365,0.7130769569511635,0.0396517340949553
17561,,839,24362,25201,140,1717,34067,9634,24433,34067,2724,0.024627939061261633,0.7151202043032847,0.004109548830246279,0.2827956673613761,0.7172043326386239,0.050400681010949015
17562,39.0,129,3905,4034,19,231,5365,1544,3821,5365,448,0.024044734389561975,0.727865796831314,0.0035414725069897483,0.28779123951537744,0.7122087604846226,0.04305684995340168
17563,27.0,291,6394,6685,20,273,9092,2570,6522,9092,688,0.03200615926088869,0.7032556093268808,0.002199736031676199,0.28266608007039157,0.7173339199296085,0.030026396832380113
17564,45.0,251,8363,8614,6,278,11190,3386,7804,11190,956,0.022430741733690796,0.7473637176050044,0.0005361930294906167,0.30259159964253796,0.697408400357462,0.02484361036639857
17565,,1033,39979,41012,195,1932,54734,15622,39112,54734,4600,0.018873095333796178,0.7304235027587971,0.0035626849855665585,0.28541674279241425,0.7145832572075858,0.03529798662622867
17566,,794,15995,16789,77,987,23058,6215,16843,23058,1589,0.0344349032873623,0.693685488767456,0.003339404978749241,0.26953768757047447,0.7304623124295255,0.042805100182149364
17567,15.0,312,7343,7655,42,447,10187,2952,7235,10187,641,0.030627270050063805,0.7208206537744184,0.00412290173750859,0.2897810935506037,0.7102189064493963,0.043879454206341414
17568,24.0,432,8628,9060,39,488,12251,3467,8784,12251,904,0.03526242755693413,0.704269039262101,0.0031834135988898864,0.2829973063423394,0.7170026936576606,0.03983348298098115
17569,,477,10379,10856,0,300,14420,4273,10147,14420,1143,0.03307905686546463,0.7197642163661581,0.0,0.2963245492371706,0.7036754507628294,0.020804438280166437
17570,,292,3735,4027,36,196,5443,1558,3885,5443,405,0.05364688590850634,0.686202461877641,0.006613999632555576,0.28623920632004407,0.7137607936799559,0.036009553555024804
17571,16.0,267,6867,7134,4,265,9760,2752,7008,9760,730,0.02735655737704918,0.7035860655737705,0.0004098360655737705,0.2819672131147541,0.7180327868852459,0.027151639344262294
17572,13.0,90,2348,2438,20,187,3419,919,2500,3419,268,0.026323486399532026,0.6867505118455689,0.0058496636443404505,0.2687920444574437,0.7312079555425564,0.054694355074583215
17573,17.0,984,32937,33921,88,2311,46537,13079,33458,46537,3725,0.021144465693963943,0.7077594172378967,0.0018909684766959623,0.2810451898489374,0.7189548101510626,0.04965941079141328
17574,,29221,702025,731246,2190,37770,973627,277691,695940,973631,70909,0.030012396893689702,0.7210380524038368,0.0022493121110564473,0.28521174859880183,0.7147882514011982,0.038792930792055716
17575,16.0,129,1815,1944,7,229,2774,730,2044,2774,152,0.04650324441240086,0.6542898341744773,0.0025234318673395817,0.2631578947368421,0.7368421052631579,0.0825522710886806
17576,,351,9645,9996,25,459,13520,3814,9706,13520,1023,0.025961538461538463,0.713387573964497,0.0018491124260355029,0.28210059171597635,0.7178994082840237,0.03394970414201184
17577,14.0,362,5988,6350,68,385,8678,2429,6249,8678,624,0.041714680802028115,0.6900207421064761,0.007835906890988707,0.2799032035031113,0.7200967964968887,0.04436506107398018
17578,25.0,466,10442,10908,19,618,15828,4042,11786,15828,990,0.02944149608289108,0.659716957290877,0.0012004043467273187,0.25537022997220116,0.7446297700277988,0.03904473085670963
17579,,1915,45025,51372,251,2901,71419,18034,53395,71429,4371,0.026809839140965155,0.6303462179226924,0.0035139789161265033,0.25247448515308907,0.7475255148469109,0.04061375631746209
17580,24.0,153,4501,4654,10,136,6012,1783,4229,6012,452,0.025449101796407185,0.7486693280106453,0.00166333998669328,0.29657351962741185,0.7034264803725881,0.02262142381902861
17581,,1956,41466,43422,173,2276,57974,16441,41533,57974,4049,0.03373926242798496,0.7152516645392762,0.0029840963190395694,0.2835926449787836,0.7164073550212164,0.03925897816262462
17582,,76,1822,1898,8,62,2450,745,1705,2450,184,0.031020408163265307,0.7436734693877551,0.0032653061224489797,0.3040816326530612,0.6959183673469388,0.025306122448979593
17583,14.0,23,5202,5225,10,706,7121,1936,5185,7121,308,0.00322988344333661,0.7305153770537846,0.001404297149276787,0.27187192809998595,0.728128071900014,0.09914337873894116
17584,16.0,1975,74995,76970,263,4612,102864,29422,73442,102864,8355,0.019200108881630113,0.7290694509254938,0.0025567739928449213,0.28602815367864365,0.7139718463213564,0.044835899828900294
17585,,475,12910,13385,82,754,17780,5220,12560,17780,1244,0.02671541057367829,0.7260967379077615,0.004611923509561305,0.29358830146231724,0.7064116985376828,0.04240719910011249
17586,,120,11003,11123,21,536,14732,4153,10579,14732,1285,0.008145533532446375,0.7468775454792289,0.0014254683681781156,0.2819033396687483,0.7180966603312517,0.03638338311159381
17587,,57,1613,1670,2,71,2181,641,1540,2181,165,0.026134800550206328,0.739569005043558,0.0009170105456212746,0.29390187987161853,0.7060981201283815,0.03255387436955525
17588,27.0,97,2711,2808,7,122,3659,1054,2605,3659,259,0.026509975403115605,0.7409128177097568,0.0019130910084722602,0.2880568461328232,0.7119431538671768,0.033342443290516534
17589,24.0,530,10773,11303,57,427,15020,4260,10760,15020,1209,0.035286284953395475,0.7172436750998669,0.003794940079893475,0.2836218375499334,0.7163781624500666,0.028428761651131826
17590,16.0,166,6394,6560,123,1227,9462,1954,7508,9462,433,0.017543859649122806,0.6757556541957302,0.012999365884590995,0.20651025153244557,0.7934897484675544,0.12967660114140775
17591,26.0,278,31010,31288,208,2019,41934,11557,30377,41934,3312,0.006629465350312396,0.739495397529451,0.0049601755139027995,0.27559975199122433,0.7244002480087757,0.04814708828158535
17592,25.0,280,6242,6522,16,381,8784,2397,6387,8784,673,0.031876138433515486,0.7106102003642987,0.0018214936247723133,0.2728825136612022,0.7271174863387978,0.04337431693989071
17593,16.0,155,3495,3650,40,149,4924,1387,3537,4924,397,0.03147847278635256,0.7097887896019497,0.008123476848090982,0.2816815597075548,0.7183184402924452,0.030259951259138912
17594,23.0,2090,65428,67518,207,4765,90754,25573,65181,90754,6431,0.02302928796526875,0.7209379200916765,0.002280891200387862,0.28178372303149174,0.7182162769685083,0.05250457280119884
17595,23.0,1184,38648,39832,135,1491,51302,15260,36042,51302,3943,0.023079022260340726,0.7533429495926085,0.0026314763556976335,0.29745429028108067,0.7025457097189194,0.02906319441737164
17596,16.0,712,15118,15830,50,1491,21857,5908,15949,21857,1585,0.03257537630964908,0.691677723383813,0.002287596650958503,0.2703024202772567,0.7296975797227433,0.06821613213158256
17597,23.0,529,13076,13605,74,500,17918,5204,12714,17918,1189,0.029523384306284182,0.7297689474271682,0.004129925214867731,0.2904342002455631,0.7095657997544369,0.027904900100457642
17598,,1570,14135,15705,701,1752,23055,5827,17228,23055,1233,0.06809802645846888,0.6130991108219476,0.030405551941010626,0.25274343960095424,0.7472565603990458,0.07599219258295381
17599,,8157,157106,165267,995,9127,231251,63304,167947,231251,15432,0.03527336098006063,0.6793743594622293,0.004302684096501204,0.2737458432612183,0.7262541567387817,0.039467937435946225
17600,15.0,265,14042,14307,2,369,19264,5509,13763,19272,1518,0.013750518887505189,0.7286218347862183,0.00010377750103777501,0.2858551266085513,0.7141448733914487,0.01914694894146949
17601,15.0,93,4105,4198,18,312,5727,1546,4181,5727,534,0.016238868517548456,0.7167801641348001,0.003143006809848088,0.2699493626680636,0.7300506373319364,0.05447878470403353
17602,13.0,120,1902,2022,42,220,3064,757,2307,3064,192,0.0391644908616188,0.6207571801566579,0.01370757180156658,0.2470626631853786,0.7529373368146214,0.07180156657963446
17603,,169,3557,3726,13,76,5130,1401,3729,5130,458,0.032943469785575046,0.6933723196881092,0.00253411306042885,0.27309941520467834,0.7269005847953216,0.014814814814814815
17604,15.0,2705,69490,72195,468,4296,97911,27534,70377,97911,7746,0.027627130761610035,0.7097261798980707,0.004779851089254527,0.281214572417808,0.718785427582192,0.04387658179366976
17605,24.0,97,2071,2168,14,62,2929,827,2102,2929,240,0.03311710481392967,0.707067258449983,0.004779788323659952,0.28234892454762717,0.7176510754523728,0.02116763400477979
17606,23.0,7,4650,4657,32,186,6099,1787,4312,6099,516,0.001147729135923922,0.7624200688637481,0.0052467617642236435,0.2929988522708641,0.7070011477291359,0.030496802754549926
17607,,320,6510,6830,30,280,8865,2654,6211,8865,544,0.03609701071630006,0.7343485617597293,0.00338409475465313,0.2993795826283136,0.7006204173716865,0.03158488437676255
17608,23.0,12270,305493,317763,1242,12988,411057,121099,289986,411085,29045,0.029847841687242298,0.743138280404296,0.0030212729727428634,0.2945838451901675,0.7054161548098326,0.03159443910626756
17609,,200,6955,7155,25,179,9186,2749,6437,9186,744,0.021772262138036142,0.7571304158502068,0.0027215327672545178,0.2992597430873068,0.7007402569126933,0.019486174613542347
17610,42.0,195,6287,6482,2,323,8564,2554,6010,8564,565,0.0227697337692667,0.734119570294255,0.00023353573096683791,0.29822512844465204,0.701774871555348,0.03771602055114433
17611,,204,4025,4229,15,379,5854,1572,4282,5854,490,0.03484796720191322,0.6875640587632388,0.002562350529552443,0.268534335497096,0.731465664502904,0.06474205671335839
17612,25.0,87,2497,2584,8,92,3461,951,2510,3461,248,0.02513724357122219,0.7214677838774921,0.0023114706732158337,0.27477607627853223,0.7252239237214678,0.026581912741982086
17613,,183,1391,1574,46,184,2306,605,1701,2306,159,0.07935819601040764,0.6032090199479618,0.0199479618386817,0.2623590633130963,0.7376409366869038,0.0797918473547268
17614,25.0,1579,21700,23279,139,1198,31298,8780,22518,31298,2286,0.05045050801968177,0.6933350373825804,0.004441178350054317,0.28052910729120073,0.7194708927087993,0.038277206211259504
17615,23.0,1993,11503,13496,94,598,22816,4779,18037,22816,400,0.08735098176718092,0.5041637447405329,0.004119915848527349,0.20945827489481067,0.7905417251051894,0.02620967741935484
17616,16.0,71,2334,2405,28,231,3370,879,2491,3370,214,0.021068249258160237,0.6925816023738872,0.00830860534124629,0.26083086053412463,0.7391691394658754,0.0685459940652819
17617,,4549,73113,77662,1276,4192,105864,29294,76570,105864,6602,0.042970225950275824,0.6906313761051915,0.012053200332502078,0.2767135192322225,0.7232864807677776,0.03959797476006952
17618,46.0,195,4660,4855,26,199,6739,1836,4903,6739,436,0.028936043923430774,0.6914972547855764,0.0038581391897907704,0.2724439827867636,0.7275560172132364,0.0295296037987832
17619,,1516,34276,35792,164,1412,46495,13615,32880,46495,3181,0.03260565652220669,0.7371975481234542,0.0035272609958060005,0.2928271857188945,0.7071728142811055,0.030368856866329712
17620,17.0,403,5226,5629,44,352,7440,2156,5284,7440,543,0.05416666666666667,0.7024193548387097,0.005913978494623656,0.28978494623655915,0.7102150537634409,0.047311827956989246
17621,,555,12051,12606,75,519,16707,4804,11903,16707,1253,0.033219608547315496,0.7213144191057641,0.00448913629017777,0.28754414317352006,0.7124558568264799,0.031064823128030168
17622,14.0,85,1710,1795,4,129,2570,663,1907,2570,202,0.033073929961089495,0.6653696498054474,0.0015564202334630351,0.2579766536964981,0.742023346303502,0.05019455252918288
17623,17.0,1098,19178,20276,44,1114,26922,7659,19263,26922,2249,0.04078448852239804,0.7123542084540524,0.0016343510883292474,0.2844885223980388,0.7155114776019612,0.04137879800906322
17624,37.0,52,2579,2631,11,81,3448,1005,2443,3448,277,0.015081206496519721,0.747969837587007,0.0031902552204176333,0.29147331786542924,0.7085266821345708,0.02349187935034803
17625,42.0,516,5816,6332,290,450,10057,2290,7767,10057,441,0.051307546982201455,0.5783036690862086,0.0288356368698419,0.22770209804116537,0.7722979019588346,0.04474495376354778
17626,17.0,242,9211,9453,69,890,13163,3440,9723,13163,847,0.018384866671731368,0.6997644913773456,0.0052419661171465475,0.2613386006229583,0.7386613993770417,0.06761376585884676
17627,16.0,91,4630,4721,20,234,6532,1763,4769,6532,525,0.01393141457440294,0.7088181261481935,0.003061849357011635,0.2699020208205756,0.7300979791794244,0.03582363747703613
17628,,244,4330,4574,11,400,6367,1726,4641,6367,424,0.03832260091094707,0.6800691063295116,0.0017276582377885974,0.27108528349301086,0.7289147165069891,0.06282393591958536
17629,23.0,387,10818,11205,24,449,14668,4343,10325,14668,1269,0.026383965094082355,0.7375238614671393,0.001636214889555495,0.29608671938914644,0.7039132806108536,0.030610853558767383
17630,,9168,105489,114863,1951,6855,157609,44067,113567,157634,5806,0.05816004161538754,0.6692020756943299,0.012376771508684674,0.27955263458390955,0.7204473654160904,0.0434868112209295
17631,16.0,8,7171,7179,44,241,9364,2798,6566,9364,727,0.0008543357539513029,0.7658052114480991,0.004698846646732166,0.2988039299444682,0.7011960700555319,0.025736864587782998
17632,13.0,119,2213,2332,6,133,3141,851,2290,3141,194,0.037886023559375995,0.7045526902260426,0.0019102196752626551,0.27093282394141993,0.7290671760585801,0.04234320280165552
17633,25.0,635,19309,19944,78,661,26678,7559,19119,26678,2138,0.02380238398680561,0.7237798935452433,0.002923757403103681,0.28334207961616314,0.7166579203838369,0.024776969787840167
17634,27.0,296,7485,7781,87,390,10614,2896,7718,10614,877,0.02788769549651404,0.70520067834935,0.00819672131147541,0.2728471829658941,0.727152817034106,0.03674392312040701
17635,,23,1820,1847,9,138,2622,688,1934,2622,236,0.008771929824561403,0.6941266209000763,0.003432494279176201,0.2623951182303585,0.7376048817696415,0.05263157894736842
17636,25.0,91,2395,2486,10,150,3359,960,2399,3359,234,0.027091396248883598,0.7130098243524858,0.002977076510866329,0.2857993450431676,0.7142006549568324,0.04465614766299494
17637,25.0,26,2651,2677,0,113,3553,1061,2492,3553,345,0.007317759639741064,0.7461300309597523,0.0,0.2986208837602026,0.7013791162397973,0.03180410920349001
17638,34.0,72,1676,1748,17,157,2405,667,1738,2405,169,0.02993762993762994,0.6968814968814969,0.007068607068607069,0.27733887733887735,0.7226611226611227,0.06528066528066528
17639,25.0,125,2465,2590,17,137,3513,1057,2456,3513,216,0.03558212354113294,0.7016794762311415,0.004839168801594079,0.3008824366638201,0.6991175633361799,0.0389980074010817
17640,26.0,3432,52735,56167,210,2960,74090,21288,52802,74090,5568,0.04632204076123633,0.7117694695640437,0.0028343906060197058,0.28732622486165477,0.7126737751383453,0.039951410446753946
17641,26.0,271,7642,7913,23,404,10462,2958,7504,10462,734,0.025903268973427644,0.7304530682469891,0.002198432422099025,0.28273752628560506,0.717262473714395,0.03861594341426113
17642,16.0,2386,29081,31467,328,3648,46532,11973,34559,46532,2701,0.051276540875096706,0.6249677641193158,0.007048912576291584,0.25730679962176567,0.7426932003782344,0.07839766182412103
17643,23.0,141,5529,5670,13,231,7360,2133,5227,7360,607,0.019157608695652174,0.7512228260869566,0.001766304347826087,0.28980978260869567,0.7101902173913044,0.03138586956521739
17644,,52,9849,9901,23,644,13261,3741,9520,13261,1023,0.003921272905512405,0.7427041701229168,0.0017344091697458713,0.2821054219138828,0.7178945780861172,0.0485634567528844
17645,,78,2326,2404,11,155,3265,899,2366,3265,263,0.023889739663093414,0.7124042879019908,0.0033690658499234303,0.2753445635528331,0.7246554364471669,0.04747320061255743
17646,45.0,150,4749,4899,21,336,6465,1855,4610,6465,463,0.02320185614849188,0.7345707656612529,0.0032482598607888632,0.28692962103634956,0.7130703789636504,0.05197215777262181
17647,,97,1909,2006,2,103,3115,719,2396,3115,176,0.03113964686998395,0.6128410914927769,0.0006420545746388443,0.23081861958266453,0.7691813804173355,0.03306581059390048
17648,,260,6866,7126,245,393,9664,2652,7012,9664,731,0.026903973509933773,0.7104718543046358,0.02535182119205298,0.27442052980132453,0.7255794701986755,0.040666390728476824
17649,16.0,292,5166,5458,106,328,7558,2060,5498,7558,499,0.03863455940725059,0.6835141571844403,0.014024874305371792,0.27255887801005557,0.7274411219899445,0.04339772426567875
17650,35.0,126,3833,3959,11,151,5079,1557,3522,5079,411,0.024808033077377438,0.7546761173459342,0.0021657806654853317,0.30655640874187834,0.6934435912581217,0.029730261862571373
17651,15.0,1629,22954,24583,83,1708,33998,9424,24574,33998,2123,0.04791458321077711,0.6751573621977763,0.0024413200776516267,0.27719277604564974,0.7228072239543503,0.05023824930878287
17652,,374,7853,8227,55,336,10787,3173,7614,10787,763,0.0346713636785019,0.7280059330675813,0.005098729952720868,0.2941503661815148,0.7058496338184852,0.031148604802076575
17653,25.0,475,11741,12216,64,447,16363,4536,11827,16363,1165,0.02902890667970421,0.7175334596345413,0.0039112632157917255,0.2772107804192385,0.7227892195807615,0.02731772902279533
17654,34.0,165,3101,3266,17,241,4493,1157,3336,4493,297,0.03672379256621411,0.69018473180503,0.0037836634765190296,0.25751168484308923,0.7424883151569107,0.053638993990652126
17655,33.0,372,13875,14247,1,448,18527,5421,13106,18527,1578,0.020078803907810222,0.7489070005937281,5.397527932207049e-05,0.2925999892049441,0.7074000107950559,0.02418092513628758
17656,16.0,843,14995,15838,98,880,21288,6117,15171,21288,1597,0.03959977452085682,0.7043874483276964,0.004603532506576475,0.28734498308906425,0.7126550169109357,0.04133784291619692
17657,23.0,861,20093,20954,46,1151,28444,8127,20317,28444,2256,0.03027000421881592,0.7064055688370131,0.0016172127689495148,0.2857193081141893,0.7142806918858107,0.04046547602306286
17658,,130,3199,3329,4,101,4372,1273,3099,4372,349,0.029734675205855442,0.7317017383348582,0.0009149130832570906,0.29117108874656905,0.708828911253431,0.023101555352241537
17659,25.0,258,3754,4012,6,204,5409,1513,3896,5409,330,0.04769828064337216,0.6940284710667406,0.0011092623405435386,0.279718986873729,0.720281013126271,0.03771491957848031
17660,,2669,53732,56401,421,3559,75276,21009,54283,75292,5289,0.03544865324337247,0.7136481963555225,0.005591563512723796,0.27903362907081763,0.7209663709291824,0.04726929819901185
17661,24.0,470,9042,9512,58,538,12799,3619,9180,12799,943,0.036721618876474724,0.7064614423001797,0.004531604031564966,0.2827564653488554,0.7172435346511447,0.042034533947964685
17662,16.0,3045,46403,49448,647,3588,67075,18947,48128,67075,4811,0.04539694371971673,0.6918076779724189,0.009645918747670517,0.28247484159522923,0.7175251584047708,0.05349235929929184
17663,16.0,178,6086,6264,11,216,8231,2319,5912,8231,653,0.021625561900133643,0.7393998299113109,0.001336411128659944,0.28173976430567366,0.7182602356943263,0.02624225489004981
17664,41.0,212,7266,7478,2,152,9579,2893,6686,9579,871,0.022131746528865227,0.7585342937676166,0.00020879006159306817,0.30201482409437314,0.6979851759056269,0.015868044681073182
17665,,590,17355,17945,44,644,23783,6919,16864,23783,2043,0.02480763570617668,0.7297229113232141,0.001850060967918261,0.2909220872051465,0.7090779127948534,0.027078165075894545
17666,14.0,799,9331,10130,47,1043,14565,3867,10698,14565,929,0.05485753518709235,0.640645382766907,0.0032269138345348437,0.2654994850669413,0.7345005149330587,0.07161002403020941
17667,,174,3973,4147,27,227,5567,1554,4013,5567,457,0.031255613436321175,0.7136698401293335,0.004850008981498114,0.27914496137955813,0.7208550386204419,0.040776001437039695
17668,,337,39534,39871,151,2510,52642,14970,37672,52642,4164,0.006401732456973519,0.7509973025340982,0.00286843205045401,0.2843736940085863,0.7156263059914137,0.047680559249268645
17669,25.0,129,3022,3151,5,219,4082,1233,2849,4082,289,0.031602155805977465,0.7403233708966193,0.001224889759921607,0.3020578147966683,0.6979421852033317,0.05365017148456639
17670,24.0,212,1194,1406,2,164,2129,552,1577,2129,145,0.099577266322217,0.5608266791921089,0.0009394081728511038,0.25927665570690467,0.7407233442930954,0.07703147017379051
17671,27.0,1547,54283,55830,90,2152,71994,21154,50840,71994,5312,0.02148790176959191,0.7539933883379171,0.0012501041753479457,0.29383004139233826,0.7061699586076617,0.029891379837208656
17672,,222,5613,5835,0,330,7914,2205,5709,7914,468,0.028051554207733132,0.7092494313874147,0.0,0.27862016679302504,0.721379833206975,0.04169825625473844
17673,,366,4903,5269,72,264,7167,1917,5250,7167,388,0.05106739221431561,0.6841077159201897,0.010046044370029301,0.2674759313520301,0.7325240686479698,0.03683549602344077
17674,,49,7655,7704,3,329,9852,2962,6890,9852,882,0.004973609419407227,0.7769995939910678,0.0003045066991473812,0.30064961429151443,0.6993503857084856,0.03339423467316281
17675,16.0,249,7714,7963,37,1130,11443,3079,8364,11443,864,0.021760027964694572,0.674123918552827,0.003233417810014856,0.26907279559556063,0.7309272044044394,0.09875032771126453
17676,23.0,866,26197,27063,103,1499,36109,10319,25790,36109,2376,0.02398294054113933,0.7254977983328256,0.002852474452352599,0.28577362984297544,0.7142263701570246,0.04151319615608297
17677,16.0,749,11511,12260,65,759,16469,4526,11943,16469,1199,0.04547938551217439,0.6989495415629364,0.003946809156597243,0.2748193575809096,0.7251806424190904,0.046086586920881654
17678,15.0,1847,42786,44633,313,2989,60352,16910,43442,60352,4524,0.030603791092258747,0.7089408801696713,0.005186240721102863,0.28018955461293743,0.7198104453870625,0.04952611346765642
17679,16.0,26,1880,1906,4,141,2752,725,2027,2752,198,0.00944767441860465,0.6831395348837209,0.0014534883720930232,0.26344476744186046,0.7365552325581395,0.05123546511627907
17680,,157,3488,3645,1,247,4976,1440,3536,4976,286,0.03155144694533762,0.7009646302250804,0.00020096463022508038,0.28938906752411575,0.7106109324758842,0.04963826366559485
17681,17.0,24,15774,15798,21,971,21087,5949,15138,21087,2056,0.0011381419832124057,0.7480438184663537,0.0009958742353108551,0.2821169440887751,0.7178830559112249,0.046047327737468585
17682,,1439,15269,16708,41,1895,26079,6371,19709,26080,981,0.05517638036809816,0.585467791411043,0.0015720858895705522,0.2442868098159509,0.755713190184049,0.07266104294478527
17683,13.0,113,2244,2357,35,546,4413,860,3553,4413,156,0.025606163607523227,0.5084976206662135,0.007931112621799229,0.19487876727849535,0.8051212327215046,0.12372535690006799
17684,,243,9924,10167,63,402,13298,3959,9339,13298,1171,0.01827342457512408,0.746277635734697,0.004737554519476613,0.2977139419461573,0.7022860580538427,0.030230109790946008
17685,15.0,4189,64104,68293,958,4719,93664,25595,68069,93664,6238,0.04472369320122993,0.6844038264434574,0.010228049197130168,0.2732640075162282,0.7267359924837717,0.05038221728732491
17686,,191,4278,4469,4,250,6145,1687,4458,6145,461,0.031082180634662327,0.6961757526444263,0.0006509357200976403,0.2745321399511798,0.7254678600488201,0.04068348250610252
17687,16.0,25,1450,1475,8,47,1948,539,1409,1948,164,0.012833675564681724,0.74435318275154,0.004106776180698152,0.276694045174538,0.723305954825462,0.024127310061601643
17688,17.0,2792,59288,62080,308,2401,80570,23754,56816,80570,5665,0.034653096686111454,0.735857018741467,0.0038227628149435275,0.29482437631872904,0.705175623681271,0.029800173761946134
17689,17.0,385,1947,2332,12,185,3556,902,2654,3556,142,0.10826771653543307,0.5475253093363329,0.003374578177727784,0.25365579302587177,0.7463442069741283,0.05202474690663667
17690,24.0,195,3664,3859,18,207,5657,1420,4237,5657,299,0.03447056743857168,0.6476931235637263,0.003181898532791232,0.2510164398090861,0.7489835601909139,0.03659183312709917
17691,17.0,108,1444,1556,9,128,2144,541,1603,2144,112,0.05037313432835821,0.6735074626865671,0.004197761194029851,0.2523320895522388,0.7476679104477612,0.05970149253731343
17692,24.0,237,7750,7987,65,419,10654,3016,7638,10654,940,0.02224516613478506,0.7274263187535198,0.006100994931481134,0.28308616482072463,0.7169138351792754,0.03932795194293223
17693,17.0,31,2364,2395,47,168,3366,903,2463,3366,274,0.00920974450386215,0.7023172905525846,0.013963161021984551,0.26827094474153296,0.731729055258467,0.049910873440285206
17694,27.0,1910,42848,44758,297,2903,59984,17268,42716,59984,4181,0.03184182448652974,0.7143238196852494,0.004951320352093892,0.28787676713790344,0.7121232328620966,0.04839623899706588
17695,,463,13136,13599,6,320,17683,5523,12160,17683,1173,0.02618333993100718,0.7428603743708647,0.0003393089407905898,0.31233387999773793,0.687666120002262,0.01809647684216479
17696,,1777,35825,37602,326,2049,49774,14341,35433,49774,3438,0.035701370193273595,0.7197532848475108,0.006549604211033873,0.28812231285410056,0.7118776871458995,0.041166070639289586
17697,,57,1382,1439,13,68,1932,562,1370,1932,150,0.029503105590062112,0.7153209109730849,0.006728778467908903,0.2908902691511387,0.7091097308488613,0.035196687370600416
17698,25.0,73,2815,2888,23,139,3854,1101,2753,3854,291,0.01894135962636222,0.7304099636741048,0.005967825635703166,0.2856772184743124,0.7143227815256876,0.036066424494032176
17699,,347,9598,9945,26,409,12871,3692,9179,12871,920,0.026959832180871727,0.7457074042420946,0.0020200450625437027,0.28684639888120583,0.7131536011187942,0.03177686271462979
17700,,13,1367,1380,15,50,1979,524,1455,1979,147,0.006568974229408792,0.6907529055078322,0.007579585649317837,0.26478019201616976,0.7352198079838302,0.025265285497726123
17701,15.0,2517,60286,62803,579,4230,84005,23776,60229,84005,5949,0.02996250223201,0.7176477590619605,0.0068924468781620144,0.2830307719778585,0.7169692280221416,0.05035414558657223
17702,15.0,23,1909,1932,17,261,2760,761,1999,2760,136,0.008333333333333333,0.6916666666666667,0.006159420289855073,0.2757246376811594,0.7242753623188406,0.09456521739130434
17703,15.0,587,10083,10670,61,1396,14940,3983,10957,14940,938,0.0392904953145917,0.6748995983935743,0.004082998661311914,0.26659973226238287,0.7334002677376171,0.09344042838018742
17704,,137,2396,2533,12,145,3447,922,2525,3447,245,0.03974470554105019,0.6950971859588048,0.0034812880765883376,0.2674789672178706,0.7325210327821294,0.042065564258775744
17705,35.0,643,15739,16382,62,792,21412,6241,15171,21412,1494,0.030029889781430973,0.7350551092845133,0.002895572576125537,0.29147207173547546,0.7085279282645246,0.03698860452082944
17706,17.0,700,15183,15883,32,1467,21304,5775,15529,21304,1344,0.032857679309049946,0.7126830642132933,0.0015020653398422831,0.271075854299662,0.7289241457003379,0.06886030792339466
17707,24.0,158,2404,2562,19,163,3488,998,2490,3488,264,0.04529816513761468,0.6892201834862385,0.005447247706422019,0.2861238532110092,0.7138761467889908,0.046731651376146786
17708,43.0,931,13352,14283,136,679,18426,5504,12922,18426,1255,0.050526430044502336,0.7246282427005318,0.007380874850754369,0.29870834690111797,0.701291653098882,0.03685010311516335
17709,,423,8278,8701,41,437,11576,3269,8307,11576,869,0.0365411195577056,0.7151002073255011,0.0035418106427090533,0.28239460953697304,0.717605390463027,0.03775051831375259
17710,17.0,1215,15794,17009,41,944,22823,6552,16271,22823,1558,0.05323577093283092,0.6920212066774745,0.001796433422424747,0.28707882399334006,0.7129211760066599,0.041361784165096616
17711,16.0,785,32938,33723,34,6012,49731,12692,37039,49731,2983,0.015784922885121955,0.6623232993505057,0.0006836781886549637,0.2552130461884941,0.744786953811506,0.120890390299813
17712,,11832,153291,165161,454,14402,225220,62341,162879,225220,14320,0.052535298818932596,0.6806278305656691,0.002015806766716988,0.2768004617707131,0.723199538229287,0.06394636355563449
17713,17.0,263,5430,5693,3,417,7656,2186,5470,7656,650,0.034352142110762804,0.7092476489028213,0.00039184952978056425,0.2855276907001045,0.7144723092998955,0.05446708463949843
17714,15.0,189,2755,2944,59,138,3918,1096,2822,3918,178,0.04823889739663093,0.7031648800408372,0.015058703420112302,0.27973455844818784,0.7202654415518122,0.03522205206738132
17715,42.0,142,2826,2968,28,113,4045,1155,2890,4045,286,0.035105067985166875,0.6986402966625463,0.0069221260815822,0.28553770086526575,0.7144622991347342,0.027935723114956738
17716,23.0,387,9818,10205,13,463,13348,3915,9433,13348,909,0.028993107581660175,0.7355409050044951,0.000973928678453701,0.29330236739586457,0.7066976326041354,0.03468684447108181
17717,27.0,7558,149501,157059,953,9044,210501,59898,150603,210501,14630,0.03590481755431091,0.710215153372193,0.0045272944071524605,0.2845497171034817,0.7154502828965184,0.04296416644101453
17718,27.0,6339,124805,131144,729,7294,173494,49411,124083,173494,11087,0.03653728659204353,0.7193620528663816,0.004201874416406331,0.28479947433340635,0.7152005256665936,0.04204179971641671
17719,24.0,120,7138,7258,20,410,9774,2808,6966,9774,880,0.012277470841006752,0.730304890525885,0.0020462451401677922,0.287292817679558,0.712707182320442,0.04194802537343974
17720,,54,3600,3654,2,363,5088,1394,3694,5088,313,0.01061320754716981,0.7075471698113207,0.00039308176100628933,0.27397798742138363,0.7260220125786163,0.07134433962264151
17721,,282,6553,6835,11,308,9027,2607,6420,9027,772,0.031239614489863742,0.7259333111775784,0.0012185665226542594,0.2888002658690595,0.7111997341309405,0.034119862634319265
17722,43.0,56,2415,2471,2,121,3239,974,2265,3239,284,0.0172892868169188,0.7456004939796234,0.0006174745291756715,0.300710095708552,0.699289904291448,0.03735720901512812
17723,15.0,372,24163,24535,96,2257,33151,9218,23933,33151,2463,0.01122138095381738,0.7288769569545414,0.0028958402461464207,0.27806099363518444,0.7219390063648156,0.06808241078700492
17724,,139,2619,2758,6,241,3965,1064,2901,3965,284,0.03505674653215637,0.6605296343001261,0.0015132408575031526,0.26834804539722573,0.7316519546027743,0.06078184110970996
17725,,237,7615,7852,11,410,10628,3072,7556,10628,760,0.022299585999247272,0.7165035754610463,0.0010350018818216034,0.2890477982687241,0.7109522017312758,0.038577342867896124
17726,,346,7845,8191,14,392,10997,3065,7932,10997,740,0.03146312630717468,0.7133763753751023,0.001273074474856779,0.27871237610257343,0.7212876238974266,0.03564608529598982
17727,14.0,1037,17468,18505,149,1864,26206,6729,19477,26206,1737,0.03957109058994124,0.6665649087995116,0.00568572082729146,0.25677325803251166,0.7432267419674884,0.071128749141418
17728,13.0,41,1824,1865,20,208,2653,709,1944,2653,190,0.015454202789295138,0.6875235582359593,0.007538635506973238,0.2672446287222013,0.7327553712777988,0.07840180927252167
17729,,180,4384,4564,52,237,6107,1724,4383,6107,375,0.02947437366955952,0.7178647453741608,0.008514819060094972,0.28229900114622564,0.7177009988537744,0.0388079253315867
17730,37.0,94,3346,3440,18,179,4569,1292,3277,4569,358,0.020573429634493323,0.7323265484788795,0.003939592908732764,0.2827752243379295,0.7172247756620704,0.039177062814620266
17731,24.0,1072,26227,27299,119,1141,35440,10368,25072,35440,2671,0.030248306997742665,0.7400395033860045,0.003357787810383747,0.2925507900677201,0.7074492099322799,0.03219525959367946
17732,15.0,451,13538,13989,60,724,18676,5210,13466,18676,1294,0.02414863996573142,0.724887556221889,0.003212679374598415,0.27896765902762904,0.721032340972371,0.03876633112015421
17733,27.0,115,3135,3250,8,230,4301,1237,3064,4301,282,0.026737967914438502,0.7289002557544757,0.001860032550569635,0.2876075331318298,0.7123924668681701,0.053475935828877004
17734,,544,8113,8657,62,788,11886,3331,8555,11886,617,0.04576813057378428,0.682567726737338,0.005216220763923944,0.2802456671714622,0.7197543328285377,0.066296483257614
17735,15.0,77,2245,2322,4,113,3026,923,2103,3026,241,0.025446133509583607,0.7419035029742234,0.0013218770654329147,0.3050231328486451,0.6949768671513549,0.03734302709847984
17736,,853,10774,11627,9,751,17577,4519,13058,17577,778,0.04852932809922057,0.6129601183364625,0.0005120327700972862,0.2570973431188485,0.7429026568811515,0.042726290038117995
17737,15.0,747,13959,14706,42,1407,20296,5538,14758,20296,1471,0.03680528182893181,0.6877709893575089,0.0020693732755222706,0.27286164761529363,0.7271383523847064,0.06932400472999606
17738,,756,15594,16350,82,736,21637,6106,15531,21637,1476,0.034940148819152375,0.7207098950871192,0.0037898045015482737,0.28220178398114343,0.7177982160188566,0.03401580625779914
17739,,153,2353,2506,24,156,3535,961,2574,3535,255,0.04328147100424328,0.6656294200848656,0.006789250353606789,0.2718528995756719,0.7281471004243282,0.04413012729844413
17740,26.0,1181,27961,29142,80,1714,39296,10829,28467,39296,3021,0.03005394951140065,0.7115482491856677,0.002035830618892508,0.27557512214983715,0.7244248778501629,0.043617671009771986
17741,26.0,356,7397,7753,35,380,10626,2914,7712,10626,836,0.033502729154903065,0.6961227178618483,0.0032938076416337285,0.27423301336344813,0.7257669866365518,0.0357613401091662
17742,24.0,200,5335,5535,15,255,7399,2076,5323,7399,576,0.027030679821597514,0.7210433842411137,0.0020273009866198133,0.2805784565481822,0.7194215434518179,0.03446411677253683
17743,17.0,70,1728,1798,0,129,2399,666,1733,2399,155,0.02917882451021259,0.7203001250521051,0.0,0.27761567319716546,0.7223843268028345,0.05377240516882034
17744,34.0,828,16663,17491,267,654,22573,6732,15841,22573,1468,0.03668099056394808,0.7381827847428344,0.011828290435476011,0.2982324015416648,0.7017675984583351,0.028972666459930005
17745,25.0,1031,34319,35350,160,1824,47630,13558,34072,47630,4092,0.02164602141507453,0.7205332773462104,0.003359227377703128,0.28465252991811885,0.7153474700818812,0.03829519210581566
17746,,5176,113752,118931,310,5090,157257,45221,112036,157257,11488,0.03291427408636818,0.7233509478115442,0.0019712953954354974,0.287561126054802,0.712438873945198,0.03236739858956994
17747,38.0,10954,89775,100729,2697,5118,141155,37582,103573,141155,8531,0.07760263540080053,0.6360029754525167,0.01910665580390351,0.2662463249619213,0.7337536750380788,0.03625801423966562
17748,15.0,196,3178,3374,5,157,4658,1278,3380,4658,337,0.0420781451266638,0.6822670674109059,0.00107342206955775,0.27436668097896094,0.7256333190210391,0.03370545298411335
17749,17.0,3167,69740,72907,91,3580,96632,27973,68659,96632,6941,0.03277382233628612,0.7217070949581919,0.0009417170295554268,0.28947967546982367,0.7105203245301763,0.03704776885503767
17750,26.0,1053,26608,27661,111,860,36144,10337,25807,36144,2607,0.029133466135458166,0.7361664453297919,0.0030710491367861885,0.28599490925188137,0.7140050907481187,0.023793714032757856
17751,,197,11519,11716,56,404,15374,4434,10940,15374,1293,0.012813841550669962,0.7492519838688695,0.0036425133342005986,0.28840900221152593,0.711590997788474,0.026278131911018604
17752,,206,6599,6805,3,214,8867,2591,6276,8867,712,0.02323220931543927,0.744220142099921,0.0003383331453704748,0.29220705988496676,0.7077929401150332,0.024134431036427203
17753,33.0,1586,39588,41174,756,2279,56341,15368,40973,56341,3852,0.028150015086704176,0.7026499352159173,0.013418292185087237,0.27276761150849294,0.7272323884915071,0.04045011625636748
17754,34.0,309,6675,6984,34,271,9430,2673,6757,9430,727,0.032767762460233295,0.707847295864263,0.0036055143160127253,0.28345705196182397,0.7165429480381761,0.028738069989395546
17755,23.0,2459,53653,56112,283,3044,75191,21220,53971,75191,5446,0.03270338205370323,0.7135561436874094,0.003763748320942666,0.28221462675054193,0.717785373249458,0.040483568512188955
17756,39.0,142,3346,3488,49,329,4593,1208,3385,4593,248,0.03091661223601132,0.7284998911386893,0.010668408447637709,0.2630089266274766,0.7369910733725235,0.0716307424341389
17757,23.0,1529,34170,35699,157,2693,52930,13797,39133,52930,2740,0.028887209522010203,0.6455696202531646,0.002966181749480446,0.26066502928395996,0.73933497071604,0.050878518798413
17758,,131,3946,4077,41,184,5543,1522,4021,5543,426,0.02363341151001263,0.7118888688435865,0.007396716579469601,0.27458055204762766,0.7254194479523723,0.03319502074688797
17759,,242,6398,6640,20,193,8402,2531,5871,8402,670,0.028802666031897167,0.7614853606284218,0.00238038562247084,0.3012378005236848,0.6987621994763151,0.02297072125684361
17760,13.0,286,4146,4432,3,262,5954,1649,4305,5954,400,0.048034934497816595,0.6963385959019147,0.0005038629492777964,0.27695666778636213,0.7230433322136379,0.04400403090359422
17761,15.0,183,4946,5129,0,208,6722,1934,4788,6722,538,0.027224040464147576,0.7357929187741743,0.0,0.2877119904790241,0.7122880095209759,0.030943171675096696
17762,24.0,165,4613,4778,7,334,6479,1818,4661,6479,487,0.025466893039049237,0.7119925914492977,0.0010804136440808766,0.2805988578484334,0.7194011421515666,0.051551165303287544
17763,24.0,1648,35839,37487,109,2099,51063,14041,37022,51063,3533,0.03227385778352231,0.701858488533772,0.0021346180208761728,0.2749740516616728,0.7250259483383271,0.04110608464054208
17764,,1516,33750,35266,157,1772,47458,13512,33946,47458,3747,0.031944034725441446,0.7111551266382907,0.0033081882928062707,0.28471490581145437,0.7152850941885457,0.037338278056386696
17765,16.0,1156,3908,5248,53,960,9598,1681,7926,9607,269,0.12032892682419069,0.4067867180181118,0.005516810658894556,0.1749765795773915,0.8250234204226086,0.09992713646299574
17766,35.0,2458,44150,46608,157,2170,62841,17597,45244,62841,4533,0.03911459079263538,0.7025667955634061,0.0024983688992854984,0.28002418803010776,0.7199758119698922,0.034531595614328225
17767,16.0,263,17612,17875,58,653,23248,6876,16372,23248,2089,0.011312801101169993,0.7575705437026841,0.002494838265657261,0.2957673778389539,0.7042326221610461,0.028088437715072263
17768,,1726,28395,30134,345,1584,40570,11234,29336,40570,2889,0.0425437515405472,0.6999014049790485,0.008503820557061868,0.2769041163421247,0.7230958836578752,0.039043628296771014
17769,13.0,465,6746,7211,195,713,10607,2760,7847,10607,617,0.043838974262279624,0.6359950975770717,0.018384085980955974,0.2602055246535307,0.7397944753464694,0.06721976053549543
17770,17.0,207,2089,2296,65,185,3353,879,2474,3353,191,0.06173575902177155,0.6230241574709215,0.01938562481359976,0.2621532955562183,0.7378467044437816,0.0551744706233224
17771,24.0,479,15544,16023,26,1111,21244,5952,15292,21244,1492,0.022547542835624178,0.7316889474675202,0.0012238749764639427,0.28017322538128414,0.7198267746187159,0.05229711918659386
17772,24.0,69,2109,2178,7,118,2884,827,2057,2884,247,0.0239251040221914,0.7312760055478502,0.0024271844660194173,0.286754507628294,0.713245492371706,0.040915395284327326
17773,24.0,3834,120061,123895,250,3061,162324,47553,114771,162324,15303,0.023619427811044577,0.7396380079347478,0.0015401296173085926,0.292951134767502,0.707048865232498,0.01885734703432641
17774,,551,17231,17782,47,962,23450,6721,16729,23450,1823,0.02349680170575693,0.7347974413646056,0.0020042643923240937,0.28660980810234543,0.7133901918976546,0.04102345415778252
17775,,132,3199,3331,9,165,4444,1274,3170,4444,299,0.0297029702970297,0.7198469846984699,0.0020252025202520253,0.2866786678667867,0.7133213321332134,0.03712871287128713
17776,16.0,591,19405,19996,8,588,26141,7467,18674,26141,2052,0.02260816342144524,0.742320492712597,0.00030603266898741443,0.28564324241612793,0.7143567575838721,0.02249340117057496
17777,,107,1822,1929,0,44,2548,811,1737,2548,142,0.041993720565149134,0.7150706436420722,0.0,0.3182888540031397,0.6817111459968603,0.01726844583987441
17778,15.0,303,3167,3470,46,210,4942,1311,3631,4942,340,0.0613112100364225,0.6408336705787131,0.009307972480777013,0.26527721570214485,0.7347227842978551,0.042492917847025496
17779,,189,3382,3571,45,160,4947,1324,3623,4947,377,0.03820497271073378,0.6836466545381039,0.009096422073984234,0.26763695168789164,0.7323630483121083,0.03234283404083283
17780,,1972,25078,27050,125,963,36327,10198,26129,36327,1993,0.054284691827015716,0.6903405180719575,0.00344096677402483,0.2807278332920417,0.7192721667079582,0.02650920802708729
17781,36.0,85,4717,4802,3,168,6327,1829,4498,6327,440,0.013434487118697646,0.7455350086929035,0.000474158368895211,0.28907855223644696,0.710921447763553,0.026552868658131817
17782,,68,2096,2164,4,128,2915,816,2099,2915,220,0.023327615780445968,0.7190394511149228,0.0013722126929674098,0.2799313893653516,0.7200686106346483,0.043910806174957115
17783,17.0,996,39486,40482,88,1474,52598,15213,37385,52598,4057,0.018936081219818244,0.750712954865204,0.0016730674170120537,0.2892315297159588,0.7107684702840412,0.0280238792349519
17784,24.0,3729,84840,88569,331,4580,119724,33938,85786,119724,8621,0.031146637265711135,0.7086298486518994,0.0027646921252213424,0.2834686445491297,0.7165313554508703,0.03825465236711102
17785,16.0,207,2827,3034,13,193,4329,1166,3163,4329,313,0.04781704781704782,0.653037653037653,0.003003003003003003,0.2693462693462694,0.7306537306537306,0.04458304458304458
17786,43.0,400,7691,8091,29,317,11213,3135,8078,11213,741,0.035672879693213234,0.6859002943012574,0.0025862837777579596,0.2795861945955587,0.7204138054044412,0.02827075715687149
17787,,91,2927,3018,18,206,4154,1152,3002,4154,342,0.021906596051998073,0.7046220510351469,0.004333172845450169,0.2773230621088108,0.7226769378911893,0.0495907558979297
17788,,671,12722,13393,19,745,18088,5044,13044,18088,1147,0.03709641751437417,0.7033392304290137,0.0010504201680672268,0.27885891198584695,0.721141088014153,0.041187527642636
17789,38.0,129,4397,4526,19,161,5925,1718,4207,5925,494,0.021772151898734177,0.7421097046413502,0.0032067510548523205,0.289957805907173,0.710042194092827,0.02717299578059072
17790,,40,3118,3158,19,396,5280,1218,4062,5280,272,0.007575757575757576,0.5905303030303031,0.0035984848484848487,0.23068181818181818,0.7693181818181818,0.075
17791,25.0,7412,162082,169494,564,9291,226513,64851,161662,226513,16292,0.032722183715724926,0.7155527497318035,0.002489923315659587,0.2863014484819856,0.7136985515180144,0.041017513343605004
17792,,157,3249,3406,6,150,4697,1332,3365,4697,356,0.03342559080263998,0.6917181179476262,0.0012774111134766872,0.2835852671918246,0.7164147328081755,0.03193527783691718
17793,,303,6515,6818,22,491,9334,2575,6759,9334,734,0.03246196700235698,0.6979858581529891,0.0023569745018212985,0.27587315191772016,0.7241268480822798,0.05260338547246625
17794,34.0,125,11212,11337,48,494,14897,4408,10489,14897,1476,0.00839095119822783,0.7526347586762435,0.0032221252601194873,0.29589850305430626,0.7041014969456938,0.03316103913539639
17795,,66,2643,2709,7,128,3590,1034,2556,3590,326,0.01838440111420613,0.7362116991643454,0.0019498607242339832,0.2880222841225627,0.7119777158774373,0.03565459610027855
17796,25.0,2374,74640,77014,217,4257,103661,28886,74775,103661,8229,0.022901573397902778,0.7200393590646434,0.0020933620165732533,0.2786583189434792,0.7213416810565207,0.041066553477199716
17797,,273,7695,7968,16,509,11455,2993,8462,11455,805,0.02383238760366652,0.6717590571802706,0.001396769969445657,0.2612832824094282,0.7387167175905718,0.04443474465298996
17798,,87,4981,5068,7,379,6402,1770,4632,6402,333,0.01358950328022493,0.7780381130896595,0.0010934083099031554,0.27647610121836924,0.7235238987816307,0.05920024992189941
17799,27.0,80,3517,3597,23,214,4907,1378,3529,4907,314,0.016303240269003465,0.7167312003260649,0.004687181577338496,0.28082331363358465,0.7191766863664153,0.043611167719584266
17800,,806,18113,18919,11,1130,25551,7416,18135,25551,1612,0.03154475362999491,0.7088959336229502,0.0004305115259676725,0.29024304332511447,0.7097569566748855,0.044225274940315445
17801,,450,10768,11218,48,466,14941,4289,10652,14941,1110,0.03011846596613346,0.720701425607389,0.0032126363697209024,0.28706244561943645,0.7129375543805635,0.031189344756040425
17802,15.0,334,6074,6408,26,182,8543,2446,6097,8543,692,0.0390963361816692,0.7109914549923915,0.003043427367435327,0.28631628233641576,0.7136837176635842,0.02130399157204729
17803,25.0,117,4655,4772,4,146,6111,1861,4250,6111,512,0.01914580265095729,0.7617411225658648,0.0006545573555882834,0.30453280968744884,0.6954671903125511,0.023891343478972343
17804,,98,3187,3285,7,151,4386,1238,3148,4386,356,0.022343821249430004,0.7266301869585043,0.0015959872321021432,0.28226174190606473,0.7177382580939352,0.034427724578203374
17805,25.0,62,3105,3167,12,151,4378,1197,3181,4378,379,0.01416171767930562,0.7092279579716766,0.002740977615349475,0.2734125171311101,0.7265874828688899,0.034490634993147556
17806,36.0,585,8374,8959,298,556,12372,3392,8980,12372,634,0.047284190106692534,0.6768509537665697,0.02408664726802457,0.27416747494342064,0.7258325250565794,0.04494018752020692
17807,24.0,2791,89541,92332,350,3570,118331,35658,82673,118331,8902,0.02358638057651841,0.7566994278760426,0.002957804801784824,0.3013411532058379,0.6986588467941621,0.030169608978205205
17808,15.0,61,4286,4347,0,343,5980,1605,4375,5980,330,0.01020066889632107,0.7167224080267559,0.0,0.2683946488294314,0.7316053511705686,0.057357859531772575
17809,27.0,63,1434,1497,3,77,1995,582,1413,1995,144,0.031578947368421054,0.718796992481203,0.0015037593984962407,0.29172932330827067,0.7082706766917293,0.03859649122807018
17810,37.0,3336,102458,105794,272,4215,135994,40278,95716,135994,9842,0.024530493992382017,0.7534008853331765,0.0020000882391870227,0.29617483124255484,0.7038251687574452,0.03099401444181361
17811,27.0,505,7459,7964,74,1083,11238,2982,8256,11238,602,0.044936821498487274,0.6637302011033992,0.006584801566114967,0.2653497063534437,0.7346502936465563,0.09636946075814201
17812,34.0,57,2104,2161,12,71,2797,808,1989,2797,227,0.020378977475867,0.7522345370039328,0.004290311047550947,0.28888094386843044,0.7111190561315696,0.02538434036467644
17813,,147,5938,6085,45,514,8176,2179,5997,8176,573,0.01797945205479452,0.7262720156555773,0.005503913894324853,0.26651174168297453,0.7334882583170255,0.062866927592955
17814,13.0,256,13900,14156,55,976,20169,5338,14831,20169,1467,0.012692746293817244,0.6891764589221082,0.0027269572115622984,0.26466359264217365,0.7353364073578263,0.04839109524517824
17815,17.0,1161,22962,24123,157,1463,32273,9194,23079,32273,2276,0.03597434387878412,0.7114925789359526,0.004864747621851083,0.2848820995878908,0.7151179004121092,0.04533201127877792
17816,24.0,3509,76917,80426,1254,6480,111619,30330,81289,111619,8179,0.03143730010123724,0.689103109685627,0.011234646431163153,0.27172793162454423,0.7282720683754558,0.05805463227586701
17817,24.0,123,2866,2989,34,110,4008,1154,2854,4008,315,0.030688622754491017,0.7150698602794411,0.008483033932135729,0.2879241516966068,0.7120758483033932,0.027445109780439122
17818,13.0,188,2822,3010,44,530,4533,1160,3373,4533,220,0.041473637767482904,0.6225457754246636,0.009706596073240679,0.25590116920361794,0.7440988307963821,0.11692036179130819
17819,24.0,696,18966,19662,131,796,25541,7526,18015,25541,1684,0.027250303433694844,0.7425707685681845,0.005129008261227047,0.2946634822442348,0.7053365177557652,0.03116557691554755
17820,,243,7060,7303,52,468,9965,2715,7250,9965,515,0.024385348720521827,0.7084796788760662,0.005218263923733066,0.27245358755644755,0.7275464124435524,0.046964375313597595
17821,,940,25725,26665,35,1495,35420,10090,25330,35420,2642,0.026538678712591756,0.7262845849802372,0.0009881422924901185,0.28486730660643705,0.715132693393563,0.04220779220779221
17822,,187,27011,27198,78,1257,36118,10163,25955,36118,3227,0.0051774738357605625,0.7478542554958746,0.002159588017055208,0.28138324381194973,0.7186167561880503,0.03480259150562046
17823,17.0,130,5390,5520,9,281,7150,2113,5037,7150,519,0.01818181818181818,0.7538461538461538,0.0012587412587412587,0.2955244755244755,0.7044755244755245,0.0393006993006993
17824,26.0,306,10017,10323,29,291,13734,3920,9814,13734,1079,0.022280471821756225,0.7293577981651376,0.0021115479831076162,0.2854230377166157,0.7145769622833843,0.021188291830493665
17825,,454,18824,19278,42,581,25034,7165,17869,25034,1886,0.01813533594311736,0.7519373651833506,0.0016777183031077734,0.28621075337540947,0.7137892466245905,0.0232084365263242
17826,16.0,48,1652,1700,7,62,2231,638,1593,2231,185,0.021515015688032272,0.7404751232631107,0.0031376064545047063,0.28597041685342894,0.7140295831465711,0.027790228597041687
17827,,1124,28760,29884,47,1305,39762,11261,28501,39762,3359,0.028268195764800563,0.7233036567577084,0.001182033096926714,0.28321010009556863,0.7167898999044313,0.03282028066998642
17828,26.0,107,2722,2829,4,127,3891,1056,2835,3891,313,0.02749935749164739,0.6995630943202261,0.0010280133641737343,0.27139552814186585,0.7286044718581342,0.03263942431251606
17829,15.0,1159,19772,20931,100,2224,30631,7948,22683,30631,2069,0.03783748490091737,0.6454898632104731,0.0032646665143155626,0.2594756945578009,0.740524305442199,0.07260618327837812
17830,,392,24872,28307,207,1524,39092,10175,28917,39092,1443,0.010027627135986903,0.6362427095057812,0.005295201064156349,0.26028343395068043,0.7397165660493196,0.03898495855929602
17831,27.0,276,6673,6949,25,377,9325,2622,6703,9325,656,0.02959785522788204,0.715603217158177,0.002680965147453083,0.28117962466487934,0.7188203753351207,0.04042895442359249
17832,23.0,365,9914,10279,9,542,13502,3857,9645,13502,1037,0.027033032143386166,0.7342615908754259,0.0006665679158643164,0.28566138349874093,0.7143386165012591,0.04014220115538439
17833,23.0,623,12333,12956,37,595,16916,5065,11862,16927,1228,0.036805104271282564,0.7285992792579902,0.002185856914987889,0.29922608849766646,0.7007739115023336,0.035150942281562
17834,34.0,145,3991,4136,14,218,5541,1575,3966,5541,411,0.026168561631474463,0.7202670998014798,0.0025266197437285687,0.284244721169464,0.715755278830536,0.03934307886663057
17835,26.0,86,1843,1929,0,96,2560,730,1830,2560,161,0.03359375,0.719921875,0.0,0.28515625,0.71484375,0.0375
17836,,669,16111,16780,103,882,22315,6251,16064,22315,1752,0.029979834192247368,0.7219807304503697,0.004615729330047054,0.2801254761371275,0.7198745238628725,0.03952498319516021
17837,25.0,817,23544,24361,65,1904,33460,9328,24132,33460,2661,0.0244172145845786,0.7036461446503287,0.0019426180514046623,0.27878063359234906,0.7212193664076509,0.05690376569037657
17838,17.0,257,9334,9591,39,1102,13004,3496,9508,13004,752,0.01976314980006152,0.7177791448784989,0.0029990772070132266,0.2688403568132882,0.7311596431867118,0.08474315595201476
17839,38.0,680,12976,13656,66,1007,19383,4957,14426,19383,1252,0.03508228860341536,0.6694526131145849,0.0034050456585667855,0.2557395655987205,0.7442604344012794,0.05195274209358716
17840,45.0,244,7639,7883,72,354,10310,3073,7237,10310,634,0.023666343355965083,0.7409311348205626,0.006983511154219205,0.2980601357904947,0.7019398642095054,0.03433559650824442
17841,15.0,370,8207,8577,7,808,12162,3319,8843,12162,865,0.03042262785726032,0.6748067752014472,0.000575563229731952,0.2728991942114784,0.7271008057885217,0.06643644137477389
17842,16.0,2066,35628,37694,226,2275,50245,14516,35729,50245,3905,0.04111851925564733,0.7090854811424022,0.004497959996019504,0.28890436859388996,0.7110956314061101,0.045278137128072445
17843,,1263,34097,35360,140,1312,46076,13425,32651,46076,3563,0.027411233614028994,0.7400164944873687,0.003038458199496484,0.29136643805885926,0.7086335619411407,0.028474693983852765
17844,23.0,145,6666,6811,4,203,8802,2659,6143,8802,770,0.016473528743467393,0.7573278800272665,0.0004544421722335833,0.3020904339922745,0.6979095660077255,0.02306294024085435
17845,17.0,3811,50527,54338,155,3147,72088,20730,51358,72088,4897,0.052865941626900455,0.7009072245033847,0.0021501498168904672,0.28756519809122183,0.7124348019087782,0.043654977250027746
17846,,865,24920,25785,113,819,33458,9934,23532,33466,2502,0.025847128428853165,0.7446363473375963,0.003376561286081396,0.2968385824418813,0.7031614175581187,0.024472599055758083
17847,27.0,74,2295,2369,2,86,3219,906,2313,3219,259,0.022988505747126436,0.7129543336439889,0.0006213109661385523,0.2814538676607642,0.7185461323392358,0.02671637154395775
17848,40.0,652,14993,15645,71,580,20652,5774,14878,20652,1342,0.031570792175092004,0.7259829556459423,0.0034379236877784235,0.27958551229905093,0.7204144877009491,0.02808444702692233
17849,25.0,38,4566,4604,0,202,6173,1743,4430,6173,657,0.006155839948161348,0.7396727685080188,0.0,0.2823586586748745,0.7176413413251256,0.032723149198120846
17850,16.0,539,10928,11467,30,573,15222,4416,10806,15222,1050,0.03540927604782552,0.71790829063198,0.001970831690973591,0.29010642491131255,0.7098935750886874,0.03764288529759559
17851,,257,4801,5058,8,233,6774,1939,4835,6774,503,0.03793917921464423,0.7087392973132566,0.00118098612341305,0.286241511662238,0.713758488337762,0.03439622084440508
17852,,88,2106,2194,52,91,2863,819,2044,2863,188,0.030736989172196996,0.7355920363255326,0.018162766329025498,0.2860635696821516,0.7139364303178484,0.03178484107579462
17853,27.0,1220,30809,32029,169,1276,43158,12285,30873,43158,3591,0.02826822373603967,0.7138653320357755,0.003915844107697298,0.2846517447518421,0.7153482552481579,0.029565781546874274
17854,24.0,1083,19901,20984,98,747,27997,8022,19975,27997,1960,0.03868271600528628,0.7108261599457084,0.0035003750401828766,0.2865306997178269,0.713469300282173,0.026681430153230705
17855,,3504,80261,83765,327,4389,114112,32231,81881,114112,8027,0.030706674144699943,0.7033528463264161,0.002865605720695457,0.2824505748738082,0.7175494251261918,0.038462212563095906
17856,,287,7236,7523,13,314,10126,2890,7236,10126,820,0.028342879715583646,0.7145960892751333,0.0012838238198696426,0.2854039107248667,0.7145960892751333,0.031009283033774444
17857,24.0,164,3835,3999,179,155,5357,1461,3896,5357,310,0.030614149710658952,0.7158857569535187,0.03341422437931678,0.2727272727272727,0.7272727272727273,0.028934104909464253
17858,34.0,336,12653,12989,60,744,17078,4766,12312,17078,1223,0.019674434945543974,0.740894718351095,0.0035132919545614242,0.2790724909239958,0.7209275090760042,0.043564820236561656
17859,,194,9305,9499,13,913,12767,3573,9194,12767,998,0.015195425706900603,0.7288321453747943,0.0010182501762356073,0.27986214459152503,0.720137855408475,0.07151249314639305
17860,27.0,151,2906,3057,22,135,4124,1178,2946,4124,300,0.03661493695441319,0.7046556741028128,0.00533462657613967,0.28564500484966054,0.7143549951503395,0.03273520853540252
17861,,34,2542,2576,14,224,3423,976,2447,3423,231,0.00993280747881975,0.7426234297399942,0.00408997955010225,0.28513000292141394,0.714869997078586,0.065439672801636
17862,36.0,19654,462367,482021,1184,29578,650415,181472,468943,650415,46719,0.03021763028220444,0.7108799766303052,0.0018203762213356088,0.2790095554376821,0.7209904445623179,0.04547558097522351
17863,,1300,31171,32471,270,1619,43426,12343,31085,43428,3101,0.02993460440268951,0.7177627337201805,0.006217187068250898,0.28421755549415123,0.7157824445058487,0.03728009579073409
17864,34.0,729,6778,7507,33,380,9854,2810,7044,9854,493,0.07398010960016237,0.6878425005074081,0.0033488938502131116,0.2851633854272377,0.7148366145727624,0.0385630200933631
17865,,302,4051,4353,37,565,6146,1612,4534,6146,336,0.0491376505043931,0.6591278880572731,0.006020175724048162,0.26228441262609825,0.7377155873739017,0.09192971038073544
17866,,116,2423,2539,12,89,3351,961,2390,3351,237,0.03461653237839451,0.7230677409728439,0.0035810205908683975,0.28678006565204417,0.7132199343479558,0.026559236048940615
17867,,7018,136159,143177,780,10076,202821,56018,146803,202821,11259,0.03460193964135864,0.6713259475103663,0.003845755617021906,0.27619427968504245,0.7238057203149575,0.04967927384245221
17868,23.0,231,6117,6348,47,269,8354,2461,5893,8354,638,0.027651424467321044,0.7322240842710079,0.005626047402441944,0.29458941824275797,0.705410581757242,0.03220014364376347
17869,,24475,506556,531031,2464,26750,709333,203123,506210,709333,51073,0.034504245537709366,0.7141300348355427,0.0034736858428974825,0.2863577473485655,0.7136422526514345,0.03771148388697551
17870,,50,1427,1477,6,65,1991,559,1432,1991,180,0.025113008538422903,0.7167252636865896,0.0030135610246107484,0.28076343545956806,0.7192365645404319,0.03264691109994977
17871,17.0,1940,33828,35768,54,2112,46924,13643,33281,46924,3259,0.041343448981331514,0.7209104083198363,0.0011507970335009803,0.29074673940840506,0.7092532605915949,0.0450089506435939
17872,,231,9460,9691,16,337,12611,3746,8865,12611,1082,0.018317342003013243,0.750138767742447,0.0012687336452303544,0.29704226468955675,0.7029577353104433,0.02672270240266434
17873,23.0,51,1531,1582,4,76,2158,578,1580,2158,156,0.023632993512511583,0.7094531974050047,0.0018535681186283596,0.267840593141798,0.732159406858202,0.03521779425393883
17874,,175,4286,4461,36,252,6270,1719,4551,6270,466,0.027910685805422646,0.683572567783094,0.005741626794258373,0.27416267942583733,0.7258373205741627,0.04019138755980861
17875,26.0,148,29955,30103,17,1810,39586,11684,27902,39586,3506,0.003738695498408528,0.7567069165866721,0.0004294447531955742,0.2951548527257111,0.7048451472742889,0.045723235487293484
17876,15.0,956,8834,9790,304,1071,14595,3652,10943,14595,726,0.06550188420692017,0.6052757793764988,0.020829051044878383,0.25022267899965744,0.7497773210003426,0.07338129496402877
17877,,260,4740,5000,24,435,6811,1761,5050,6811,436,0.03817354279841433,0.6959330494787843,0.0035237116429305535,0.25855234180002934,0.7414476581999706,0.06386727352811629
17878,,835,57241,58076,218,1845,76661,22145,54516,76661,6473,0.01089210941678298,0.7466769282947,0.0028436884465373527,0.2888691772870169,0.7111308227129831,0.024066996256245025
17879,27.0,2058,36802,38860,457,1130,47605,15341,32264,47605,2397,0.043230753072156285,0.7730700556664216,0.009599831950425375,0.3222560655393341,0.6777439344606659,0.023737002415712635
17880,23.0,1175,29798,30973,260,1864,41790,11827,29963,41790,2837,0.028116774347930126,0.713041397463508,0.006221584111031347,0.2830102895429529,0.7169897104570472,0.0446039722421632
17881,,984,16266,17250,62,1220,24204,6640,17564,24204,1585,0.0406544372830937,0.67203767972236,0.0025615600727152536,0.2743348206907949,0.725665179309205,0.05040489175342919
17882,,41,4717,4758,8,275,6298,1821,4477,6298,549,0.006510003175611305,0.7489679263258178,0.0012702445220704986,0.2891394093362972,0.7108605906637028,0.04366465544617339
17883,25.0,724,21019,21743,29,711,27796,8347,19449,27796,2135,0.02604691322492445,0.7561879407108937,0.0010433155849762555,0.3002950064757519,0.6997049935242481,0.02557922003165923
17884,,1724,10577,12314,334,599,16912,4522,12396,16918,677,0.10190329826220594,0.6251921030854711,0.019742286322260313,0.26728927769239863,0.7327107223076014,0.035406076368365055
17885,23.0,187,4581,4768,11,206,6235,1839,4396,6235,511,0.02999198075380914,0.7347233360064154,0.001764234161988773,0.29494787489975943,0.7050521251002406,0.033039294306335204
17886,24.0,2076,31594,33670,251,2578,48072,12645,35427,48072,3130,0.04318522216674987,0.6572224995839574,0.005221334664669662,0.2630429355966051,0.7369570644033949,0.0536278914960892
17887,,62,1725,1787,23,66,2358,694,1664,2358,166,0.026293469041560644,0.7315521628498728,0.009754028837998304,0.29431721798134014,0.7056827820186599,0.027989821882951654
17888,25.0,5846,98668,104514,662,5024,142689,39941,102748,142689,10362,0.040970221951236604,0.6914898835929889,0.004639460645179376,0.2799164616753919,0.720083538324608,0.0352094415126604
17889,,463,15306,15769,10,547,20353,6074,14279,20353,1536,0.022748489166216284,0.7520267282464501,0.000491328059745492,0.2984326634894119,0.7015673365105881,0.026875644868078415
17890,37.0,668,9165,9833,80,540,13281,3702,9579,13281,885,0.05029741736315037,0.690083578043822,0.00602364279798208,0.27874407047662075,0.7212559295233792,0.040659588886379036
17891,,893,28668,29561,3,2030,39082,10671,28411,39082,2889,0.022849393582723504,0.7335346195179366,7.676168056905992e-05,0.27304129778414615,0.7269587022158538,0.051942070518397214
17892,,84,1788,1872,0,79,2378,704,1674,2378,165,0.03532380151387721,0.751892346509672,0.0,0.2960470984020185,0.7039529015979815,0.03322119428090833
17893,33.0,176,2601,2777,14,121,3677,1102,2575,3677,304,0.047865107424530866,0.7073701387000272,0.003807451726951319,0.2997008430785967,0.7002991569214033,0.03290726135436497
17894,,364,6663,7027,60,784,10064,2582,7482,10064,556,0.03616852146263911,0.6620627980922098,0.005961844197138315,0.2565580286168522,0.7434419713831478,0.07790143084260731
17895,17.0,1531,3068,4599,33,320,7210,1750,5460,7210,181,0.21234396671289876,0.42552011095700415,0.004576976421636616,0.24271844660194175,0.7572815533980582,0.044382801664355064
17896,14.0,254,5063,5317,66,317,7198,1975,5223,7198,524,0.03528757988330092,0.7033898305084746,0.009169213670464018,0.274381772714643,0.7256182272853571,0.04404001111419839
17897,15.0,212,2727,2939,111,346,4263,1156,3107,4263,246,0.04973023692235515,0.6396903589021815,0.026038001407459536,0.2711705371803894,0.7288294628196106,0.08116349988271171
17898,,8758,251467,260225,490,11074,334354,99181,235173,334354,23931,0.026193794600931946,0.7520980756922304,0.0014655126004175215,0.2966347045347147,0.7033652954652853,0.03312058476943599
17899,,22170,288500,310670,1508,17653,411897,116655,295242,411897,28147,0.05382413564556188,0.7004178229023276,0.0036611094521203117,0.28321400738534147,0.7167859926146585,0.04285780182909805
17900,,193,11042,11235,121,755,15305,4071,11234,15305,1327,0.012610258085592943,0.7214635739954264,0.007905913100294022,0.2659915060437765,0.7340084939562235,0.04933028422084286
17901,17.0,657,14736,15393,120,891,20922,5721,15201,20922,1685,0.03140235159162604,0.7043303699455119,0.005735589331803843,0.2734442213937482,0.7265557786062518,0.04258675078864353
17902,,110,2128,2238,10,130,3152,848,2304,3152,259,0.03489847715736041,0.6751269035532995,0.0031725888324873096,0.26903553299492383,0.7309644670050761,0.041243654822335024
17903,,264,11235,11499,19,560,15322,4295,11027,15322,1157,0.01723012661532437,0.7332593656180655,0.0012400469912544055,0.2803158856546143,0.7196841143453857,0.03654875342644563
17904,27.0,375,12541,12916,33,719,16714,4755,11959,16714,1185,0.022436280962067727,0.7503290654541104,0.00197439272466196,0.2844920425990188,0.7155079574009812,0.04301782936460452
17905,24.0,456,13728,14184,36,630,18839,5258,13581,18839,1616,0.02420510642815436,0.7287010987844366,0.0019109294548542916,0.2791018631562185,0.7208981368437816,0.033441265459950104
17906,27.0,122,2015,2137,4,83,2823,812,2011,2823,217,0.04321643641516117,0.7137796670208998,0.0014169323414806943,0.2876372653205809,0.712362734679419,0.029401346085724405
17907,40.0,185,3950,4135,50,263,5461,1535,3926,5461,313,0.03387657938106574,0.7233107489470793,0.009155832265152902,0.2810840505401941,0.7189159494598059,0.048159677714704266
17908,25.0,181,2387,2568,1,102,3515,957,2558,3515,226,0.051493598862019915,0.6790896159317212,0.0002844950213371266,0.27226173541963017,0.7277382645803698,0.029018492176386912
17909,16.0,135,3349,3484,4,207,4654,1283,3371,4654,363,0.029007305543618394,0.7195960464116888,0.0008594757198109154,0.2756768371293511,0.7243231628706489,0.044477868500214866
17910,34.0,1494,112239,113733,234,4755,151017,43023,107994,151017,13629,0.009892925961977791,0.743220961878464,0.001549494427779654,0.28488845626651305,0.715111543733487,0.03148652138500963
17911,40.0,3509,102699,106208,333,5539,137585,40481,97105,137586,10050,0.025504048377015105,0.7464349570450481,0.002420304391435175,0.29422324945852046,0.7057767505414795,0.040258456529007315
17912,,1543,19769,21312,128,1236,28462,7862,20600,28462,1875,0.0542126343897126,0.6945752231044902,0.004497224369334551,0.27622795306022063,0.7237720469397794,0.04342632281638676
17913,,246,3503,3749,32,135,4931,1405,3526,4931,332,0.04988846075846684,0.710403569255729,0.006489555871020077,0.2849320624619753,0.7150679375380248,0.02737781383086595
17914,17.0,135,8148,8283,34,272,10900,3136,7764,10900,866,0.012385321100917432,0.7475229357798165,0.0031192660550458714,0.2877064220183486,0.7122935779816514,0.02495412844036697
17915,,60,6044,6104,13,736,8415,2219,6196,8415,425,0.0071301247771836,0.7182412358882947,0.0015448603683897802,0.26369578134284016,0.7363042186571598,0.08746286393345216
17916,24.0,3061,82869,85930,166,4415,114759,32439,82320,114759,7778,0.026673289240930993,0.722113298303401,0.0014465096419452941,0.2826706402112253,0.7173293597887748,0.03847192812764141
17917,17.0,3026,42195,45221,132,3116,60230,17103,43127,60230,3777,0.0502407438153744,0.7005645027394986,0.002191598870994521,0.2839614809895401,0.7160385190104599,0.051735015772870666
17918,16.0,1429,27720,29149,301,2085,39066,11196,27870,39066,2852,0.03657912251062305,0.7095684226693288,0.007704909640096247,0.2865919213638458,0.7134080786361542,0.05337121793887268
17919,,478,9044,9522,33,560,12615,3551,9064,12615,786,0.037891399128022196,0.7169242964724535,0.002615933412604043,0.28149028933808956,0.7185097106619104,0.04439159730479588
17920,25.0,141,9888,10029,17,1753,14447,3818,10629,14447,897,0.009759811725617776,0.6844327542050253,0.0011767148889042709,0.2642763203433239,0.7357236796566762,0.12134007060289334
17921,17.0,1780,25785,27565,132,1620,37446,10673,26773,37446,2921,0.047535117235485765,0.6885915718634834,0.0035250761095978207,0.28502376755861775,0.7149762324413823,0.04326229770870053
17922,34.0,107,3097,3204,12,148,4436,1178,3258,4436,349,0.02412082957619477,0.6981514878268711,0.002705139765554554,0.2655545536519387,0.7344454463480613,0.033363390441839495
17923,33.0,616,10885,11501,38,836,15611,4332,11279,15611,1174,0.03945935558260201,0.6972647492152969,0.0024341810261994746,0.2774966369867401,0.7225033630132599,0.05355198257638844
17924,,503,10689,11192,14,602,15360,4343,11017,15360,1084,0.03274739583333333,0.6958984375,0.0009114583333333333,0.28274739583333336,0.7172526041666667,0.03919270833333333
17925,33.0,59,1872,1931,0,78,2600,763,1837,2600,189,0.022692307692307692,0.72,0.0,0.29346153846153844,0.7065384615384616,0.03
17926,15.0,1253,25332,26585,99,2023,37086,10233,26853,37086,2812,0.03378633446583616,0.6830609933667692,0.0026694709593916843,0.2759262255298495,0.7240737744701504,0.05454888637221593
17927,24.0,333,10714,11047,5,818,14596,3914,10682,14596,989,0.022814469717730886,0.7340367223896959,0.0003425596053713346,0.26815565908468075,0.7318443409153192,0.05604275143875034
17928,48.0,1231,46172,47403,106,1839,61143,18331,42812,61143,4747,0.020133130530068856,0.7551477683463357,0.0017336408092504456,0.29980537428650866,0.7001946257134913,0.030077032530297827
17929,,175,3975,4150,16,266,5649,1579,4070,5649,387,0.030978934324659233,0.7036643653744026,0.0028323597096831295,0.27951849884935387,0.7204815011506461,0.04708798017348203
17930,14.0,112,5087,5199,30,206,6990,2038,4952,6990,626,0.01602288984263233,0.7277539341917024,0.004291845493562232,0.2915593705293276,0.7084406294706724,0.029470672389127324
17931,42.0,34,12179,12213,25,431,16085,4664,11421,16085,1637,0.002113770593720858,0.7571650606154803,0.001554243083618278,0.28995958967982594,0.7100404103201741,0.026795150761579112
17932,,326,7574,7900,5,496,10644,2976,7668,10644,875,0.030627583615182263,0.7115745960165352,0.00046974821495678314,0.27959413754227735,0.7204058624577226,0.04659902292371289
17933,17.0,54,1417,1471,3,74,1966,556,1410,1966,166,0.027466937945066123,0.7207527975584944,0.001525940996948118,0.28280773143438453,0.7171922685656155,0.03763987792472025
17934,17.0,85,2864,2949,6,112,3857,1101,2756,3857,289,0.022037853253824215,0.7425460202229712,0.00155561317085818,0.28545501685247604,0.714544983147524,0.029038112522686024
17935,24.0,1670,27334,29004,523,1496,38914,10921,27993,38914,2209,0.04291514621986946,0.7024207226191088,0.013439893097599836,0.28064449812406844,0.7193555018759316,0.03844374775145192
17936,35.0,638,13824,14462,106,835,19655,5595,14060,19655,1509,0.03245993385906894,0.7033324853726787,0.005393029763418977,0.28466039175782243,0.7153396082421776,0.04248282879674383
17937,17.0,68,1456,1524,5,62,2014,573,1441,2014,171,0.033763654419066536,0.7229394240317776,0.0024826216484607746,0.2845084409136048,0.7154915590863953,0.030784508440913606
17938,27.0,116,4767,4883,11,227,6418,1849,4569,6418,492,0.01807416640698037,0.7427547522592708,0.0017139295730757246,0.2880959800560922,0.7119040199439077,0.03536927391710813
17939,23.0,2729,33407,36136,453,1897,49142,13606,35536,49142,2990,0.05553294534206992,0.6798054617231696,0.009218184038093687,0.2768711082170038,0.7231288917829962,0.03860241748402588
17940,,186,1758,1944,10,134,2626,747,1879,2626,192,0.07083015993907082,0.6694592536176694,0.003808073115003808,0.28446306169078445,0.7155369383092155,0.051028179741051026
17941,24.0,488,14536,15024,55,707,19661,5657,14004,19661,1541,0.024820711052337113,0.7393316718376481,0.002797416204669142,0.2877269721784243,0.7122730278215758,0.035959513758201514
17942,26.0,223,10116,10339,45,361,13252,3954,9298,13252,1071,0.01682764865680652,0.7633564744944159,0.0033957138545125266,0.29837005734983396,0.701629942650166,0.02724117114397827
17943,,14,1928,1942,2,106,2576,759,1817,2576,208,0.005434782608695652,0.7484472049689441,0.0007763975155279503,0.29464285714285715,0.7053571428571429,0.04114906832298137
17944,,301,7303,7604,20,318,9960,2862,7098,9960,765,0.030220883534136544,0.7332329317269076,0.002008032128514056,0.28734939759036143,0.7126506024096385,0.031927710843373494
17945,,534,12273,12807,38,893,17154,4635,12519,17154,1125,0.03112976565232599,0.7154599510318294,0.0022152267692666433,0.270199370409234,0.729800629590766,0.05205782907776612
17946,,1426,3392,4818,10,756,6700,1785,4915,6700,99,0.2128358208955224,0.506268656716418,0.0014925373134328358,0.2664179104477612,0.7335820895522388,0.11283582089552238
17947,17.0,304,8160,8464,44,330,10899,3201,7698,10899,761,0.02789246719882558,0.7486925406000551,0.00403706762088265,0.2936966694192128,0.7063033305807872,0.030278007156619872
17948,17.0,464,4532,4996,26,267,6744,1909,4835,6744,485,0.06880189798339265,0.6720047449584816,0.003855278766310795,0.2830664294187426,0.7169335705812574,0.03959074733096085
17949,,117,3709,3826,13,133,5124,1541,3583,5124,457,0.022833723653395786,0.7238485558157689,0.002537080405932865,0.3007416081186573,0.6992583918813428,0.025956284153005466
17950,25.0,2148,40137,42285,213,2311,56234,15800,40434,56234,4093,0.03819753174236227,0.7137496888003699,0.0037877440694241917,0.2809688089056443,0.7190311910943558,0.041096134011452144
17951,,3517,50508,54025,498,3394,75879,20853,55026,75879,5324,0.046350110043622085,0.66563871426877,0.006563080694263235,0.2748191199146009,0.7251808800853992,0.04472910818540044
17952,34.0,4819,135192,140011,932,6947,186150,53650,132500,186150,11508,0.025887724952994896,0.7262530217566479,0.005006715014773033,0.28820843405855495,0.7117915659414451,0.037319366102605424
17953,16.0,372,11785,12157,82,1581,17205,4588,12617,17205,1072,0.021621621621621623,0.6849752978785237,0.0047660563789596044,0.26666666666666666,0.7333333333333333,0.0918918918918919
17954,16.0,175,20067,20242,91,2621,28683,7705,20978,28683,1957,0.006101174911968762,0.6996130111912979,0.003172610954223756,0.2686260154098246,0.7313739845901753,0.09137816825297214
17955,17.0,2345,31260,33605,391,2484,46975,12777,34198,46975,2815,0.04992017030335285,0.6654603512506653,0.008323576370409792,0.2719957424161788,0.7280042575838211,0.052879191059073974
17956,,482,13065,13547,0,668,17949,4953,12996,17949,1606,0.02685386372499861,0.7278957044960722,0.0,0.2759485208089587,0.7240514791910413,0.037216558025516745
17957,35.0,861,15416,16277,189,1059,22109,5961,16148,22109,1280,0.03894341670812791,0.6972726039169569,0.008548554887150029,0.26961870731376364,0.7303812926862364,0.04789904563752318
17958,,1886,39271,41157,185,1936,54324,15701,38623,54324,4383,0.03471762020469774,0.7229033208158456,0.0034054929681172227,0.2890251086076136,0.7109748913923865,0.035638023709594284
17959,15.0,41,1521,1562,17,182,2240,590,1650,2240,163,0.01830357142857143,0.6790178571428571,0.007589285714285714,0.26339285714285715,0.7366071428571429,0.08125
17960,26.0,112,3200,3312,62,186,4598,1244,3354,4598,336,0.02435841670291431,0.6959547629404089,0.013484123531970421,0.27055241409308395,0.729447585906916,0.040452370595911266
17961,23.0,55,1454,1509,3,77,2181,594,1587,2181,184,0.02521779000458505,0.6666666666666666,0.001375515818431912,0.2723521320495186,0.7276478679504814,0.03530490600641907
17962,13.0,1452,8405,9857,110,1516,14533,3667,10866,14533,746,0.09991054840707356,0.5783389527282736,0.007568980939929815,0.25232230097020575,0.7476776990297943,0.10431431913575999
17963,17.0,1870,47960,49830,300,2311,63997,19292,44705,63997,4289,0.029220119693110613,0.7494101285997781,0.004687719736862665,0.3014516305451818,0.6985483694548182,0.03611106770629873
17964,24.0,43,4164,4207,30,182,5415,1647,3768,5415,465,0.007940904893813482,0.7689750692520776,0.00554016620498615,0.3041551246537396,0.6958448753462604,0.03361034164358264
17965,16.0,1282,25382,26664,26,1476,36140,10271,25869,36140,2710,0.03547315993359159,0.7023242944106254,0.0007194244604316547,0.28420033204205863,0.7157996679579414,0.04084117321527393
17966,14.0,110,3008,3120,9,240,4209,1202,3007,4209,330,0.02613447374673319,0.7146590639106676,0.0021382751247327157,0.2855785222143027,0.7144214777856973,0.05702066999287242
17967,,78,4188,4266,2,190,5607,1716,3891,5607,512,0.013911182450508293,0.7469234884965222,0.0003566969859104691,0.30604601391118247,0.6939539860888175,0.03388621366149456
17968,13.0,278,5233,5511,7,827,7964,1823,6141,7964,463,0.03490708186840784,0.6570818684078352,0.0008789552988448016,0.22890507282772476,0.7710949271722752,0.1038422903063787
17969,15.0,90,2350,2440,3,113,3373,954,2419,3373,288,0.026682478505781204,0.696709160984287,0.0008894159501927068,0.28283427216128076,0.7171657278387192,0.03350133412392529
17970,17.0,261,4985,5246,37,262,6943,1982,4961,6943,568,0.03759181909837246,0.7179893417830909,0.005329108454558548,0.2854673772144606,0.7145326227855394,0.03773584905660377
17971,,1506,31705,33211,182,1789,43600,12345,31255,43600,2900,0.03454128440366973,0.7271788990825688,0.004174311926605505,0.2831422018348624,0.7168577981651376,0.04103211009174312
17972,,546,12759,13305,7,566,17702,5117,12585,17702,1385,0.030843972432493504,0.7207660151395322,0.000395435544006327,0.289063382668625,0.710936617331375,0.03197378827251158
17973,,126,4988,5114,32,406,6872,1936,4936,6872,434,0.018335273573923165,0.7258440046565774,0.004656577415599534,0.2817229336437718,0.7182770663562281,0.059080325960419094
17974,25.0,165,3119,3284,8,340,4507,1086,3421,4507,109,0.03660971821610828,0.6920346128244952,0.0017750166407810074,0.24095850898602175,0.7590414910139782,0.0754382072331928
17975,25.0,410,7054,7464,29,345,9910,2760,7150,9910,628,0.04137235116044399,0.7118062563067609,0.0029263370332996974,0.2785065590312815,0.7214934409687185,0.03481331987891019
17976,,110,2303,2413,5,90,3317,908,2409,3317,221,0.03316249623153452,0.6943020801929455,0.0015073861923424782,0.27374133252939403,0.726258667470606,0.027132951462164608
17977,16.0,70,2090,2160,11,83,2855,845,2010,2855,280,0.024518388791593695,0.7320490367775832,0.003852889667250438,0.29597197898423816,0.7040280210157618,0.02907180385288967
17978,24.0,1265,30168,31433,122,1758,42928,11845,31083,42928,3004,0.029467946328736488,0.7027581065970928,0.0028419679463287367,0.27592713380544165,0.7240728661945584,0.040952292210212446
17979,25.0,66,12481,12547,15,702,16573,4795,11778,16573,1445,0.00398238098111386,0.7530923791709407,0.0009050865866167863,0.28932601218849935,0.7106739878115006,0.0423580522536656
17980,16.0,197,1649,1846,11,113,2653,710,1943,2653,172,0.07425555974368639,0.6215604975499435,0.0041462495288352805,0.2676215604975499,0.7323784395024501,0.042593290614398795
17981,23.0,761,20859,21620,45,1169,28462,8156,20306,28462,2188,0.026737404258309325,0.7328718993746047,0.0015810554423441783,0.28655751528353596,0.7134424847164641,0.041072306935563206
17982,34.0,144,4143,4287,23,197,5632,1598,4034,5632,436,0.02556818181818182,0.7356178977272727,0.004083806818181818,0.28373579545454547,0.7162642045454546,0.034978693181818184
17983,23.0,5165,111226,116391,353,9387,157558,42863,114695,157558,10845,0.0327815788471547,0.7059368613462979,0.0022404447885857907,0.2720458497823024,0.7279541502176976,0.059578060142931495
17984,24.0,63,1415,1478,6,52,1986,591,1395,1986,163,0.03172205438066465,0.7124874118831823,0.0030211480362537764,0.297583081570997,0.702416918429003,0.026183282980866064
17985,15.0,493,9630,10123,66,661,14206,3815,10391,14206,1006,0.03470364634661411,0.6778825848233141,0.004645924257356047,0.26854850063353514,0.7314514993664649,0.04652963536533859
17986,13.0,569,25259,25828,116,2006,36115,9747,26368,36115,2954,0.015755226360238128,0.6994046794960542,0.0032119617887304444,0.2698878582306521,0.7301121417693479,0.055544787484424755
17987,15.0,125,3493,3618,35,144,4815,1356,3459,4815,401,0.02596053997923157,0.725441329179647,0.007268951194184839,0.28161993769470406,0.7183800623052959,0.029906542056074768
17988,16.0,1826,41115,42941,216,1812,57797,16208,41589,57797,4797,0.03159333529421942,0.7113691022025365,0.0037372181947159886,0.28042978009239233,0.7195702199076076,0.03135110818900635
17989,16.0,132,1765,1897,3,60,2583,769,1814,2583,195,0.05110336817653891,0.6833139759969028,0.0011614401858304297,0.29771583430120013,0.7022841656987998,0.023228803716608595
17990,24.0,280,7612,7892,12,308,10217,3069,7148,10217,688,0.027405304884016834,0.745032788489772,0.0011745130664578642,0.3003817167465988,0.6996182832534011,0.03014583537241852
17991,13.0,128,27796,27924,68,2998,38514,10398,28116,38514,2460,0.003323466791296671,0.7217115853975178,0.0017655917328763566,0.26997974762424054,0.7300202523757595,0.07784182375240173
17992,25.0,146,3547,3693,0,199,4768,1387,3381,4768,296,0.030620805369127518,0.7439177852348994,0.0,0.2908976510067114,0.7091023489932886,0.04173657718120805
17993,26.0,130,4140,4270,14,222,5659,1647,4012,5659,506,0.02297225658243506,0.7315780173175472,0.0024739353242622373,0.2910408199328503,0.7089591800671496,0.03922954585615833
17994,17.0,179,12875,13054,25,377,17009,4983,12026,17009,1519,0.010523840319830677,0.7569522017755306,0.0014698101005350109,0.29296254923863835,0.7070374507613616,0.022164736316067964
17995,,703,16507,17210,85,664,22819,6558,16261,22819,1884,0.030807660283097418,0.7233884043998422,0.003724966037074368,0.2873920855427495,0.7126079144572506,0.029098558219028004
17996,,97,2870,2967,16,104,3815,1150,2665,3815,250,0.025425950196592398,0.7522935779816514,0.0041939711664482305,0.30144167758846657,0.6985583224115334,0.0272608125819135
17997,,1074,23125,25454,175,2326,36136,9043,27101,36144,2073,0.029714475431606907,0.6398019034971226,0.00484174413457282,0.25019366976538293,0.7498063302346171,0.06435369632580788
17998,16.0,937,19599,20536,109,1335,28579,7767,20812,28579,1869,0.032786311627418734,0.68578326743413,0.0038139892928373983,0.2717729801602575,0.7282270198397425,0.04671262115539382
17999,25.0,100,6382,6482,51,395,8824,2430,6394,8824,644,0.011332728921124207,0.7232547597461468,0.005779691749773346,0.27538531278331824,0.7246146872166818,0.04476427923844062
18000,15.0,451,2986,3437,9,367,4760,1199,3561,4760,354,0.09474789915966386,0.6273109243697479,0.0018907563025210084,0.251890756302521,0.748109243697479,0.07710084033613446
18001,23.0,377,10274,10651,28,507,14215,4005,10210,14215,976,0.026521280337671475,0.7227576503693282,0.001969750263805839,0.2817446359479423,0.7182553640520577,0.03566654941962715
18002,17.0,112,4077,4189,18,274,5513,1578,3935,5513,384,0.020315617631053873,0.7395247596589879,0.0032650099764193726,0.2862325412660983,0.7137674587339017,0.049700707418828226
18003,41.0,851,9018,9869,286,653,13461,3840,9621,13461,751,0.06321967164400862,0.6699353688433252,0.021246564148280217,0.2852685535992868,0.7147314464007132,0.04851051184904539
18004,16.0,75,2376,2451,3,122,3204,924,2280,3204,249,0.023408239700374533,0.7415730337078652,0.0009363295880149813,0.2883895131086142,0.7116104868913857,0.038077403245942575
18005,35.0,1026,37016,38042,432,1414,49565,14700,34865,49565,3696,0.020700090789871884,0.7468173106022394,0.008715827700998689,0.29658024815898315,0.7034197518410168,0.02852819529910219
18006,23.0,1653,30242,31895,30,1690,42153,12067,30086,42153,3108,0.039214290797807985,0.7174341090788319,0.0007116931179275497,0.2862666951343914,0.7137333048656086,0.040092045643251965
18007,27.0,246,5058,5304,30,374,7319,2011,5308,7319,452,0.03361114906407979,0.6910780161224211,0.004098920617570706,0.2747643120644897,0.7252356879355103,0.051099877032381474
18008,17.0,211,13149,13360,64,672,17720,5029,12691,17720,1542,0.01190744920993228,0.7420428893905192,0.0036117381489841984,0.283803611738149,0.7161963882618511,0.037923250564334085
18009,17.0,254,2781,3035,2,339,4262,1121,3141,4262,272,0.059596433599249175,0.6525105584232754,0.0004692632566870014,0.2630220553730643,0.7369779446269357,0.07954012200844673
18010,26.0,228,19947,20175,7,833,25697,7544,18153,25697,2102,0.008872631046425652,0.776238471416897,0.00027240533914464724,0.29357512550103126,0.7064248744989687,0.03241623535821302
18011,16.0,332,7754,8086,22,542,10883,3129,7754,10883,851,0.030506294220343656,0.7124873656160985,0.0020215014242396397,0.2875126343839015,0.7124873656160985,0.049802444178994765
18012,23.0,574,13719,14293,70,741,19243,5415,13828,19243,1562,0.029829028737722807,0.7129345736111833,0.0036376864314296106,0.2814010289455906,0.7185989710544094,0.03850750922413345
18013,,76,1545,1621,8,86,2173,610,1563,2173,146,0.034974689369535204,0.7109986194201565,0.0036815462494247586,0.28071790151863785,0.7192820984813622,0.039576622181316155
18014,,1060,29047,30107,38,1264,39035,11419,27616,39035,2871,0.027155117202510567,0.7441270654540797,0.0009734853336749071,0.2925323427693096,0.7074676572306904,0.03238119636223902
18015,37.0,604,16420,17024,208,622,21860,6528,15332,21860,1430,0.027630375114364135,0.7511436413540714,0.009515096065873741,0.29862763037511436,0.7013723696248856,0.028453796889295516
18016,,155,5003,5158,2,163,6837,2020,4817,6837,629,0.022670762030130173,0.7317536931402662,0.000292525961679099,0.29545122129589,0.70454877870411,0.02384086587684657
18017,16.0,134,2026,2160,9,135,2972,852,2120,2972,206,0.04508748317631225,0.6816958277254375,0.003028263795423957,0.28667563930013457,0.7133243606998654,0.04542395693135935
18018,16.0,178,5823,6001,20,434,8235,2259,5976,8235,592,0.02161505768063145,0.7071038251366121,0.0024286581663630845,0.2743169398907104,0.7256830601092896,0.05270188221007893
18019,,40,1672,1712,7,121,2321,628,1693,2321,165,0.017233950883239983,0.7203791469194313,0.003015941404566997,0.27057302886686774,0.7294269711331323,0.052132701421800945
18020,,99,6218,6317,36,159,8392,2396,5996,8392,797,0.011796949475691135,0.7409437559580553,0.004289799809342231,0.28551000953288846,0.7144899904671115,0.01894661582459485
18021,15.0,80,2517,2597,23,101,3464,1024,2440,3464,284,0.023094688221709007,0.7266166281755196,0.0066397228637413395,0.2956120092378753,0.7043879907621247,0.02915704387990762
18022,24.0,170,5238,5408,27,182,7022,2078,4944,7022,527,0.0242096268869268,0.7459413272571916,0.0038450583879236686,0.29592708630019937,0.7040729136998006,0.025918541726003986
18023,14.0,73,2057,2130,5,155,3035,828,2207,3035,207,0.024052718286655683,0.6777594728171334,0.0016474464579901153,0.2728171334431631,0.727182866556837,0.051070840197693576
18024,,1890,32813,34703,217,1567,50237,12764,37473,50237,2710,0.03762167326870633,0.6531640026275455,0.004319525449369986,0.2540756812707765,0.7459243187292235,0.03119214921273165
18025,,747,3525,4272,9,324,5928,1642,4286,5928,381,0.12601214574898786,0.5946356275303644,0.0015182186234817814,0.27699055330634276,0.7230094466936572,0.05465587044534413
18026,24.0,5,1689,1694,0,65,2198,650,1548,2198,205,0.0022747952684258415,0.7684258416742493,0.0,0.29572338489535943,0.7042766151046406,0.029572338489535943
18027,43.0,84,1659,1743,13,97,2361,674,1687,2361,216,0.035578144853875476,0.7026683608640406,0.005506141465480729,0.28547225751800087,0.7145277424819991,0.041084286319356206
18028,36.0,173,4530,4703,29,246,6169,1836,4333,6169,428,0.02804344302155941,0.7343167450153996,0.004700923974712271,0.297617117847301,0.702382882152699,0.039876803371697196
18029,13.0,283,6733,7016,29,476,9325,2682,6643,9325,654,0.0303485254691689,0.7220375335120643,0.0031099195710455763,0.28761394101876675,0.7123860589812332,0.051045576407506704
18030,26.0,146,2834,2980,20,33,3864,1165,2699,3864,271,0.03778467908902691,0.7334368530020704,0.005175983436853002,0.30150103519668736,0.6984989648033126,0.008540372670807454
18031,17.0,220,3765,3985,13,337,5455,1485,3970,5455,382,0.04032997250229148,0.69019248395967,0.002383134738771769,0.27222731439046743,0.7277726856095326,0.0617781851512374
18032,,120,4998,5118,6,161,6678,1943,4735,6678,413,0.017969451931716084,0.7484276729559748,0.0008984725965858042,0.29095537586103626,0.7090446241389637,0.02410901467505241
18033,17.0,24621,277806,302427,1391,32755,442038,115952,326086,442038,26638,0.05569883132219402,0.6284663309489229,0.003146788285170053,0.26231228989362904,0.7376877101063709,0.07409996425646664
18034,24.0,222,4675,4897,19,256,6626,1918,4708,6626,570,0.03350437669785693,0.7055538786598249,0.0028674916993661334,0.2894657410202234,0.7105342589797766,0.03863567763356474
18035,,128,1860,1988,2,213,2739,770,1969,2739,163,0.046732384081781674,0.6790799561883899,0.0007301935012778386,0.28112449799196787,0.7188755020080321,0.07776560788608981
18036,,489,12680,13169,33,652,17376,5023,12353,17376,1346,0.028142265193370167,0.7297421731123389,0.001899171270718232,0.2890768876611418,0.7109231123388582,0.03752302025782689
18037,23.0,203,6987,7190,18,351,9332,2760,6572,9332,655,0.021753107586798114,0.7487141020145736,0.0019288469781397343,0.2957565366480926,0.7042434633519075,0.03761251607372482
18038,26.0,36,4313,4349,0,171,5783,1641,4142,5783,541,0.006225142659519281,0.745806674736296,0.0,0.28376275289642056,0.7162372471035795,0.029569427632716583
18039,,261,2849,3110,19,191,4299,1174,3125,4299,293,0.06071179344033496,0.6627122586648058,0.004419632472668062,0.2730867643638055,0.7269132356361945,0.044428936962084206
18040,16.0,1058,21707,22765,83,1960,31075,8586,22489,31075,2216,0.03404666130329847,0.6985358004827031,0.002670957361222848,0.27629927594529363,0.7237007240547063,0.06307320997586484
18041,13.0,1319,3091,4410,31,603,6507,1516,4991,6507,224,0.20270477946826496,0.47502689411403104,0.004764100199784847,0.23297986783463961,0.7670201321653604,0.09266943291839558
18042,17.0,673,7865,8538,69,805,11941,3331,8610,11941,608,0.056360438824219074,0.6586550540155766,0.005778410518382045,0.27895486140189263,0.7210451385981074,0.06741478938112386
18043,23.0,927,7457,8384,243,339,11021,3142,7879,11021,541,0.08411214953271028,0.6766173668451139,0.022048815896924055,0.2850920969059069,0.7149079030940931,0.030759459214227385
18044,,15971,363328,379299,634,14588,503742,144452,359290,503742,39184,0.031704721861587876,0.7212581043470666,0.0012585807814317646,0.2867579038476045,0.7132420961523954,0.028959268832060858
18045,15.0,426,2699,3125,30,275,4333,1210,3123,4333,176,0.0983152550196169,0.6228940687745211,0.006923609508423725,0.27925225017309024,0.7207477498269098,0.06346642049388415
18046,,362,16115,16477,0,793,21162,6068,15094,21162,1521,0.017106133635762216,0.7615064738682544,0.0,0.286740383706644,0.713259616293356,0.03747282865513656
18047,,81,1504,1585,7,46,2116,596,1520,2116,201,0.03827977315689981,0.7107750472589792,0.0033081285444234404,0.28166351606805295,0.718336483931947,0.021739130434782608
18048,,443,21260,21703,139,1380,29523,8264,21259,29523,2494,0.01500525014395556,0.720116519323917,0.004708193611760322,0.27991735257257055,0.7200826474274294,0.04674321715272838
18049,27.0,328,8224,8552,48,644,11292,3079,8213,11292,671,0.029047113000354233,0.7283032235210769,0.004250797024442083,0.2726709174636911,0.7273290825363089,0.057031526744597945
18050,,42,1473,1515,0,98,1985,543,1442,1985,153,0.02115869017632242,0.7420654911838791,0.0,0.27355163727959697,0.726448362720403,0.04937027707808564
18051,14.0,255,25286,25541,129,1721,34259,9744,24515,34259,3029,0.007443299570915672,0.7380834233340144,0.0037654339005808693,0.2844216118392247,0.7155783881607752,0.05023497475116028
18052,15.0,154,3196,3350,36,226,4524,1250,3274,4524,287,0.03404067197170645,0.7064544650751547,0.007957559681697613,0.27630415561450045,0.7236958443854996,0.04995579133510168
18053,,311,6965,7276,87,374,9753,2762,6991,9753,727,0.03188762432072183,0.7141392392084487,0.008920332205475239,0.28319491438531735,0.7168050856146827,0.03834717522813493
18054,,1165,42241,43406,357,2314,61104,16476,44628,61104,5007,0.01906585493584708,0.691296805446452,0.005842498036135114,0.26963864886095834,0.7303613511390417,0.03786986122021472
18055,14.0,25,2974,2999,16,189,4128,1123,3005,4128,364,0.006056201550387597,0.7204457364341085,0.003875968992248062,0.27204457364341084,0.7279554263565892,0.04578488372093023
18056,,118,6521,6639,0,216,8316,2534,5782,8316,575,0.01418951418951419,0.7841510341510342,0.0,0.3047138047138047,0.6952861952861953,0.025974025974025976
18057,,124,2069,2193,72,167,3021,844,2177,3021,170,0.04104601125455147,0.684872558755379,0.023833167825223437,0.2793776895067858,0.7206223104932141,0.05527970870572658
18058,16.0,164,2991,3155,10,229,4627,1194,3433,4627,269,0.035444132267127726,0.6464231683596283,0.002161227577263886,0.25805057272530796,0.741949427274692,0.049492111519342984
18059,,136,2621,2757,8,76,3710,1166,2544,3710,170,0.036657681940700806,0.7064690026954178,0.00215633423180593,0.3142857142857143,0.6857142857142857,0.020485175202156335
18060,,127,2016,2143,2,77,2798,821,1977,2798,258,0.045389563974267334,0.7205146533238027,0.0007147962830593281,0.2934238741958542,0.7065761258041459,0.027519656897784132
18061,24.0,1306,34298,35604,24,1144,47192,13996,33196,47192,4337,0.027674182064756737,0.7267757246991016,0.0005085607730123749,0.29657569079505003,0.70342430920495,0.024241396846923207
18062,23.0,224,6668,6892,6,302,9048,2676,6372,9048,817,0.02475685234305924,0.7369584438549955,0.000663129973474801,0.2957559681697613,0.7042440318302388,0.033377541998231654
18063,23.0,492,9791,10283,91,495,13691,3883,9808,13691,1012,0.03593601636111314,0.7151413337228837,0.006646702213132715,0.2836169746548828,0.7163830253451172,0.036155138412095535
18064,25.0,5731,110831,116562,4173,7158,157745,44944,112801,157745,10731,0.03633078702969983,0.7025959618371422,0.026454087292782657,0.28491552822593424,0.7150844717740658,0.045377032552537326
18065,23.0,1664,49537,51201,155,2581,67811,19236,48575,67811,5558,0.024538791641474097,0.7305156980430904,0.002285764846411349,0.28367079087463687,0.7163292091253631,0.03806167141024318
18066,,311,6406,6717,62,211,9082,2570,6512,9082,737,0.03424355868751376,0.7053512442193349,0.006826690156353226,0.282977317771416,0.717022682228584,0.023232768112750494
18067,,123,3106,3229,3,74,4214,1285,2929,4214,404,0.02918841955386806,0.7370669197911723,0.0007119126720455624,0.3049359278595159,0.695064072140484,0.017560512577123873
18068,,271,3689,3960,23,207,5864,1541,4323,5864,375,0.04621418826739427,0.6290927694406548,0.003922237380627558,0.26278990450204637,0.7372100954979536,0.03530013642564802
18069,,608,9950,10558,102,552,14816,3976,10840,14816,988,0.04103671706263499,0.6715712742980562,0.006884449244060475,0.2683585313174946,0.7316414686825053,0.03725701943844492
18070,17.0,190,13148,13338,48,1660,18342,5012,13330,18342,1241,0.01035873950496129,0.7168247737433213,0.0026169447170428526,0.27325264420455786,0.7267473557954421,0.09050267146439865
18071,,274,7831,8105,2,1513,11902,3180,8722,11902,809,0.023021340951100654,0.6579566459418585,0.00016803898504453034,0.26718198622080325,0.7328180137791968,0.1271214921861872
18072,,200,2638,2838,21,128,3884,1062,2822,3884,246,0.05149330587023687,0.6791967044284243,0.005406797116374871,0.27342945417095776,0.7265705458290422,0.032955715756951595
18073,24.0,3932,47271,51203,393,5132,71320,19399,51921,71320,4613,0.0551318003365115,0.6628014582164891,0.005510375771172181,0.2719994391475042,0.7280005608524958,0.07195737521031968
18074,35.0,110,8164,8274,32,357,11057,3170,7887,11057,980,0.009948448946368815,0.7383557927105001,0.0028940942389436555,0.2866962105453559,0.7133037894546441,0.03228723885321516
18075,14.0,1562,36079,37641,174,3627,53397,13983,39414,53397,3664,0.029252579732943797,0.6756746633706013,0.0032586100342715885,0.2618686443058599,0.7381313556941401,0.067925164335075
18076,,99,3394,3493,35,477,5071,1320,3751,5071,212,0.019522776572668113,0.6692959968448038,0.006901991717609939,0.2603036876355748,0.7396963123644251,0.09406428712285546
18077,44.0,142,2722,2864,52,149,3862,1069,2793,3862,252,0.03676851372345935,0.7048161574313827,0.013464526152252718,0.2767995857068876,0.7232004142931123,0.038581046090108755
18078,27.0,215,5489,5704,25,353,7533,2183,5350,7533,522,0.02854108588875614,0.7286605602017788,0.0033187309172972254,0.28979158369839375,0.7102084163016062,0.04686048055223682
18079,15.0,127,3678,3805,17,318,5171,1434,3737,5171,392,0.024560046412686134,0.7112744150067685,0.0032875652678398763,0.27731579965190484,0.7226842003480951,0.061496809127828275
18080,,150,3160,3310,32,142,4505,1225,3280,4505,282,0.033296337402885685,0.7014428412874584,0.007103218645948946,0.27192008879023305,0.7280799112097669,0.031520532741398447
18081,14.0,766,10394,11160,57,829,15757,4152,11605,15757,1057,0.04861331471726851,0.6596433331217871,0.0036174398679951767,0.2635019356476487,0.7364980643523513,0.052611537729263184
18082,16.0,605,8868,9473,67,565,12569,3564,9005,12569,885,0.04813429867133424,0.7055453894502347,0.005330575224759329,0.2835547776274962,0.7164452223725037,0.04495186570132866
18083,15.0,5367,56414,61781,495,6908,84709,25323,59386,84709,2856,0.06335808473715898,0.665974099564391,0.005843534925450661,0.29894108064078195,0.701058919359218,0.08154977629295589
18084,16.0,945,85955,86900,202,7698,117066,33477,83589,117066,10505,0.008072369432627749,0.7342439307740932,0.0017255223549109049,0.28596689047204144,0.7140331095279586,0.06575777766388191
18085,,144,1564,1708,24,114,2762,616,2146,2762,145,0.05213613323678494,0.5662563359884142,0.008689355539464157,0.22302679217958002,0.77697320782042,0.041274438812454746
18086,23.0,801,20823,21624,145,735,28643,8136,20508,28644,2366,0.027963971512358608,0.7269585253456221,0.005062142158916353,0.28403854210305823,0.7159614578969418,0.025659824046920823
18087,14.0,167,5277,5444,11,268,7493,2136,5357,7493,557,0.022287468303750165,0.7042573068196983,0.0014680368343787534,0.28506606165754705,0.714933938342453,0.035766715601227815
18088,,264,7014,7278,36,302,9574,2741,6833,9574,692,0.027574681428869856,0.7326091497806559,0.003760183831209526,0.2862962189262586,0.7137037810737413,0.03154376436181324
18089,,1719,39386,41105,189,2277,55021,15475,39546,55021,4064,0.03124261645553516,0.7158357717962233,0.0034350520710274258,0.28125624761454715,0.7187437523854528,0.04138419876047327
18090,27.0,271,3692,3963,30,267,5456,1525,3931,5456,405,0.04967008797653959,0.6766862170087976,0.005498533724340176,0.2795087976539589,0.720491202346041,0.048936950146627564
18091,17.0,517,10104,10621,54,556,14680,3998,10682,14680,1076,0.03521798365122616,0.688283378746594,0.003678474114441417,0.2723433242506812,0.7276566757493188,0.037874659400544956
18092,,111,2628,2739,16,123,3566,1041,2525,3566,222,0.031127313516545147,0.7369601794727987,0.00448681996634885,0.29192372406057204,0.7080762759394279,0.034492428491306786
18093,25.0,299,6326,6625,31,273,8852,2450,6402,8852,745,0.03377767736104835,0.7146407591504744,0.0035020334387708993,0.27677361048350657,0.7232263895164934,0.030840488025305014
18094,15.0,125,1814,1939,5,131,2530,746,1784,2530,153,0.04940711462450593,0.71699604743083,0.001976284584980237,0.2948616600790514,0.7051383399209487,0.05177865612648221
18095,16.0,197,3349,3546,29,187,5293,1380,3913,5293,370,0.03721896844889477,0.632722463631211,0.005478934441715474,0.2607217079161156,0.7392782920838844,0.03532968071037219
18096,15.0,1947,31652,33599,261,3101,45806,12585,33221,45806,2843,0.04250534864428241,0.6910011788848622,0.005697943500851417,0.2747456665065712,0.7252543334934288,0.0676985547744837
18097,14.0,4055,56616,60671,379,4956,84995,23263,61740,85003,5536,0.04770419867534087,0.6660470806912697,0.004458666164723598,0.273672693904921,0.726327306095079,0.0583038245708975
18098,24.0,1261,8036,9297,79,535,12728,3550,9178,12728,925,0.09907291011942175,0.6313639220615965,0.006206788183532369,0.27891263356379636,0.7210873664362036,0.04203331238214959
18099,43.0,2819,70334,73153,95,3952,98337,27631,70706,98337,8249,0.028666727681340695,0.7152343471938335,0.00096606567212748,0.2809827430163621,0.7190172569836379,0.04018833196050317
18100,,477,10559,11036,14,830,14874,4235,10639,14874,1030,0.03206938281565147,0.7098964636278069,0.0009412397472098965,0.28472502353099366,0.7152749764690063,0.055802070727443864
18101,,312,9581,9893,17,493,13115,3808,9307,13115,967,0.023789553945863514,0.7305375524208921,0.0012962256957682044,0.29035455585207776,0.7096454441479222,0.037590545177277924
18102,24.0,1036,24164,25200,65,1181,32605,9458,23147,32605,2048,0.03177426775034504,0.7411133261769667,0.001993559270050606,0.2900782088636712,0.7099217911363288,0.036221438429688696
18103,17.0,872,25971,26843,51,1534,36501,10244,26257,36501,2746,0.023889756445028904,0.7115147530204652,0.0013972219939179748,0.2806498452097203,0.7193501547902797,0.04202624585627791
18104,17.0,14751,276165,290916,1503,20428,399664,110827,288837,399664,27822,0.03690850314263982,0.6909929340646143,0.0037606589535209576,0.2773004323631851,0.722699567636815,0.05111293486528684
18105,23.0,445,12792,13237,36,576,17201,4904,12297,17201,1169,0.025870588919248882,0.7436776931573745,0.002092901575489797,0.28509970350561015,0.7149002964943899,0.033486425207836755
18106,,178,5496,5674,49,166,7597,2163,5434,7597,713,0.023430301434776885,0.7234434645254706,0.006449914439910491,0.28471765170462027,0.7152823482953797,0.0218507305515335
18107,17.0,5317,82558,87875,2536,8285,124012,33759,90254,124013,8071,0.042874537346891055,0.6657205292993477,0.020449469007281496,0.2722214606533186,0.7277785393466814,0.0668075121156653
18108,,239,4758,4997,22,219,6495,1916,4579,6495,437,0.036797536566589684,0.7325635103926097,0.0033872209391839878,0.2949961508852964,0.7050038491147036,0.033718244803695153
18109,26.0,65,8976,9041,11,741,12698,3400,9298,12698,1162,0.005118916364781855,0.7068829736966451,0.0008662781540400063,0.2677587021578201,0.7322412978421798,0.05835564655851315
18110,,11640,132735,144375,1362,12978,206218,55250,150968,206218,12477,0.056445121182438,0.6436635017311777,0.006604661086811045,0.26792035612798104,0.732079643872019,0.06293340057608938
18111,15.0,127,2092,2219,9,121,2915,828,2087,2915,188,0.04356775300171527,0.7176672384219555,0.0030874785591766723,0.28404802744425384,0.7159519725557462,0.04150943396226415
18112,,233,4008,4241,12,138,5705,1650,4055,5705,443,0.04084136722173532,0.7025416301489921,0.0021034180543382996,0.2892199824715162,0.7107800175284837,0.02418930762489045
18113,16.0,395,8607,9002,42,442,12368,3385,8983,12368,1073,0.0319372574385511,0.6959087968952135,0.0033958602846054335,0.2736901681759379,0.7263098318240621,0.03573738680465718
18114,38.0,399,8020,8419,24,128,11023,3340,7683,11023,935,0.03619704254740089,0.7275696271432459,0.0021772657171368957,0.3030028123015513,0.6969971876984487,0.01161208382473011
18115,37.0,257,3610,3867,31,183,5352,1470,3882,5352,408,0.04801943198804185,0.6745142002989537,0.0057922272047832585,0.27466367713004486,0.7253363228699552,0.034192825112107625
18116,,9772,334040,343812,3067,24382,459792,129248,330544,459792,30168,0.021253088352994397,0.7265024184848802,0.006670407488603543,0.28110101959146744,0.7188989804085325,0.053028325851689456
18117,24.0,1445,42187,43632,91,1713,57383,16520,40863,57383,4339,0.025181674014952162,0.7351828938884338,0.0015858355262011398,0.28789014167959154,0.7121098583204085,0.02985204677343464
18118,16.0,2036,77637,80128,200,5768,108828,30082,78746,108828,7981,0.01870842062704451,0.7133917741757636,0.001837762340574117,0.27641783364575295,0.7235821663542471,0.053001065902157536
18119,14.0,287,3749,4036,41,265,5701,1601,4100,5701,213,0.05034204525521838,0.6576039291352395,0.0071917207507454835,0.28082792492545167,0.7191720750745483,0.04648307314506227
18120,24.0,75,2635,2710,7,81,3561,1026,2535,3561,277,0.02106149957877001,0.7399606852007863,0.001965739960685201,0.2881213142375737,0.7118786857624263,0.02274641954507161
18121,23.0,717,8814,9531,98,562,12657,3642,9015,12657,908,0.05664849490400569,0.6963735482341787,0.007742751046851544,0.2877459113534013,0.7122540886465987,0.044402307023781305
18122,23.0,1021,31709,32730,21,1463,42984,12392,30592,42984,3233,0.023753024381165083,0.7376930951051555,0.0004885538805136795,0.2882933184440722,0.7117066815559278,0.03403592034245301
18123,25.0,644,4774,5418,122,304,7937,1997,5940,7937,455,0.0811389693838982,0.601486707824115,0.015371046995086304,0.251606400403175,0.7483935995968249,0.03830162529923145
18124,17.0,21496,224398,245894,21146,27779,364390,91368,273022,364390,21113,0.0589917396196383,0.6158182167457943,0.05803123027525454,0.25074233650758804,0.749257663492412,0.07623425450753314
18125,16.0,351,3962,4313,10,431,6014,1654,4360,6014,382,0.05836381775856335,0.6587961423345527,0.0016627868307283007,0.2750249418024609,0.724975058197539,0.07166611240438976
18126,25.0,275,7360,7635,13,452,10099,2915,7184,10099,706,0.027230418853351816,0.7287850282206159,0.0012872561639766314,0.2886424398455293,0.7113575601544707,0.04475690662441826
18127,,184,4131,4315,9,201,5884,1609,4275,5884,435,0.03127124405166554,0.7020734194425561,0.0015295717199184228,0.27345343303874914,0.7265465669612509,0.03416043507817811
18128,17.0,2976,33030,36006,988,2648,48678,13382,35296,48678,2767,0.06113644767656847,0.6785406138296561,0.02029664324746292,0.2749085829327417,0.7250914170672583,0.05439829080898969
18129,27.0,177,2321,2498,14,169,3560,931,2629,3560,279,0.049719101123595504,0.6519662921348315,0.003932584269662922,0.2615168539325843,0.7384831460674157,0.04747191011235955
18130,,639,12726,13365,42,721,17688,5213,12475,17688,1305,0.03612618724559023,0.7194708276797829,0.0023744911804613297,0.29471958389868835,0.7052804161013116,0.040762098597919495
18131,17.0,503,13883,14386,25,1038,19932,5458,14474,19932,1495,0.02523580172586795,0.6965181617499498,0.0012542644992976119,0.2738310254866546,0.7261689745133454,0.052077062010836846
18132,,120,4120,4240,2,71,5335,1649,3686,5335,424,0.022492970946579195,0.7722586691658857,0.00037488284910965324,0.3090909090909091,0.6909090909090909,0.01330834114339269
18133,17.0,91,2055,2146,73,127,3041,832,2209,3041,169,0.029924366984544558,0.6757645511344952,0.024005261427162118,0.27359421243012166,0.7264057875698783,0.04176257809930944
18134,,49,1571,1620,0,78,2171,614,1557,2171,148,0.022570244127130355,0.7236296637494243,0.0,0.28281897742975587,0.7171810225702441,0.03592814371257485
18135,13.0,130,1654,1784,15,227,2568,656,1912,2568,114,0.050623052959501556,0.6440809968847352,0.005841121495327103,0.2554517133956386,0.7445482866043613,0.08839563862928349
18136,,2625,33039,35664,314,2880,50178,13818,36360,50178,3182,0.052313763003706805,0.6584359679540834,0.006257722507871976,0.27537964845151264,0.7246203515484874,0.05739567140978118
18137,27.0,353,7943,8296,6,676,11242,2972,8270,11242,831,0.031400106742572494,0.7065468777797544,0.0005337128624799857,0.2643657712150863,0.7356342287849137,0.060131649172745064
18138,13.0,451,18439,18890,122,1033,25626,7147,18479,25626,1918,0.017599313197533755,0.7195426519940685,0.004760789822836182,0.2788964333099196,0.7211035666900804,0.04031062202450636
18139,15.0,159,1554,1713,23,82,2275,632,1643,2275,140,0.0698901098901099,0.683076923076923,0.01010989010989011,0.2778021978021978,0.7221978021978022,0.03604395604395604
18140,,2362,71128,73490,213,4607,98501,29114,69387,98501,5591,0.023979451985259033,0.7221043441183338,0.0021624145947756876,0.2955706033441285,0.7044293966558716,0.046771098770570854
18141,,470,7921,8391,271,903,12013,3211,8802,12013,763,0.039124282027803214,0.6593690168983601,0.02255889453092483,0.26729376508782154,0.7327062349121785,0.07516856738533256
18142,14.0,120,1785,1905,2,131,2558,737,1821,2558,188,0.04691164972634871,0.6978107896794371,0.0007818608287724785,0.28811571540265835,0.7118842845973417,0.051211884284597345
18143,,97,1518,1615,6,93,2191,602,1589,2191,163,0.04427202190780465,0.6928343222272935,0.0027384755819260614,0.2747603833865815,0.7252396166134185,0.04244637151985395
18144,14.0,19,4169,4188,19,587,6066,1578,4488,6066,346,0.0031322123310253873,0.6872733267392022,0.0031322123310253873,0.26013847675568746,0.7398615232443125,0.09676887570062644
18145,,293,8966,9259,14,432,11969,3422,8547,11969,814,0.024479906424931072,0.7491018464366279,0.0011696883616008021,0.2859052552427103,0.7140947447572896,0.036093240872253324
18146,,168,2403,2571,0,167,3546,937,2609,3546,184,0.047377326565143825,0.6776649746192893,0.0,0.26424139875916525,0.7357586012408347,0.04709531866892273
18147,,7516,258619,266135,700,17355,368827,102574,266253,368827,29961,0.0203781176540763,0.7011932423602394,0.0018979087756590487,0.2781087067920732,0.7218912932079268,0.0470545811450897
18148,34.0,23,1817,1840,0,60,2395,697,1698,2395,257,0.009603340292275574,0.7586638830897704,0.0,0.2910229645093946,0.7089770354906054,0.025052192066805846
18149,24.0,266,6087,6353,12,344,8353,2430,5923,8353,650,0.03184484616305519,0.7287202202801388,0.0014366096013408356,0.2909134442715192,0.7090865557284808,0.04118280857177062
18150,,24,1418,1442,13,70,1934,522,1412,1934,200,0.012409513960703205,0.733195449844881,0.00672182006204757,0.26990692864529475,0.7300930713547052,0.03619441571871768
18151,,177,4521,4698,6,148,5951,1805,4146,5951,469,0.02974290035288187,0.7597042513863216,0.001008233910267182,0.30331036800537725,0.6966896319946227,0.02486976978659049
18152,,443,7465,7908,77,534,11155,3067,8088,11155,973,0.03971313312415957,0.6692066337965038,0.006902734199910354,0.27494397131331244,0.7250560286866876,0.047870909905871804
18153,,510,11742,12252,8,653,15749,4664,11085,15749,1029,0.032383008444980634,0.7455711473744365,0.0005079687599212648,0.2961457870340974,0.7038542129659026,0.04146295002857324
18154,,268,5405,5673,8,271,7723,2163,5560,7723,587,0.034701540852000515,0.6998575683024731,0.001035866891104493,0.2800725106823773,0.7199274893176227,0.0350899909361647
18155,40.0,219,2978,3197,8,309,4858,1228,3630,4858,329,0.045080279950596956,0.6130094689172499,0.0016467682173734047,0.2527789213668176,0.7472210786331824,0.06360642239604776
18156,14.0,78,2825,2903,36,214,4159,1082,3077,4159,323,0.018754508295263286,0.6792498196681894,0.008655926905506131,0.26015869199326763,0.7398413080067324,0.05145467660495311
18157,,207,8558,8765,65,1267,12587,3241,9346,12587,771,0.016445539048224357,0.6799078414236911,0.005164058155239533,0.25748788432509734,0.7425121156749027,0.10065941050289982
18158,26.0,1064,15047,16111,35,750,21333,6119,15226,21345,1321,0.049847739517451396,0.704942609510424,0.0016397282736003748,0.28667135160459123,0.7133286483954088,0.035137034434293744
18159,,472,6095,6567,49,479,8869,2467,6402,8869,564,0.05321907768632315,0.6872251663096177,0.0055248618784530384,0.27815988273762543,0.7218401172623745,0.0540083436689593
18160,24.0,226,4677,4903,16,174,6550,1901,4649,6550,459,0.03450381679389313,0.7140458015267176,0.0024427480916030535,0.2902290076335878,0.7097709923664122,0.026564885496183206
18161,,76,4990,5066,13,318,6859,1874,4985,6859,553,0.0110803324099723,0.7275112990231812,0.0018953200174952618,0.273217670214317,0.726782329785683,0.046362443504884096
18162,17.0,543,13262,13805,41,718,18218,5222,12996,18218,1435,0.029805686683499834,0.7279613568997695,0.0022505214622900427,0.28663958722142935,0.7133604127785707,0.03941157097376222
18163,,163,1966,2129,20,139,2878,812,2066,2878,193,0.056636553161918,0.6831132731063239,0.006949270326615705,0.28214037526059765,0.7178596247394023,0.04829742876997915
18164,,43,5414,5457,83,292,7531,2018,5513,7531,631,0.005709733103173549,0.7188952330367813,0.011021112734032666,0.2679591023768424,0.7320408976231576,0.03877307130527154
18165,27.0,117,2961,3078,20,138,4132,1166,2966,4132,335,0.028315585672797676,0.7166021297192643,0.00484027105517909,0.2821878025169409,0.717812197483059,0.03339787028073572
18166,,910,16874,17784,25,1276,23977,6752,17225,23977,1537,0.037953038328398046,0.7037577678608666,0.0010426658881428036,0.2816032030696084,0.7183967969303916,0.05321766693080869
18167,34.0,780,11876,12656,290,562,16750,4746,12004,16750,1025,0.046567164179104475,0.7090149253731344,0.017313432835820895,0.28334328358208954,0.7166567164179104,0.03355223880597015
18168,,20244,392369,412613,1683,24136,551711,156786,394925,551711,39606,0.03669312375500942,0.7111857476106149,0.003050510140272715,0.28418139206939863,0.7158186079306014,0.04374754173833764
18169,,118,2265,2383,12,103,3004,983,2021,3004,167,0.039280958721704395,0.753994673768309,0.0039946737683089215,0.32723035952063917,0.6727696404793608,0.034287616511318245
18170,,22,4854,4876,3,197,6267,1881,4386,6267,538,0.0035104515717249082,0.7745332695069411,0.0004786979415988511,0.30014360938247964,0.6998563906175204,0.03143449816499123
18171,26.0,3174,56191,59365,334,4373,80436,22326,58110,80436,5112,0.039459943308966135,0.6985802377045104,0.004152369585757621,0.27756228554378637,0.7224377144562136,0.05436620418717987
18172,24.0,213,10182,10395,27,440,13623,4037,9587,13624,1091,0.015634174985320024,0.7473576042278333,0.0019817968291250734,0.29631532589547854,0.7036846741045214,0.03229594832648268
18173,,230,4353,4583,5,271,7188,1683,5505,7188,413,0.03199777406789093,0.6055926544240401,0.0006956037840845854,0.23414023372287146,0.7658597662771286,0.03770172509738453
18174,,522,10824,11346,57,510,14912,4322,10590,14912,1085,0.03500536480686695,0.7258583690987125,0.0038224248927038627,0.28983369098712447,0.7101663090128756,0.03420064377682403
18175,25.0,5205,115242,120447,556,6043,163063,45816,117247,163063,11760,0.03192017809067661,0.7067329805044676,0.0034097250755842834,0.28097115838663583,0.7190288416133641,0.03705929610028026
18176,25.0,115,2835,2950,23,162,4118,1126,2992,4118,297,0.027926177756192327,0.6884409907722195,0.0055852355512384655,0.2734337056823701,0.7265662943176299,0.03933948518698397
18177,24.0,9674,187852,197526,6413,11789,260471,75428,185043,260471,15158,0.03714041102464382,0.7212012085798419,0.024620783119809884,0.2895831013817277,0.7104168986182723,0.045260316887484595
18178,,273,7395,7668,46,487,10173,2851,7322,10173,827,0.02683574166912415,0.7269242111471542,0.004521773321537403,0.28025164651528556,0.7197483534847144,0.04787181755627642
18179,,381,13667,14048,41,609,18150,5472,12678,18150,1612,0.02099173553719008,0.7530027548209366,0.002258953168044077,0.3014876033057851,0.6985123966942148,0.03355371900826446
18180,27.0,8321,197579,205900,807,8238,265207,78440,186767,265207,19026,0.03137549159712979,0.7449991893124993,0.00304290610730486,0.2957689653742171,0.7042310346257828,0.031062528515461506
18181,,202,5525,5727,15,231,7360,2162,5198,7360,449,0.027445652173913045,0.7506793478260869,0.0020380434782608695,0.29375,0.70625,0.03138586956521739
18182,44.0,2036,37596,39632,262,1704,51202,15130,36072,51202,3266,0.0397640717159486,0.7342681926487247,0.005116987617671185,0.29549626967696574,0.7045037303230343,0.03327995000195305
18183,16.0,918,18528,19446,234,905,26043,6918,19125,26043,1495,0.035249395230964174,0.7114387743347541,0.008985139960834006,0.26563759935491305,0.734362400645087,0.03475022078869562
18184,14.0,546,4445,4991,6,318,7868,1952,5916,7868,484,0.0693950177935943,0.5649466192170819,0.000762582613116421,0.24809354346720894,0.7519064565327911,0.04041687849517031
18185,23.0,135,3764,3899,23,264,5087,1369,3718,5087,305,0.026538234715942598,0.7399252997837625,0.004521328877530961,0.2691173579712994,0.7308826420287006,0.05189699233339886
18186,41.0,453,14743,15196,105,373,19810,5838,13972,19810,1716,0.02286723876829884,0.7442200908632004,0.00530035335689046,0.29469964664310955,0.7053003533568905,0.01882887430590611
18187,23.0,154,3543,3697,65,124,6469,1463,5006,6469,364,0.023805843252434688,0.547688978203741,0.010047920853300356,0.22615551089812955,0.7738444891018704,0.019168341320142217
18188,16.0,145,7044,7189,9,275,9290,2830,6460,9290,786,0.015608180839612486,0.7582346609257266,0.000968783638320775,0.30462863293864373,0.6953713670613563,0.029601722282023683
18189,,380,7737,8117,72,389,10938,3083,7855,10938,818,0.034741268970561345,0.7073505211190345,0.006582556226001097,0.28186140062168585,0.7181385993783141,0.035564088498811486
18190,,192,5039,5231,35,293,6966,1971,4995,6966,548,0.02756244616709733,0.7233706574791846,0.0050244042492104506,0.28294573643410853,0.7170542635658915,0.04206144128624749
18191,24.0,392,8272,8664,46,513,11430,3321,8109,11430,833,0.03429571303587051,0.7237095363079615,0.004024496937882764,0.2905511811023622,0.7094488188976378,0.04488188976377953
18192,,73,3202,3275,19,100,4254,1219,3035,4254,363,0.017160319699106724,0.7527033380347908,0.004466384579219558,0.2865538316878232,0.7134461683121768,0.023507287259050307
18193,23.0,247,6255,6502,24,221,8507,2433,6074,8507,747,0.029034912425061715,0.7352768308451864,0.002821206065593041,0.2859997648994945,0.7140002351005055,0.025978605854002586
18194,25.0,135,3970,4105,1,258,5421,1531,3890,5421,347,0.024903154399557276,0.7323372071573511,0.00018446781036709093,0.28242021767201625,0.7175797823279838,0.047592695074709465
18195,,4536,119430,123966,761,7454,166516,47278,119238,166516,12595,0.02724062552547503,0.7172283744505032,0.004570131398784501,0.2839246678997814,0.7160753321002186,0.04476446707823873
18196,27.0,1432,31343,32775,153,1754,44440,12296,32158,44454,3267,0.032213074189049354,0.7050659108291717,0.003441760021595357,0.27660053088585956,0.7233994691141404,0.03945651684887749
18197,23.0,397,14781,15178,115,997,20802,5657,15145,20802,1460,0.01908470339390443,0.7105566772425729,0.005528314585136045,0.27194500528795307,0.7280549947120469,0.047928083838092495
18198,25.0,153,3919,4072,4,179,5206,1585,3621,5206,352,0.029389166346523242,0.7527852477910104,0.000768344218209758,0.3044563964656166,0.6955436035343834,0.03438340376488667
18199,15.0,386,4508,4894,118,336,7048,1826,5222,7048,397,0.05476730987514188,0.6396140749148694,0.01674233825198638,0.2590805902383655,0.7409194097616345,0.04767309875141884
18200,16.0,595,6803,7398,25,627,10103,2957,7146,10103,550,0.058893398000593886,0.673364347223597,0.0024745125210333565,0.2926853409878254,0.7073146590121746,0.06206077402751658
18201,,207,4509,4716,28,248,6237,1786,4451,6237,407,0.03318903318903319,0.7229437229437229,0.004489337822671156,0.286355619688953,0.7136443803110469,0.039762706429373094
18202,47.0,54,2037,2091,14,89,2750,803,1947,2750,180,0.019636363636363636,0.7407272727272727,0.005090909090909091,0.292,0.708,0.032363636363636365
18203,,115,1976,2091,15,119,2760,784,1976,2760,191,0.041666666666666664,0.7159420289855073,0.005434782608695652,0.28405797101449276,0.7159420289855073,0.043115942028985506
18204,,95,2200,2295,12,119,3064,883,2181,3064,220,0.03100522193211488,0.7180156657963447,0.0039164490861618795,0.2881853785900783,0.7118146214099217,0.03883812010443864
18205,14.0,381,5596,5977,47,397,8037,2318,5719,8037,602,0.04740574841358716,0.6962797063580938,0.005847953216374269,0.28841607565011823,0.7115839243498818,0.049396540997884784
18206,27.0,1240,18546,19786,133,1367,27214,7225,19989,27214,1708,0.045564782832365695,0.6814874696847211,0.004887190416697288,0.2654883515837437,0.7345116484162564,0.050231498493422504
18207,13.0,75,2355,2430,16,156,3408,928,2480,3408,302,0.022007042253521125,0.6910211267605634,0.004694835680751174,0.27230046948356806,0.7276995305164319,0.045774647887323945
18208,,439,13506,13945,28,756,18501,5200,13301,18501,1392,0.023728447110966975,0.7300145938057402,0.001513431706394249,0.2810658883303605,0.7189341116696395,0.04086265607264472
18209,44.0,358,7471,7829,107,284,10231,3001,7230,10231,707,0.03499169191672368,0.730231648910175,0.010458410712540318,0.29332421073208875,0.7066757892679113,0.02775877235851823
18210,23.0,5023,201666,206689,243,8158,270415,78536,191879,270415,22706,0.01857515300556552,0.7457648429266128,0.0008986187896381488,0.29042767597951297,0.709572324020487,0.03016844479781077
18211,,606,19137,19743,61,696,24999,7526,17473,24999,1690,0.02424096963878555,0.765510620424817,0.0024400976039041563,0.3010520420816833,0.6989479579183168,0.027841113644545782
18212,,481,13180,13661,30,611,17984,5227,12757,17984,1394,0.026745996441281138,0.7328736654804271,0.0016681494661921709,0.29064724199288255,0.7093527580071174,0.03397464412811388
18213,42.0,844,16015,16859,157,752,21977,6413,15564,21977,1398,0.03840378577603858,0.728716385311917,0.007143832188196751,0.2918050689357055,0.7081949310642945,0.03421759111798699
18214,,469,9436,9905,49,465,13564,3690,9874,13564,1059,0.034576820996756116,0.6956649955765261,0.0036125036862282513,0.27204364494249483,0.7279563550575051,0.034281922736655854
18215,15.0,100,2218,2318,0,103,3050,872,2178,3050,218,0.03278688524590164,0.7272131147540983,0.0,0.28590163934426227,0.7140983606557377,0.033770491803278686
18216,14.0,220,2906,3126,46,131,4288,1164,3124,4288,335,0.051305970149253734,0.6777052238805971,0.010727611940298507,0.271455223880597,0.7285447761194029,0.03055037313432836
18217,16.0,610,10881,11491,66,605,15386,4352,11034,15386,1193,0.0396464318211361,0.707201351878331,0.004289613934745873,0.2828545430911218,0.7171454569088782,0.03932146106850384
18218,,507,16693,17200,110,707,23056,6591,16465,23056,1815,0.021989937543372657,0.7240197779319917,0.004770992366412214,0.28586918806384454,0.7141308119361555,0.030664469118667593
18219,15.0,280,7412,7692,14,557,10693,2947,7746,10693,772,0.02618535490507809,0.6931637519872814,0.0013092677452539044,0.2756008603759469,0.7243991396240531,0.052090152436173195
18220,33.0,2335,51854,54189,311,2847,72353,20310,52044,72354,5616,0.032271885452082816,0.7166708129474528,0.004298311081626448,0.28070320922132846,0.7192967907786715,0.039348204660419606
18221,26.0,275,5756,6031,30,302,8179,2261,5918,8179,519,0.03362269226066757,0.7037535150996455,0.003667930064800098,0.27643966255043406,0.7235603374495659,0.036923829318987654
18222,,77,1686,1763,5,461,2774,668,2106,2774,139,0.0277577505407354,0.6077865897620764,0.001802451333813987,0.24080749819754865,0.7591925018024513,0.1661860129776496
18223,,121,3534,3655,27,134,4731,1432,3299,4731,361,0.02557598816317903,0.7469879518072289,0.0057070386810399495,0.3026844218981188,0.6973155781018812,0.028323821602198266
18224,25.0,1075,29679,30754,199,1943,42462,11421,31041,42462,3242,0.025316753803400687,0.6989543591917479,0.004686543262210918,0.2689699025010598,0.7310300974989402,0.045758560595355845
18225,,989,28776,29765,73,1298,38988,11316,27672,38988,2736,0.025366779521904175,0.7380732533087103,0.0018723709859443931,0.2902431517389966,0.7097568482610034,0.03329229506514825
18226,,67,1578,1645,10,61,2257,648,1609,2257,174,0.02968542312804608,0.6991581745680107,0.004430660168365086,0.2871067789100576,0.7128932210899424,0.02702702702702703
18227,,743,18587,19330,79,833,25238,7389,17849,25238,1994,0.029439733734844282,0.7364688168634599,0.0031302004913226085,0.2927728029162374,0.7072271970837626,0.03300578492749029
18228,26.0,113,1812,1925,0,204,4276,658,3618,4276,128,0.026426566884939197,0.4237605238540692,0.0,0.1538821328344247,0.8461178671655754,0.047708138447146865
18229,,315,7563,7878,186,652,11244,2936,8308,11244,887,0.028014941302027748,0.6726254002134472,0.016542155816435433,0.2611170401992174,0.7388829598007827,0.057986481679117755
18230,33.0,609,18966,19575,87,756,25775,7517,18258,25775,2055,0.023627546071774974,0.7358292919495635,0.0033753637245392825,0.29163918525703203,0.708360814742968,0.02933074684772066
18231,14.0,2152,23032,25207,69,2798,34296,9514,24782,34296,1559,0.06274784231397247,0.6715651971075344,0.0020118964310706787,0.27740844413342663,0.7225915558665733,0.08158385817588057
18232,17.0,242,2794,3036,51,137,4055,1155,2900,4055,293,0.05967940813810111,0.6890258939580765,0.012577065351418002,0.2848335388409371,0.7151664611590629,0.03378545006165228
18233,,1287,35726,37013,125,1685,48420,14147,34273,48420,3019,0.026579925650557622,0.7378356051218504,0.002581577860388269,0.2921726559273028,0.7078273440726972,0.03479966955803387
18234,24.0,967,18477,19444,396,2681,28694,5935,22759,28694,1387,0.03370042517599498,0.6439325294486652,0.013800794591203735,0.2068376664110964,0.7931623335889036,0.09343416742176065
18235,24.0,581,18415,19096,97,773,24893,7208,17685,24893,1938,0.02333989474952798,0.7397661993331459,0.0038966777809022616,0.28955931386333505,0.7104406861366649,0.031052906439561323
18236,27.0,330,38855,39185,516,1677,52029,15170,36859,52029,4264,0.006342616617655538,0.7467950566030483,0.009917545983970478,0.2915681639085894,0.7084318360914106,0.03223202444790405
18237,16.0,1177,17945,19122,71,1650,26630,7157,19473,26630,1821,0.04419827262485918,0.6738640630867443,0.0026661659782200526,0.2687570409312805,0.7312429590687195,0.06196019526849418
18238,17.0,598,9969,10567,30,729,14094,4111,9983,14094,965,0.04242940258265929,0.7073222647935291,0.0021285653469561515,0.29168440471122464,0.7083155952887754,0.05172413793103448
18239,,35,4499,4534,21,316,6085,1616,4469,6085,494,0.005751848808545604,0.7393590797041907,0.003451109285127362,0.2655710764174199,0.7344289235825802,0.05193097781429745
18240,,84,1383,1467,16,65,2037,568,1469,2037,148,0.041237113402061855,0.678939617083947,0.007854688267059401,0.27884143348060875,0.7211585665193913,0.031909671084928815
18241,,436,5286,5722,14,313,7678,2177,5501,7678,490,0.056785621255535296,0.6884605365980724,0.0018233915082052619,0.28353737952591823,0.7164626204740818,0.04076582443344621
18242,24.0,353,6258,6611,42,304,8876,2566,6310,8876,696,0.039770166741775574,0.7050473186119873,0.00473186119873817,0.28909418657052727,0.7109058134294728,0.034249662009914375
18243,25.0,139,1788,1927,6,99,2796,712,2084,2796,151,0.04971387696709585,0.6394849785407726,0.002145922746781116,0.25464949928469244,0.7453505007153076,0.03540772532188841
18244,23.0,493,14448,14941,36,742,19495,5727,13768,19495,1462,0.0252885355219287,0.741113105924596,0.001846627340343678,0.2937676327263401,0.7062323672736599,0.03806104129263914
18245,,52,1717,1769,0,68,2538,665,1873,2538,158,0.02048857368006304,0.6765169424743893,0.0,0.2620173364854216,0.7379826635145784,0.026792750197005517
18246,,737,8506,9243,213,541,13066,3439,9627,13066,669,0.05640593907852441,0.6510026021735803,0.016301852135313027,0.2632022041940915,0.7367977958059084,0.04140517373335374
18247,24.0,185,3788,3973,25,367,5659,1478,4181,5659,382,0.03269128821346528,0.6693762148789538,0.004417741650468281,0.26117688637568476,0.7388231136243153,0.06485244742887436
18248,14.0,313,3145,3458,14,327,4878,1321,3557,4878,324,0.06416564165641657,0.6447314473144732,0.002870028700287003,0.27080770807708077,0.7291922919229192,0.06703567035670356
18249,27.0,750,12098,12848,32,642,16466,5019,11447,16466,987,0.04554840276934289,0.734726102271347,0.00194339851815863,0.3048099113324426,0.6951900886675574,0.03898943277055751
18250,13.0,17,2121,2138,8,284,3107,799,2308,3107,212,0.0054715159317669775,0.6826520759575153,0.002574831026713872,0.25716124879304797,0.7428387512069521,0.09140650144834245
18251,35.0,2848,6642,9490,39,826,13442,3536,9906,13442,706,0.2118732331498289,0.49412289837821755,0.0029013539651837525,0.26305609284332687,0.7369439071566731,0.061449189108763576
18252,,74,1754,1828,19,99,2474,698,1776,2474,190,0.029911075181891674,0.7089733225545675,0.007679870654810024,0.28213419563459985,0.7178658043654002,0.04001616814874697
18253,23.0,181,3466,3647,19,241,5129,1410,3719,5129,329,0.03528953012283096,0.6757652563852603,0.00370442581399883,0.27490738935465003,0.72509261064535,0.0469877169038799
18254,38.0,94,4104,4198,51,237,5766,1620,4146,5766,484,0.016302462712452306,0.7117585848074922,0.008844953173777315,0.2809573361082206,0.7190426638917794,0.041103017689906346
18255,16.0,641,13375,14016,46,799,18639,5393,13246,18639,1270,0.03439025698803584,0.7175814153119803,0.0024679435592038198,0.2893395568431783,0.7106604431568218,0.04286710660443157
18256,16.0,1357,22869,24226,71,1517,33778,9180,24598,33778,2334,0.04017407780211972,0.6770383089584937,0.0021019598555272663,0.2717745277991592,0.7282254722008408,0.044910888744153
18257,,324,9022,9346,52,411,12642,3672,8970,12642,985,0.025628856193640248,0.7136529030216738,0.004113273216263249,0.2904603701945895,0.7095396298054105,0.03251067869008068
18258,,9,1963,1972,1,313,3026,751,2275,3026,222,0.002974223397224058,0.6487111698612029,0.00033046926635822867,0.24818241903502974,0.7518175809649703,0.10343688037012558
18259,25.0,78,4694,4772,13,297,6375,1767,4608,6375,492,0.01223529411764706,0.736313725490196,0.00203921568627451,0.2771764705882353,0.7228235294117648,0.046588235294117646
18260,17.0,536,10956,11492,27,991,15389,4607,10782,15389,479,0.03483007342907271,0.7119370979270908,0.0017544999675092599,0.29936967964130223,0.7006303203586978,0.06439664695561764
18261,25.0,87,2818,2905,35,391,4306,1114,3192,4306,227,0.020204366000928935,0.6544356711565258,0.008128193218764514,0.2587087784486763,0.7412912215513238,0.09080352995819786
18262,23.0,13602,366881,380483,1300,20783,505303,143507,361797,505304,35592,0.026918449092031727,0.7260599559868911,0.0025727087060462613,0.28400131406044676,0.7159986859395532,0.04112969618289188
18263,38.0,355,10976,11331,53,977,15453,4255,11198,15453,1240,0.022972885523846503,0.7102827929851808,0.0034297547401799,0.2753510645182165,0.7246489354817834,0.06322396945576911
18264,14.0,60,2045,2105,11,177,2970,788,2182,2970,227,0.020202020202020204,0.6885521885521886,0.003703703703703704,0.26531986531986534,0.7346801346801347,0.0595959595959596
18265,27.0,67,2771,2838,0,138,3716,1085,2631,3716,285,0.018030139935414424,0.7456942949407965,0.0,0.2919806243272336,0.7080193756727664,0.03713670613562971
18266,45.0,1483,24191,25674,150,1075,33479,9870,23609,33479,2101,0.04429642462439141,0.7225723587920786,0.004480420562143433,0.29481167298903793,0.7051883270109621,0.03210968069536127
18267,,678,12205,12883,117,862,18091,5019,13072,18091,1276,0.03747719860704218,0.6746448510308993,0.006467304184401083,0.2774307666795644,0.7225692333204355,0.04764800176883533
18268,27.0,77,2106,2183,3,54,2846,844,2002,2846,178,0.027055516514406183,0.7399859451862263,0.0010541110330288123,0.2965565706254392,0.7034434293745608,0.018973998594518624
18269,40.0,192,4160,4352,9,197,5783,1666,4117,5783,426,0.0332007608507695,0.7193498184333391,0.0015562856648798202,0.2880857686321978,0.7119142313678022,0.03406536399792495
18270,17.0,176,4636,4812,54,336,6685,1805,4880,6685,487,0.02632759910246821,0.693492894540015,0.008077786088257292,0.2700074794315632,0.7299925205684368,0.050261780104712044
18271,,575,18494,19069,146,1164,25447,7496,17951,25447,1537,0.022595983809486384,0.726765434039376,0.005737415019452195,0.29457303414940855,0.7054269658505914,0.04574213070302983
18272,45.0,2729,78330,81059,536,3308,107110,30801,76310,107111,7281,0.02547824219734668,0.7312974391052273,0.005004154568625071,0.287561501619815,0.712438498380185,0.030883849464574134
18273,,262,5626,5888,27,291,8063,2240,5823,8063,641,0.032494108892471785,0.697755177973459,0.0033486295423539626,0.2778122286989954,0.7221877713010046,0.03609078506759271
18274,15.0,771,18969,19740,47,1263,25838,7545,18293,25838,1867,0.02983977088009908,0.7341512500967567,0.0018190262404210852,0.2920117656165338,0.7079882343834663,0.048881492375570865
18275,27.0,462,112209,112671,286,5334,149097,42643,106454,149097,13872,0.003098653896456669,0.7525905953842129,0.0019182143168541286,0.28600843746017696,0.7139915625398231,0.03577536771363609
18276,,244,2372,2616,0,365,3612,1051,2561,3612,154,0.06755260243632337,0.6566998892580288,0.0,0.2909745293466224,0.7090254706533776,0.10105204872646734
18277,35.0,294,3741,4035,13,211,5465,1543,3922,5465,360,0.053796889295516924,0.6845379688929552,0.0023787740164684353,0.28234217749313817,0.7176578225068618,0.038609332113449225
18278,39.0,4,12861,12865,18,793,17190,4950,12240,17190,1768,0.0002326934264107039,0.7481675392670157,0.0010471204188481676,0.2879581151832461,0.7120418848167539,0.04613147178592205
18279,,1403,17558,18961,96,1198,26022,7195,18827,26022,1369,0.053915917300745526,0.6747367612020598,0.0036891860733225734,0.27649681039120744,0.7235031896087926,0.04603796787333794
18280,,554,12102,12656,56,685,17120,4791,12329,17120,1233,0.03235981308411215,0.7068925233644859,0.0032710280373831778,0.2798481308411215,0.7201518691588785,0.040011682242990655
18281,16.0,634,19753,20387,48,657,26718,7630,19088,26718,2551,0.023729321056965343,0.7393143199341268,0.001796541657309679,0.285575267609851,0.7144247323901489,0.02459016393442623
18282,26.0,7994,181864,189858,1184,8024,252933,71875,181058,252933,20673,0.03160520770322576,0.7190204520564735,0.004681081551240842,0.28416616258060434,0.7158338374193957,0.03172381618847679
18283,14.0,2,3016,3018,0,78,4164,1103,3061,4164,373,0.0004803073967339097,0.7243035542747358,0.0,0.2648895292987512,0.7351104707012488,0.018731988472622477
18284,23.0,80,1929,2247,13,132,3014,761,2253,3014,163,0.026542800265428004,0.6400132714001328,0.0043132050431320505,0.2524883875248839,0.7475116124751161,0.043795620437956206
18285,,39,14897,14936,62,1848,20977,5591,15386,20977,1709,0.0018591791009200554,0.7101587452924631,0.0029556180578729084,0.2665300090575392,0.7334699909424608,0.08809648662821185
18286,26.0,755,21690,22445,55,1338,30711,8667,22044,30711,2662,0.02458402526781935,0.7062616000781479,0.0017908892579206147,0.2822115854254176,0.7177884145745824,0.04356745140177787
18287,,2551,44288,46839,461,2222,61897,17889,44008,61897,3970,0.041213629093494034,0.7155112525647447,0.007447856923598882,0.28901239155371017,0.7109876084462898,0.03589834725430958
18288,,481,21394,21875,272,1836,30134,8116,22018,30134,1524,0.015962036238136326,0.7099621689785625,0.009026348974580208,0.2693303245503418,0.7306696754496582,0.06092785557841641
18289,14.0,1266,26996,28262,161,2526,38987,10654,28333,38987,2426,0.03247236258239926,0.69243594018519,0.004129581655423603,0.2732705773719445,0.7267294226280555,0.06479082771180136
18290,17.0,89,1931,2020,11,111,2726,770,1956,2726,186,0.0326485693323551,0.7083639031548056,0.004035216434336023,0.28246515040352166,0.7175348495964784,0.040719002201027144
18291,,94,2773,2867,24,104,3744,1097,2647,3744,286,0.025106837606837608,0.7406517094017094,0.00641025641025641,0.29300213675213677,0.7069978632478633,0.027777777777777776
18292,17.0,83,2141,2224,2,80,2929,857,2072,2929,207,0.028337316490269715,0.7309662000682827,0.0006828269033799932,0.29259132809832705,0.7074086719016729,0.02731307613519973
18293,15.0,2056,41516,43572,848,3045,60091,15990,44101,60091,3885,0.03421477425904045,0.6908854903396515,0.014111930239137309,0.266096420429016,0.733903579570984,0.050673145728977714
18294,,38,1420,1458,6,116,2158,544,1614,2158,142,0.017608897126969416,0.6580166821130676,0.0027803521779425394,0.2520852641334569,0.7479147358665431,0.05375347544022243
18295,14.0,79,1938,2017,11,85,2785,770,2015,2785,183,0.02836624775583483,0.6958707360861759,0.0039497307001795335,0.2764811490125673,0.7235188509874326,0.03052064631956912
18296,,725,10776,11501,49,1200,16141,4319,11822,16141,1011,0.04491667182950251,0.6676166284616815,0.003035747475373273,0.26757945604361566,0.7324205439563843,0.07434483613159036
18297,24.0,4387,123112,127499,435,5572,168045,48622,119423,168045,12113,0.026106102532059864,0.7326132881073522,0.002588592341337142,0.28933916510458507,0.7106608348954149,0.033157785117081735
18298,27.0,424,12176,12600,82,357,16672,4782,11890,16672,1319,0.02543186180422265,0.7303262955854126,0.004918426103646833,0.2868282149712092,0.7131717850287908,0.021413147792706335
18299,16.0,2,16912,16914,68,364,22289,6373,15916,22289,2460,8.973036026739648e-05,0.7587599264211046,0.00305083224909148,0.28592579299205884,0.7140742070079411,0.01633092556866616
18300,,524,1923,2447,11,122,3416,911,2505,3416,107,0.15339578454332553,0.5629391100702577,0.0032201405152224825,0.2666861826697892,0.7333138173302107,0.03571428571428571
18301,24.0,114,2401,2515,10,140,3420,972,2448,3420,249,0.03333333333333333,0.702046783625731,0.0029239766081871343,0.28421052631578947,0.7157894736842105,0.04093567251461988
18302,,64,2228,2292,6,118,3124,874,2250,3124,268,0.020486555697823303,0.7131882202304738,0.0019206145966709346,0.2797695262483995,0.7202304737516005,0.03777208706786172
18303,,369,10903,11272,46,428,15340,4121,11219,15340,1071,0.024054758800521513,0.7107561929595828,0.002998696219035202,0.26864406779661015,0.7313559322033898,0.02790091264667536
18304,,982,13967,14949,172,955,20499,5561,14938,20499,1333,0.04790477584272403,0.6813503097712084,0.00839065320259525,0.27128152592809407,0.7287184740719059,0.04658763842138641
18305,33.0,760,18273,19033,40,830,25373,7240,18133,25373,1788,0.029953099751704567,0.7201749891617073,0.0015764789343002403,0.28534268710834354,0.7146573128916565,0.03271193788672999
18306,,351,6193,6544,13,622,8894,2509,6385,8894,589,0.039464807735552054,0.6963121205306948,0.0014616595457611872,0.28210029233190914,0.7178997076680909,0.06993478749718912
18307,25.0,926,15832,16758,120,865,22251,6246,16005,22251,1584,0.04161610714125208,0.7115185834344524,0.005393016044222732,0.2807064851017932,0.7192935148982068,0.03887465731877219
18308,,1438,34883,36321,206,1495,46981,13946,33035,46981,3509,0.030608118175432623,0.742491645558843,0.004384751282433324,0.296843404780656,0.703156595219344,0.031821374598241844
18309,15.0,849,21556,22405,203,1880,30854,8382,22472,30854,2005,0.027516691514876516,0.6986452323847799,0.006579373825111817,0.27166655863097167,0.7283334413690283,0.060932131976405006
18310,17.0,850,17401,18251,165,2658,26828,6970,19858,26828,1967,0.03168331593857164,0.6486133889965707,0.006150290741016848,0.25980319069628743,0.7401968093037126,0.0990755926643805
18311,27.0,164,3356,3520,26,191,5129,1310,3819,5129,274,0.03197504386820043,0.6543185806200039,0.005069214271787873,0.25541041138623516,0.7445895886137649,0.03723922791967245
18312,45.0,26296,543333,569629,3266,14940,745953,218021,527932,745953,61762,0.03525155070091547,0.7283743077646984,0.004378291929920518,0.2922717651112067,0.7077282348887932,0.020028071473671933
18313,26.0,209,4110,4319,118,205,5852,1628,4224,5852,417,0.03571428571428571,0.702323991797676,0.020164046479835954,0.2781954887218045,0.7218045112781954,0.03503075871496924
18314,17.0,841,39330,40171,106,933,52630,15165,37465,52630,5033,0.01597947938438153,0.7472924187725631,0.0020140604218126545,0.28814364430932926,0.7118563556906707,0.017727531825954778
18315,,14169,341128,355297,1854,17543,469411,135368,334043,469411,37135,0.03018463563913074,0.7267149683326551,0.003949630494385517,0.2883784146515527,0.7116215853484473,0.03737236664671258
18316,,89,1863,1952,68,78,2784,707,2077,2784,216,0.0319683908045977,0.6691810344827587,0.02442528735632184,0.25395114942528735,0.7460488505747126,0.028017241379310345
18317,,330,4819,5149,10,298,6877,1955,4922,6877,582,0.04798604042460375,0.7007416024429257,0.0014541224371092047,0.2842809364548495,0.7157190635451505,0.0433328486258543
18318,17.0,2430,62179,64609,937,3138,89837,24824,65013,89837,7369,0.027048988724022397,0.6921313044736579,0.010430001001814397,0.2763226732860625,0.7236773267139375,0.03492992864855238
18319,26.0,73,2187,2260,48,95,2961,874,2087,2961,196,0.02465383316447146,0.7386018237082067,0.016210739614994935,0.2951705504896994,0.7048294495103006,0.032083755488010804
18320,,203,5349,5552,67,518,7643,2019,5624,7643,534,0.026560251210257752,0.6998560774564961,0.008766191286144184,0.2641632866675389,0.735836713332461,0.06777443412272668
18321,,137,1904,2041,7,118,2781,751,2030,2781,189,0.04926285508809781,0.6846458108594031,0.0025170801869830997,0.2700467457749011,0.7299532542250989,0.042430780294857966
18322,40.0,94,2535,2629,11,93,3450,1005,2445,3450,231,0.027246376811594204,0.7347826086956522,0.003188405797101449,0.29130434782608694,0.7086956521739131,0.026956521739130435
18323,,374,7696,8070,31,345,11009,3101,7908,11009,922,0.03397220455990553,0.6990644018530293,0.002815877918067036,0.28167862657825415,0.7183213734217458,0.0313379961849396
18324,24.0,1690,67213,68903,474,3192,92158,26107,66051,92158,6760,0.018338071572733785,0.7293235530284945,0.005143340784305215,0.28328522754400054,0.7167147724559995,0.034636168319624995
18325,,1387,8555,9942,31,695,14618,3972,10646,14618,648,0.09488302093309618,0.5852373785743604,0.00212067314270078,0.27171979750991926,0.7282802024900807,0.047544123683130386
18326,,416,7260,7676,25,510,10364,2934,7430,10364,737,0.04013894249324585,0.7005017367811656,0.002412196063296025,0.28309532998842146,0.7169046700115785,0.049208799691238904
18327,35.0,5938,34861,40799,6851,4104,86006,14691,71315,86006,2180,0.06904169476548148,0.4053321861265493,0.07965723321628723,0.17081366416296537,0.8291863358370346,0.047717601097597845
18328,23.0,1102,17370,21697,228,874,28819,6959,21860,28819,1303,0.03823866199382352,0.6027273673618099,0.007911447309066936,0.24147263957805615,0.7585273604219439,0.030327214684756583
18329,,189,4699,4888,62,359,6748,1767,4981,6748,484,0.028008298755186723,0.6963544754001185,0.009187907528156491,0.26185536455246,0.73814463544754,0.053200948429164195
18330,16.0,399,8694,9093,64,406,11995,3497,8498,11995,955,0.033263859941642354,0.7248020008336807,0.005335556481867444,0.29153814089203833,0.7084618591079617,0.0338474364318466
18331,,297,8317,8614,42,483,11549,3290,8259,11549,897,0.025716512252143043,0.7201489306433457,0.0036366785003030568,0.28487314919040607,0.7151268508095939,0.04182180275348515
18332,17.0,162,2728,2890,28,157,3855,1101,2754,3855,238,0.04202334630350195,0.7076523994811933,0.007263294422827497,0.2856031128404669,0.7143968871595331,0.04072632944228275
18333,24.0,5648,148269,153917,1673,9231,209736,58461,151275,209736,14133,0.026929091810657207,0.7069315711179769,0.007976694511195027,0.2787361254148072,0.7212638745851928,0.044012472822977454
18334,36.0,6616,136217,142833,1030,5934,189918,54105,135813,189918,11432,0.03483608715340305,0.7172411251171559,0.005423393253930644,0.2848861087416675,0.7151138912583326,0.031245063659052854
18335,23.0,1371,28224,29595,177,2643,41906,11066,30840,41906,2846,0.032716078843125086,0.6735073736457786,0.004223738844079607,0.2640671980146041,0.7359328019853959,0.0630697274853243
18336,24.0,1016,28642,29658,68,1582,39302,11312,27990,39302,3108,0.02585110172510305,0.7287669838685055,0.0017301918477431173,0.28782250267161974,0.7121774973283802,0.04025240445778841
18337,,75,2473,2548,41,334,3824,973,2851,3824,209,0.01961297071129707,0.6467050209205021,0.010721757322175732,0.2544456066945607,0.7455543933054394,0.08734309623430962
18338,,92,2204,2296,1,260,3219,874,2345,3219,219,0.02858030444237341,0.6846846846846847,0.00031065548306927616,0.2715128922025474,0.7284871077974526,0.0807704255980118
18339,,3120,63521,66641,438,3974,89164,24471,64693,89164,5834,0.034991700686375665,0.7124063523395092,0.00491229644251043,0.27444932932573685,0.7255506706742632,0.04456955722040285
18340,27.0,145,2922,3067,7,136,4100,1184,2916,4100,261,0.03536585365853658,0.7126829268292683,0.0017073170731707317,0.288780487804878,0.7112195121951219,0.033170731707317075
18341,26.0,164,3158,3322,17,353,4763,1299,3464,4763,296,0.03443208062145706,0.663027503674155,0.003569179088809574,0.2727272727272727,0.7272727272727273,0.07411295402057527
18342,26.0,2707,29712,32419,136,2050,44996,12293,32703,44996,3197,0.06016090319139479,0.6603253622544226,0.0030224908880789403,0.2732020624055472,0.7267979375944529,0.045559605298248734
18343,,440,9038,9478,24,966,13703,3775,9928,13703,721,0.03210975698752098,0.6595635992118514,0.001751441290228417,0.27548711960884475,0.7245128803911552,0.07049551193169379
18344,17.0,8520,21116,29636,769,1838,40953,10860,30093,40953,671,0.20804336678631602,0.5156154616267429,0.018777623128952703,0.26518203794593803,0.734817962054062,0.0448807169193954
18345,27.0,1744,33258,35002,518,1977,47927,13067,34878,47945,3040,0.036375013035770155,0.6936698300135572,0.010804046303055585,0.2725414537490875,0.7274585462509126,0.04123474814892064
18346,,541,16627,17168,19,638,22391,6620,15771,22391,1718,0.024161493457192623,0.7425751417980438,0.0008485552230807021,0.2956545040418025,0.7043454959581975,0.02849359117502568
18347,,66,1654,1720,8,218,2397,604,1793,2397,125,0.02753441802252816,0.69002920317063,0.003337505214851898,0.2519816437213183,0.7480183562786817,0.09094701710471423
18348,,88,3979,4067,10,363,5295,1384,3911,5295,285,0.016619452313503306,0.7514636449480642,0.0018885741265344666,0.2613786591123702,0.7386213408876299,0.06855524079320113
18349,,285,9255,9540,2,507,12769,3630,9139,12769,1055,0.022319680476153184,0.7248022554624481,0.00015662933667475918,0.28428224606468794,0.7157177539353121,0.03970553684705145
18350,13.0,1365,23208,24573,91,1460,33100,9275,23825,33100,2448,0.041238670694864046,0.7011480362537764,0.0027492447129909368,0.2802114803625378,0.7197885196374623,0.044108761329305135
18351,16.0,476,18208,18684,195,2822,28223,6877,21346,28223,987,0.016865676930163342,0.6451475746731389,0.006909258406264394,0.24366651312759097,0.756333486872409,0.09998937037168266
18352,17.0,915,14798,15713,64,836,21061,6006,15055,21061,1507,0.043445230520867954,0.702625706281753,0.003038792080148141,0.2851716442714021,0.7148283557285979,0.039694221546935096
18353,25.0,296,1830,2126,250,208,3457,726,2731,3457,113,0.08562337286664738,0.5293607173850159,0.07231703789412786,0.2100086780445473,0.7899913219554527,0.06016777552791438
18354,,625,14388,15013,223,697,21159,5677,15482,21159,1322,0.02953825795169904,0.6799943286544733,0.010539250437166218,0.2683019046268727,0.7316980953731272,0.03294106526773477
18355,,400,6239,6639,19,791,9084,2554,6530,9084,449,0.044033465433729636,0.686811977102598,0.0020915896081021576,0.2811536767943637,0.7188463232056362,0.08707617789520035
18356,14.0,307,35607,35914,68,1308,47844,13690,34154,47844,4429,0.006416687567929103,0.7442312515675947,0.001421285845665078,0.28613828275227826,0.7138617172477217,0.027338851266616504
18357,16.0,338,5416,5754,59,295,7722,2148,5575,7723,544,0.043765376149164835,0.7012818852777418,0.0076395183218956365,0.2781302602615564,0.7218697397384436,0.03819759160947818
18358,23.0,1986,37410,39396,398,2309,53734,14867,38867,53734,3575,0.036959839207950276,0.6962072430863141,0.007406855994342502,0.2766777087132914,0.7233222912867086,0.04297093088175084
18359,24.0,3650,65669,69319,626,3175,91718,26417,65301,91718,6272,0.03979589611635666,0.7159881375520618,0.006825268758586101,0.288024161015286,0.7119758389847141,0.034616978128611614
18360,37.0,187,6661,6848,23,242,8978,2601,6377,8978,719,0.020828692359100023,0.7419247048340387,0.0025618177767877033,0.2897081755402094,0.7102918244597906,0.026954778347070617
18361,,4764,99160,103924,101,5167,137985,39387,98598,137985,9327,0.03452549190129362,0.718628836467732,0.0007319636192339747,0.2854440700076095,0.7145559299923905,0.037446099213682645
18362,,9085,96887,105972,907,4450,141282,40474,100808,141282,9824,0.06430401608131255,0.6857703033649014,0.0064197845443864044,0.2864766920060588,0.7135233079939411,0.03149728910972382
18363,23.0,947,21184,22131,108,1162,29010,8426,20584,29010,2067,0.032643915891072045,0.7302309548431576,0.003722854188210962,0.2904515684246811,0.7095484315753189,0.040055153395380905
18364,24.0,3051,110461,113512,455,5256,146855,43132,103723,146855,10867,0.020775594974634843,0.7521773177624187,0.0030982942358108337,0.2937046746791052,0.7062953253208948,0.03579040550202581
18365,,101,3632,3733,3,123,4913,1465,3448,4913,421,0.020557704050478322,0.7392631793201709,0.0006106248727864848,0.29818847954406674,0.7018115204559332,0.02503561978424588
18366,24.0,5261,85779,91040,875,4476,123800,34393,89407,123800,7981,0.042495961227786754,0.6928836833602585,0.0070678513731825526,0.27781098546042005,0.72218901453958,0.03615508885298869
18367,17.0,45,2887,2932,5,231,4000,1077,2923,4000,281,0.01125,0.72175,0.00125,0.26925,0.73075,0.05775
18368,16.0,1712,49422,51134,24,2107,68094,19319,48775,68094,5151,0.025141715863365346,0.7257908185743237,0.0003524539607013834,0.28371075278291774,0.7162892472170823,0.030942520633242283
18369,35.0,3171,47739,50910,533,2684,72665,19038,53627,72665,4155,0.04363861556457717,0.6569737838023808,0.007335030619968348,0.26199683478978875,0.7380031652102113,0.0369366269868575
18370,35.0,3042,41882,44924,297,2509,61241,16812,44429,61241,3784,0.04967260495419735,0.683888244803318,0.0048496921996701555,0.2745219705752682,0.7254780294247318,0.04096928528273542
18371,24.0,313,8105,11664,106,740,15744,3289,12455,15744,950,0.01988058943089431,0.5147992886178862,0.0067327235772357726,0.20890497967479674,0.7910950203252033,0.047002032520325206
18372,23.0,232,5761,5993,14,366,8053,2282,5771,8053,622,0.028809139451136223,0.7153855705948093,0.0017384825530858065,0.28337265615298646,0.7166273438470135,0.0454489010306718
18373,,3006,71150,74156,519,3421,99466,27965,71501,99466,7656,0.030221382180845715,0.7153198077735106,0.005217863390505298,0.2811513481993847,0.7188486518006153,0.03439366215591257
18374,17.0,56,1764,1820,0,112,2411,694,1717,2411,206,0.023226876814599753,0.7316466196598922,0.0,0.2878473662380755,0.7121526337619245,0.046453753629199505
18375,23.0,77,1936,2013,7,90,2577,704,1873,2577,171,0.029879705083430345,0.7512611563833915,0.002716336825766395,0.273185875048506,0.726814124951494,0.034924330616996506
18376,24.0,2003,18901,20904,277,1024,28502,7882,20620,28502,1713,0.07027577012139499,0.6631464458634482,0.00971861623745702,0.2765419970528384,0.7234580029471616,0.03592730334713354
18377,14.0,152,12866,13021,52,1103,17745,4901,12844,17745,1055,0.008565793181177797,0.7250493096646943,0.0029304029304029304,0.2761904761904762,0.7238095238095238,0.06215835446604678
18378,35.0,268,8546,8814,47,337,11614,3366,8248,11614,891,0.023075598415705185,0.7358360599276735,0.004046840020664715,0.28982262786292406,0.710177372137076,0.029016703977957636
18379,17.0,3536,65336,68872,622,3393,91530,26177,65353,91530,6509,0.03863214246695073,0.713820605266033,0.006795586146618595,0.28599366327979897,0.714006336720201,0.03706981317600787
18380,26.0,262,11261,11523,48,388,14728,4458,10270,14728,919,0.017789244975556763,0.7645980445410103,0.0032590983161325366,0.30268875611080936,0.6973112438891906,0.026344378055404672
18381,,234,9085,9319,27,224,12342,3579,8763,12342,1179,0.018959649975692758,0.7361043590990115,0.0021876519202722413,0.2899854156538649,0.7100145843461352,0.018149408523740074
18382,16.0,201,47407,47608,564,7384,69776,17956,51820,69776,4154,0.0028806466406787433,0.6794169915157074,0.008083008484292593,0.25733776656730106,0.7426622334326989,0.10582435221279524
18383,17.0,1629,28068,29697,98,2715,40764,11340,29424,40764,2940,0.03996173093906388,0.6885487194583456,0.0024040820331665195,0.2781866352664115,0.7218133647335885,0.0666028848984398
18384,26.0,276,10169,10445,17,486,13752,3993,9759,13752,1215,0.02006980802792321,0.7394560791157649,0.0012361838278068644,0.29035776614310643,0.7096422338568935,0.03534031413612566
18385,17.0,1488,26782,29171,106,2396,38699,10462,28237,38699,2423,0.03845060595881031,0.6920592263365979,0.0027390888653453576,0.27034290291738805,0.729657097082612,0.06191374454120262
18386,,360,10574,10934,39,774,14886,4014,10872,14886,1106,0.02418379685610641,0.7103318554346366,0.0026199113260781943,0.26964933494558646,0.7303506650544136,0.05199516324062878
18387,13.0,606,14603,15209,12,720,19841,5758,14083,19841,1622,0.030542815382289198,0.7360012096164508,0.0006048082253918653,0.2902071468171967,0.7097928531828033,0.03628849352351192
18388,13.0,121,2288,2409,12,109,3249,905,2344,3249,247,0.03724222837796245,0.7042166820560173,0.003693444136657433,0.2785472453062481,0.7214527546937519,0.033548784241305016
18389,17.0,1926,34024,35950,6,2533,49229,14278,34951,49229,3460,0.03912328099291068,0.6911373377480753,0.00012187938004022019,0.2900322980357107,0.7099677019642894,0.051453411606979624
18390,,62,2480,2542,0,93,3321,1020,2301,3321,279,0.018669075579644687,0.7467630231857875,0.0,0.3071364046973803,0.6928635953026197,0.028003613369467027
18391,13.0,87,2015,2102,19,184,2877,769,2108,2877,230,0.03023983315954119,0.7003823427181092,0.006604101494612443,0.2672923183872089,0.7327076816127911,0.06395550921098367
18392,23.0,81,1854,1935,11,103,2593,743,1850,2593,181,0.031237948322406478,0.7150019282684149,0.004242190512919399,0.28654068646355574,0.7134593135364443,0.039722329348245274
18393,,147,2935,3082,11,53,4300,1158,3142,4300,230,0.034186046511627904,0.6825581395348838,0.0025581395348837207,0.26930232558139533,0.7306976744186047,0.012325581395348837
18394,23.0,16802,260925,277727,1733,23541,388685,104859,283826,388685,27612,0.04322780657859192,0.6713019540244671,0.004458623306790846,0.2697788697788698,0.7302211302211302,0.060565753759471035
18395,27.0,511,9798,10309,37,537,13680,3875,9805,13680,1090,0.037353801169590646,0.7162280701754385,0.0027046783625730994,0.28326023391812866,0.7167397660818714,0.03925438596491228
18396,,349,6740,7089,21,374,9658,2771,6887,9658,832,0.03613584593083454,0.6978670532201284,0.002174363222199213,0.2869124042244771,0.7130875957755228,0.0387243735763098
18397,41.0,1204,20808,22012,138,1231,31204,8250,22954,31204,1877,0.03858479682092039,0.6668375849250097,0.004422509934623766,0.2643891808742469,0.7356108191257531,0.03945007050378157
18398,17.0,96,5070,5166,34,866,7367,1962,5405,7367,439,0.013031084566309217,0.6882041536582055,0.004615175783901181,0.2663227908239446,0.7336772091760554,0.11755124202524772
18399,16.0,292,5328,5620,11,469,7703,2118,5585,7703,503,0.03790730884071141,0.6916785667921589,0.0014280150590678957,0.27495780864598207,0.7250421913540179,0.06088536933662209
18400,35.0,780,17728,18508,79,763,24635,7067,17568,24635,2058,0.0316622691292876,0.7196265475948853,0.003206819565658616,0.28686827684189165,0.7131317231581084,0.030972194032880047
18401,15.0,275,6311,6586,14,269,8849,2501,6348,8849,764,0.031076957848344446,0.7131879308396429,0.0015820996722793535,0.28263080574076166,0.7173691942592383,0.030398915131653294
18402,25.0,571,9372,9943,6,339,13266,3719,9547,13266,1080,0.043042363937886324,0.7064676616915423,0.0004522840343735866,0.2803407206392281,0.7196592793607719,0.025554047942107645
18403,23.0,1012,27808,28820,7,1199,37704,10881,26823,37704,3194,0.02684065351156376,0.7375344791003607,0.00018565669424994695,0.2885900700190961,0.7114099299809039,0.03180033948652663
18404,,285,4044,4329,0,280,6779,1493,5286,6779,309,0.04204159905590795,0.596548163445936,0.0,0.22023897329989675,0.7797610267001033,0.04130402714264641
18405,17.0,669,21469,22138,46,1018,29571,8402,21169,29571,2533,0.022623516282844678,0.7260153528795104,0.001555578100165703,0.28412972168678774,0.7158702783132123,0.034425619694971425
18406,17.0,516,10105,11440,53,1249,16413,4012,12401,16413,1073,0.031438493876804974,0.6156705050874307,0.0032291476268811307,0.24444038262353013,0.7555596173764698,0.07609821482970816
18407,,95,4778,4873,25,330,6685,1846,4839,6685,469,0.014210919970082274,0.7147344801795064,0.0037397157816005983,0.2761406133133882,0.7238593866866119,0.0493642483171279
18408,,128,3292,3420,2,126,4524,1311,3213,4524,406,0.028293545534924844,0.7276746242263483,0.0004420866489832007,0.28978779840848806,0.7102122015915119,0.027851458885941646
18409,16.0,356,4787,5143,23,274,7325,1930,5395,7325,459,0.04860068259385666,0.6535153583617748,0.0031399317406143345,0.26348122866894197,0.736518771331058,0.037406143344709895
18410,14.0,105,2518,2623,12,368,4118,1018,3100,4118,229,0.025497814473045166,0.6114618746964546,0.0029140359397765905,0.24720738222438077,0.7527926177756192,0.08936376881981545
18411,,640,14135,14775,72,754,19787,5685,14102,19787,1420,0.03234446859048871,0.7143579117602467,0.0036387527164299794,0.2873098499014504,0.7126901500985495,0.038105827058169506
18412,,793,18911,19704,45,1115,25741,7424,18317,25741,1686,0.030806883959442134,0.7346645429470494,0.0017481838312419875,0.2884114836253448,0.7115885163746553,0.043316110485218134
18413,,2127,38779,40906,106,2137,55595,15770,39825,55595,3938,0.03825883622627934,0.6975267560032377,0.0019066462811403904,0.28365860239230145,0.7163413976076985,0.03843870851695296
18414,37.0,475,8297,8772,78,459,11840,3324,8516,11840,911,0.04011824324324324,0.7007601351351351,0.006587837837837838,0.28074324324324323,0.7192567567567567,0.03876689189189189
18415,26.0,413,10460,10873,63,493,14522,4163,10359,14522,1106,0.02843960886930175,0.7202864619198458,0.004338245420740945,0.28666850296102464,0.7133314970389754,0.0339484919432585
18416,,151,3475,3626,9,157,4705,1384,3321,4705,342,0.03209351753453773,0.7385759829968119,0.0019128586609989374,0.29415515409139215,0.7058448459086079,0.03336875664187035
18417,34.0,118,3386,3504,4,181,4729,1341,3388,4729,362,0.024952421230704167,0.7160076126030873,0.0008458447874814971,0.2835694650031719,0.7164305349968281,0.038274476633537745
18418,26.0,170,2990,3160,59,147,4288,1217,3071,4288,342,0.039645522388059705,0.6972947761194029,0.013759328358208955,0.2838152985074627,0.7161847014925373,0.034281716417910446
18419,15.0,139,2786,2925,0,304,4033,1169,2864,4033,267,0.03446565831886933,0.6908008926357551,0.0,0.289858666005455,0.710141333994545,0.07537813042400199
18420,36.0,34951,455221,490172,4737,30372,678399,184142,494257,678399,42278,0.0515198283016337,0.6710225103515778,0.0069826164248473245,0.2714361312442972,0.7285638687557028,0.04477011316349228
18421,34.0,100,2149,2249,3,119,3101,858,2243,3101,250,0.032247662044501774,0.6930022573363431,0.0009674298613350532,0.2766849403418252,0.7233150596581748,0.03837471783295711
18422,,206,3756,3962,8,268,5236,1510,3727,5237,280,0.039335497422188274,0.717204506396792,0.0015275921329005156,0.28833301508497233,0.7116669849150277,0.05117433645216727
18423,,113,2977,3090,3,135,4183,1214,2969,4183,374,0.02701410470953861,0.7116901745158977,0.0007171886206072197,0.2902223284723882,0.7097776715276117,0.03227348792732489
18424,25.0,492,11024,11516,44,637,15583,4381,11202,15583,1080,0.03157286786883142,0.7074375922479625,0.002823589809407688,0.28113970352307,0.71886029647693,0.04087787974074312
18425,39.0,706,17044,17750,53,1125,23496,6816,16680,23496,1896,0.030047667688117126,0.7254000680966973,0.0022557030983997276,0.2900919305413687,0.7099080694586313,0.047880490296220636
18426,,58,2985,3043,1,149,3964,1157,2807,3964,321,0.014631685166498487,0.7530272452068617,0.0002522704339051463,0.2918768920282543,0.7081231079717457,0.0375882946518668
18427,,187,4352,4539,12,356,6118,1759,4359,6118,446,0.030565544295521413,0.7113435763321346,0.001961425302386401,0.2875122589081399,0.7124877410918601,0.058188950637463224
18428,,117,4837,4954,13,109,6340,1835,4505,6340,567,0.018454258675078865,0.7629337539432177,0.002050473186119874,0.2894321766561514,0.7105678233438486,0.01719242902208202
18429,15.0,280,24866,25146,106,1245,33617,9585,24032,33617,3150,0.00832911919564506,0.7396852782818217,0.0031531665526370587,0.2851235981794925,0.7148764018205075,0.03703483356635036
18430,,348,11524,11872,54,672,16278,4595,11683,16278,1261,0.02137854773313675,0.7079493795306548,0.003317360855141909,0.28228283572920504,0.7177171642707949,0.04128271286398821
18431,,90,1377,1467,10,103,1983,540,1443,1983,134,0.0453857791225416,0.6944024205748865,0.005042864346949067,0.2723146747352496,0.7276853252647504,0.05194150277357539
18432,25.0,250,9123,9373,19,576,12513,3578,8935,12513,947,0.01997922160952609,0.7290817549748262,0.001518420842323983,0.28594261967553747,0.7140573803244625,0.04603212658834812
18433,,9572,93323,102895,1382,8239,142997,39332,103665,142997,8923,0.06693846724057148,0.6526220829807619,0.009664538416889865,0.27505472142772225,0.7249452785722778,0.05761659335510535
18434,15.0,365,6272,6637,1,151,9001,2673,6328,9001,769,0.0405510498833463,0.6968114653927341,0.00011109876680368848,0.2969670036662593,0.7030329963337407,0.01677591378735696
18435,34.0,4346,96325,100671,574,3213,129388,38716,90672,129388,8897,0.03358889541533991,0.7444662565307447,0.0044362692057996105,0.2992240393235849,0.7007759606764151,0.024832287383683184
18436,26.0,2389,41404,43793,271,2418,59085,16662,42424,59086,3901,0.040432589784382085,0.7007412923535186,0.004586534881359374,0.28199573503029485,0.7180042649697052,0.040923399790136414
18437,17.0,391,17445,17836,10,291,22948,6722,16226,22948,2298,0.01703852187554471,0.7601969670559526,0.00043576782290395677,0.29292313055603975,0.7070768694439603,0.012680843646505142
18438,17.0,118,1786,1904,17,127,2560,737,1823,2560,192,0.04609375,0.69765625,0.006640625,0.287890625,0.712109375,0.049609375
18439,17.0,551,12445,12996,31,545,17095,4984,12111,17095,1381,0.03223164668031588,0.7279906405381691,0.0018133957297455396,0.29154723603392807,0.7084527639660719,0.03188066686165546
18440,,3975,54518,58493,234,3038,83765,21891,61874,83765,4521,0.04745418730973557,0.6508446248433116,0.0027935295171014145,0.2613382677729362,0.7386617322270638,0.03626813108100042
18441,,166,2102,2268,18,147,3064,825,2239,3064,186,0.054177545691906005,0.6860313315926893,0.00587467362924282,0.26925587467362927,0.7307441253263708,0.047976501305483026
18442,14.0,232,4663,4895,50,320,6696,1932,4764,6696,446,0.03464755077658303,0.6963859020310633,0.007467144563918757,0.2885304659498208,0.7114695340501792,0.04778972520908005
18443,17.0,5714,90801,96515,708,6194,130674,36556,94118,130674,9342,0.04372713776267659,0.6948666146287709,0.005418063271959227,0.2797496058894654,0.7202503941105346,0.04740040099790318
18444,23.0,75,3752,3827,7,292,5180,1446,3734,5180,411,0.01447876447876448,0.7243243243243244,0.0013513513513513514,0.27915057915057917,0.7208494208494208,0.05637065637065637
18445,16.0,35,2153,2188,0,78,2948,857,2091,2948,236,0.011872455902306648,0.730325644504749,0.0,0.2907055630936228,0.7092944369063772,0.026458616010854818
18446,14.0,2350,46879,49229,167,2862,66014,18955,47059,66014,5142,0.03559850940709546,0.7101372436149908,0.0025297664131850818,0.28713606204744446,0.7128639379525555,0.04335443996727967
18447,34.0,339,12787,13126,73,502,17049,4903,12146,17049,1444,0.0198838641562555,0.7500146636166344,0.00428177605724676,0.2875828494339844,0.7124171505660156,0.029444542201888673
18448,,1327,18920,20247,109,918,26591,7608,18983,26591,1753,0.049904102891955925,0.7115189349780001,0.004099131285021248,0.2861118423526757,0.7138881576473243,0.034522958895867026
18449,27.0,282,8816,9098,18,433,12177,3466,8711,12177,1035,0.023158413402315843,0.7239878459390654,0.0014781966001478197,0.28463496756179685,0.7153650324382032,0.03555884043688922
18450,14.0,560,6912,7472,13,532,10121,2900,7221,10121,643,0.055330500938642425,0.6829364687283865,0.0012844580575041991,0.28653295128939826,0.7134670487106017,0.05256397589171031
18451,17.0,685,13662,14347,61,615,19403,5405,13998,19403,1575,0.03530381899706231,0.7041179199092924,0.003143843735504819,0.27856517033448436,0.7214348296655156,0.0316961294645158
18452,17.0,1232,19850,21082,128,2547,28990,8220,20770,28990,2222,0.04249741290100034,0.6847188685753708,0.004415315626077958,0.2835460503621939,0.7164539496378062,0.08785788202828562
18453,,146,2743,2889,16,263,4060,1073,2987,4060,277,0.03596059113300493,0.675615763546798,0.003940886699507389,0.2642857142857143,0.7357142857142858,0.06477832512315271
18454,44.0,191,5430,5621,9,344,7440,1972,5468,7440,457,0.02567204301075269,0.7298387096774194,0.0012096774193548388,0.26505376344086023,0.7349462365591398,0.046236559139784944
18455,,19,2450,2469,24,148,3346,917,2429,3346,244,0.005678421996413628,0.7322175732217573,0.007172743574417215,0.27405857740585776,0.7259414225941423,0.04423191870890616
18456,34.0,5674,123915,129589,169,6034,173313,49653,123660,173313,12753,0.03273845585732173,0.7149781032005678,0.0009751143884186414,0.28649322324349585,0.7135067767565041,0.034815622601882146
18457,,1181,25900,27081,113,1290,35709,10394,25315,35709,2610,0.03307289478842869,0.725307345487132,0.0031644683413145146,0.29107507911170855,0.7089249208882915,0.03612534655128959
18458,,893,10217,11110,186,545,14808,4183,10625,14808,675,0.06030524041058887,0.6899648838465694,0.012560777957860616,0.2824824419232847,0.7175175580767152,0.036804430037817394
18459,,595,9024,9619,65,648,12759,3626,9133,12759,835,0.046633748726389215,0.7072654596755231,0.005094443138176973,0.28419155106199545,0.7158084489380045,0.05078767928521044
18460,15.0,120,3217,3337,7,290,4462,1164,3298,4462,324,0.02689376961004034,0.7209771402958315,0.0015688032272523531,0.2608695652173913,0.7391304347826086,0.06499327655759748
18461,,260,7714,7974,33,432,10848,2996,7852,10848,832,0.02396755162241888,0.711098820058997,0.0030420353982300885,0.27617994100294985,0.7238200589970502,0.03982300884955752
18462,,470,15724,16194,74,1165,21722,6079,15643,21722,1526,0.02163704999539637,0.7238744130374736,0.00340668446736028,0.27985452536598837,0.7201454746340116,0.053632262222631434
18463,,2789,175420,178209,1691,8483,236196,67769,168427,236196,19375,0.011807989974428017,0.7426882758387102,0.007159308371013904,0.286918491422378,0.713081508577622,0.03591508746972853
18464,16.0,352,11586,11938,36,376,15854,4416,11438,15854,1086,0.022202598713258484,0.7307934906017409,0.0022707203229468905,0.2785416929481519,0.7214583070518481,0.023716412261889745
18465,17.0,65,1967,2032,4,110,2845,776,2069,2845,210,0.022847100175746926,0.6913884007029877,0.00140597539543058,0.27275922671353253,0.7272407732864675,0.03866432337434095
18466,,1903,95719,97622,340,6701,132579,37323,95256,132579,10285,0.014353706092216716,0.7219770853604266,0.002564508708015598,0.28151517208607696,0.718484827913923,0.05054344956591919
18467,17.0,187,4667,4854,0,153,6439,1866,4573,6439,474,0.02904177667339649,0.7248019878863178,0.0,0.28979655225966766,0.7102034477403324,0.023761453641869854
18468,,0,3144,3144,6,261,4421,1180,3241,4421,312,0.0,0.7111513232300385,0.0013571590137977834,0.2669079393802307,0.7330920606197693,0.059036417100203575
18469,13.0,756,18268,19024,20,1136,25634,7343,18291,25634,1831,0.02949208083014746,0.7126472653507061,0.0007802137785753296,0.2864554888039323,0.7135445111960678,0.04431614262307872
18470,,111,4391,4502,16,217,5956,1676,4280,5956,447,0.018636668905305576,0.7372397582269979,0.002686366689053056,0.2813969106783076,0.7186030893216924,0.03643384822028207
18471,16.0,12,1940,1952,0,185,2625,753,1872,2625,218,0.004571428571428572,0.7390476190476191,0.0,0.28685714285714287,0.7131428571428572,0.07047619047619047
18472,25.0,163,3644,3807,0,275,5054,1390,3664,5054,374,0.032251681836169374,0.7210130589631975,0.0,0.27502967946181245,0.7249703205381876,0.05441234665611397
18473,,269,6158,6427,11,443,8716,2432,6284,8716,620,0.03086278109224415,0.7065167508031207,0.0012620468104635153,0.27902707664066084,0.7209729233593392,0.05082606700321248
18474,24.0,725,16635,17360,240,963,23366,6676,16690,23366,1726,0.031027989386287768,0.7119318668150304,0.010271334417529743,0.2857142857142857,0.7142857142857143,0.041213729350338096
18475,,2643,70339,72982,376,3240,94512,27419,67094,94513,6773,0.027964407012791893,0.7442256620782326,0.003978288701025256,0.29010823907822203,0.709891760921778,0.03428099838117508
18476,26.0,457,8621,9078,89,636,12424,3397,9027,12424,905,0.03678364455891822,0.6938989053444945,0.007163554410817772,0.27342240824211206,0.7265775917578879,0.05119124275595621
18477,25.0,934,13477,14411,68,981,19107,5474,13633,19107,1382,0.0488826084681007,0.7053435913539541,0.0035589051133092585,0.2864918616213953,0.7135081383786047,0.05134243994347621
18478,23.0,239,9190,9429,14,765,12585,3619,8966,12585,891,0.018990862137465238,0.7302344060389352,0.0011124354390147,0.2875645609853,0.7124354390147001,0.060786650774731825
18479,23.0,1461,28790,30251,243,2267,41974,11426,30548,41974,2988,0.03480726163815696,0.6859007957306904,0.005789298136941916,0.2722161337971125,0.7277838662028875,0.05400962500595607
18480,,157,2502,2659,15,220,3656,985,2671,3656,237,0.04294310722100656,0.6843544857768052,0.004102844638949671,0.26942013129102843,0.7305798687089715,0.060175054704595186
18481,16.0,31407,399373,430780,7249,30294,584370,163663,420707,584370,36577,0.0537450587812516,0.6834248849188015,0.012404812019781988,0.2800674230367746,0.7199325769632253,0.05184044355459726
18482,,509,11773,12282,37,584,16166,4631,11535,16166,1112,0.03148583446740072,0.7282568353334158,0.0022887541754299146,0.2864654212544847,0.7135345787455153,0.03612520103921811
18483,15.0,330,7828,8158,14,304,10859,3083,7776,10859,876,0.030389538631549865,0.7208766921447647,0.0012892531540657519,0.2839119624274795,0.7160880375725205,0.027995211345427755
18484,16.0,2214,73020,75234,102,6482,104350,28867,75483,104350,8989,0.02121705797795879,0.6997604216578821,0.00097747963584092,0.27663632007666505,0.723363679923335,0.062117872544321995
18485,16.0,112,1893,2005,3,117,2651,764,1887,2651,175,0.042248208223311955,0.7140701622029423,0.001131648434552999,0.2881931346661637,0.7118068653338363,0.044134288947566956
18486,,1062,18165,19227,119,1314,26703,7462,19241,26703,1860,0.03977081226828446,0.6802606448713627,0.0044564281166910085,0.2794442571995656,0.7205557428004344,0.04920795416245366
18487,16.0,8,2142,2150,36,326,3171,732,2439,3171,172,0.002522863450015768,0.6754966887417219,0.011352885525070956,0.23084200567644275,0.7691579943235572,0.10280668558814254
18488,,2777,61553,64330,313,2848,86635,24186,62449,86635,6617,0.032054019737981186,0.7104865239222024,0.003612858544468171,0.2791712356437929,0.7208287643562071,0.03287354995094362
18489,14.0,273,1792,2065,23,177,3074,784,2290,3074,155,0.08880936890045543,0.58295380611581,0.007482108002602472,0.2550422901756669,0.7449577098243331,0.057579700715679895
18490,24.0,148,2727,2875,24,122,3753,1076,2677,3753,253,0.039435118571809216,0.7266187050359713,0.006394884092725819,0.28670397015720755,0.7132960298427924,0.03250732747135625
18491,26.0,819,19160,19979,45,767,26423,7566,18857,26423,1921,0.030995723422775612,0.7251258373386822,0.0017030617265261325,0.2863414449532604,0.7136585550467396,0.029027740983234303
18492,25.0,161,4034,4195,38,170,5634,1583,4051,5634,472,0.02857649982250621,0.7160099396521121,0.0067447639332623354,0.2809726659566915,0.7190273340433084,0.03017394391196308
18493,,344,5272,5616,59,476,7440,2071,5369,7440,394,0.046236559139784944,0.7086021505376344,0.007930107526881721,0.27836021505376346,0.7216397849462366,0.06397849462365592
18494,17.0,326,8078,8404,57,592,11396,3156,8240,11396,774,0.028606528606528608,0.7088452088452089,0.005001755001755002,0.27693927693927695,0.7230607230607231,0.05194805194805195
18495,,258,5776,6034,24,296,8194,2331,5863,8194,739,0.03148645350256285,0.7049060288015622,0.002928972418843056,0.2844764461801318,0.7155235538198682,0.03612399316573102
18496,13.0,258,5518,5776,14,438,8033,2160,5873,8033,535,0.03211751524959542,0.6869164695630524,0.0017428109050168057,0.26889082534545,0.7311091746545499,0.05452508402838292
18497,25.0,194,5450,5644,11,242,7467,2132,5335,7467,576,0.02598098299183072,0.7298781304406053,0.0014731485201553503,0.28552296772465513,0.7144770322753449,0.032409267443417704
18498,,168,4562,4730,23,157,6276,1759,4517,6276,549,0.02676864244741874,0.7268961121733588,0.0036647546207775653,0.2802740599107712,0.7197259400892289,0.02501593371574251
18499,,809,9573,10382,42,801,15055,3916,11139,15055,943,0.0537363002324809,0.6358684822318167,0.002789770840252408,0.26011291929591496,0.739887080704085,0.05320491531052807
18500,17.0,170,4326,4496,14,242,6030,1729,4301,6030,456,0.028192371475953566,0.7174129353233831,0.002321724709784411,0.2867330016583748,0.7132669983416252,0.040132669983416254
18501,,401,6090,6491,40,408,8865,2471,6394,8865,536,0.04523406655386351,0.6869712351945855,0.0045121263395375075,0.2787366046249295,0.7212633953750704,0.046023688663282575
18502,16.0,185,17223,17408,111,694,23433,6577,16856,23433,2429,0.007894849144369052,0.7349891179106388,0.004736909486621432,0.28067255579737976,0.7193274442026202,0.029616353006443902
18503,14.0,305,3278,3583,6,250,4870,1348,3522,4870,306,0.06262833675564682,0.6731006160164271,0.0012320328542094457,0.2767967145790554,0.7232032854209446,0.0513347022587269
18504,,102,3480,3582,8,219,4740,1356,3384,4740,347,0.021518987341772152,0.7341772151898734,0.0016877637130801688,0.28607594936708863,0.7139240506329114,0.046202531645569624
18505,,245,5148,5393,19,319,7429,2081,5348,7429,538,0.03297886660384978,0.692960021537219,0.0025575447570332483,0.2801184547045363,0.7198815452954638,0.04293983039440032
18506,27.0,542,13323,13865,109,577,17855,5297,12558,17855,1211,0.030355642677121254,0.7461775413049566,0.006104732567908149,0.29666760011201343,0.7033323998879866,0.03231587790534864
18507,25.0,546,184067,184613,591,9159,249175,70030,179145,249175,21014,0.0021912310625062706,0.7387057289053878,0.002371827029196348,0.28104745660680247,0.7189525433931976,0.03675729908698706
18508,17.0,139,3541,3680,25,259,4914,1365,3549,4914,331,0.028286528286528285,0.7205942205942206,0.005087505087505087,0.2777777777777778,0.7222222222222222,0.05270655270655271
18509,17.0,182,2348,2530,50,268,3669,949,2720,3669,182,0.04960479694739711,0.639956391387299,0.01362769146906514,0.2586535840828564,0.7413464159171437,0.07304442627418915
18510,,1684,45673,47357,140,3035,64738,17984,46754,64738,4897,0.026012542865086967,0.7055052673854614,0.0021625629460286077,0.2777966572955606,0.7222033427044394,0.04688127529426303
18511,27.0,197,6310,6507,8,268,8457,2510,5949,8459,675,0.02328880482326516,0.7459510580446861,0.0009457382669346259,0.2967253812507389,0.7032746187492611,0.031682231942309964
18512,,177,3654,3831,78,133,5274,1464,3810,5274,295,0.0335608646188851,0.6928327645051194,0.01478953356086462,0.2775881683731513,0.7224118316268487,0.02521805081532044
18513,27.0,909,15286,16195,120,765,22111,6087,16024,22111,1211,0.0411107593505495,0.6913301071864683,0.005427162950567591,0.27529284066754106,0.724707159332459,0.03459816380986839
18514,34.0,146,3881,4027,14,192,5283,1504,3779,5283,398,0.027635812985046374,0.7346204807874314,0.0026500094643195156,0.28468673102403935,0.7153132689759606,0.03634298693923907
18515,,279,3135,3414,206,281,5073,1324,3749,5073,342,0.05499704316972206,0.6179775280898876,0.04060713581707077,0.2609895525330179,0.7390104474669821,0.055391287206781
18516,,108,3104,3212,8,128,4154,1208,2946,4154,306,0.02599903707270101,0.7472315840154068,0.0019258545979778526,0.29080404429465573,0.7091959557053442,0.030813673567645642
18517,46.0,8892,228315,237207,810,16996,329194,90390,238804,329194,23900,0.02701142791180884,0.6935575982551322,0.0024605551741526273,0.27457973110080985,0.7254202688991901,0.05162913054308402
18518,16.0,567,11365,11932,35,777,15806,4450,11356,15806,1072,0.03587245349867139,0.7190307478172846,0.0022143489813994687,0.28153865620650387,0.7184613437934961,0.0491585473870682
18519,16.0,194,14444,14638,17,765,19559,5594,13965,19559,1727,0.009918707500383456,0.7384835625543228,0.0008691650902397873,0.28600644204713943,0.7139935579528606,0.03911242906079043
18520,17.0,225,11445,11670,118,393,14772,4525,10247,14772,941,0.015231519090170594,0.7747766043866775,0.007988085567289466,0.3063227728134308,0.6936772271865692,0.026604386677497968
18521,,112,7598,7710,5,698,10714,2941,7773,10714,986,0.010453612096322569,0.70916557774874,0.00046667911144297183,0.274500653350756,0.725499346649244,0.06514840395743887
18522,24.0,3542,63156,66698,322,4716,91069,25371,65698,91069,6224,0.038893586181906026,0.6934961402892312,0.003535780561991457,0.27859095850399146,0.7214090414960085,0.05178491034270718
18523,24.0,1337,40104,41441,118,3578,55998,15729,40269,55998,4405,0.023875852709025324,0.7161684345869496,0.0021072181149326763,0.2808850316082717,0.7191149683917283,0.06389513911211114
18524,24.0,35,1731,1766,14,101,2349,671,1678,2349,202,0.01489995742869306,0.7369093231162197,0.005959982971477224,0.28565346956151555,0.7143465304384845,0.04299702000851426
18525,15.0,1569,27119,28688,229,1614,38720,10798,27922,38720,2820,0.04052169421487603,0.7003873966942149,0.0059142561983471075,0.2788739669421488,0.7211260330578513,0.04168388429752066
18526,,171,3428,3599,104,271,5417,1333,4084,5417,313,0.031567288166882035,0.6328225955325826,0.019198818534244048,0.24607716448218572,0.7539228355178142,0.05002769060365516
18527,,1365,25221,26586,168,1216,37290,10282,27008,37290,3044,0.03660498793242156,0.6763475462590507,0.004505229283990346,0.27573075891659965,0.7242692410834004,0.03260927862697774
18528,,574,21740,22318,89,883,30319,8547,21778,30325,2158,0.018928276999175597,0.7169002473206925,0.002934872217642209,0.28184666117065127,0.7181533388293487,0.029117889530090684
18529,15.0,40,2948,2988,11,201,4189,1139,3050,4189,379,0.009548818333731201,0.7037479111959895,0.0026259250417760803,0.27190260205299593,0.728097397947004,0.047982812126999286
18530,17.0,134,3705,3839,55,439,5351,1440,3911,5351,347,0.025042048215286862,0.6923939450569987,0.010278452625677444,0.2691085778359185,0.7308914221640814,0.08204074004858905
18531,36.0,652,9658,10310,55,584,14005,3870,10135,14005,1006,0.04655480185647983,0.6896108532666905,0.003927168868261335,0.27632988218493393,0.7236701178150661,0.04169939307390218
18532,34.0,1,3007,3008,4,134,3958,1123,2835,3958,391,0.00025265285497726126,0.7597271349166246,0.001010611419909045,0.28372915613946437,0.7162708438605356,0.033855482566953005
18533,23.0,1810,65491,67301,585,1994,85844,25679,60165,85844,5719,0.021084758398956245,0.7629071338707423,0.0068146871068449745,0.29913564139602067,0.7008643586039793,0.023228181352220306
18534,24.0,28,1954,1982,0,173,2731,731,2000,2731,224,0.010252654705236177,0.715488831929696,0.0,0.26766752105455877,0.7323324789454412,0.06334675942878067
18535,,96,2290,2386,2,216,3206,868,2338,3206,207,0.02994385527136619,0.7142857142857143,0.0006238303181534623,0.27074235807860264,0.7292576419213974,0.06737367436057393
18536,35.0,127,2166,2293,4,89,2975,864,2111,2975,208,0.0426890756302521,0.7280672268907563,0.0013445378151260505,0.29042016806722687,0.7095798319327731,0.02991596638655462
18537,,957,11011,11968,18,888,16299,4596,11703,16299,1085,0.05871525860482238,0.6755629179704277,0.0011043622308117063,0.28198048960058897,0.718019510399411,0.054481870053377505
18538,,14,2708,2722,14,286,3762,974,2788,3762,251,0.003721424774056353,0.7198298777246146,0.003721424774056353,0.25890483785220625,0.7410951621477937,0.07602339181286549
18539,,185,2595,2780,9,258,3835,1056,2779,3835,218,0.048239895697522815,0.6766623207301173,0.002346805736636245,0.27535853976531943,0.7246414602346806,0.06727509778357237
18540,24.0,130,3054,3184,60,135,4172,1228,2944,4172,329,0.0311601150527325,0.7320230105465004,0.014381591562799617,0.2943432406519655,0.7056567593480345,0.03235858101629914
18541,13.0,1217,25581,26798,25,1762,35399,10078,25321,35399,2461,0.03437950224582615,0.72264753241617,0.0007062346393965931,0.2846973078335546,0.7153026921664454,0.04977541738467188
18542,34.0,201,3472,3673,62,126,5003,1447,3556,5003,368,0.04017589446332201,0.6939836098340996,0.012392564461323205,0.2892264641215271,0.7107735358784729,0.025184889066560065
18543,15.0,150,12818,12968,32,1142,18256,4853,13403,18256,1561,0.008216476774758983,0.702125328659071,0.0017528483786152498,0.26583041191936896,0.734169588080631,0.06255477651183172
18544,13.0,55,1720,1775,14,167,2629,638,1991,2629,193,0.02092050209205021,0.6542411563332066,0.005325218714340053,0.24267782426778242,0.7573221757322176,0.06352225180677064
18545,17.0,378,31643,32021,89,1582,42211,12015,30196,42211,3295,0.008955011726801071,0.7496387197649902,0.002108455142024591,0.28464144417331977,0.7153585558266803,0.037478382412167444
18546,,9,9119,9128,32,480,12135,3444,8691,12135,1150,0.0007416563658838071,0.7514627111660486,0.0026370004120313145,0.2838071693448702,0.7161928306551298,0.03955500618046971
18547,15.0,202,4037,4239,18,306,5888,1561,4327,5888,405,0.034307065217391304,0.6856317934782609,0.0030570652173913045,0.26511548913043476,0.7348845108695652,0.051970108695652176
18548,24.0,543,10700,11243,13,1158,15362,3756,11606,15362,907,0.03534696003124593,0.6965238901184742,0.0008462439786486134,0.244499414138784,0.7555005858612159,0.07538080979039187
18549,,2612,18314,20960,68,2469,29932,8016,21916,29932,1404,0.08726446612321262,0.6118535346786048,0.002271816116530803,0.26780702926633704,0.732192970733663,0.08248697046639049
18550,,44,1876,1920,9,83,2528,742,1786,2528,190,0.01740506329113924,0.7420886075949367,0.003560126582278481,0.2935126582278481,0.7064873417721519,0.03283227848101266
18551,25.0,160,5343,5503,16,199,7123,2082,5041,7123,558,0.022462445598764567,0.7501052927137442,0.0022462445598764565,0.2922925733539239,0.7077074266460761,0.027937666713463427
18552,,1083,24247,25330,147,1242,33583,9608,23976,33584,2276,0.032247498808956644,0.7219807050976655,0.0043770843258694615,0.28608861362553595,0.713911386374464,0.03698189614101954
18553,16.0,2029,48514,50543,219,2769,67504,19087,48417,67504,4928,0.03005747807537331,0.7186833372837165,0.003244252192462669,0.28275361460061627,0.7172463853993838,0.04101979141976772
18554,,129,14728,14857,104,1298,20653,5434,15219,20653,1387,0.006246065946835811,0.7131167384883552,0.005035588050162204,0.26310947562097514,0.7368905243790248,0.06284801239529367
18555,,56,1973,2029,12,53,2602,768,1834,2602,212,0.021521906225980016,0.7582628747117602,0.004611837048424289,0.29515757109915447,0.7048424289008455,0.020368946963873945
18556,17.0,298,4030,4328,138,162,5796,1629,4167,5796,422,0.05141476880607315,0.6953071083505866,0.023809523809523808,0.281055900621118,0.718944099378882,0.027950310559006212
18557,16.0,120,5071,5191,99,493,7303,1872,5431,7303,358,0.016431603450636725,0.6943721758181569,0.013556072846775298,0.2563330138299329,0.7436669861700671,0.06750650417636588
18558,17.0,195,5536,5731,23,305,7579,2169,5410,7579,580,0.025728987993138937,0.7304393719488059,0.003034701147908695,0.28618551260060693,0.713814487399393,0.040242776091832695
18559,,156,3674,3830,17,164,5338,1444,3894,5338,389,0.029224428624953166,0.6882727613338329,0.0031847133757961785,0.27051330086174596,0.729486699138254,0.030723117272386663
18560,,186,3797,3983,12,287,5384,1529,3855,5384,401,0.034546805349182766,0.7052377414561665,0.002228826151560178,0.2839895988112927,0.7160104011887073,0.05330609212481426
18561,23.0,52,1767,1819,6,78,2385,710,1675,2385,213,0.02180293501048218,0.740880503144654,0.0025157232704402514,0.2976939203354298,0.7023060796645703,0.03270440251572327
18562,14.0,4634,74250,78884,1280,4241,107490,29775,77715,107490,6696,0.04311098706856452,0.6907619313424505,0.01190808447297423,0.27700251186156855,0.7229974881384315,0.03945483300772165
18563,,299,7888,8187,22,894,11278,3132,8146,11278,701,0.026511792871076433,0.6994147898563575,0.0019507004788082993,0.27770881361943606,0.7222911863805639,0.07926937400248271
18564,37.0,127,5152,5279,5,170,6856,2023,4833,6856,542,0.01852392065344224,0.751458576429405,0.0007292882147024504,0.2950700116686114,0.7049299883313885,0.024795799299883313
18565,,154,4580,4734,0,306,6143,1782,4361,6143,404,0.02506918443757122,0.7455640566498454,0.0,0.2900862770633241,0.7099137229366759,0.04981279505127788
18566,27.0,510,7028,7538,41,493,10344,2806,7538,10344,787,0.049303944315545245,0.6794276875483372,0.003963650425367363,0.27126836813611754,0.7287316318638825,0.04766047950502707
18567,23.0,633,24011,24644,65,1445,32340,9387,22955,32342,2288,0.019572073464844474,0.7424092511285635,0.0020097705769587535,0.2902417908601818,0.7097582091398182,0.044678745903159976
18568,26.0,8,9958,9966,3,499,13387,3864,9523,13387,1298,0.0005975946814073355,0.7438559796817809,0.0002240980055277508,0.288638231119743,0.7113617688802569,0.03727496825278255
18569,,255,3602,3857,32,279,5248,1445,3803,5248,337,0.048589939024390245,0.6863567073170732,0.006097560975609756,0.27534298780487804,0.7246570121951219,0.05316310975609756
18570,17.0,143,4565,4708,2,243,6253,1772,4481,6253,518,0.02286902286902287,0.7300495762034224,0.00031984647369262754,0.283383975691668,0.716616024308332,0.038861346553654245
18571,,902,19343,20245,74,900,26999,7553,19446,26999,2124,0.03340864476462091,0.7164339419978518,0.002740842253416793,0.27975110189266267,0.7202488981073373,0.033334567946961
18572,,41,1794,1835,4,349,2754,681,2073,2754,130,0.014887436456063908,0.6514161220043573,0.0014524328249818446,0.24727668845315903,0.7527233115468409,0.12672476397966595
18573,25.0,451,6547,6998,51,397,9532,2830,6702,9532,591,0.04731430969366345,0.6868443138900545,0.005350398657154847,0.2968946705832984,0.7031053294167017,0.041649181703734786
18574,17.0,143,11340,11483,62,871,15517,4293,11224,15517,1114,0.009215698910871947,0.7308113681768383,0.003995617709608816,0.27666430366694594,0.7233356963330541,0.05613198427531095
18575,27.0,296,8900,9196,18,410,11960,3493,8467,11960,877,0.024749163879598662,0.7441471571906354,0.0015050167224080267,0.292056856187291,0.7079431438127091,0.034280936454849496
18576,24.0,7062,159911,166973,978,7357,220374,64328,156046,220374,16917,0.03204552261156035,0.7256346029930936,0.004437910098287457,0.2919037636018768,0.7080962363981231,0.03338415602566546
18577,,53,1873,1926,15,79,2627,738,1889,2627,186,0.020175104682146935,0.7129805862200228,0.005709935287400076,0.28092881614008375,0.7190711838599163,0.030072325846973735
18578,,121,9673,9794,74,908,13684,3775,9909,13684,874,0.008842443729903537,0.7068839520608009,0.005407775504238527,0.27586962876351945,0.7241303712364806,0.06635486699795382
18579,25.0,4011,79277,83288,313,2984,108560,32266,76308,108574,7348,0.03694254609759243,0.7301656013410208,0.002882826459373331,0.29717980363622964,0.7028201963637704,0.027483559599904214
18580,,1930,42429,44359,171,1532,57868,16718,41150,57868,4642,0.03335176608833898,0.733203152001106,0.0029550010368424692,0.2888988732978503,0.7111011267021498,0.026474044376857676
18581,,193,1691,1884,12,303,2963,713,2250,2963,133,0.0651366857914276,0.5707053661829227,0.004049949375632805,0.24063449206884913,0.7593655079311509,0.10226122173472832
18582,,149,3957,4106,12,187,5461,1622,3839,5461,448,0.02728438015015565,0.7245925654642007,0.0021973997436366965,0.2970151986815602,0.7029848013184399,0.034242812671671854
18583,17.0,8121,115873,123994,852,5332,164847,47095,117752,164847,9902,0.04926386285464704,0.7029123975565221,0.005168428906804492,0.28568915418539614,0.7143108458146038,0.03234514428530698
18584,17.0,272,6320,6592,15,124,8614,2539,6075,8614,624,0.03157650336661249,0.7336893429301138,0.0017413512885999535,0.2947527281170188,0.7052472718829812,0.014395170652426282
18585,,165,3626,3791,8,234,5239,1409,3830,5239,337,0.03149456003054018,0.6921168161862951,0.0015270089711777056,0.2689444550486734,0.7310555449513266,0.04466501240694789
18586,23.0,290,7425,7715,20,299,9904,2936,6968,9904,722,0.029281098546042002,0.7496970920840065,0.0020193861066235864,0.2964458804523425,0.7035541195476576,0.030189822294022617
18587,33.0,1290,24440,25730,101,1485,34848,9866,24982,34848,2450,0.037017906336088154,0.7013314967860422,0.002898301193755739,0.2831152433425161,0.716884756657484,0.04261363636363636
18588,,844,24424,25268,71,1043,32940,9865,23075,32940,2658,0.02562234365513054,0.7414693381906496,0.0021554341226472373,0.29948391013964787,0.7005160898603522,0.031663630843958714
18589,23.0,54,1781,1835,2,103,2544,691,1853,2544,231,0.02122641509433962,0.7000786163522013,0.0007861635220125787,0.2716194968553459,0.7283805031446541,0.0404874213836478
18590,25.0,9960,177892,187852,1540,16427,259312,67774,191545,259319,15951,0.038408292489173566,0.6859967838839421,0.005938631569611174,0.2613537766226154,0.7386462233773846,0.06334668882727451
18591,,517,9538,10055,206,694,13828,3772,10056,13828,849,0.037387908591264105,0.6897599074341915,0.014897309806190338,0.2727798669366503,0.7272201330633498,0.05018802429852473
18592,,7602,180413,188015,390,8131,245031,72584,172489,245073,18046,0.03101932893464396,0.7361602461307447,0.001591362573600519,0.2961729770313335,0.7038270229686665,0.03317786945114313
18593,33.0,764,16561,17325,276,842,25282,6554,18728,25282,1590,0.03021912823352583,0.6550510244442687,0.010916857843525038,0.25923581995095324,0.7407641800490468,0.03330432718930464
18594,23.0,171,4529,4700,13,317,6232,1676,4556,6232,450,0.027439024390243903,0.7267329910141207,0.002086007702182285,0.26893453145057766,0.7310654685494223,0.050866495507060336
18595,14.0,192,4179,4371,1,179,5941,1704,4237,5941,487,0.0323177916175728,0.703416933176233,0.000168321831341525,0.2868204006059586,0.7131795993940414,0.030129607810132974
18596,,5313,1025033,1030346,5663,131971,1428803,391798,1037005,1428803,106749,0.003718497231598758,0.7174068083563654,0.003963457523535435,0.27421414988630344,0.7257858501136966,0.09236472767764345
18597,26.0,935,22048,22983,80,1000,30179,8867,21312,30179,2466,0.030981808542363896,0.7305742403658173,0.002650849928758408,0.2938135789787601,0.70618642102124,0.0331356241094801
18598,,642,12895,13537,57,565,19679,5095,14584,19679,1450,0.03262360892321765,0.6552670359266223,0.002896488642715585,0.25890543218659484,0.7410945678134051,0.028710808476040448
18599,34.0,3402,82828,86230,226,2685,113955,33222,80733,113955,10568,0.02985388969329999,0.7268483173182396,0.0019832389978500283,0.2915361326839542,0.7084638673160458,0.023561932341713835
18600,,1255,17773,19028,66,1146,29601,7095,22506,29601,1683,0.04239721631025979,0.6004189047667309,0.002229654403567447,0.23968784838350055,0.7603121516164995,0.03871490828012567
18601,16.0,448,13126,13574,37,597,18560,5176,13384,18560,1288,0.02413793103448276,0.7072198275862069,0.0019935344827586208,0.2788793103448276,0.7211206896551724,0.03216594827586207
18602,26.0,278,7067,7345,1,377,9969,2835,7134,9969,789,0.027886447988765172,0.7088975825057678,0.00010031096398836393,0.2843815829070117,0.7156184170929882,0.0378172334236132
18603,24.0,444,9988,10432,15,443,14104,3945,10159,14104,1224,0.031480431083380604,0.7081678956324446,0.0010635280771412365,0.2797078842881452,0.7202921157118548,0.03140952921157118
18604,,152,4048,4200,6,245,5537,1561,3976,5537,402,0.027451688640057793,0.731081813256276,0.001083619288423334,0.28192161820480405,0.718078381795196,0.04424778761061947
18605,23.0,110,4834,4944,0,177,6375,1888,4487,6375,512,0.017254901960784313,0.7582745098039215,0.0,0.29615686274509806,0.703843137254902,0.02776470588235294
18606,,199,4212,4411,8,280,5785,1653,4132,5785,380,0.03439930855661193,0.7280898876404495,0.001382886776145203,0.2857389801210026,0.7142610198789974,0.04840103716508211
18607,27.0,2946,46024,48970,273,2194,65345,18554,46791,65345,5413,0.045083786058611984,0.7043232075904813,0.0041778253883235136,0.28393909250899074,0.7160609074910093,0.033575637003596295
18608,33.0,198,4472,4670,38,353,6594,1787,4807,6594,448,0.03002729754322111,0.678192296026691,0.005762814680012132,0.27100394297846525,0.7289960570215347,0.053533515316954806
18609,40.0,293,8415,8708,203,354,11836,3240,8596,11836,675,0.024754984792159512,0.7109665427509294,0.017151064548834066,0.2737411287597161,0.7262588712402839,0.029908752957080096
18610,,52,3571,3623,30,337,5092,1390,3702,5092,418,0.01021209740769835,0.7012961508248232,0.00589159465828751,0.27297721916732126,0.7270227808326787,0.06618224666142969
18611,16.0,128,1456,1584,25,157,2184,571,1613,2184,120,0.05860805860805861,0.6666666666666666,0.011446886446886446,0.26144688644688646,0.7385531135531136,0.07188644688644688
18612,15.0,435,9023,9458,57,537,12962,3579,9383,12962,991,0.03355963585866378,0.6961117111556858,0.004397469526307669,0.2761147970992131,0.723885202900787,0.04142879185310909
18613,,60,2875,2935,30,311,4221,1075,3146,4221,206,0.014214641080312722,0.6811182184316512,0.007107320540156361,0.2546789860222696,0.7453210139777304,0.07367922293295427
18614,24.0,1644,43108,44752,36,2356,59952,17122,42830,59952,4621,0.02742193755004003,0.7190419001868161,0.0006004803843074459,0.2855951427808914,0.7144048572191086,0.0392981051507873
18615,14.0,330,15255,15585,31,638,20389,5896,14493,20389,1937,0.01618519790082888,0.7481975575064986,0.001520427681593016,0.28917553582814265,0.7108244641718574,0.031291382608269164
18616,,333,8742,9075,132,588,12323,3516,8807,12323,741,0.027022640590765236,0.7094051773107198,0.010711677351294328,0.2853201330844762,0.7146798669155238,0.04771565365576564
18617,25.0,2112,63140,65252,124,2041,83024,25302,57722,83024,6393,0.02543842744266718,0.760502987088071,0.0014935440354596262,0.30475525149354404,0.695244748506456,0.02458325303526691
18618,14.0,205,3097,3302,50,284,4884,1193,3691,4884,265,0.041973791973791974,0.6341113841113841,0.010237510237510237,0.24426699426699428,0.7557330057330057,0.05814905814905815
18619,23.0,1013,18831,19844,88,1074,26445,7629,18816,26445,1978,0.03830591794290036,0.7120816789563245,0.00332766118358858,0.28848553601815086,0.7115144639818491,0.040612592172433355
18620,,825,17812,18637,92,533,24291,6987,17304,24291,2077,0.033963196245523034,0.7332756988184924,0.003787410975258326,0.2876373965666296,0.7123626034333704,0.021942283150137912
18621,,126,2057,2183,1,166,2966,819,2147,2966,198,0.04248145650708024,0.6935266351989211,0.00033715441672285906,0.27612946729602156,0.7238705327039784,0.055967633175994604
18622,25.0,370,10229,10599,9,493,14123,3945,10178,14123,1029,0.026198399773419246,0.724279544006231,0.0006372583728669546,0.27933158677334846,0.7206684132266515,0.03490759753593429
18623,,79,2826,2905,10,103,3741,1121,2620,3741,260,0.02111734830259289,0.7554129911788292,0.002673082063619353,0.2996524993317295,0.7003475006682706,0.027532745255279337
18624,,117,3057,3174,20,195,4296,1206,3090,4296,360,0.02723463687150838,0.7115921787709497,0.004655493482309125,0.2807262569832402,0.7192737430167597,0.04539106145251397
18625,,780,22477,23257,233,1514,32115,8655,23460,32115,1896,0.024287716020551145,0.6998910166588821,0.007255176708703098,0.269500233535731,0.7304997664642691,0.047143079557839015
18626,17.0,4517,87759,92276,871,7384,128322,35663,92659,128322,9399,0.03520051121397734,0.6838967597138449,0.006787612412524743,0.27791804990570596,0.722081950094294,0.057542744034538115
18627,25.0,398,6196,6594,2,358,8634,2504,6130,8634,551,0.046096826499884176,0.7176279823951819,0.0002316423442205235,0.2900162149640954,0.7099837850359045,0.04146397961547371
18628,,3816,72505,76321,142,4969,102877,29342,73535,102877,7044,0.0370928390213556,0.7047736617514119,0.0013802890830797944,0.2852143822234319,0.7147856177765681,0.04830039756213731
18629,26.0,45,1936,1981,2,73,2539,768,1771,2539,191,0.017723513194170933,0.7625049231981095,0.0007877116975187081,0.3024812918471839,0.697518708152816,0.028751476959432847
18630,,136,4806,4942,14,147,6375,1845,4530,6375,536,0.021333333333333333,0.7538823529411764,0.002196078431372549,0.28941176470588237,0.7105882352941176,0.023058823529411764
18631,,158,3044,3202,28,473,4638,1211,3427,4638,279,0.03406640793445451,0.6563173781802502,0.00603708495040966,0.26110392410521777,0.7388960758947822,0.10198361362656318
18632,23.0,1257,5839,7096,17,262,9777,2796,6985,9781,595,0.12851446682343318,0.5969737245680401,0.001738063592679685,0.28586034147837647,0.7141396585216235,0.026786627134239852
18633,26.0,245,3327,3572,36,209,5092,1273,3819,5092,292,0.048114689709348,0.6533778476040848,0.007069913589945012,0.25,0.75,0.041044776119402986
18634,14.0,120,1915,2035,0,195,2907,803,2104,2907,191,0.0412796697626419,0.6587547299621603,0.0,0.2762297901616787,0.7237702098383213,0.06707946336429309
18635,25.0,403,22913,23316,131,2151,32551,8869,23682,32551,2415,0.012380572025437006,0.7039107861509631,0.004024453933826918,0.272464747626801,0.7275352523731989,0.06608091917299008
18636,16.0,4669,74748,79417,568,5106,111234,30514,80720,111234,8070,0.04197457611881259,0.6719887804088678,0.0051063523742740525,0.27432259920527896,0.725677400794721,0.045903231026484706
18637,,221,5459,5680,8,561,7725,2007,5718,7725,505,0.0286084142394822,0.7066666666666667,0.001035598705501618,0.25980582524271845,0.7401941747572816,0.07262135922330097
18638,24.0,148,4355,4503,14,235,5924,1803,4121,5924,340,0.024983119513842,0.7351451721809588,0.002363268062120189,0.30435516542876434,0.6956448345712356,0.039669142471303175
18639,,479,7691,8170,12,451,10767,3248,7519,10767,643,0.04448778675582799,0.7143122503947246,0.0011145165784341043,0.3016624872294975,0.6983375127705025,0.04188724807281508
18640,25.0,53,1493,1546,1,44,2109,588,1521,2109,193,0.025130393551446185,0.70791844476055,0.000474158368895211,0.27880512091038406,0.7211948790896159,0.020862968231389285
18641,,500,9572,10072,59,527,13727,3796,9931,13727,994,0.03642456472645152,0.6973118671231878,0.00429809863772128,0.2765352954032199,0.72346470459678,0.0383914912216799
18642,33.0,194,5066,5260,13,238,6939,2060,4879,6939,521,0.027957919008502665,0.7300763798818274,0.0018734687995388384,0.29687274823461596,0.703127251765384,0.03429889033001873
18643,39.0,143,4572,4715,8,197,5923,1793,4130,5923,368,0.02414317069052845,0.7719061286510215,0.0013506668917778154,0.30271821711970287,0.6972817828802972,0.0332601722100287
18644,26.0,247,7944,8191,42,371,10547,3178,7369,10547,641,0.023418981700957617,0.7531999620745236,0.003982175026073765,0.3013179103062482,0.6986820896937518,0.035175879396984924
18645,13.0,119,2105,2224,22,135,3064,834,2230,3064,215,0.03883812010443864,0.6870104438642297,0.007180156657963447,0.27219321148825065,0.7278067885117493,0.04406005221932115
18646,17.0,142,4454,4596,5,270,6167,1744,4423,6167,510,0.023025782390141074,0.7222312307442841,0.0008107669855683476,0.2827955245662397,0.7172044754337603,0.043781417220690774
18647,16.0,704,9129,9833,59,611,13338,3805,9533,13338,783,0.05278152646573699,0.6844354475933423,0.004423451791872844,0.2852751536962063,0.7147248463037936,0.04580896686159844
18648,24.0,188,4484,4672,37,212,6285,1773,4512,6285,504,0.029912490055688145,0.7134447096260939,0.0058870326173428794,0.2821002386634845,0.7178997613365156,0.03373110580747812
18649,17.0,7160,99394,106554,179,5602,143322,41205,102117,143322,12060,0.04995743849513683,0.6935013466181047,0.0012489359623784207,0.28749947670280906,0.7125005232971909,0.03908681151532912
18650,33.0,341,4665,5006,35,341,7045,1830,5215,7045,415,0.04840312278211498,0.6621717530163236,0.0049680624556423,0.25975869410929736,0.7402413058907026,0.04840312278211498
18651,17.0,236,9836,10072,0,346,13210,3801,9409,13210,1243,0.01786525359576079,0.7445874337623013,0.0,0.28773656320968966,0.7122634367903103,0.02619227857683573
18652,27.0,92,2858,2950,9,155,3925,1090,2835,3925,304,0.023439490445859874,0.7281528662420382,0.0022929936305732482,0.27770700636942675,0.7222929936305732,0.03949044585987261
18653,14.0,250,10510,10760,1,435,14393,4171,10222,14393,1217,0.017369554644618913,0.7302160772597791,6.947821857847565e-05,0.28979364969082194,0.7102063503091781,0.030223025081636906
18654,25.0,71,1502,1573,2,90,2182,638,1544,2182,162,0.03253895508707608,0.6883593033913841,0.0009165902841429881,0.2923923006416132,0.7076076993583869,0.04124656278643447
18655,24.0,226,2536,2762,1,123,3665,1098,2567,3665,275,0.061664392905866304,0.6919508867667121,0.00027285129604365623,0.29959072305593454,0.7004092769440655,0.033560709413369715
18656,40.0,983,23264,24247,93,904,31650,9263,22388,31651,2521,0.03105747053805567,0.7350162712078607,0.002938295788442703,0.2926605794445673,0.7073394205554326,0.02856149884679789
18657,26.0,416,18760,19176,65,752,25202,7284,17918,25202,2005,0.016506626458217603,0.7443853662407746,0.0025791603840965003,0.2890246805809063,0.7109753194190938,0.02983890167447028
18658,14.0,425,3807,4232,19,339,5869,1588,4281,5869,298,0.07241438064406203,0.6486624637928097,0.0032373487817345375,0.27057420344181293,0.7294257965581871,0.05776111773726359
18659,,1205,37474,38679,80,1668,49423,14803,34620,49423,3380,0.024381360904841876,0.7582299738987921,0.0016186795621471785,0.29951641948080854,0.7004835805191915,0.03374946887076867
18660,25.0,40747,413592,454339,3088,26164,633505,170768,462737,633505,39219,0.06431993433358853,0.6528630397550138,0.0048744682362412296,0.26956061909535045,0.7304393809046495,0.04130038436949984
18661,,179,7910,8089,0,264,10368,3024,7344,10368,775,0.01726466049382716,0.7629243827160493,0.0,0.2916666666666667,0.7083333333333334,0.02546296296296296
18662,16.0,294,6176,6470,12,363,8599,2425,6174,8599,613,0.034190022095592514,0.7182230491917665,0.0013955111059425515,0.2820095359925573,0.7179904640074427,0.04221421095476218
18663,23.0,673,13678,14351,58,746,18417,5410,13007,18417,1186,0.03654232502579139,0.742683390345876,0.0031492642667101047,0.2937503393603736,0.7062496606396265,0.04050605418906445
18664,,1804,48523,50327,164,3104,67466,19234,48232,67466,5011,0.026739394658049982,0.7192215338096226,0.0024308540598227254,0.28509174991847747,0.7149082500815226,0.04600835976640085
18665,38.0,80,3347,3427,2,193,4510,1334,3176,4510,287,0.017738359201773836,0.7421286031042129,0.0004434589800443459,0.2957871396895787,0.7042128603104213,0.04279379157427938
18666,,618,13865,14483,88,625,19563,5544,14019,19563,1461,0.03159024689464806,0.7087358789551704,0.004498287583703931,0.28339211777334766,0.7166078822266524,0.031948065225169964
18667,,225,7695,7920,9,405,10384,3076,7308,10384,733,0.021667950693374422,0.7410439137134053,0.0008667180277349769,0.29622496147919875,0.7037750385208013,0.03900231124807396
18668,,332,7878,8210,26,305,11018,3117,7901,11018,704,0.030132510437465964,0.7150117988745689,0.002359774913777455,0.2829007079324741,0.7170992920675259,0.027681974950081685
18669,26.0,134,4426,4560,4,129,5899,1791,4108,5899,471,0.022715714527886084,0.7502966604509239,0.0006780810306831666,0.3036107814883879,0.6963892185116122,0.021868113239532125
18670,25.0,871,26275,27146,253,1135,35993,10341,25653,35994,2861,0.024198477524031783,0.729982774906929,0.0070289492693226645,0.28729788298049674,0.7127021170195033,0.031533033283325
18671,23.0,1961,49109,51070,199,2101,66828,19497,47331,66828,4744,0.029343987550128688,0.734856646914467,0.002977793739151254,0.29174896749865326,0.7082510325013467,0.031438917818878316
18672,35.0,303,8741,9044,21,430,11856,3405,8451,11856,912,0.025556680161943318,0.7372638326585695,0.001771255060728745,0.28719635627530365,0.7128036437246964,0.03626855600539811
18673,34.0,2510,39887,42397,652,2401,57424,16482,40942,57424,3580,0.04370994706046252,0.6946050431875174,0.011354137642797437,0.2870228475898579,0.7129771524101421,0.04181178601281694
18674,,8,1616,1624,8,55,2151,628,1523,2151,210,0.003719200371920037,0.7512784751278475,0.003719200371920037,0.2919572291957229,0.7080427708042771,0.025569502556950254
18675,25.0,6006,191767,197773,408,7958,260164,75346,184818,260164,18163,0.023085438415768517,0.7371004443351117,0.0015682415707015576,0.2896096308482342,0.7103903691517658,0.03058839808736028
18676,,234,12830,13064,11,339,17018,5050,11968,17018,1557,0.013750146903278882,0.7539076272182396,0.0006463744270772124,0.29674462333999296,0.703255376660007,0.019920084616288636
18677,15.0,301,7426,7727,17,583,10300,2908,7392,10300,717,0.029223300970873785,0.7209708737864078,0.0016504854368932038,0.28233009708737866,0.7176699029126213,0.05660194174757282
18678,23.0,406,14165,14571,49,632,18717,5650,13067,18717,1370,0.02169151039162259,0.7567986322594433,0.0026179409093337607,0.3018646150558316,0.6981353849441684,0.033766094993855855
18679,,808,17850,18658,120,831,23720,7082,16638,23720,1426,0.03406408094435076,0.7525295109612141,0.00505902192242833,0.29856661045531196,0.701433389544688,0.03503372681281619
18680,17.0,99,2713,2812,68,118,3862,1103,2759,3862,308,0.02563438632832729,0.702485758674262,0.017607457276022784,0.285603314344899,0.714396685655101,0.030554117037804248
18681,,1646,48844,50490,64,1972,65227,19242,45985,65227,4371,0.025234948717555612,0.7488310055651801,0.000981188771520996,0.29500053658760944,0.7049994634123906,0.030232879022490687
18682,,110,2492,2602,7,226,3564,978,2586,3564,252,0.030864197530864196,0.6992143658810326,0.001964085297418631,0.27441077441077444,0.7255892255892256,0.06341189674523008
18683,26.0,189,2060,2249,68,151,3126,845,2281,3126,159,0.060460652591170824,0.6589891234804862,0.021753039027511197,0.2703134996801024,0.7296865003198977,0.04830454254638516
18684,,20,1861,1881,20,79,2704,738,1966,2704,211,0.0073964497041420114,0.6882396449704142,0.0073964497041420114,0.2729289940828402,0.7270710059171598,0.029215976331360947
18685,25.0,220,15303,15523,14,385,19873,5994,13879,19873,1555,0.011070296382025864,0.7700397524279172,0.0007044734061289186,0.3016152568811956,0.6983847431188044,0.019373018668545263
18686,16.0,41,2589,2630,14,287,3708,986,2722,3708,280,0.011057173678532902,0.698220064724919,0.0037756202804746495,0.26591154261057176,0.7340884573894283,0.07740021574973031
18687,27.0,864,25180,26044,98,1626,34853,9877,24976,34853,2667,0.024789831578343326,0.7224629156744039,0.0028118096003213497,0.28339023900381605,0.716609760996184,0.04665308581757668
18688,17.0,946,13995,14941,42,958,20052,5643,14409,20052,1354,0.04717733891881109,0.697935368043088,0.002094554159186116,0.28141831238779175,0.7185816876122083,0.047775782964292836
18689,,188,4585,4773,122,314,6287,1728,4559,6287,348,0.02990297439160172,0.7292826467313505,0.019405121679656433,0.27485287100365835,0.7251471289963417,0.049944329568951805
18690,,853,10381,11234,35,597,15625,4164,11461,15625,872,0.054592,0.664384,0.00224,0.266496,0.733504,0.038208
18691,16.0,300,2210,2510,6,271,3752,947,2805,3752,167,0.07995735607675906,0.5890191897654584,0.0015991471215351812,0.2523987206823028,0.7476012793176973,0.07222814498933902
18692,24.0,1126,25576,26702,91,1544,34929,9785,25144,34929,2270,0.03223682327006212,0.7322282344183916,0.002605285006727934,0.28013971198717397,0.719860288012826,0.044203956597669555
18693,23.0,152,2801,2953,4,209,4001,1143,2858,4001,282,0.0379905023744064,0.7000749812546864,0.000999750062484379,0.2856785803549113,0.7143214196450888,0.052236940764808795
18694,24.0,173,3414,3587,15,165,4728,1361,3367,4728,371,0.036590524534686975,0.7220812182741116,0.0031725888324873096,0.2878595600676819,0.7121404399323181,0.03489847715736041
18695,16.0,122,2463,2585,8,213,3543,971,2572,3543,275,0.034434095399379056,0.6951735817104149,0.0022579734688117415,0.27406152977702514,0.7259384702229749,0.060118543607112614
18696,,155,6029,6184,2,264,8553,2379,6174,8553,641,0.01812229627031451,0.7048988658950076,0.00023383608090728398,0.2781480182392143,0.7218519817607857,0.030866362679761488
18697,16.0,26,10944,10970,41,517,14331,4137,10194,14331,1053,0.0018142488312050799,0.7636592003349383,0.0028609308492080106,0.2886749005652083,0.7113250994347917,0.03607564022050101
18698,15.0,2240,84170,86410,575,8785,119287,32103,87184,119287,6900,0.018778240713573147,0.7056091610988624,0.004820307326028821,0.26912404536957085,0.7308759546304291,0.07364591279854468
18699,,1844,83034,84878,29,3347,108793,30422,78371,108793,7144,0.01694961992039929,0.7632292518820145,0.00026656126772862227,0.27963196161517745,0.7203680383848226,0.030764847003024093
18700,16.0,52,1977,2029,13,158,2773,760,2013,2773,231,0.01875225387666787,0.712946267580238,0.0046880634691669676,0.2740714028128381,0.725928597187162,0.0569780021637216
18701,14.0,118,3770,3888,6,241,5229,1467,3762,5229,394,0.02256645630139606,0.7209791547140945,0.0011474469305794606,0.28055077452667815,0.7194492254733219,0.04608911837827501
18702,23.0,570,13534,14104,51,458,20862,5286,15576,20862,1404,0.0273224043715847,0.6487393346754865,0.002444636180615473,0.2533793500143802,0.7466206499856198,0.02195379158278209
18703,13.0,254,3938,4192,9,405,5897,1612,4285,5897,359,0.04307274885535018,0.6677971850093267,0.001526199762591148,0.2733593352552145,0.7266406647447855,0.06867898931660166
18704,24.0,600,9399,9999,22,570,13304,3854,9450,13304,894,0.04509921828021648,0.7064792543595911,0.0016536380036079375,0.2896873120865905,0.7103126879134095,0.04284425736620565
18705,25.0,115,2677,2792,1,140,3692,1086,2606,3692,278,0.03114842903575298,0.7250812567713976,0.00027085590465872155,0.2941495124593716,0.7058504875406284,0.03791982665222102
18706,38.0,1353,35794,37147,155,2778,50171,13701,36470,50171,4052,0.02696777022582767,0.7134400350800263,0.0030894341352574197,0.2730860457236252,0.7269139542763748,0.055370632437065234
18707,,90,3144,3234,9,137,5180,1212,3968,5180,350,0.017374517374517374,0.6069498069498069,0.0017374517374517374,0.23397683397683397,0.766023166023166,0.026447876447876446
18708,13.0,1500,22993,24493,468,3898,36835,9061,27774,36835,1681,0.0407221392697163,0.6242160988190579,0.012705307452151487,0.24598886928193295,0.754011130718067,0.10582326591556943
18709,,329,10026,10355,84,365,13474,4116,9358,13474,1011,0.0244173964672703,0.7440997476621641,0.006234228885260502,0.30547721537776457,0.6945227846222354,0.027089208846667656
18710,16.0,35,3252,3287,32,220,4576,1213,3363,4576,367,0.007648601398601399,0.7106643356643356,0.006993006993006993,0.26507867132867136,0.7349213286713286,0.04807692307692308
18711,,119,2841,2960,23,105,3959,1126,2833,3959,346,0.030058095478656226,0.7176054559232129,0.005809547865622632,0.2844152563778732,0.7155847436221268,0.026521848951755495
18712,27.0,167,2513,2680,14,174,3709,996,2713,3709,220,0.045025613372876784,0.6775411162038285,0.0037746023186842814,0.26853599352925317,0.7314640064707468,0.04691291453221893
18713,,1017,22577,23594,130,1242,31540,9055,22485,31540,2188,0.03224476854787571,0.7158211794546607,0.004121750158528852,0.2870957514267597,0.7129042485732403,0.03937856689917565
18714,,123,3689,3812,0,137,5054,1500,3554,5054,442,0.02433715868618916,0.7299168975069252,0.0,0.296794618124258,0.703205381875742,0.02710724178868223
18715,16.0,213,2924,3137,153,357,4568,1231,3337,4568,267,0.04662872154115587,0.6401050788091068,0.0334938704028021,0.2694833625218914,0.7305166374781086,0.0781523642732049
18716,26.0,2138,56724,58862,278,2904,77053,21885,55168,77053,5068,0.02774713508883496,0.7361686112156568,0.003607906246349915,0.28402528129988447,0.7159747187001155,0.037688344386331486
18717,,543,14507,15050,39,609,20026,5785,14241,20026,1636,0.027114750823928894,0.724408269249975,0.0019474682912214122,0.2888744631978428,0.7111255368021572,0.030410466393688204
18718,25.0,223,4030,4253,30,276,6013,1590,4423,6013,416,0.03708631298852486,0.6702145351737901,0.004989190088142358,0.26442707467154497,0.735572925328455,0.04590054881090969
18719,,618,30255,30873,247,1932,42120,11737,30383,42120,3864,0.014672364672364673,0.7183048433048433,0.005864197530864198,0.278656220322887,0.721343779677113,0.04586894586894587
18720,,242,5128,5370,58,373,7224,2044,5180,7224,525,0.03349944629014397,0.7098560354374308,0.008028792912513842,0.28294573643410853,0.7170542635658915,0.05163344407530454
18721,,97,6532,6629,26,287,8898,2585,6313,8898,751,0.010901326140705776,0.7340975500112384,0.0029220049449314453,0.29051472240953025,0.7094852775904698,0.032254439199820184
18722,,211,6473,6684,19,636,9684,2521,7163,9684,602,0.021788517141676993,0.6684221396117307,0.001961999173895085,0.2603263114415531,0.739673688558447,0.06567534076827757
18723,24.0,1224,33238,34756,362,1740,46830,13057,33773,46830,3706,0.026137091607943627,0.7097587016869528,0.007730087550715354,0.27881699765107837,0.7211830023489216,0.037155669442664956
18724,13.0,0,1627,1627,10,16,2143,627,1516,2143,224,0.0,0.7592160522631825,0.004666355576294913,0.29258049463369107,0.7074195053663089,0.007466168922071862
18725,14.0,797,7302,8099,43,1225,11641,3146,8495,11641,405,0.06846490851301434,0.6272656988231251,0.003693840735332016,0.27025169658964004,0.7297483034103599,0.10523150932050511
18726,,220,3713,3933,44,363,5586,1533,4053,5586,417,0.039384174722520586,0.6646974579305407,0.007876834944504118,0.2744360902255639,0.7255639097744361,0.06498388829215897
18727,17.0,10714,176620,187334,616,11940,249948,70815,179133,249948,17500,0.042864915902507725,0.7066269784115096,0.002464512618624674,0.2833189303375102,0.7166810696624898,0.04776993614671852
18728,24.0,735,22097,22832,317,1006,30097,8719,21378,30097,1993,0.02442103864172509,0.7341927766887065,0.010532611223710004,0.289696647506396,0.710303352493604,0.033425258331395154
18729,,1056,8801,9857,187,853,13364,3673,9691,13364,748,0.07901825800658485,0.6585603112840467,0.013992816521999402,0.27484286141873693,0.7251571385812631,0.06382819515115234
18730,,7776,155741,163517,1297,21938,230264,61788,168476,230264,15706,0.03376993364138554,0.6763584407462738,0.005632665114824723,0.2683354758016885,0.7316645241983115,0.09527325157210853
18731,15.0,66,6593,6659,49,200,8750,2598,6152,8750,508,0.007542857142857143,0.7534857142857143,0.0056,0.29691428571428574,0.7030857142857143,0.022857142857142857
18732,24.0,1521,33010,34531,252,1760,45139,13139,32000,45139,3247,0.03369591705620417,0.7312966614236026,0.005582755488601874,0.2910786681140477,0.7089213318859523,0.038990673253727376
18733,,228,6449,6677,68,249,8750,2545,6205,8750,679,0.02605714285714286,0.7370285714285715,0.0077714285714285715,0.29085714285714287,0.7091428571428572,0.028457142857142858
18734,,211,3087,3298,37,250,4483,1264,3219,4483,277,0.04706669640865492,0.6886013830024537,0.008253401739906312,0.28195404862815077,0.7180459513718492,0.05576622797233995
18735,13.0,284,5774,6058,21,312,7994,2312,5682,7994,639,0.0355266449837378,0.7222917187890918,0.002626970227670753,0.2892169126845134,0.7107830873154866,0.03902927195396547
18736,13.0,295,3943,4238,0,200,5466,1603,3863,5466,439,0.0539699963410172,0.72136845956824,0.0,0.2932674716428833,0.7067325283571168,0.03658982802780827
18737,,376,6049,6425,53,411,8734,2538,6196,8734,509,0.04305014884359973,0.6925807190290818,0.006068239065720174,0.29058850469429814,0.7094114953057018,0.04705747652850927
18738,40.0,8943,124503,133446,1924,5892,171405,51403,120530,171933,11708,0.05201444748826578,0.7241367276788051,0.011190405564958443,0.2989711108396875,0.7010288891603125,0.03426916298790808
18739,42.0,726,13228,13954,78,503,18467,5344,13123,18467,1335,0.03931336979476905,0.7163047598418801,0.004223750473818162,0.28938105810364434,0.7106189418963557,0.02723777549141712
18740,,218,4078,4296,47,200,5921,1662,4259,5921,380,0.036818105049822664,0.6887350109778754,0.007937848336429658,0.2806958284073636,0.7193041715926364,0.03377807802736024
18741,16.0,642,10935,11577,69,705,16550,4450,12100,16550,1016,0.03879154078549849,0.6607250755287009,0.004169184290030212,0.2688821752265861,0.7311178247734139,0.042598187311178246
18742,,856,34681,35537,149,1070,44011,13830,30181,44011,2790,0.019449683033787007,0.7880075435686533,0.003385517257049374,0.31423962191270366,0.6857603780872964,0.02431210379223376
18743,,3883,41709,45592,583,2609,66655,16755,49900,66655,2892,0.05825519465906533,0.6257445052884255,0.008746530642862502,0.2513689895731753,0.7486310104268247,0.03914184982371915
18744,,144,3378,3522,6,151,4718,1327,3391,4718,365,0.03052140737600678,0.7159813480288257,0.001271725307333616,0.28126324713861806,0.718736752861382,0.032005086901229336
18745,,3871,103348,107274,735,7555,145832,39934,105898,145832,9925,0.02654424269021888,0.7086784793460968,0.005040046080421307,0.2738356464973394,0.7261643535026606,0.05180618794228976
18746,,155,2928,3083,6,157,4293,1188,3105,4293,296,0.03610528767761472,0.6820405310971349,0.001397624039133473,0.27672955974842767,0.7232704402515723,0.03657116235732588
18747,14.0,240,5454,5694,28,279,7634,2159,5475,7634,547,0.03143830233167409,0.7144354204872937,0.0036678019386953103,0.2828137280586848,0.7171862719413151,0.036547026460571126
18748,16.0,10,3447,3457,26,503,4861,1311,3550,4861,161,0.002057189878625797,0.7091133511623123,0.005348693684427073,0.269697593087842,0.730302406912158,0.10347665089487759
18749,26.0,122,3531,3653,14,211,4851,1443,3408,4851,213,0.025149453720882294,0.7278911564625851,0.002886002886002886,0.2974644403215832,0.7025355596784169,0.04349618635332921
18750,,128,3585,3713,12,254,4943,1342,3601,4943,376,0.0258952053408861,0.7252680558365365,0.002427675500708072,0.27149504349585274,0.7285049565041473,0.051385798098320855
18751,24.0,11453,220251,231704,1296,13702,303088,88099,214989,303088,18558,0.037787705220925935,0.7266899382357599,0.004275985852293723,0.29067135617378453,0.7093286438262155,0.045207992398247375
18752,,626,9176,9802,34,712,13489,3714,9775,13489,977,0.04640818444658611,0.6802579879902142,0.002520572318185188,0.27533545852175845,0.7246645414782416,0.0527837497219957
18753,16.0,59,3642,3701,0,144,4798,1412,3386,4798,369,0.012296790329303876,0.7590662776156732,0.0,0.29428928720300124,0.7057107127969987,0.030012505210504376
18754,17.0,237,14755,14992,23,373,18788,5895,12893,18788,1418,0.012614434745582286,0.785341707472855,0.0012241856504151586,0.3137641047477113,0.6862358952522887,0.01985309772195018
18755,23.0,285,6434,6719,70,279,8651,2579,6072,8651,552,0.03294416830424229,0.7437290486648942,0.008091550109813894,0.2981158247601433,0.7018841752398567,0.03225060686625823
18756,27.0,14031,289453,303484,1641,15831,414368,115311,299169,414480,30703,0.033852055587724375,0.6983521520941903,0.003959177764910249,0.27820642733063117,0.7217935726693688,0.038194846554719164
18757,23.0,1275,29753,31028,394,1366,40393,11732,28661,40393,2792,0.03156487510212166,0.7365880226771966,0.00975416532567524,0.29044636446909117,0.7095536355309088,0.033817740697645635
18758,24.0,180,4225,4405,10,388,5942,1663,4279,5942,413,0.030292830696735107,0.7110400538539212,0.001682935038707506,0.2798720969370582,0.7201279030629417,0.06529787950185123
18759,26.0,205,4811,5016,12,230,6773,1852,4921,6773,408,0.030267237560903586,0.7103203897829617,0.0017717407352724052,0.2734386534770412,0.7265613465229588,0.0339583640927211
18760,17.0,309,3188,3497,16,469,5155,1303,3852,5155,302,0.05994180407371484,0.6184287099903006,0.0031037827352085354,0.2527643064985451,0.7472356935014549,0.09097963142580019
18761,25.0,118,1993,2111,7,122,2840,800,2040,2840,195,0.04154929577464789,0.7017605633802817,0.0024647887323943664,0.28169014084507044,0.7183098591549296,0.04295774647887324
18762,25.0,1003,19307,20310,44,1036,27391,7749,19642,27391,1853,0.03661786718265123,0.7048665620094191,0.0016063670548720382,0.28290314336825967,0.7170968566317404,0.03782264247380526
18763,,1622,45733,47355,216,2125,61787,18189,43598,61787,4496,0.026251476847880623,0.740171880816353,0.003495881010568566,0.294382313431628,0.705617686568372,0.03439234790489909
18764,25.0,2776,49381,52157,172,3695,70300,19938,50362,70300,4994,0.039487908961593175,0.7024324324324325,0.0024466571834992888,0.2836130867709815,0.7163869132290185,0.05256045519203414
18765,,46,2181,2227,3,124,2916,831,2085,2916,226,0.01577503429355281,0.7479423868312757,0.00102880658436214,0.28497942386831276,0.7150205761316872,0.04252400548696845
18766,17.0,225,5793,6018,57,385,8443,2270,6173,8443,537,0.026649295274191638,0.6861305223261873,0.006751154802795215,0.2688617789885112,0.7311382210114888,0.04559990524695014
18767,24.0,376,4038,4414,10,270,6156,1684,4472,6156,433,0.06107862248213125,0.6559454191033138,0.0016244314489928524,0.27355425601039635,0.7264457439896036,0.043859649122807015
18768,24.0,361,13290,13651,2,532,17748,5199,12549,17748,1423,0.0203403200360604,0.748816768086545,0.0001126887536623845,0.2929344151453685,0.7070655848546316,0.029975208474194274
18769,15.0,438,20978,21416,5,3212,29895,8074,21821,29895,2175,0.014651279478173608,0.7017226961030273,0.00016725204883759825,0.2700786084629537,0.7299213915370464,0.10744271617327313
18770,27.0,618,17901,18519,196,641,24397,7009,17388,24397,2174,0.025330983317621018,0.7337377546419642,0.008033774644423494,0.28728942083042996,0.71271057916957,0.02627372217895643
18771,17.0,404,6239,6643,59,432,9207,2516,6691,9207,623,0.04387965678288259,0.6776365808623873,0.006408167698490279,0.2732703377864668,0.7267296622135332,0.0469208211143695
18772,17.0,48,2102,2150,4,96,2895,836,2059,2895,236,0.016580310880829015,0.7260794473229706,0.001381692573402418,0.2887737478411054,0.7112262521588947,0.03316062176165803
18773,,805,17583,18388,41,939,24750,7004,17746,24750,1787,0.032525252525252527,0.7104242424242424,0.0016565656565656565,0.282989898989899,0.717010101010101,0.03793939393939394
18774,,118,2366,2484,0,106,3514,940,2574,3514,267,0.03357996585088219,0.6733067729083665,0.0,0.2675014228799089,0.732498577120091,0.03016505406943654
18775,39.0,553,13807,14360,87,641,22534,5459,17075,22534,1354,0.02454069406230585,0.612718558622526,0.0038608325197479363,0.2422561462678619,0.7577438537321382,0.028445903967338246
18776,25.0,856,17774,18630,57,691,24135,7046,17089,24135,1751,0.03546716386989849,0.7364408535322147,0.0023617153511497823,0.2919411642842345,0.7080588357157654,0.028630619432359644
18777,,189,3131,3320,17,147,4434,1295,3139,4434,279,0.04262516914749662,0.7061344158773116,0.0038340099233198015,0.2920613441587731,0.7079386558412268,0.033152909336941816
18778,24.0,2094,35789,37883,172,2723,52694,13911,38783,52694,3211,0.03973886970053517,0.6791854860135879,0.003264128743310434,0.26399590086157815,0.7360040991384218,0.05167571260485065
18779,,202,4808,5010,7,247,6615,1892,4723,6615,548,0.03053665910808768,0.726832955404384,0.0010582010582010583,0.2860166288737717,0.7139833711262282,0.03733938019652305
18780,13.0,64,1986,2050,6,106,2788,756,2032,2788,194,0.02295552367288379,0.712338593974175,0.002152080344332855,0.27116212338593976,0.7288378766140603,0.03802008608321377
18781,,159,4163,4322,0,124,5770,1677,4093,5770,546,0.02755632582322357,0.7214904679376083,0.0,0.29064124783362216,0.7093587521663778,0.02149046793760832
18782,,94,1710,1804,4,141,2467,679,1788,2467,182,0.03810295905958654,0.6931495743818403,0.0016214025131738954,0.2752330766112687,0.7247669233887313,0.05715443858937981
18783,,145,1631,1776,2,118,2528,660,1868,2528,179,0.05735759493670886,0.6451740506329114,0.0007911392405063291,0.2610759493670886,0.7389240506329114,0.04667721518987342
18784,16.0,150,6248,6398,12,1472,9417,2424,6993,9417,496,0.01592863969417012,0.6634809387278326,0.0012742911755336094,0.2574068174577891,0.7425931825422109,0.15631305086545608
18785,,1260,23054,24314,54,1420,32170,9217,22953,32170,2409,0.039166925707180604,0.7166304009947155,0.00167858253030774,0.28650917003419335,0.7134908299658067,0.04414050357475909
18786,17.0,231,5748,5979,24,294,7966,2432,5534,7966,518,0.02899824253075571,0.7215666582977655,0.003012804418779814,0.3052975144363545,0.6947024855636454,0.03690685413005272
18787,,375,9451,9826,34,580,13268,3742,9526,13268,985,0.028263491106421464,0.712315345191438,0.0025625565269822128,0.28203195658727764,0.7179680434127224,0.043714199577931864
18788,26.0,361,12138,12499,36,564,16359,4747,11612,16359,1351,0.022067363530778164,0.7419768934531451,0.0022006235099944985,0.2901766611651079,0.7098233388348921,0.03447643498991381
18789,15.0,766,10217,10983,35,1044,15480,4317,11163,15480,1174,0.04948320413436692,0.6600129198966408,0.0022609819121447027,0.27887596899224804,0.7211240310077519,0.06744186046511629
18790,24.0,5,6403,6408,7,260,8252,2504,5748,8252,743,0.0006059137178865729,0.7759331071255453,0.0008482792050412022,0.30344158991759573,0.6965584100824043,0.031507513330101794
18791,17.0,92,1675,1767,6,85,2409,685,1724,2409,192,0.038190120381901206,0.6953092569530925,0.0024906600249066002,0.2843503528435035,0.7156496471564965,0.0352843503528435
18792,,120,4413,4533,49,946,6506,1132,5374,6506,235,0.018444512757454658,0.678296956655395,0.007531509375960652,0.17399323701198893,0.826006762988011,0.14540424223793422
18793,24.0,2890,83667,86557,241,4003,113156,32468,80688,113156,7788,0.025539962529605147,0.739395171267984,0.0021298031036798754,0.28693131605924566,0.7130686839407544,0.03537594117854997
18794,25.0,72,1625,1697,0,139,2368,647,1721,2368,161,0.030405405405405407,0.6862331081081081,0.0,0.27322635135135137,0.7267736486486487,0.05869932432432432
18795,26.0,6367,176155,182524,1156,9645,244817,70208,174610,244818,17606,0.02600707464320434,0.7195345113512895,0.004721875025529169,0.2867762991283321,0.713223700871668,0.039396612994142585
18796,26.0,5,6425,6430,8,52,8538,2403,6135,8538,706,0.0005856172405715624,0.7525181541344578,0.0009369875849144999,0.2814476458186929,0.7185523541813071,0.006090419301944249
18797,,290,7169,7459,44,421,9873,2837,7036,9873,748,0.02937303757723083,0.7261217461764408,0.00445659880482123,0.28734933657449613,0.7126506634255039,0.04264154765522131
18798,16.0,40,2419,2459,27,66,3265,963,2302,3265,241,0.01225114854517611,0.7408882082695253,0.008269525267993875,0.29494640122511484,0.7050535987748852,0.02021439509954058
18799,34.0,14929,322082,337011,3280,12987,427392,129232,298160,427392,26944,0.03493046196466008,0.7535985699311171,0.0076744534291704105,0.3023734651093142,0.6976265348906858,0.03038662398921833
18800,26.0,427,11011,11438,79,614,15253,4351,10902,15253,851,0.02799449288664525,0.7218907755851308,0.005179308988395725,0.28525535960138987,0.7147446403986101,0.04025437618829083
18801,17.0,322,4288,4610,9,187,6159,1749,4410,6159,443,0.0522812144828706,0.6962169183308978,0.0014612761811982464,0.28397467121285924,0.7160253287871408,0.0303620717648969
18802,24.0,570,9117,9687,16,757,13207,3712,9495,13207,905,0.04315893086999319,0.6903157416521541,0.0012114787612629665,0.2810630726130083,0.7189369273869918,0.05731808889225411
18803,24.0,214,12488,12702,0,379,16101,4888,11213,16101,1243,0.013291099931681262,0.7756039997515682,0.0,0.30358362834606545,0.6964163716539346,0.02353891062666915
18804,,15474,352880,368354,1819,15002,479969,139223,340746,479969,33324,0.032239582139679854,0.7352141492471389,0.003789828093064344,0.2900666501378214,0.7099333498621786,0.031256185295300325
18805,,35,1556,1591,0,144,2159,574,1585,2159,193,0.01621120889300602,0.7207040296433534,0.0,0.2658638258452988,0.7341361741547012,0.0666975451597962
18806,,459,21544,22003,100,2138,30991,8408,22583,30991,2246,0.014810751508502468,0.6951695653576845,0.0032267432480397535,0.27130457229518246,0.7286954277048175,0.06898777064308993
18807,25.0,152,7228,7380,0,165,9571,2876,6695,9571,816,0.015881308118273953,0.7551979939400272,0.0,0.30049106676418347,0.6995089332358165,0.017239577891547384
18808,24.0,509,14313,14822,49,579,19390,5612,13779,19391,1366,0.026249290908153266,0.7381259347119797,0.002526945490175855,0.28941261409932445,0.7105873859006756,0.029859213036975918
18809,,169,3817,3986,23,155,5373,1535,3838,5373,461,0.0314535641168807,0.7104038712078913,0.004280662572119859,0.28568769774799924,0.7143123022520007,0.028847943420807744
18810,37.0,92,1522,1614,10,87,2161,624,1537,2161,170,0.04257288292457196,0.7043035631652013,0.004627487274409995,0.2887552059231837,0.7112447940768163,0.04025913928736696
18811,42.0,26,2290,2316,0,61,2962,908,2054,2962,266,0.008777852802160702,0.7731262660364618,0.0,0.3065496286293045,0.6934503713706954,0.020594193112761647
18812,26.0,466,7351,7817,39,422,10386,3094,7292,10386,611,0.044868091661852495,0.7077797034469478,0.003755054881571346,0.2979010206046601,0.7020989793953398,0.040631619487772004
18813,24.0,203,8465,8668,61,580,11693,3189,8504,11693,833,0.017360814162319337,0.7239373984435132,0.005216796373898914,0.2727272727272727,0.7272727272727273,0.049602326178055246
18814,,455,13924,14379,43,905,18946,5282,13664,18946,1266,0.02401562335057532,0.7349308561173863,0.0022696083606038213,0.27879235722579965,0.7212076427742004,0.04776733875224322
18815,23.0,126,3644,3770,7,217,5190,1367,3823,5190,382,0.024277456647398842,0.7021194605009634,0.001348747591522158,0.2633911368015414,0.7366088631984585,0.041811175337186895
18816,27.0,234,2301,2535,13,213,3616,947,2669,3616,243,0.06471238938053098,0.6363384955752213,0.003595132743362832,0.26189159292035397,0.738108407079646,0.05890486725663717
18817,14.0,343,2821,3164,44,420,4813,1204,3609,4813,233,0.07126532308331601,0.5861209225015582,0.00914190733430293,0.2501558279659256,0.7498441720340744,0.08726366091834614
18818,15.0,711,13353,14064,24,1112,19216,5596,13620,19216,844,0.03700041631973355,0.6948896752706079,0.0012489592006661116,0.2912156536219817,0.7087843463780183,0.0578684429641965
18819,17.0,1091,20391,21482,74,1933,29532,8104,21428,29532,1958,0.03694297710957605,0.6904713531084925,0.0025057564675606122,0.274414194771773,0.725585805228227,0.06545442232154951
18820,,2261,72640,74901,271,5768,105769,28505,77264,105769,7691,0.021376773912961264,0.6867796802465751,0.002562187408408891,0.26950240618706806,0.730497593812932,0.05453393716495381
18821,26.0,162,6769,6931,31,389,9084,2621,6463,9084,599,0.0178335535006605,0.7451563188022897,0.0034125935711140465,0.2885292822545134,0.7114707177454865,0.04282254513430207
18822,15.0,421,9072,9493,30,597,12838,3590,9248,12838,1015,0.03279326997974762,0.7066521264994547,0.0023368125876304722,0.2796385729864465,0.7203614270135535,0.046502570493846394
18823,17.0,223,4278,4501,14,192,5903,1740,4163,5903,462,0.03777740132136202,0.7247162459766221,0.002371675419278333,0.29476537353887855,0.7052346264611214,0.03252583432153142
18824,,56,2278,2334,28,313,3351,846,2505,3351,207,0.016711429424052522,0.6797970754998508,0.008355714712026261,0.25246195165622204,0.747538048343778,0.0934049537451507
18825,,503,10297,10800,11,772,14747,3930,10817,14747,932,0.03410863226418933,0.6982437105852037,0.00074591442327253,0.26649488031464025,0.7335051196853597,0.05234963043330847
18826,,74,2166,2240,2,162,3724,776,2948,3724,170,0.01987110633727175,0.5816326530612245,0.0005370569280343716,0.2083780880773362,0.7916219119226638,0.043501611170784105
18827,26.0,1279,18027,19306,148,722,24923,7315,17608,24923,1306,0.05131805962364081,0.7233077879869999,0.00593828993299362,0.2935039922962725,0.7064960077037274,0.028969225213658068
18828,17.0,68,1487,1555,0,74,2203,577,1626,2203,137,0.030866999546073536,0.6749886518384022,0.0,0.26191556967771223,0.7380844303222878,0.033590558329550615
18829,23.0,1366,27499,28865,208,1627,37845,11005,26840,37845,2491,0.036094596379970936,0.7266217465979654,0.005496102523450918,0.29079138591623727,0.7092086140837627,0.04299114810410887
18830,15.0,12,2060,2072,4,123,2765,803,1962,2765,220,0.00433996383363472,0.7450271247739603,0.0014466546112115732,0.29041591320072335,0.7095840867992766,0.04448462929475588
18831,16.0,3441,71478,74919,886,4434,106778,28475,78303,106778,6961,0.03222573938451741,0.6694075558635674,0.008297589391073067,0.2666747831950402,0.7333252168049599,0.04152540785555077
18832,24.0,3729,99371,103100,372,4882,134741,39495,95246,134741,9899,0.027675317831988778,0.7374963819475884,0.0027608523018234983,0.2931179076895674,0.7068820923104326,0.036232475638447094
18833,17.0,690,29985,30675,212,3247,43497,11318,32179,43497,2288,0.01586316297675702,0.6893578867508104,0.004873899349380417,0.2602018530013564,0.7397981469986435,0.07464882635584064
18834,17.0,1001,14537,15538,315,991,21368,5710,15658,21368,1097,0.04684575065518532,0.6803163609135155,0.01474166978659678,0.2672220142268813,0.7327779857731187,0.04637776113815051
18835,25.0,189,2587,2776,44,530,4361,921,3440,4361,121,0.04333868378812199,0.5932125659252465,0.010089429030038982,0.21119009401513414,0.7888099059848659,0.1215317587709241
18836,33.0,762,16981,17743,88,901,23420,6647,16773,23420,1807,0.032536293766011956,0.725064047822374,0.003757472245943638,0.28381725021349274,0.7161827497865073,0.03847139197267293
18837,26.0,671,21504,22175,18,1013,28654,8377,20277,28654,1946,0.023417323933831228,0.7504711384099951,0.0006281845466601522,0.2923501081873386,0.7076498918126614,0.03535283032037412
18838,27.0,638,17273,17911,72,961,23811,6769,17042,23811,1950,0.02679433875099744,0.7254210238965184,0.0030238125236235354,0.28428037461677375,0.7157196253832262,0.04035949771114191
18839,14.0,2010,52226,54236,541,3947,75729,20790,54939,75729,5785,0.026542011646793172,0.6896433334653831,0.007143894677072191,0.2745315533019055,0.7254684466980945,0.05212005968651375
18840,,214,4696,4910,35,264,6433,1854,4579,6433,399,0.03326597233017255,0.729986009637805,0.00544069640914037,0.288201461215607,0.7117985387843929,0.04103839577180165
18841,,330,5814,6144,90,459,8614,2326,6288,8614,563,0.038309728349198977,0.674947759461342,0.010448107731599722,0.2700255398188995,0.7299744601811006,0.05328534943115858
18842,15.0,178,7615,7793,12,744,10310,2571,7739,10310,752,0.017264791464597477,0.7386032977691561,0.0011639185257032007,0.24936954413191076,0.7506304558680892,0.07216294859359845
18843,17.0,49,21819,21868,11,1593,29739,8414,21325,29739,2802,0.0016476680453276842,0.7336830424694846,0.00036988466323682707,0.28292814149769663,0.7170718585023034,0.053566024412387774
18844,17.0,723,11539,12262,6,414,16430,4756,11674,16430,1489,0.04400486914181376,0.7023128423615338,0.0003651856360316494,0.2894704808277541,0.7105295191722459,0.02519780888618381
18845,23.0,1210,29762,30972,70,1628,43564,12130,31434,43564,3026,0.027775227251859335,0.6831787714626756,0.0016068313286199615,0.2784409145165733,0.7215590854834267,0.037370305757047105
18846,15.0,1241,29471,30712,58,1386,42136,11546,30591,42137,3386,0.029451550893514013,0.699409070413176,0.0013764624913971094,0.2740109642357073,0.7259890357642926,0.03289270712200679
18847,33.0,527,19977,20504,14,843,26944,7798,19154,26952,2282,0.019553279905016326,0.741206589492431,0.0005194419709112497,0.28932917779756606,0.7106708222024339,0.03127782724844167
18848,26.0,1036,17977,19013,94,609,26463,7182,19281,26463,1801,0.03914900049125194,0.6793258511884518,0.003552129388202396,0.2713978007028682,0.7286021992971319,0.02301326380228999
18849,,780,15806,16586,50,651,21622,6329,15323,21652,1679,0.03602438573803805,0.7300018474043968,0.0023092554960280807,0.29230556068723446,0.7076944393127655,0.03006650655828561
18850,33.0,5980,135938,141918,678,8895,189066,53993,135074,189067,11255,0.031628999243654365,0.7189937958501483,0.0035860303490297092,0.2855760127362258,0.7144239872637742,0.047046814092358794
18851,,87,2989,3076,36,404,4556,1186,3370,4556,237,0.019095697980684813,0.6560579455662863,0.007901668129938543,0.2603160667251975,0.7396839332748024,0.08867427568042142
18852,,92,1291,1383,0,80,1949,536,1413,1949,145,0.04720369420215495,0.6623909697280657,0.0,0.2750128270908158,0.7249871729091842,0.04104669061056952
18853,26.0,313,6063,6376,20,384,8650,2366,6284,8650,640,0.0361849710982659,0.7009248554913294,0.0023121387283236996,0.2735260115606936,0.7264739884393063,0.04439306358381503
18854,16.0,555,7166,7721,16,461,11464,2940,8524,11464,674,0.04841242149337055,0.6250872295882763,0.0013956734124214933,0.2564549895324494,0.7435450104675506,0.04021284019539428
18855,16.0,155,2163,2318,9,203,3194,860,2334,3194,228,0.04852849092047589,0.6772072636192862,0.002817783343769568,0.26925485284909206,0.730745147150908,0.06355666875391358
18856,,80,2444,2524,10,131,3357,960,2397,3357,267,0.023830801310694073,0.7280309800417039,0.002978850163836759,0.28596961572832885,0.7140303842716711,0.039022937146261545
18857,42.0,786,7716,8502,360,424,11678,3339,8339,11678,592,0.06730604555574585,0.66072957698236,0.03082719643774619,0.2859222469600959,0.7140777530399041,0.036307586915567736
18858,27.0,648,16442,17090,30,715,22034,6502,15532,22034,1699,0.029409095034945994,0.7462104021058364,0.001361532177543796,0.2950894072796587,0.7049105927203413,0.03244985023146047
18859,17.0,2410,42871,45281,117,2265,60495,17451,43065,60516,4257,0.03982417872959217,0.7084242183885253,0.001933372992266508,0.28837001784651994,0.7116299821534801,0.03742811818362086
18860,,16,4084,4100,29,360,5709,1487,4222,5709,358,0.0028025923979681207,0.7153617095813628,0.005079698721317218,0.2604659309861622,0.7395340690138378,0.0630583289542827
18861,,77,5292,5369,18,186,7041,2196,4845,7041,393,0.010935946598494532,0.7515977844056242,0.0025564550489987218,0.31188751597784403,0.688112484022156,0.026416702172986792
18862,,621,11502,12123,24,607,15808,4610,11198,15808,1089,0.03928390688259109,0.7276062753036437,0.0015182186234817814,0.2916244939271255,0.7083755060728745,0.03839827935222672
18863,14.0,148,3715,3863,50,684,5891,914,4977,5891,204,0.025123069088439993,0.6306229842132066,0.008487523340689187,0.15515192666779834,0.8448480733322017,0.11610931930062808
18864,,2522,82220,84742,364,4492,116091,32298,83793,116091,8418,0.021724336942570914,0.7082375033378987,0.003135471311298895,0.2782127813525596,0.7217872186474403,0.0386937833251501
18865,27.0,502,13593,14095,66,1001,19207,5397,13810,19207,1399,0.026136304472327797,0.707710730462852,0.003436247201541105,0.2809913052532931,0.7190086947467069,0.05211641589004009
18866,15.0,108,3280,3388,15,177,4541,1265,3276,4541,333,0.023783307641488657,0.7223078617044704,0.0033032371724289805,0.27857300154151066,0.7214269984584893,0.03897819863466197
18867,37.0,6,16289,16295,28,954,22225,6411,15814,22225,2229,0.0002699662542182227,0.7329133858267717,0.0012598425196850393,0.288458942632171,0.711541057367829,0.04292463442069741
18868,24.0,257,8609,8866,9,275,11320,3365,7955,11320,824,0.022703180212014135,0.7605123674911661,0.0007950530035335689,0.29726148409893993,0.7027385159010601,0.02429328621908127
18869,40.0,158,6667,6825,15,214,8889,2602,6287,8889,752,0.01777477781527731,0.7500281246484419,0.0016874789065136687,0.2927213409832377,0.7072786590167623,0.02407469906626167
18870,24.0,106,3210,3316,33,149,4379,1256,3123,4379,320,0.024206439826444395,0.7330440739894953,0.007535967115779858,0.2868234756793789,0.7131765243206212,0.03402603334094542
18871,,154,3633,3787,30,163,5016,1452,3564,5016,377,0.03070175438596491,0.7242822966507177,0.005980861244019139,0.2894736842105263,0.7105263157894737,0.032496012759170655
18872,40.0,923,20163,21086,188,972,28336,7919,20417,28336,1893,0.03257340485601355,0.7115683229813664,0.006634669678147939,0.27946781479390176,0.7205321852060983,0.034302653867871256
18873,25.0,371,11656,12027,7,391,15606,4666,10940,15606,1267,0.02377290785595284,0.7468922209406639,0.0004485454312443932,0.29898756888376266,0.7010124311162373,0.02505446623093682
18874,,63,1518,1581,1,93,2106,603,1503,2106,165,0.029914529914529916,0.7207977207977208,0.0004748338081671415,0.2863247863247863,0.7136752136752137,0.04415954415954416
18875,26.0,182,3972,4154,172,259,5630,1726,3904,5630,299,0.03232682060390764,0.70550621669627,0.030550621669627,0.30657193605683836,0.6934280639431616,0.04600355239786856
18876,23.0,429,11055,11484,30,581,15191,4317,10874,15191,1184,0.028240405503258507,0.7277335264301231,0.001974853531696399,0.28418142321111184,0.7158185767888882,0.0382463300638536
18877,33.0,237,6090,6327,41,273,8382,2429,5953,8382,637,0.028274874731567645,0.7265569076592698,0.004891434025292293,0.28978764018134096,0.710212359818659,0.032569792412312094
18878,,49,4339,4388,2,218,5814,1690,4124,5814,534,0.008427932576539388,0.7463020295837633,0.0003439972480220158,0.2906776745786034,0.7093223254213966,0.037495700034399726
18879,,4,1750,1754,6,120,2403,679,1724,2403,207,0.0016645859342488557,0.7282563462338744,0.0024968789013732834,0.28256346233874324,0.7174365376612568,0.049937578027465665
18880,,203,4331,4534,13,237,6068,1722,4346,6068,393,0.03345418589321028,0.713744232036915,0.0021423862887277522,0.28378378378378377,0.7162162162162162,0.03905735003295979
18881,,145,2546,2691,14,125,3560,1011,2549,3560,279,0.04073033707865169,0.7151685393258427,0.003932584269662922,0.28398876404494383,0.7160112359550562,0.0351123595505618
18882,,1145,17192,18337,312,1079,24759,6731,18028,24759,1605,0.04624580960458823,0.6943737630760531,0.012601478250333212,0.2718607375095925,0.7281392624904075,0.043580112282402356
18883,,255,5093,5348,21,388,7358,1983,5375,7358,427,0.03465615656428377,0.6921717858113617,0.0028540364229410167,0.26950258222343026,0.7304974177765697,0.05273172057624354
18884,,27,10516,10543,99,423,14051,3967,10084,14051,1244,0.001921571418404384,0.7484164828126112,0.007045761867482741,0.28232865988185896,0.717671340118141,0.03010461888833535
18885,,153,11118,11271,152,1150,15370,4341,11029,15370,972,0.009954456733897202,0.7233571893298634,0.00988939492517892,0.2824333116460638,0.7175666883539362,0.07482108002602472
18886,,972,9169,10141,215,707,14981,3861,11120,14981,596,0.06488218409985982,0.6120419197650357,0.01435151191509245,0.2577264535077765,0.7422735464922234,0.047193111274280754
18887,,939,14341,15280,65,803,20473,5798,14675,20473,1409,0.04586528598642114,0.7004835637180677,0.003174913300444488,0.2832022663996483,0.7167977336003517,0.039222390465491135
18888,14.0,113,4327,4440,29,100,5877,1695,4182,5877,545,0.019227497022290284,0.7362599965969032,0.004934490386251489,0.2884124553343543,0.7115875446656458,0.017015484090522375
18889,27.0,3179,122588,125767,717,3771,160559,48101,112458,160559,10658,0.01979957523402612,0.7635074956869438,0.004465648141804571,0.2995845763862505,0.7004154236137494,0.023486693365055836
18890,,89,1399,1488,0,89,2052,574,1478,2052,152,0.04337231968810916,0.6817738791423001,0.0,0.2797270955165692,0.7202729044834308,0.04337231968810916
18891,26.0,146,4733,4879,5,166,6287,1821,4466,6287,478,0.023222522665818354,0.7528232861460156,0.000795291872117067,0.2896452998250358,0.7103547001749642,0.026403690154286622
18892,,281,6174,6455,2,456,8791,2476,6315,8791,637,0.03196450915709248,0.7023091798430213,0.00022750540325332727,0.28165168922761913,0.7183483107723808,0.05187123194175862
18893,24.0,149,6018,6167,10,469,8210,2316,5894,8210,576,0.018148599269183923,0.7330085261875762,0.001218026796589525,0.282095006090134,0.7179049939098661,0.05712545676004872
18894,13.0,168,2711,2879,7,133,4416,1063,3353,4416,286,0.03804347826086957,0.6139039855072463,0.001585144927536232,0.24071557971014493,0.7592844202898551,0.030117753623188404
18895,16.0,149,3109,3258,6,191,4508,1261,3247,4508,347,0.033052351375332745,0.6896628216503993,0.0013309671694764862,0.2797249334516415,0.7202750665483585,0.042369121561668145
18896,16.0,85,2007,2092,9,124,2769,775,1994,2769,204,0.030697002527988442,0.7248104008667389,0.0032502708559046588,0.27988443481401226,0.7201155651859877,0.04478150957024196
18897,26.0,340,8700,9040,30,514,12622,3416,9206,12622,819,0.026937093962921883,0.6892726984630011,0.0023768024084931073,0.27063856758041516,0.7293614324195848,0.040722547932181906
18898,26.0,2379,63096,65475,37,3454,87577,24930,62647,87577,7538,0.02716466652203204,0.7204631352980806,0.00042248535574408805,0.2846637815864896,0.7153362184135104,0.03943957888486703
18899,17.0,402,6744,7146,139,586,10043,2518,7525,10043,657,0.04002788011550334,0.6715124962660559,0.013840485910584486,0.2507218958478542,0.7492781041521458,0.0583490988748382
18900,,1175,24591,25766,42,1356,34191,9930,24261,34191,2643,0.03436576876955924,0.7192243572870054,0.0012283934368693516,0.29042730543125383,0.7095726945687462,0.039659559533210494
18901,16.0,134,3609,3743,4,165,5160,1397,3763,5160,399,0.025968992248062015,0.6994186046511628,0.0007751937984496124,0.27073643410852716,0.7292635658914729,0.03197674418604651
18902,,80,1461,1541,10,155,2157,545,1612,2157,123,0.03708854891052388,0.6773296244784422,0.004636068613815485,0.2526657394529439,0.7473342605470561,0.07185906351414001
18903,24.0,1052,28630,29682,176,881,38025,11417,26608,38025,3023,0.027666009204470744,0.7529257067718607,0.00462853385930309,0.300249835634451,0.6997501643655489,0.0231689677843524
18904,13.0,1069,12763,13832,87,1390,19627,5175,14452,19627,1096,0.054465786926173126,0.6502776787079024,0.004432669282111377,0.26366739695317676,0.7363326030468232,0.0708208080705151
18905,40.0,508,14092,14600,23,442,19522,5630,13892,19522,1722,0.02602192398319844,0.7218522692347096,0.0011781579756172523,0.2883925827271796,0.7116074172728204,0.022641122835775022
18906,16.0,613,9646,10259,119,525,13812,3801,10019,13820,865,0.04435600578871201,0.6979739507959479,0.008610709117221418,0.27503617945007236,0.7249638205499277,0.03798842257597684
18907,25.0,1527,86219,87778,197,5879,120195,33049,87153,120202,8780,0.012703615580439594,0.7172842381990316,0.0016389078384719056,0.27494550839420306,0.7250544916057969,0.0489093359511489
18908,27.0,7684,175579,183263,706,8148,242231,69304,172927,242231,15776,0.03172178622884767,0.7248411640128638,0.0029145732792252026,0.28610706309266776,0.7138929369073322,0.033637313143239304
18909,,3284,67857,71141,301,4288,94557,26632,67925,94557,6688,0.03473037427160337,0.7176306354897046,0.0031832651205093224,0.28165022155948266,0.7183497784405174,0.04534830842772085
18910,,201,5186,5387,14,195,7122,2021,5101,7122,566,0.02822240943555181,0.7281662454366751,0.001965739960685201,0.2837686043246279,0.7162313956753721,0.02737994945240101
18911,,92,3524,3616,10,191,4853,1368,3485,4853,356,0.018957345971563982,0.7261487739542551,0.0020605810838656502,0.28188749227282095,0.718112507727179,0.03935709870183392
18912,,3679,59956,63635,744,3057,84759,25284,59476,84760,2667,0.04340490797546012,0.7073619631901841,0.00877772534214252,0.2983010854176498,0.7016989145823501,0.03606654082114205
18913,,1653,17497,19153,247,1798,24916,6555,18361,24916,858,0.0663429121849414,0.7022395248033392,0.009913308717290095,0.2630839621126987,0.7369160378873013,0.07216246588537487
18914,25.0,449,12307,12756,33,364,16600,4903,11697,16600,1253,0.027048192771084337,0.7413855421686747,0.0019879518072289156,0.2953614457831325,0.7046385542168675,0.021927710843373496
18915,,4467,107368,111835,602,4062,142596,42930,99686,142616,9215,0.03132187131878611,0.7528468054075279,0.004221125259437931,0.3010181185841701,0.69898188141583,0.028482077747237336
18916,,99,2073,2172,1,94,2876,812,2064,2876,255,0.03442280945757997,0.7207927677329624,0.0003477051460361613,0.282336578581363,0.717663421418637,0.03268428372739916
18917,17.0,356,4273,4629,6,345,6089,1736,4353,6089,368,0.05846608638528494,0.7017572672031532,0.0009853834784036787,0.28510428641813107,0.714895713581869,0.05665955000821153
18918,24.0,2043,55379,57422,143,3066,76443,21980,54463,76443,5969,0.02672579569090695,0.7244482817262535,0.0018706748819381763,0.28753450283217563,0.7124654971678244,0.04010831600015698
18919,25.0,145,4825,4970,48,253,6672,1926,4746,6672,615,0.021732613908872902,0.7231714628297362,0.007194244604316547,0.2886690647482014,0.7113309352517986,0.03791966426858513
18920,14.0,4177,95265,99442,507,7470,135190,37797,97393,135190,10844,0.030897255714180043,0.7046749019897921,0.0037502773873807236,0.27958428877875585,0.7204157112212441,0.05525556624010652
18921,14.0,241,3173,3414,11,332,4645,1300,3345,4645,230,0.051883745963401506,0.6831001076426265,0.0023681377825618944,0.2798708288482239,0.7201291711517761,0.07147470398277718
18922,16.0,209,5094,5303,17,161,7058,1976,5082,7058,537,0.029611788041938227,0.7217342023236044,0.002408614338339473,0.2799659960328705,0.7200340039671295,0.022810994616038537
18923,25.0,198,12762,12960,211,812,17501,4987,12514,17501,1465,0.011313639220615965,0.7292154734015199,0.012056453916919034,0.2849551454202617,0.7150448545797383,0.046397348722930117
18924,,556,16232,16788,72,578,21833,6434,15399,21833,1776,0.025466037649429764,0.7434617322401869,0.003297760271149178,0.2946915220079696,0.7053084779920304,0.02647368662116979
18925,40.0,466,11279,11745,17,502,15178,4433,10745,15178,1127,0.030702332323099223,0.7431150349189617,0.0011200421662933193,0.29206746606931083,0.7079325339306891,0.0330741863223086
18926,17.0,6246,117725,123971,316,10056,171034,46906,124128,171034,11583,0.036519054690880175,0.6883134347556626,0.0018475858601213794,0.2742495644140931,0.7257504355859069,0.05879532724487529
18927,25.0,1090,38608,39698,119,1125,51106,15172,35934,51106,3742,0.02132821977849959,0.7554494579892772,0.0023284937189371113,0.2968731655774273,0.7031268344225727,0.02201307087230462
18928,38.0,2287,53100,55387,462,2775,72088,21317,50772,72089,4685,0.0317246736672724,0.7365894935427042,0.006408744746077765,0.29570392154142794,0.704296078458572,0.038494083702090474
18929,27.0,157,1874,2031,25,198,3120,770,2350,3120,179,0.05032051282051282,0.6006410256410256,0.008012820512820512,0.2467948717948718,0.7532051282051282,0.06346153846153846
18930,,137,3525,3662,2,138,4910,1415,3495,4910,351,0.02790224032586558,0.7179226069246436,0.0004073319755600815,0.28818737270875766,0.7118126272912424,0.02810590631364562
18931,16.0,788,10547,11335,207,677,15423,4519,10904,15423,684,0.05109252415224016,0.6838487972508591,0.013421513324255981,0.29300395513194577,0.7069960448680542,0.043895480775465213
18932,33.0,1199,24276,25475,87,914,33286,9885,23401,33286,2274,0.03602115003304693,0.7293156281920327,0.0026137114702878086,0.2969716998137355,0.7030283001862645,0.027458991768311
18933,,1226,20805,22031,174,1225,32999,8081,24918,32999,1158,0.03715264098912088,0.6304736507166884,0.005272887057183551,0.2448862086729901,0.75511379132701,0.03712233704051638
18934,17.0,86,1777,1863,5,177,2573,696,1877,2573,208,0.03342401865526622,0.6906335017489312,0.00194325689856199,0.270501360279829,0.729498639720171,0.06879129420909444
18935,,256,12897,13153,69,647,17956,4986,12970,17956,1357,0.014257072844731567,0.7182557362441524,0.003842726665181555,0.27767877032746713,0.7223212296725329,0.03603252394742704
18936,44.0,581,26379,26960,37,855,34814,10340,24474,34814,3172,0.016688688458666053,0.7577124145458723,0.0010627908312747746,0.29700695122651805,0.7029930487734819,0.024559085425403575
18937,23.0,459,16354,16813,25,405,21276,6303,14973,21276,1659,0.021573604060913704,0.768659522466629,0.0011750329009212258,0.2962492949802594,0.7037507050197406,0.01903553299492386
18938,14.0,641,12650,13291,174,886,18556,5072,13484,18556,1173,0.03454408277646044,0.6817201983186032,0.00937702090967881,0.2733347704246605,0.7266652295753395,0.04774735934468635
18939,,881,35363,36244,151,1458,46712,13867,32845,46712,3375,0.01886025004281555,0.7570431580750129,0.003232574070902552,0.296861620140435,0.703138379859565,0.031212536393218016
18940,39.0,143,3160,3303,13,180,4440,1277,3163,4440,300,0.032207207207207204,0.7117117117117117,0.002927927927927928,0.2876126126126126,0.7123873873873874,0.04054054054054054
18941,16.0,240,5805,6045,12,419,8150,2275,5875,8150,530,0.029447852760736196,0.7122699386503067,0.00147239263803681,0.2791411042944785,0.7208588957055214,0.051411042944785275
18942,23.0,501,9487,9988,96,541,13263,3730,9533,13263,965,0.03777425921737163,0.7152981979944205,0.007238181406921511,0.2812335067480962,0.7187664932519038,0.04079016813692227
18943,,37,3382,3419,5,116,4475,1303,3172,4475,303,0.008268156424581006,0.7557541899441341,0.0011173184357541898,0.2911731843575419,0.7088268156424581,0.025921787709497206
18944,25.0,598,16450,17048,49,1239,23019,6404,16615,23019,1703,0.0259785394673965,0.7146270472218602,0.0021286763108736262,0.27820496111907556,0.7217950388809244,0.05382510100351883
18945,36.0,3875,128468,132343,240,4685,172644,51408,121236,172644,14100,0.02244503139408262,0.7441208498412919,0.0013901438798915688,0.297768819072774,0.7022311809272259,0.027136766988716667
18946,24.0,112,3127,3239,7,277,4512,1159,3353,4512,358,0.024822695035460994,0.693040780141844,0.0015514184397163121,0.25687056737588654,0.7431294326241135,0.06139184397163121
18947,35.0,109,2589,2698,40,157,3663,974,2689,3663,213,0.029757029757029756,0.7067977067977068,0.01092001092001092,0.2659022659022659,0.734097734097734,0.042861042861042864
18948,23.0,1009,20835,21844,69,1044,29118,8360,20758,29118,2069,0.034652105227007346,0.715536781372347,0.002369668246445498,0.2871076310186139,0.7128923689813861,0.03585411085926231
18949,23.0,151,4162,4313,19,354,5736,1651,4085,5736,367,0.026324965132496513,0.7255927475592747,0.003312412831241283,0.28783124128312415,0.7121687587168759,0.06171548117154812
18950,15.0,51,2803,2854,24,283,4157,1088,3069,4157,332,0.012268462833774356,0.6742843396680298,0.005773394274717345,0.2617272071205196,0.7382727928794804,0.06807794082270868
18951,36.0,7071,229132,236203,322,8722,311414,89787,221630,311417,24265,0.022705889530757795,0.735772292456738,0.001033983372776695,0.2883175934518668,0.7116824065481332,0.028007462662603518
18952,36.0,109,2763,2872,11,108,3811,1108,2703,3811,338,0.028601416950931515,0.7250065599580162,0.0028863815271582263,0.29073733928102863,0.7092626607189714,0.028339018630280766
18953,25.0,264,6172,6436,2,303,8496,2494,6002,8496,838,0.031073446327683617,0.7264595103578154,0.00023540489642184556,0.2935499058380414,0.7064500941619586,0.0356638418079096
18954,23.0,86,2465,2551,1,150,3568,1019,2549,3568,294,0.024103139013452915,0.6908632286995515,0.0002802690582959641,0.2855941704035874,0.7144058295964125,0.04204035874439462
18955,27.0,1577,60423,62000,220,1883,81884,23976,57908,81884,7406,0.019258951687753406,0.7379097259537882,0.0026867275658248252,0.29280445508280006,0.7071955449171999,0.02299594548385521
18956,35.0,105,1732,1837,0,103,2424,693,1731,2424,169,0.043316831683168314,0.7145214521452146,0.0,0.28589108910891087,0.7141089108910891,0.04249174917491749
18957,15.0,120,6021,6141,34,281,8168,2322,5846,8168,677,0.014691478942213516,0.7371449559255632,0.00416258570029383,0.2842801175318315,0.7157198824681684,0.03440254652301665
18958,26.0,1734,27343,29077,194,2241,39540,10918,28622,39540,2955,0.04385432473444613,0.6915275670207385,0.00490642387455741,0.2761254425897825,0.7238745574102176,0.05667678300455235
18959,27.0,674,13914,14588,85,810,19791,5619,14172,19791,1187,0.03405588398767116,0.7030468394724875,0.0042948815117982925,0.28391693193876005,0.71608306806124,0.040927694406548434
18960,15.0,181,2084,2265,14,136,3084,845,2239,3084,165,0.05869001297016861,0.6757457846952011,0.004539559014267186,0.27399481193255515,0.7260051880674449,0.04409857328145266
18961,23.0,136,4508,4644,2,151,6039,1737,4302,6039,457,0.022520284815366783,0.7464812054975989,0.0003311806590495115,0.28763040238450077,0.7123695976154992,0.02500413975823812
18962,,663,15594,16257,94,938,21904,6295,15609,21904,1866,0.03026844411979547,0.7119247626004382,0.00429145361577794,0.28739043097151207,0.7126095690284879,0.042823228634039444
18963,,5045,133314,138359,653,8023,199174,53064,146110,199174,13661,0.025329611294646892,0.6693343508690893,0.0032785403717352666,0.26642031590468634,0.7335796840953136,0.04028136202516393
18964,26.0,3156,41932,45088,335,3212,61274,17072,44202,61274,4130,0.051506348532819796,0.6843359336749681,0.005467245487482456,0.27861735809641935,0.7213826419035806,0.05242027613669746
18965,42.0,495,13849,14344,51,714,19195,5583,13612,19195,1549,0.025787965616045846,0.7214899713467049,0.0026569419119562387,0.29085699400885645,0.7091430059911435,0.03719718676738734
18966,34.0,1524,41108,42632,157,1435,55360,16193,39167,55360,4040,0.027528901734104046,0.7425578034682081,0.0028359826589595375,0.292503612716763,0.707496387283237,0.025921242774566474
18967,,227,4477,4704,18,310,6383,1755,4628,6383,442,0.03556321478928404,0.7013943286855711,0.0028199906000313333,0.27494908350305497,0.725050916496945,0.04856650477831741
18968,17.0,394,7395,7789,44,481,10567,2992,7575,10567,771,0.03728589003501467,0.6998201949465317,0.004163906501372197,0.28314564209330934,0.7168543579066906,0.04551906879909151
18969,,982,23194,24176,57,1509,32479,9119,23360,32479,2383,0.030234921025893653,0.7141229717663721,0.0017549801410141938,0.2807660334369901,0.71923396656301,0.04646079004895471
18970,,278,6037,6315,4,189,8061,2372,5689,8061,616,0.03448703634784766,0.7489145267336559,0.0004962163503287433,0.2942562957449448,0.7057437042550552,0.023446222553033122
18971,17.0,2312,44369,46681,83,2424,63762,17423,46339,63762,4630,0.036259841284777765,0.695853329569336,0.001301715755465638,0.2732505253912989,0.7267494746087011,0.03801637338853863
18972,25.0,18,2447,2465,21,151,3296,887,2409,3296,187,0.0054611650485436895,0.7424150485436893,0.006371359223300971,0.2691140776699029,0.7308859223300971,0.045813106796116505
18973,25.0,83,3155,3238,4,214,4395,1266,3129,4395,398,0.01888509670079636,0.7178612059158134,0.0009101251422070534,0.2880546075085324,0.7119453924914676,0.04869169510807736
18974,,783,15455,16238,337,742,21140,6199,14941,21140,1290,0.03703878902554399,0.7310785241248817,0.015941343424787133,0.2932355723746452,0.7067644276253547,0.035099337748344374
18975,,162,2360,2522,77,328,3711,797,2914,3711,213,0.043654001616814875,0.6359471840474266,0.020749124225276205,0.21476690918889788,0.7852330908111022,0.08838587981676098
18976,,988,50181,51169,326,3921,68617,19139,49478,68617,5377,0.014398764154655552,0.7313202267659618,0.00475100922511914,0.278925047728697,0.721074952271303,0.057143273532797995
18977,,17463,451327,468790,2981,23342,620056,178085,441972,620057,48698,0.028163539803598703,0.7278798562067681,0.004807622525025925,0.28720746641034617,0.7127925335896539,0.03764492619226942
18978,,1062,33797,34859,50,1432,45828,13229,32599,45828,3579,0.023173605655930872,0.7374749061708998,0.0010910360478310203,0.28866631753513133,0.7113336824648686,0.03124727240988042
18979,17.0,99,1895,1994,0,92,2770,770,2000,2770,205,0.035740072202166066,0.6841155234657039,0.0,0.2779783393501805,0.7220216606498195,0.0332129963898917
18980,25.0,14777,319016,333793,2711,16804,453037,126105,326932,453037,32245,0.03261764491641963,0.7041720654162905,0.005984058697192503,0.27835474806693494,0.7216452519330651,0.03709189315662959
18981,17.0,181,3608,3789,8,146,5075,1457,3618,5075,391,0.03566502463054187,0.710935960591133,0.0015763546798029558,0.2870935960591133,0.7129064039408867,0.02876847290640394
18982,16.0,444,8954,9398,4,269,12557,3636,8921,12557,1046,0.03535876403599586,0.7130684080592499,0.00031854742374771045,0.2895596081866688,0.7104403918133312,0.021422314247033527
18983,,141,4725,4866,36,721,7016,1831,5185,7016,397,0.020096921322690992,0.673460661345496,0.005131128848346636,0.26097491448118587,0.7390250855188142,0.10276510832383125
18984,,128,3221,3349,10,155,4453,1294,3159,4453,322,0.028744666516954863,0.7233325847743095,0.0022456770716370988,0.2905906130698406,0.7094093869301594,0.03480799461037503
18985,,21,4792,4813,11,128,6252,1801,4451,6252,605,0.0033589251439539347,0.7664747280870121,0.0017594369801663468,0.2880678182981446,0.7119321817018555,0.020473448496481125
18986,16.0,424,7267,7691,6,455,13456,2682,10774,13456,618,0.03151010701545779,0.5400564803804994,0.00044589774078478004,0.19931629013079666,0.8006837098692033,0.03381391200951248
18987,,878,19928,20806,78,817,27489,7975,19514,27489,2170,0.031940048746771435,0.724944523263851,0.0028374986358179637,0.2901160464185674,0.7098839535814325,0.029720979300811235
18988,24.0,1667,27646,29313,217,1374,40318,11090,29228,40318,2746,0.04134629693933231,0.6856986953717943,0.005382211419217223,0.2750632471848802,0.7249367528151198,0.034079071382509055
18989,23.0,220,5389,5609,19,225,7323,2109,5214,7323,557,0.03004233237744094,0.7359005871910419,0.0025945650689608085,0.2879967226546497,0.7120032773453503,0.030725112658746414
18990,24.0,105,1543,1648,1,87,2464,597,1867,2464,133,0.04261363636363636,0.6262175324675324,0.00040584415584415587,0.24228896103896103,0.757711038961039,0.03530844155844156
18991,17.0,117,3448,3565,1,149,4746,1335,3411,4746,335,0.02465233881163085,0.7265065318162663,0.00021070375052675939,0.28128950695322374,0.7187104930467763,0.031394858828487145
18992,27.0,122,3009,3131,97,150,4275,1261,3014,4275,298,0.02853801169590643,0.703859649122807,0.022690058479532163,0.2949707602339181,0.7050292397660819,0.03508771929824561
18993,27.0,27479,380264,407743,3534,26569,559783,153904,405879,559783,36207,0.04908866471471981,0.6793060882520549,0.006313160635460527,0.2749351087832249,0.7250648912167751,0.04746303478312132
18994,,3022,39682,42704,312,2375,57757,16207,41550,57757,3860,0.05232266218813304,0.6870509202347768,0.005401942621673563,0.28060667970981873,0.7193933202901813,0.04112055681562408
18995,17.0,2850,30059,32909,1539,4136,47932,12538,35394,47932,3045,0.05945923391471251,0.6271175832429274,0.03210798631394476,0.26157890344654927,0.7384210965534507,0.08628890928815823
18996,,55,1883,1938,3,102,2588,767,1821,2588,217,0.02125193199381762,0.7275888717156105,0.00115919629057187,0.2963678516228748,0.7036321483771252,0.03941267387944358
18997,16.0,224,1279,1530,13,179,2206,551,1659,2210,75,0.10135746606334842,0.5787330316742082,0.0058823529411764705,0.2493212669683258,0.7506787330316742,0.08099547511312218
18998,23.0,40,14075,14115,31,596,18502,5394,13108,18502,1740,0.0021619284401686303,0.7607285698843368,0.0016754945411306887,0.29153605015673983,0.7084639498432602,0.03221273375851259
18999,,271,9437,9708,10,529,12846,3674,9172,12846,1030,0.021096061030671028,0.7346255643780165,0.0007784524365561264,0.28600342519072086,0.7139965748092791,0.04118013389381909
19000,25.0,551,17518,18069,181,1586,24473,6975,17498,24473,1680,0.02251460793527561,0.7158092591835901,0.007395905691987088,0.2850079679646958,0.7149920320353043,0.06480611285906918
19001,,9,3478,3487,34,345,4744,1316,3428,4744,339,0.0018971332209106238,0.7331365935919055,0.007166947723440135,0.2774030354131535,0.7225969645868465,0.07272344013490725
19002,17.0,86,2249,2335,23,159,3161,879,2282,3161,248,0.027206580196140463,0.7114837076874407,0.007276178424549193,0.2780765580512496,0.7219234419487504,0.05030053780449225
19003,27.0,340,8515,8855,26,433,12107,3386,8721,12107,895,0.02808292723217973,0.7033121334765012,0.002147517964813744,0.2796729164945899,0.7203270835054101,0.03576443379862889
19004,16.0,816,15131,15947,66,814,21396,6018,15378,21396,1699,0.03813796971396523,0.7071882594877548,0.0030846887268648347,0.28126752664049354,0.7187324733595064,0.03804449429799962
19005,17.0,1400,64425,65825,229,4814,89693,24824,64869,89693,7927,0.01560879890292442,0.7182834780863613,0.0025531535348354943,0.276766302832997,0.723233697167003,0.05367196994191297
19006,14.0,687,15395,16082,287,618,21139,5941,15198,21139,1741,0.032499172146269927,0.7282747528265292,0.013576801173187,0.2810445148777142,0.7189554851222858,0.02923506315341312
19007,,147,6666,6813,5,253,8660,2770,5890,8660,381,0.01697459584295612,0.7697459584295612,0.0005773672055427252,0.31986143187066973,0.6801385681293303,0.029214780600461895
19008,23.0,1323,40761,42084,105,1679,55754,16037,39724,55761,4157,0.023726260289449616,0.7309947812987572,0.0018830365309086996,0.28760244615412206,0.712397553845878,0.030110650813292443
19009,17.0,548,13642,14190,35,565,18674,5437,13237,18674,1649,0.02934561422298383,0.7305344329013602,0.0018742636821248795,0.29115347542037057,0.7088465245796294,0.03025597086858734
19010,24.0,107,3467,3574,11,178,4722,1379,3343,4722,392,0.02265988987717069,0.7342227869546802,0.002329521389241847,0.29203727234222787,0.7079627276577721,0.037695891571368066
19011,,130,3579,3709,19,101,4920,1399,3521,4920,477,0.026422764227642278,0.7274390243902439,0.003861788617886179,0.28434959349593497,0.7156504065040651,0.020528455284552844
19012,23.0,364,29544,29908,497,1914,40416,11094,29322,40416,2556,0.00900633412509897,0.7309976247030879,0.012297110055423595,0.27449524940617576,0.7255047505938242,0.04735748218527316
19013,14.0,131,1783,1914,4,166,2686,731,1955,2686,139,0.04877140729709605,0.6638123603871928,0.0014892032762472078,0.2721518987341772,0.7278481012658228,0.06180193596425912
19014,,7239,107541,114780,3810,7883,161010,43503,117507,161010,11561,0.04495994037637414,0.667915036333147,0.023663126513881125,0.2701881870691261,0.7298118129308738,0.04895969194459972
19015,,1557,15730,17287,996,1746,24496,6663,17833,24496,1453,0.06356139777922926,0.6421456564337035,0.04065969954278249,0.2720035924232528,0.7279964075767472,0.07127694317439583
19016,,2776,65498,68274,231,3055,90291,26124,64167,90291,6466,0.030745035496339612,0.7254100630184626,0.0025583945243712,0.28933116257434294,0.710668837425657,0.0338350444673334
19017,16.0,1807,26204,28011,119,2244,38425,10477,27948,38425,2174,0.047026675341574495,0.6819518542615485,0.0030969420949902406,0.27266102797657776,0.7273389720234222,0.058399479505530254
19018,,94,3089,3183,53,152,4257,1208,3049,4257,275,0.022081277895231382,0.7256283767911675,0.012450082217524078,0.2837679116748884,0.7162320883251115,0.03570589617101245
19019,26.0,0,3574,3574,11,176,4821,1352,3469,4821,453,0.0,0.7413399709603816,0.0022816842978635138,0.2804397427919519,0.7195602572080482,0.03650694876581622
19020,13.0,213,1826,2039,5,128,2881,809,2072,2881,169,0.07393266227004512,0.6338077056577577,0.0017355085039916696,0.28080527594585214,0.7191947240541479,0.04442901770218674
19021,,1753,30603,32356,334,2008,45374,12366,33008,45374,3138,0.03863446026358708,0.6744611451492044,0.007361043769559659,0.2725349318993256,0.7274650681006744,0.04425441883016706
19022,16.0,1054,24460,25514,235,1550,34248,9625,24623,34248,2697,0.030775519738378884,0.7142022891847699,0.006861714552674609,0.28103830880635366,0.7189616911936464,0.04525811726232189
19023,16.0,4895,137335,142230,287,9609,192654,53900,138754,192654,16690,0.025408244832705266,0.7128582848007309,0.0014897173170554466,0.2797761790567546,0.7202238209432454,0.04987698153165779
19024,,76,1826,1902,0,122,2554,748,1806,2554,180,0.02975724353954581,0.7149569303054033,0.0,0.29287392325763506,0.7071260767423649,0.047768206734534066
19025,,152,4196,4348,0,146,5825,1659,4166,5825,448,0.02609442060085837,0.7203433476394849,0.0,0.2848068669527897,0.7151931330472103,0.025064377682403435
19026,25.0,10,12097,12107,22,1027,16785,4445,12340,16785,1275,0.0005957700327673518,0.7207030086386654,0.001310694072088174,0.2648197795650879,0.7351802204349122,0.061185582365207034
19027,,9469,181165,190634,1392,10177,254870,72077,182793,254870,16360,0.03715227370816495,0.7108133558284616,0.0054616078785263075,0.28279907403774474,0.7172009259622553,0.03993016047396712
19028,24.0,55,1499,1554,11,54,2294,618,1676,2294,191,0.023975588491717523,0.6534437663469922,0.004795117698343505,0.26939843068875324,0.7306015693112468,0.023539668700959023
19029,16.0,915,5992,6907,16,309,8924,2714,6210,8924,536,0.1025324966382788,0.6714477812640072,0.0017929179740026895,0.30412371134020616,0.6958762886597938,0.03462572837292694
19030,25.0,93,1964,2057,7,103,2765,790,1975,2765,162,0.03363471971066908,0.7103074141048824,0.002531645569620253,0.2857142857142857,0.7142857142857143,0.03725135623869801
19031,42.0,536,10352,10888,68,483,14313,4135,10178,14313,1158,0.03744847341577587,0.7232585761196115,0.004750925731852163,0.28889820442953956,0.7111017955704604,0.03374554600712639
19032,,7955,130632,138587,225,8786,193289,52777,140512,193289,13195,0.04115598921821728,0.675837735204797,0.001164060034456177,0.273047095282194,0.7269529047178059,0.04545525094547543
19033,36.0,1197,41132,42329,185,1533,53617,16461,37202,53663,3560,0.022305871829752345,0.7664871512960513,0.003447440508357714,0.3067476659896018,0.6932523340103982,0.0285671691854723
19034,14.0,332,2445,2777,19,102,4101,1039,3062,4101,252,0.08095586442331139,0.5961960497439649,0.004633016337478664,0.25335284077054376,0.7466471592294562,0.02487198244330651
19035,15.0,12189,181942,194131,2217,8602,254968,74501,180467,254968,15753,0.04780599918421135,0.713587587461956,0.008695208810517397,0.2921974522292994,0.7078025477707006,0.03373756706723981
19036,,3,4652,4655,0,199,6390,1754,4636,6390,651,0.00046948356807511736,0.7280125195618153,0.0,0.27449139280125195,0.725508607198748,0.031142410015649453
19037,,82,2493,2575,2,107,3614,976,2638,3614,250,0.022689540675152185,0.6898173768677366,0.0005534034311012728,0.27006087437742116,0.7299391256225789,0.029607083563918096
19038,,437,26438,26875,203,1779,39956,10315,29641,39956,2751,0.010937030733807187,0.6616778456301932,0.005080588647512264,0.2581589748723596,0.7418410251276404,0.04452397637401141
19039,,2518,93505,96023,372,5107,126715,36421,90294,126715,10022,0.019871364873929685,0.7379157952886398,0.0029357218955924714,0.2874245353746597,0.7125754646253404,0.04030304226019019
19040,35.0,212,6979,7191,21,627,9819,2750,7069,9819,717,0.021590793359812607,0.7107648436704349,0.0021387106630003055,0.2800692534881353,0.7199307465118647,0.06385578979529484
19041,17.0,915,13765,14680,97,1255,20341,5546,14795,20341,1405,0.04498303918194779,0.676712059387444,0.004768693771201022,0.2726512954132049,0.7273487045867951,0.06169804827687921
19042,26.0,920,21621,22541,455,1239,30931,8478,22453,30931,2259,0.029743622902589636,0.6990074682357506,0.014710161326824222,0.2740939510523423,0.7259060489476576,0.04005690084381365
19043,,417,10293,10710,29,707,14382,4111,10271,14382,1002,0.028994576554025864,0.7156862745098039,0.0020164094006396883,0.28584341538033653,0.7141565846196635,0.04915867056042275
19044,48.0,529,8411,8940,31,595,12415,3429,8986,12415,819,0.042609746274667744,0.6774869109947644,0.0024969794603302456,0.2761981474023359,0.7238018525976642,0.04792589609343536
19045,,348,9472,9820,85,318,13339,3735,9604,13339,1096,0.02608891221230977,0.7100982082614888,0.006372291775995202,0.2800059974510833,0.7199940025489167,0.023839868056076168
19046,,427,7884,8311,28,508,11401,3164,8237,11401,758,0.03745285501271818,0.6915182878694851,0.002455924918866766,0.27751951583194456,0.7224804841680554,0.044557494956582754
19047,25.0,307,8008,8315,38,323,11049,3165,7884,11049,1011,0.02778531993845597,0.7247714725314508,0.003439225269255136,0.28645126255769754,0.7135487374423025,0.029233414788668657
19048,15.0,6,1535,1541,8,153,2278,565,1713,2278,165,0.0026338893766461808,0.6738366988586479,0.003511852502194908,0.24802458296751537,0.7519754170324846,0.06716417910447761
19049,,81,1630,1711,0,97,2308,679,1629,2308,172,0.03509532062391681,0.7062391681109186,0.0,0.2941941074523397,0.7058058925476604,0.042027729636048526
19050,,309,5846,6155,21,418,8376,2357,6019,8376,543,0.03689111747851003,0.6979465138490927,0.002507163323782235,0.2813992359121299,0.7186007640878701,0.04990448901623687
19051,15.0,96,1764,1860,11,143,2531,722,1809,2531,186,0.03792967206637693,0.6969577242196761,0.00434610825760569,0.2852627419992098,0.7147372580007902,0.056499407348873966
19052,23.0,301,7110,7411,31,212,9781,2798,6983,9781,772,0.030773949493916777,0.7269195378795624,0.0031694100807688375,0.2860648195481035,0.7139351804518965,0.021674675391064307
19053,13.0,142,1915,2057,7,155,3643,651,2992,3643,122,0.03897886357397749,0.5256656601701895,0.0019214932747735384,0.17869887455393907,0.8213011254460609,0.042547351084271205
19054,,2820,58791,61611,452,2940,81241,23969,57272,81241,5261,0.03471153727797541,0.7236616979111532,0.00556369320909393,0.29503575780701863,0.7049642421929814,0.03618862397065521
19055,,237,3487,3724,3,210,4999,1454,3545,4999,397,0.04740948189637927,0.6975395079015804,0.000600120024004801,0.29085817163432687,0.7091418283656732,0.042008401680336066
19056,16.0,359,2784,3143,94,266,4713,1188,3525,4713,191,0.07617228941226395,0.5907065563335455,0.01994483343942287,0.25206874602164225,0.7479312539783577,0.05643963505198388
19057,33.0,41,1676,1717,0,86,2283,665,1618,2283,169,0.017958826106000875,0.7341217696014016,0.0,0.2912833990363557,0.7087166009636443,0.037669732807709154
19058,,27,1938,1965,0,123,2738,807,1931,2738,225,0.009861212563915266,0.7078159240321402,0.0,0.2947406866325785,0.7052593133674214,0.04492330168005844
19059,25.0,789,13436,14225,67,867,19346,5330,14016,19346,1377,0.040783624521864986,0.6945104931251939,0.00346324821668562,0.2755091491781247,0.7244908508218754,0.04481546572934974
19060,23.0,231,5391,5622,13,293,7455,2170,5285,7455,591,0.030985915492957747,0.723138832997988,0.001743796109993293,0.29107981220657275,0.7089201877934272,0.03930248155600268
19061,14.0,1217,25581,26798,25,1762,35399,10078,25321,35399,2461,0.03437950224582615,0.72264753241617,0.0007062346393965931,0.2846973078335546,0.7153026921664454,0.04977541738467188
19062,,613,9011,9624,92,616,13057,3682,9375,13057,927,0.04694799724285824,0.6901279007428965,0.007046028949988512,0.2819943325419315,0.7180056674580685,0.04717775905644482
19063,24.0,139,3562,3701,16,179,5209,1428,3781,5209,349,0.026684584373200232,0.683816471491649,0.0030716068343252063,0.2741409099635247,0.7258590900364753,0.034363601459013245
19064,15.0,45882,291801,337683,5673,38119,486184,128504,357680,486184,23546,0.09437167821236404,0.6001863492011255,0.011668421832063581,0.26431145409968243,0.7356885459003176,0.07840447238082701
19065,24.0,59,1848,1907,12,79,2508,709,1799,2508,180,0.023524720893141945,0.7368421052631579,0.004784688995215311,0.28269537480063794,0.717304625199362,0.03149920255183413
19066,27.0,196,6372,6568,41,265,8755,2463,6292,8755,689,0.02238720731010851,0.7278126784694461,0.004683038263849229,0.28132495716733297,0.718675042832667,0.03026841804683038
19067,24.0,5637,276143,281780,1101,14366,370033,105941,264096,370037,28414,0.01523361177395774,0.7462578066517672,0.0029753781378618893,0.2862983971873083,0.7137016028126917,0.03882314471255577
19068,,118,2819,2937,2,182,4100,1091,3009,4100,225,0.02878048780487805,0.687560975609756,0.0004878048780487805,0.26609756097560977,0.7339024390243902,0.04439024390243902
19069,17.0,958,33718,34676,239,2304,46832,13023,33809,46832,3429,0.020456098394260335,0.7199777929620772,0.005103348138025282,0.27807909121967883,0.7219209087803211,0.0491971301674069
19070,,2294,62583,64877,312,3251,86016,24716,61300,86016,6815,0.026669456845238096,0.7275739397321429,0.003627232142857143,0.2873418898809524,0.7126581101190477,0.03779529389880952
19071,24.0,3474,29783,33257,14,3144,46231,12933,33298,46231,3226,0.075144383638684,0.6442214098764898,0.00030282710735220957,0.27974735567043757,0.7202526443295624,0.06800631610823905
19072,25.0,312,4922,5234,19,374,7095,1974,5121,7095,479,0.04397463002114165,0.6937279774489077,0.002677942212825934,0.27822410147991544,0.7217758985200846,0.05271317829457364
19073,17.0,271,3677,3948,17,258,5355,1495,3860,5355,358,0.05060690943043884,0.6866479925303455,0.0031746031746031746,0.2791783380018674,0.7208216619981326,0.048179271708683476
19074,16.0,9,3057,3066,9,310,4217,1176,3041,4217,284,0.0021342186388427793,0.7249229309935974,0.0021342186388427793,0.2788712354754565,0.7211287645245436,0.07351197533791795
19075,,2269,31842,34111,154,2526,46955,13058,33897,46955,3374,0.04832286231498243,0.6781386433819615,0.0032797359173676924,0.2780960494090086,0.7219039505909913,0.05379618783942072
19076,,100,3949,4049,2,420,5653,1490,4163,5653,340,0.01768972227136034,0.6985671324960198,0.0003537944454272068,0.26357686184326906,0.736423138156731,0.07429683353971343
19077,26.0,534,9596,10130,44,728,14107,3815,10292,14107,838,0.037853547884029205,0.6802296732118807,0.003119018926773942,0.27043311831005884,0.7295668816899412,0.05160558587935068
19078,25.0,1125,31035,32160,156,1458,42261,12256,30005,42261,3108,0.02662028820898701,0.7343650173919216,0.0036913466316461988,0.2900073353683065,0.7099926646316935,0.03449989351884716
19079,37.0,1942,71905,73847,412,2723,93032,29025,64007,93032,6190,0.020874537793447417,0.7729060968268983,0.0044285837131309656,0.31198942299423854,0.6880105770057614,0.02926949866712529
19080,,1179,24532,25711,232,1130,32856,9757,23099,32856,1897,0.035883856829802774,0.7466520574628682,0.0070611151692232775,0.2969625030435841,0.7030374969564159,0.034392500608716826
19081,,6465,115664,122129,545,8907,166715,46126,120595,166721,11776,0.03877735858110256,0.6937578349458077,0.0032689343274092644,0.2766658069469353,0.7233341930530647,0.05342458358575104
19082,17.0,2309,109240,111549,369,4610,150257,43129,107150,150279,13169,0.015364754889239348,0.7269146055004359,0.002455432894815643,0.28699285994716495,0.713007140052835,0.030676275460975917
19083,23.0,1501,40632,42133,130,2031,55319,16002,39317,55319,3985,0.027133534590285436,0.7345035159710045,0.002350006326940111,0.28926770187458195,0.710732298125418,0.03671432961550281
19084,,1247,6592,7839,33,505,10783,2888,7895,10783,620,0.11564499675415005,0.6113326532504869,0.0030603728090512843,0.26782899007697303,0.732171009923027,0.04683297783548178
19085,,78,17633,17711,130,1907,24352,6771,17581,24352,1234,0.0032030223390275953,0.724088370565046,0.005338370565045992,0.2780469776609724,0.7219530223390276,0.07830978975032851
19086,35.0,145,2070,2215,12,151,2958,829,2129,2958,160,0.049019607843137254,0.6997971602434077,0.004056795131845842,0.28025693035835025,0.7197430696416498,0.051048005409060175
19087,,2661,46657,49318,276,3198,65640,18680,46960,65640,4301,0.04053930530164534,0.7108013406459476,0.004204753199268739,0.2845825716026813,0.7154174283973187,0.048720292504570384
19088,23.0,387,21940,22327,47,1376,29637,8378,21259,29637,2801,0.013058001822046765,0.7402908526504032,0.001585855518439788,0.2826871815635861,0.7173128184364139,0.046428450922832945
19089,17.0,401,5609,6010,58,583,8397,2287,6110,8397,558,0.047755150649041324,0.6679766583303561,0.0069072287721805405,0.2723591758961534,0.7276408241038466,0.06942955817553888
19090,25.0,72,2224,2296,8,250,3151,877,2274,3151,242,0.022849888924151063,0.705807680101555,0.0025388765471278957,0.27832434147889556,0.7216756585211044,0.07933989209774675
19091,,740,24101,24841,78,1548,32753,9574,23179,32753,2656,0.02259335022746008,0.7358409916648857,0.002381461240191738,0.29230910145635514,0.7076908985436449,0.047262846151497576
19092,16.0,1160,26372,27532,17,1359,35790,10550,25240,35790,2702,0.032411288069293095,0.7368538697960324,0.0004749930148086058,0.29477507683710535,0.7052249231628946,0.03797150041911149
19093,40.0,2116,75099,77215,348,2045,100809,29049,71761,100810,8426,0.020989981152663425,0.7449558575538141,0.003452038488245214,0.2881559369110207,0.7118440630889793,0.020285685943854777
19094,47.0,104,2303,2407,4,78,3143,915,2228,3143,199,0.03308940502704422,0.732739420935412,0.0012726694241170856,0.2911231307667833,0.7088768692332167,0.02481705377028317
19095,40.0,504,10410,10914,65,511,14640,4171,10469,14640,1060,0.03442622950819672,0.7110655737704918,0.004439890710382513,0.28490437158469945,0.7150956284153005,0.03490437158469945
19096,14.0,288,3636,3924,17,167,5331,1495,3836,5331,311,0.05402363534046145,0.6820483961733258,0.0031888951416244606,0.2804351903957982,0.7195648096042019,0.031326205214781466
19097,15.0,2010,33021,35031,230,2389,47958,13337,34621,47958,3215,0.04191167271362442,0.6885399724759165,0.0047958630468326454,0.27809750198089994,0.7219024980191,0.04981442095166604
19098,34.0,1389,29943,31332,232,1481,42741,11982,30759,42741,2769,0.03249806976907419,0.7005685407454201,0.005428043330759692,0.2803397206429424,0.7196602793570577,0.03465056971058234
19099,,31,6041,6072,47,227,8110,2335,5775,8110,746,0.0038224414303329223,0.7448828606658446,0.005795314426633786,0.2879161528976572,0.7120838471023427,0.027990135635018495
19100,15.0,3174,75151,78325,203,3998,102832,29359,73473,102832,7547,0.030865878325812977,0.7308133654893418,0.0019740936673409057,0.2855045122140968,0.7144954877859032,0.03887894818733468
19101,38.0,368,9497,9865,132,1596,14414,3770,10644,14414,1026,0.025530734008602746,0.6588733176078813,0.009157763285694464,0.261551269599001,0.738448730400999,0.11072568336339669
19102,,163,3365,3528,14,136,4725,1361,3364,4725,361,0.0344973544973545,0.7121693121693121,0.002962962962962963,0.28804232804232804,0.711957671957672,0.028783068783068782
19103,16.0,139,2151,2290,3,166,3186,860,2326,3186,201,0.04362837413684871,0.6751412429378532,0.0009416195856873823,0.2699309478970496,0.7300690521029504,0.052102950408035156
19104,35.0,868,21939,22807,83,1570,30512,8717,21795,30512,2811,0.028447823807026745,0.7190285789197692,0.0027202412165705297,0.2856908757210278,0.7143091242789722,0.05145516518091243
19105,14.0,478,5217,5695,10,375,8363,2231,6132,8363,513,0.05715652277890709,0.6238192036350592,0.0011957431543704413,0.26677029774004546,0.7332297022599545,0.04484036828889155
19106,,126,1365,1491,0,125,2079,547,1532,2079,140,0.06060606060606061,0.6565656565656566,0.0,0.2631072631072631,0.7368927368927369,0.06012506012506012
19107,23.0,78,3157,3235,4,144,4518,1275,3243,4518,374,0.017264276228419653,0.6987605135015493,0.0008853474988933156,0.2822045152722444,0.7177954847277557,0.03187250996015936
19108,27.0,175,5651,5826,3,241,7703,2224,5479,7703,619,0.022718421394261976,0.7336102817084252,0.0003894586524730624,0.2887186810333636,0.7112813189666364,0.03128651174866935
19109,,92,2607,2699,12,193,3607,955,2652,3607,262,0.02550596063210424,0.7227612974771278,0.0033268644302744664,0.2647629609093429,0.7352370390906571,0.053507069586914334
19110,26.0,109,20085,20194,127,1442,28117,7644,20473,28117,2319,0.0038766582494576237,0.7143365223885906,0.004516840345698332,0.27186399687022084,0.7281360031297791,0.05128569904328342
19111,15.0,266,6851,7117,43,462,10272,2649,7623,10272,755,0.02589563862928349,0.666958722741433,0.00418613707165109,0.2578855140186916,0.7421144859813084,0.04497663551401869
19112,27.0,163,6041,6204,22,125,7977,2354,5623,7977,732,0.020433747022690234,0.7573022439513601,0.002757929046007271,0.29509840792277797,0.704901592077222,0.015670051397768586
19113,16.0,173,3733,3906,27,152,5165,1462,3703,5165,387,0.033494675701839303,0.7227492739593417,0.005227492739593417,0.2830590513068732,0.7169409486931269,0.029428848015488868
19114,,216,6504,6720,0,318,8921,2572,6349,8921,776,0.024212532227328776,0.7290662481784553,0.0,0.2883084855957852,0.7116915144042147,0.03564622800134514
19115,15.0,120,7451,7571,16,436,10174,2876,7298,10174,862,0.011794770984863378,0.7323569884018085,0.001572636131315117,0.28268134460389227,0.7173186553961077,0.042854334578336935
19116,33.0,2013,35164,37177,495,2127,50409,14219,36194,50413,3509,0.039930176740126555,0.6975184972130205,0.00981889591970325,0.28205026481264756,0.7179497351873525,0.042191498224664274
19117,,1166,14525,15691,46,1215,23683,5743,17940,23683,1337,0.04923362749651649,0.6133091246885952,0.00194232149643204,0.24249461639150446,0.7575053836084955,0.05130262213402018
19118,17.0,1223,22930,24153,180,1585,32465,9119,23346,32465,2487,0.037671338364392425,0.7062990913291237,0.005544432465732327,0.28088710919451715,0.7191128908054828,0.04882180810103188
19119,15.0,52,3929,3981,14,326,5507,1536,3971,5507,518,0.009442527692028328,0.7134556019611403,0.002542218994007627,0.27891774105683675,0.7210822589431632,0.05919738514617759
19120,,463,13486,13949,27,1126,19376,5275,14101,19376,1677,0.02389554087530966,0.6960156895127994,0.001393476465730801,0.2722440132122213,0.7277559867877786,0.05811312964492155
19121,24.0,6432,109634,116066,1685,6561,156950,44338,112612,156950,10187,0.04098120420516088,0.6985281936922587,0.010735903153870659,0.2824976107040459,0.7175023892959541,0.04180312201338006
19122,25.0,949,2448,3397,212,347,4795,1253,3542,4795,179,0.19791449426485924,0.5105318039624609,0.044212721584984356,0.2613138686131387,0.7386861313868613,0.07236704900938477
19123,27.0,499,18945,19444,136,834,25370,7434,17936,25370,1883,0.019668900275916435,0.7467481277098936,0.005360662199448167,0.2930232558139535,0.7069767441860465,0.0328734726054395
19124,23.0,748,19463,20211,57,1000,26832,7822,19010,26832,2072,0.02787716159809183,0.7253652355396542,0.00212432915921288,0.2915175909361956,0.7084824090638044,0.037268932617769826
19125,,528,7828,8356,27,493,11397,3180,8217,11397,842,0.046327981047644115,0.6868474159866632,0.0023690444853908922,0.27902079494603843,0.7209792050539615,0.043256997455470736
19126,39.0,390,10163,10553,90,646,14473,3967,10506,14473,1068,0.026946728390796655,0.7022041041940165,0.006218475782491536,0.2740965936571547,0.7259034063428453,0.04463483728321702
19127,24.0,152,2523,2675,32,160,3695,1012,2683,3695,253,0.041136671177266576,0.6828146143437077,0.008660351826792964,0.27388362652232745,0.7261163734776725,0.04330175913396482
19128,26.0,1058,37247,38305,108,1231,49256,14631,34625,49256,3662,0.021479616696443073,0.7561921390287477,0.002192626279031996,0.2970399545233068,0.7029600454766932,0.02499187916192951
19129,25.0,1150,12009,13159,14,727,17735,5103,12632,17735,1482,0.06484352974344516,0.6771356075556808,0.0007893994925288976,0.2877361150267832,0.7122638849732168,0.0409923879334649
19130,23.0,7625,179966,187591,870,9135,247186,71124,176062,247186,17007,0.030847216266293397,0.7280590324694765,0.003519616806777083,0.2877347422588658,0.7122652577411343,0.03695597647115937
19131,,5195,123488,128683,1049,4919,170376,49758,120618,170376,13254,0.03049138376297131,0.724796919753956,0.006156970465323755,0.2920481757994084,0.7079518242005917,0.028871437291637318
19132,23.0,517,13340,13857,16,871,18836,5253,13583,18836,1330,0.027447441070290932,0.7082183053726906,0.0008494372478233171,0.2788808664259928,0.7211191335740073,0.04624124017838182
19133,16.0,138,5514,5652,32,808,7772,2222,5550,7772,329,0.017756047349459597,0.7094698919197118,0.004117344312918168,0.28589809572825525,0.7141019042717447,0.10396294390118374
19134,,2294,66777,69071,350,2740,88499,26072,62427,88499,5660,0.025921196849681916,0.7545508988802133,0.0039548469474231344,0.29460219889490274,0.7053978011050972,0.030960801816969682
19135,,2145,38377,40522,127,2405,53687,15732,37965,53697,4148,0.03994636571875524,0.7146954206007784,0.0023651228187794478,0.29297726129951396,0.707022738700486,0.04478834944224072
19136,23.0,58,1824,1933,10,100,2573,726,1847,2573,215,0.022541780023319084,0.708900116595414,0.00388651379712398,0.28216090167120095,0.7178390983287991,0.0388651379712398
19137,43.0,337,10384,10721,18,429,13819,4187,9632,13819,1165,0.024386713944569073,0.7514291916925971,0.0013025544540125914,0.30298863883059557,0.6970113611694044,0.031044214487300093
19138,,216,4169,4385,7,209,5722,1630,4092,5722,374,0.03774903879762321,0.7285914016078294,0.001223348479552604,0.2848654316672492,0.7151345683327508,0.036525690318070604
19139,15.0,1155,17089,18244,124,1956,25573,6823,18750,25573,1203,0.04516482227349157,0.6682438509365346,0.004848864036288273,0.2668048332225394,0.7331951667774605,0.0764869197982247
19140,27.0,150,6843,6993,21,300,9361,2585,6776,9361,744,0.01602392906740733,0.7310116440551223,0.002243350069437026,0.27614571092831963,0.7238542890716804,0.03204785813481466
19141,17.0,81,1742,1823,2,103,2389,714,1675,2389,185,0.03390539974884889,0.7291753871912934,0.0008371703641691084,0.2988698200083717,0.7011301799916283,0.04311427375470908
19142,14.0,503,5356,5859,33,418,8454,2195,6259,8454,522,0.05949846226638278,0.633546250295718,0.0039034776437189495,0.2596404069079726,0.7403595930920275,0.04944405015377336
19143,,152,2496,2648,4,181,3615,984,2631,3615,237,0.04204702627939143,0.6904564315352697,0.0011065006915629322,0.2721991701244813,0.7278008298755186,0.050069156293222686
19144,,43,1791,1834,10,106,2508,698,1810,2508,194,0.0171451355661882,0.7141148325358851,0.003987240829346092,0.2783094098883573,0.7216905901116427,0.04226475279106858
19145,23.0,523,16115,16638,30,837,21745,6261,15484,21745,1452,0.024051506093354793,0.7410899057254541,0.0013796275005748448,0.28792825936997013,0.7120717406300299,0.03849160726603817
19146,24.0,116,3819,3935,5,210,5134,1536,3598,5134,372,0.02259446825087651,0.7438644331904948,0.0009738994935722633,0.2991819244253993,0.7008180755746007,0.04090377873003506
19147,17.0,103,2107,2210,6,181,3073,858,2215,3073,205,0.03351773511226814,0.6856492027334852,0.0019524894240156199,0.27920598763423365,0.7207940123657663,0.0589000976244712
19148,,100,2216,2316,11,107,3076,888,2188,3076,223,0.032509752925877766,0.7204161248374512,0.003576072821846554,0.2886866059817945,0.7113133940182055,0.034785435630689206
19149,16.0,135,3859,3994,34,642,6028,1450,4578,6028,255,0.022395487723954877,0.6401791639017916,0.00564034505640345,0.24054412740544126,0.7594558725945587,0.10650298606502986
19150,16.0,70,3840,3910,4,159,5040,1477,3563,5040,407,0.013888888888888888,0.7619047619047619,0.0007936507936507937,0.29305555555555557,0.7069444444444445,0.03154761904761905
19151,15.0,307,11979,12286,34,1273,17070,4695,12375,17070,1178,0.017984768599882836,0.7017574692442883,0.0019917984768599885,0.2750439367311072,0.7249560632688928,0.07457527826596368
19152,,252,4000,4252,4,191,5719,1614,4105,5719,473,0.044063647490820076,0.6994229760447631,0.000699422976044763,0.2822171708340619,0.717782829165938,0.033397447106137436
19153,,729,13522,14251,61,1295,21459,5536,15923,21459,1035,0.03397176010065707,0.6301318793979216,0.002842630131879398,0.2579803345915467,0.7420196654084533,0.060347639684980664
19154,24.0,108,2890,2998,34,182,3968,1105,2863,3968,299,0.02721774193548387,0.7283266129032258,0.008568548387096774,0.2784778225806452,0.7215221774193549,0.04586693548387097
19155,37.0,172,3470,3642,10,190,4904,1362,3542,4904,401,0.03507340946166395,0.7075856443719413,0.0020391517128874386,0.2777324632952692,0.7222675367047309,0.03874388254486134
19156,14.0,478,14159,14637,34,969,20338,5621,14717,20338,1597,0.023502802635460715,0.6961844822499754,0.0016717474677942767,0.2763791916609303,0.7236208083390697,0.04764480283213689
19157,17.0,3895,78373,82268,153,4760,110854,31195,79659,110854,8079,0.03513630541072041,0.7069929817597922,0.0013801937683800313,0.28140617388637307,0.718593826113627,0.04293936168293431
19158,15.0,116,1955,2071,7,158,2860,794,2066,2860,148,0.04055944055944056,0.6835664335664335,0.0024475524475524478,0.2776223776223776,0.7223776223776224,0.05524475524475524
19159,24.0,6355,59313,66260,910,10267,101860,23796,78132,101928,5138,0.06234793187347932,0.5819107605368495,0.008927870653794835,0.2334589121732988,0.7665410878267012,0.10072796483792482
19160,,14,2177,2191,0,148,2877,819,2058,2877,219,0.004866180048661801,0.7566909975669099,0.0,0.2846715328467153,0.7153284671532847,0.05144247480013903
19161,27.0,193,5016,5209,13,389,6813,1835,4978,6813,396,0.0283281960956994,0.7362395420519595,0.0019081168354616175,0.2693380302363129,0.730661969763687,0.05709672684573609
19162,25.0,161,2929,4896,225,169,6373,1177,5199,6376,219,0.025250941028858217,0.4593789209535759,0.03528858218318695,0.18459849435382686,0.8154015056461732,0.02650564617314931
19163,16.0,121,3307,3428,2,210,4760,1268,3492,4760,338,0.02542016806722689,0.6947478991596638,0.0004201680672268908,0.26638655462184874,0.7336134453781512,0.04411764705882353
19164,,1066,12316,13382,58,733,17809,5056,12753,17809,1170,0.05985737548430569,0.6915604469650177,0.0032567802796338928,0.28390139816946486,0.7160986018305351,0.04115896456847661
19165,23.0,1347,34123,35470,70,1433,47167,13374,33793,47167,3283,0.028558102062882947,0.7234507176627727,0.0014840884516717197,0.2835456993236797,0.7164543006763203,0.03038141073207963
19166,14.0,152,2950,3102,4,114,4245,1160,3085,4245,313,0.03580683156654888,0.6949352179034158,0.0009422850412249705,0.27326266195524146,0.7267373380447585,0.02685512367491166
19167,24.0,1055,12172,13227,934,1038,18321,4730,13591,18321,794,0.05758419300256536,0.6643742153812565,0.05097975001364554,0.25817368047595657,0.7418263195240434,0.05665629605370886
19168,23.0,480,14381,14861,45,499,19132,5713,13419,19132,1231,0.025088856366297305,0.7516725904244198,0.0023520802843403723,0.298609659209701,0.7013903407902989,0.02608195693079657
19169,25.0,988,21480,22468,114,1416,29691,8739,20952,29691,2115,0.03327607692566771,0.723451550975043,0.0038395473375770436,0.2943316156411034,0.7056683843588967,0.047691219561483277
19170,25.0,239,5822,6061,6,352,8128,2334,5794,8128,597,0.029404527559055118,0.7162893700787402,0.0007381889763779527,0.2871555118110236,0.7128444881889764,0.04330708661417323
19171,24.0,630,12412,13042,87,737,17071,4977,12094,17071,1331,0.03690469216800422,0.7270810145861403,0.005096362251772011,0.2915470681272333,0.7084529318727667,0.04317263194891922
19172,,311,6137,6448,12,490,9163,2581,6582,9163,534,0.03394084906689949,0.6697588126159555,0.0013096147549929063,0.2816763068863909,0.7183236931136091,0.053475935828877004
19173,16.0,134,3429,3563,17,184,4945,1386,3559,4945,383,0.027098078867542973,0.693427704752275,0.0034378159757330637,0.28028311425682506,0.7197168857431749,0.037209302325581395
19174,,73,13113,13186,52,287,17246,5010,12236,17246,1908,0.004232865592021338,0.7603502261393946,0.003015191928563145,0.2905021454250261,0.7094978545749739,0.016641540067261974
19175,14.0,475,38744,39219,215,4320,56200,12907,43297,56204,3718,0.008451355775389652,0.6893459540246246,0.0038253505088605795,0.22964557682727207,0.770354423172728,0.07686285673617536
19176,17.0,997,21976,22973,44,1461,30739,8681,22058,30739,2273,0.03243436676534695,0.7149224112690719,0.0014314063567455024,0.282409967793357,0.7175900322066431,0.047529197436481346
19177,,1794,31586,33380,285,1321,44859,12718,32141,44859,3732,0.03999197485454424,0.7041173454602198,0.0063532401524777635,0.2835105552954814,0.7164894447045186,0.029447825408502194
19178,38.0,1632,36693,38325,115,1629,48567,14317,34250,48567,3045,0.033603063808759034,0.7555130026561245,0.0023678629522103484,0.29478864249387443,0.7052113575061255,0.03354129347087528
19179,,512,10415,10927,102,578,14933,4173,10773,14946,966,0.034256657299611935,0.696841964405192,0.006824568446407065,0.27920513849859496,0.720794861501405,0.03867255452964004
19180,25.0,2730,80384,83114,974,2820,109996,31261,78735,109996,8443,0.024819084330339285,0.730790210553111,0.008854867449725445,0.28420124368158844,0.7157987563184116,0.02563729590166915
19181,13.0,146,16405,16551,230,1115,22161,6063,16098,22161,1196,0.006588150354225893,0.7402644285005189,0.010378593023780516,0.2735887369703533,0.7264112630296466,0.05031361400658815
19182,23.0,77,3073,3150,12,197,4278,1201,3077,4278,341,0.017999064983637212,0.7183263207106124,0.002805049088359046,0.2807386629266012,0.7192613370733988,0.04604955586722768
19183,17.0,236,6167,6403,18,295,8458,2414,6044,8458,635,0.027902577441475528,0.729132182549066,0.002128162686214235,0.28541026247339796,0.714589737526602,0.034878221801844404
19184,,4210,92596,96806,861,4942,131070,36792,94278,131070,9403,0.032120241092545965,0.706462195773251,0.00656900892652781,0.2807049668116274,0.7192950331883726,0.037705043106736856
19185,37.0,8222,199434,207656,834,11276,278851,78298,200553,278851,22326,0.029485280669604916,0.7151991565387967,0.0029908445729081123,0.280787947685323,0.719212052314677,0.04043736619198066
19186,,162,4030,4192,4,227,5763,1601,4162,5763,485,0.028110359187922956,0.6992885649835155,0.0006940829429116779,0.2778066979003991,0.7221933020996009,0.03938920701023772
19187,41.0,165,6523,6688,13,194,8572,2676,5896,8572,690,0.019248716752216517,0.760965935604293,0.001516565562295847,0.3121791880541297,0.6878208119458703,0.02263182454503033
19188,,12233,194818,207051,978,17037,281691,79370,202321,281691,19835,0.04342701754759648,0.6916017906145386,0.003471889410737297,0.28176264062394607,0.7182373593760539,0.060481165532445126
19189,26.0,6572,120886,127458,425,6765,169888,48114,121774,169888,12650,0.038684309662836695,0.711562912036165,0.0025016481446600114,0.2832101148992277,0.7167898851007722,0.03982035223205877
19190,,214,4340,4554,27,345,6427,1702,4725,6427,406,0.03329702816243971,0.6752761786214408,0.004201026917690991,0.26482028940407654,0.7351797105959235,0.05367978839271822
19191,17.0,223,4914,5137,11,310,6718,2006,4712,6718,488,0.03319440309615957,0.7314676987198571,0.001637392080976481,0.2986007740398928,0.7013992259601072,0.0461446859184281
19192,24.0,196,7659,7855,17,844,10959,2970,7989,10959,794,0.01788484350761931,0.6988776348206953,0.0015512364266812666,0.2710101286613742,0.7289898713386258,0.07701432612464641
19193,23.0,237,6395,6632,50,277,8712,2464,6248,8712,655,0.027203856749311296,0.7340449954086318,0.00573921028466483,0.2828282828282828,0.7171717171717171,0.03179522497704316
19194,,37624,1028393,1066017,4196,41568,1376274,403949,972392,1376341,92656,0.02733624879299534,0.747193464410346,0.0030486630856742625,0.2934948533829916,0.7065051466170085,0.030201817718138166
19195,,2349,67739,70088,288,5791,99607,27093,72514,99607,7781,0.023582679932133283,0.6800626461995642,0.002891363056813276,0.27199895589667394,0.7280010441033261,0.058138484243075286
19196,23.0,125,3483,3608,8,161,4787,1393,3394,4787,379,0.02611238771673282,0.7275955713390433,0.0016711928138709003,0.29099644871527053,0.7090035512847295,0.03363275537915187
19197,,1140,23247,24387,123,1149,32536,9322,23214,32536,2458,0.03503811163019425,0.7145008605851979,0.0037804278337841162,0.28651340054093927,0.7134865994590607,0.035314728300958935
19198,16.0,579,11980,12559,28,1180,17552,4721,12831,17552,1082,0.032987693710118504,0.6825432999088423,0.0015952597994530538,0.2689721969006381,0.7310278030993619,0.06722880583409298
19199,13.0,2497,33083,35580,138,2304,48385,13291,35094,48385,3422,0.05160690296579518,0.6837449622816989,0.002852123592022321,0.27469257001136715,0.7253074299886328,0.04761806344941614
19200,,185,4836,5021,0,204,6654,1995,4659,6654,591,0.027802825368199578,0.7267808836789901,0.0,0.29981965734896304,0.700180342651037,0.030658250676284943
19201,16.0,26295,215925,242220,3255,21011,354629,92431,262198,354629,21605,0.07414791232527515,0.6088757546619142,0.009178606374549177,0.2606414027053625,0.7393585972946375,0.059247833651506224
19202,36.0,498,5295,5793,4,272,7467,2214,5253,7467,520,0.06669345118521494,0.7091201285656891,0.0005356903709655819,0.2965046203294496,0.7034953796705504,0.03642694522565957
19203,14.0,156,1981,2137,25,135,3048,819,2229,3048,204,0.051181102362204724,0.6499343832020997,0.008202099737532808,0.2687007874015748,0.7312992125984252,0.04429133858267716
19204,26.0,3344,44381,47725,121,2117,62368,17582,44787,62369,4506,0.05361637993233818,0.7115874873735349,0.001940066379130658,0.281902868412192,0.7180971315878081,0.03394314483156696
19205,,426,28959,29385,382,1586,40555,11172,29383,40555,3060,0.010504253482924424,0.71406731599063,0.00941930711379608,0.27547774627049687,0.7245222537295032,0.03910738503267168
19206,,17887,335640,353531,2176,16278,470303,134427,335876,470303,34803,0.0380329277083072,0.7136675717569312,0.004626804421830182,0.28583062408702475,0.7141693759129752,0.034611729034260894
19207,,268,13245,13513,24,1043,18228,5114,13114,18228,1390,0.014702655255650647,0.7266293614219882,0.0013166556945358788,0.2805573842440202,0.7194426157559798,0.057219662058371736
19208,15.0,581,21080,21661,64,2864,30886,8279,22607,30886,2261,0.018811111830602863,0.6825098750242828,0.0020721362429579745,0.2680502493038917,0.7319497506961082,0.09272809687236935
19209,,34,1931,1965,12,307,2822,769,2053,2822,161,0.012048192771084338,0.6842664776754075,0.004252303330970942,0.27250177179305457,0.7274982282069454,0.10878809355067329
19210,34.0,611,12737,13348,157,646,18289,4978,13311,18289,1262,0.03340805948931051,0.6964295478156268,0.00858439499152496,0.27218546667395704,0.727814533326043,0.035321778117994425
19211,16.0,7933,128392,136325,792,10577,191637,51751,139886,191637,12720,0.0413959725940189,0.669975004826834,0.004132813600713849,0.2700470159729071,0.7299529840270929,0.055192890725694936
19212,25.0,387,15403,15790,38,1021,21469,6091,15378,21469,1925,0.018025990963715124,0.7174530718710699,0.0017699939447575574,0.2837113978294285,0.7162886021705716,0.04755694256835437
19213,,259,9579,9838,37,331,12704,3775,8929,12704,1012,0.02038727959697733,0.754014483627204,0.0029124685138539044,0.2971505037783375,0.7028494962216625,0.02605478589420655
19214,,41,1902,1943,4,68,2628,739,1889,2628,283,0.015601217656012176,0.723744292237443,0.0015220700152207,0.2812024353120244,0.7187975646879756,0.0258751902587519
19215,,78,1774,1852,3,109,2480,730,1750,2480,177,0.031451612903225803,0.7153225806451613,0.0012096774193548388,0.29435483870967744,0.7056451612903226,0.04395161290322581
19216,,533,17811,18344,29,895,24352,7095,17257,24352,1960,0.021887319316688567,0.7313978318002629,0.0011908672798948753,0.29135183968462547,0.7086481603153745,0.03675262812089356
19217,16.0,72,2150,2222,36,157,3139,871,2268,3139,234,0.02293724115960497,0.684931506849315,0.011468620579802484,0.27747690347244347,0.7225230965275565,0.05001592863969417
19218,24.0,7921,141082,149003,390,8545,200094,56319,143775,200094,14287,0.03958639439463452,0.7050786130518656,0.0019490839305526403,0.2814627125251132,0.7185372874748868,0.042704928683518745
19219,,132,3329,3461,38,162,4549,1302,3247,4549,324,0.02901736645416575,0.7318091888327105,0.008353484282259837,0.2862167509342713,0.7137832490657288,0.03561222246647615
19220,,47,1550,1597,0,57,2248,628,1620,2248,187,0.02090747330960854,0.6895017793594306,0.0,0.2793594306049822,0.7206405693950177,0.025355871886120998
19221,,333,8411,8744,16,427,11490,3288,8202,11490,837,0.02898172323759791,0.7320278503046127,0.001392515230635335,0.28616187989556136,0.7138381201044386,0.037162750217580504
19222,13.0,121,2604,2725,12,137,4049,1025,3024,4049,256,0.029883921956038527,0.6431217584588788,0.0029636947394418374,0.25314892566065694,0.7468510743393431,0.03383551494196098
19223,24.0,46,1681,1727,7,72,2335,676,1659,2335,230,0.019700214132762312,0.7199143468950749,0.0029978586723768737,0.28950749464668096,0.7104925053533191,0.030835117773019272
19224,27.0,81,1727,1808,11,94,2413,681,1732,2413,195,0.033568172399502695,0.7157065893079154,0.0045586406962287605,0.28222130128470785,0.7177786987152922,0.03895565685868214
19225,16.0,1561,66676,68237,424,6025,95683,25511,70172,95683,4526,0.01631428780452118,0.6968426993300796,0.004431299185853286,0.2666199847412811,0.7333800152587189,0.0629683433838822
19226,14.0,171,2835,3006,14,234,4211,1123,3088,4211,285,0.04060793160769413,0.6732367608644028,0.0033246259795772976,0.26668249821895035,0.7333175017810496,0.05556874851579197
19227,,2198,24740,26938,87,1969,36019,10283,25736,36019,2552,0.06102334878813959,0.6868597129292873,0.00241539187650962,0.28548821455343015,0.7145117854465699,0.054665593159166
19228,,1079,74769,75848,455,4794,101820,28080,73741,101821,7114,0.010597028117971734,0.7343180679820469,0.004468626314807358,0.27577808114239694,0.724221918857603,0.04708262539161862
19229,26.0,111,2778,2889,5,170,3813,1085,2728,3813,303,0.029110936270653028,0.7285601888276947,0.0013113034356150013,0.2845528455284553,0.7154471544715447,0.044584316810910046
19230,17.0,632,29253,29885,500,2775,41254,11460,29794,41254,2714,0.015319726571968778,0.709094875648422,0.012120036844912009,0.2777912444853832,0.7222087555146167,0.06726620448926164
19231,16.0,205,4078,4283,132,178,5619,1652,3967,5619,338,0.03648336002847482,0.7257519131518063,0.023491724506139882,0.2940024915465385,0.7059975084534614,0.03167823456130984
19232,16.0,462,8218,8680,51,502,11664,3215,8449,11664,803,0.03960905349794239,0.7045610425240055,0.004372427983539095,0.2756344307270233,0.7243655692729767,0.04303840877914952
19233,23.0,1653,48391,50044,266,2182,65225,19141,46084,65225,4504,0.025343043311613644,0.7419087773093139,0.004078190877730931,0.2934610962054427,0.7065389037945573,0.03345343043311614
19234,,311,8748,9059,17,434,11771,3411,8360,11771,943,0.026420864837312038,0.7431823974173817,0.0014442273383739699,0.28977996771727127,0.7102200322827288,0.03687027440319429
19235,36.0,134,3801,3935,13,165,5203,1503,3705,5208,411,0.02572964669738863,0.7298387096774194,0.0024961597542242702,0.28859447004608296,0.711405529953917,0.03168202764976959
19236,,108,2202,2310,21,113,3068,892,2176,3068,206,0.035202086049543675,0.7177314211212517,0.006844850065189048,0.2907431551499348,0.7092568448500652,0.036831812255541066
19237,23.0,608,14131,14739,31,762,19611,5572,14039,19611,1463,0.031003008515628983,0.7205649890367651,0.001580745499974504,0.28412625567283667,0.7158737443271633,0.03885574422517975
19238,15.0,736,13573,14309,42,1153,19687,5457,14230,19687,1584,0.03738507644638594,0.6894397318027125,0.0021333875146035456,0.2771879920759892,0.7228120079240108,0.058566566769949716
19239,23.0,94,2683,2777,10,204,3828,1052,2776,3828,247,0.024555903866248695,0.7008881922675027,0.002612330198537095,0.27481713688610243,0.7251828631138976,0.05329153605015674
19240,13.0,214,3285,3499,11,189,4689,1333,3356,4689,320,0.04563872894007251,0.7005758157389635,0.002345915973555129,0.2842823629771806,0.7157176370228193,0.04030710172744722
19241,,140,2610,2750,13,160,3702,1059,2643,3702,214,0.037817396002161,0.7050243111831442,0.0035116153430578066,0.2860615883306321,0.7139384116693679,0.04321988114532685
19242,,729,22258,22987,73,1446,31119,8659,22460,31119,2575,0.023426202641473055,0.7152543462193515,0.002345833735017192,0.2782544426234776,0.7217455573765224,0.046466788778559726
19243,25.0,860,23656,24516,49,1425,32559,9398,23161,32559,2677,0.026413587640898063,0.726557940968703,0.0015049602260511687,0.2886452286618139,0.711354771338186,0.04376670045148807
19244,,5571,107946,113517,469,10822,160338,44213,116125,160338,8122,0.03474535044718033,0.6732402799086928,0.0029250707879604335,0.27574873080617196,0.724251269193828,0.06749491698786314
19245,,286,4038,4324,20,227,7040,1711,5329,7040,149,0.040625,0.5735795454545455,0.002840909090909091,0.24303977272727273,0.7569602272727273,0.03224431818181818
19246,,465,12322,12787,270,405,16387,4983,11404,16387,958,0.028376151827668273,0.7519375114419967,0.016476475254775125,0.30408250442423873,0.6959174955757613,0.02471471288216269
19247,14.0,277,6491,6768,178,451,9312,2522,6790,9312,696,0.02974656357388316,0.697057560137457,0.01911512027491409,0.2708333333333333,0.7291666666666666,0.04843213058419244
19248,15.0,1658,17857,19515,181,1708,28587,7382,21205,28587,1740,0.05799839087697205,0.6246545632630216,0.006331549305628433,0.25822926505054744,0.7417707349494526,0.059747437646482666
19249,25.0,1469,37498,38967,186,2244,51381,14526,36855,51381,3674,0.02859033494871645,0.7298028454097818,0.0036200151807088223,0.28271150814503415,0.7172884918549658,0.04367373153500321
19250,17.0,1079,29049,30128,276,1823,39648,11247,28401,39648,2683,0.027214487489911218,0.7326725181598063,0.0069612590799031475,0.2836713075060533,0.7163286924939467,0.04597962066182405
19251,,326,16227,16553,71,502,21175,6343,14832,21175,1596,0.015395513577331758,0.7663282172373082,0.0033530106257378986,0.2995513577331759,0.7004486422668241,0.02370720188902007
19252,27.0,370,4550,4920,38,586,6969,1808,5161,6969,211,0.05309226574831396,0.6528913760941312,0.0054527191849619745,0.2594346391160855,0.7405653608839144,0.08408666953651887
19253,17.0,428,9949,10377,65,640,13989,3977,10012,13989,966,0.030595467867610266,0.7112016584459218,0.004646507970548288,0.2842948030595468,0.7157051969404532,0.04575023232539853
19254,,1289,12856,14145,53,741,19039,5526,13513,19039,1571,0.06770313566889018,0.6752455486107464,0.002783759651242187,0.29024633646725145,0.7097536635327486,0.03892011135038605
19255,35.0,93,3552,3645,4,190,4723,1362,3361,4723,362,0.019690874444209187,0.7520643658691509,0.0008469193309337286,0.28837603218293456,0.7116239678170654,0.04022866821935211
19256,15.0,1172,24867,26039,24,1408,34557,9979,24578,34557,2651,0.033914981045808375,0.7195937147321816,0.0006945047313134821,0.28876927974071825,0.7112307202592818,0.040744277570390945
19257,,945,7720,8665,40,823,12403,3288,9115,12403,743,0.07619124405385794,0.6224300572442151,0.0032250262033379023,0.26509715391437555,0.7349028460856244,0.06635491413367733
19258,17.0,31,2742,2773,10,156,3883,1074,2809,3883,232,0.007983517898532062,0.7061550347669328,0.0025753283543651817,0.2765902652588205,0.7234097347411795,0.040175122328096835
19259,,73,4417,4490,84,408,6190,1723,4467,6190,527,0.011793214862681745,0.7135702746365105,0.0135702746365105,0.27835218093699515,0.7216478190630048,0.06591276252019386
19260,17.0,9157,140972,150129,548,8706,204396,57401,146995,204396,14104,0.04480028963384802,0.6897003855261356,0.0026810700796493082,0.28083230591596703,0.7191676940840329,0.04259378852815124
19261,,699,19115,19814,47,1206,26016,7490,18526,26016,1675,0.02686808118081181,0.734740159901599,0.001806580565805658,0.28789975399754,0.71210024600246,0.046356088560885605
19262,24.0,76,2094,2170,5,82,2835,817,2018,2835,182,0.026807760141093474,0.7386243386243386,0.001763668430335097,0.28818342151675486,0.7118165784832452,0.02892416225749559
19263,15.0,446,5725,6171,41,498,8684,2337,6347,8684,535,0.05135882081989866,0.6592584062643942,0.004721326577614003,0.26911561492399816,0.7308843850760018,0.05734684477199447
19264,14.0,59,1430,1489,7,93,2040,525,1515,2040,182,0.02892156862745098,0.7009803921568627,0.003431372549019608,0.25735294117647056,0.7426470588235294,0.045588235294117645
19265,,72,1474,1546,21,53,2070,592,1478,2070,171,0.034782608695652174,0.7120772946859903,0.010144927536231883,0.28599033816425123,0.7140096618357488,0.025603864734299518
19266,,2009,53664,55673,347,2628,73735,21291,52444,73735,5387,0.02724621957008205,0.7277954838272191,0.0047060419068285075,0.2887502542890079,0.7112497457109921,0.0356411473520038
19267,,31494,401324,432818,7249,30415,587068,164438,422630,587068,36782,0.05364625562967152,0.6836073504261857,0.012347802980233977,0.28010043129586354,0.7198995687041365,0.051808308407203255
19268,26.0,107,3583,3690,74,177,5015,1438,3577,5015,376,0.021335992023928215,0.714456630109671,0.014755732801595214,0.2867397806580259,0.713260219341974,0.03529411764705882
19269,24.0,214,3290,3504,13,245,4756,1287,3469,4756,334,0.04499579478553406,0.691757779646762,0.0027333894028595458,0.270605550883095,0.729394449116905,0.0515138772077376
19270,,455,13301,13756,50,650,17882,5213,12669,17882,1336,0.025444581143048876,0.7438206017224024,0.002796107817917459,0.29152220109607424,0.7084777989039257,0.036349401632926964
19271,17.0,101,2325,2426,3,82,3101,920,2181,3101,219,0.03257013866494679,0.7497581425346662,0.0009674298613350532,0.29667849080941633,0.7033215091905837,0.026443082876491456
19272,,170,3670,3840,33,151,4958,1472,3486,4958,290,0.03428801936264623,0.7402178297700686,0.006655909640984268,0.29689390883420735,0.7031060911657927,0.03045582896329165
19273,17.0,947,19027,19974,106,1041,26799,7632,19167,26799,1902,0.035337139445501695,0.7099891787006978,0.003955371469084667,0.2847867457740961,0.715213254225904,0.03884473301242584
19274,15.0,161,7108,7269,31,705,10245,2698,7547,10245,756,0.015714982918496826,0.6938018545632015,0.0030258662762323086,0.26334797462176673,0.7366520253782333,0.06881405563689605
19275,,207,6341,6548,4,207,8628,2609,6019,8628,822,0.023991655076495134,0.7349327770050996,0.0004636068613815484,0.302387575336115,0.6976124246638851,0.023991655076495134
19276,,5092,113862,118954,780,5507,158310,44940,113370,158310,11988,0.032164740066957236,0.7192344134925147,0.004927041879855979,0.28387341292400986,0.7161265870759902,0.03478617901585497
19277,16.0,267,3048,3315,43,205,4474,1263,3211,4474,299,0.05967814036656236,0.681269557443004,0.009611086276262852,0.2822977201609298,0.7177022798390702,0.04582029503799732
19278,26.0,1496,17892,19388,160,998,26540,7446,19094,26540,1512,0.056367746797287115,0.6741522230595328,0.006028636021100226,0.2805576488319518,0.7194423511680482,0.03760361718161266
19279,25.0,3009,67082,70091,268,5172,94184,26426,67758,94184,6271,0.03194810158838019,0.7122441178968827,0.002845493926781619,0.28057844219825023,0.7194215578017498,0.05491378578102438
19280,23.0,1398,4464,5862,9,380,10850,1955,8895,10850,237,0.12884792626728112,0.4114285714285714,0.0008294930875576037,0.18018433179723503,0.819815668202765,0.035023041474654376
19281,16.0,245,4801,5046,11,414,6868,1922,4946,6868,441,0.03567268491555038,0.6990390215492137,0.001601630751310425,0.27984857309260336,0.7201514269073966,0.06027955736750146
19282,15.0,56,5187,5243,38,239,6954,1977,4977,6954,539,0.00805291918320391,0.7459016393442623,0.00546448087431694,0.2842968075927524,0.7157031924072477,0.034368708656888125
19283,25.0,76,2718,2794,2,107,3597,1045,2552,3597,246,0.0211287183764248,0.755629691409508,0.0005560189046427579,0.290519877675841,0.709480122324159,0.029747011398387545
19284,24.0,46,7722,7768,14,430,10366,2933,7433,10366,903,0.0044375844105730275,0.7449353656183677,0.0013505691684352692,0.2829442407871889,0.7170557592128111,0.041481767316226124
19285,23.0,65,3049,3114,28,363,4334,1204,3130,4334,318,0.014997692662667282,0.7035071527457314,0.006460544531610522,0.2778034148592524,0.7221965851407476,0.08375634517766498
19286,,386,9103,9489,16,419,12484,3586,8898,12484,933,0.030919577058635052,0.7291733418776033,0.001281640499839795,0.28724767702659404,0.712752322973406,0.03356296058955463
19287,23.0,106,2174,2280,4,134,4139,844,3295,4139,181,0.02561005073689297,0.5252476443585407,0.0009664170089393573,0.2039139888862044,0.7960860111137956,0.032374969799468474
19288,,477,10489,10966,57,435,14504,4126,10378,14504,1098,0.032887479316050745,0.7231798124655268,0.003929950358521787,0.28447324875896307,0.7155267512410369,0.02999172642029785
19289,26.0,11130,207509,218639,1519,8587,291070,82602,208468,291070,19315,0.03823822448208335,0.7129178548115573,0.0052186759198818156,0.28378740509155875,0.7162125949084412,0.029501494485862506
19290,24.0,296,9320,9616,18,614,13823,3615,10208,13823,672,0.021413586052231787,0.6742385878608117,0.0013021775302032843,0.26152065398249297,0.7384793460175071,0.04441872241915648
19291,16.0,409,2864,3273,1,265,4695,1229,3466,4695,300,0.0871139510117146,0.610010649627263,0.00021299254526091586,0.2617678381256656,0.7382321618743344,0.05644302449414271
19292,,725,16798,17523,63,1086,23509,6542,16967,23509,1565,0.03083925305202263,0.714534858990174,0.002679824747968863,0.2782764047811476,0.7217235952188523,0.04619507422689183
19293,13.0,5364,73138,78502,620,4653,106882,29655,77227,106882,6855,0.05018618663572912,0.6842873449224378,0.005800789655882188,0.2774555116857843,0.7225444883142157,0.043533990756161
19294,24.0,2559,73248,75807,190,2350,98009,27695,70314,98009,7523,0.026109847054862308,0.7473599363323776,0.0019385974757420237,0.28257608995092287,0.7174239100490771,0.023977389831546084
19295,33.0,100,2266,2366,10,86,3220,895,2325,3220,288,0.031055900621118012,0.7037267080745342,0.003105590062111801,0.2779503105590062,0.7220496894409938,0.02670807453416149
19296,,1508,57518,59026,244,4631,79569,22487,57082,79569,6616,0.018952104462793298,0.7228694592115019,0.003066520881247722,0.2826100617074489,0.7173899382925512,0.0582010582010582
19297,13.0,18,1682,1700,7,477,2720,646,2074,2720,155,0.006617647058823529,0.6183823529411765,0.002573529411764706,0.2375,0.7625,0.17536764705882352
19298,,1571,19304,20875,96,938,27584,7899,19685,27584,2094,0.05695330626450116,0.6998259860788864,0.0034802784222737818,0.2863616589327146,0.7136383410672854,0.03400522041763341
19299,27.0,1,6945,6946,10,397,9262,2572,6690,9262,804,0.00010796804145972792,0.7498380479378104,0.0010796804145972792,0.27769380263442023,0.7223061973655798,0.042863312459511985
19300,,135,7623,7758,29,274,10215,2991,7224,10215,920,0.013215859030837005,0.7462555066079295,0.002838962310327949,0.2928046989720999,0.7071953010279002,0.026823299069995105
19301,39.0,5820,131582,137402,2387,6855,185062,52084,132978,185062,13623,0.03144891982146524,0.7110157676886665,0.012898380002377582,0.28144081442975866,0.7185591855702413,0.03704164009899385
19302,17.0,657,18959,19616,26,1215,26196,7446,18750,26196,1976,0.025080164910673386,0.7237364483127195,0.000992517941670484,0.2842418689876317,0.7157581310123683,0.046381126889601464
19303,,219,5034,5253,43,239,7049,1998,5051,7049,530,0.03106823662930912,0.7141438501915165,0.006100156050503618,0.28344446020712155,0.7165555397928784,0.033905518513264295
19304,,1018,29784,30802,106,1729,40527,11375,29152,40527,2720,0.025119056431514793,0.7349174624324525,0.002615540257112542,0.28067707947787895,0.7193229205221211,0.0426629160806376
19305,,1740,3251,4991,29,257,6688,1919,4769,6688,296,0.26016746411483255,0.4860944976076555,0.004336124401913876,0.2869318181818182,0.7130681818181818,0.03842703349282297
19306,,267,3162,3429,0,204,6530,1134,5396,6530,270,0.040888208269525265,0.48422664624808576,0.0,0.17366003062787136,0.8263399693721286,0.03124042879019908
19307,14.0,121,3930,4051,9,239,5524,1513,4011,5524,481,0.021904417089065896,0.7114409847936278,0.0016292541636495294,0.27389572773352644,0.7261042722664736,0.043265749456915276
19308,23.0,214,5217,5431,28,257,7160,2045,5115,7160,548,0.02988826815642458,0.7286312849162011,0.003910614525139665,0.2856145251396648,0.7143854748603352,0.03589385474860335
19309,24.0,665,5907,6572,14,432,12212,2128,10084,12212,302,0.05445463478545693,0.48370455289878805,0.0011464133639043563,0.17425483131346217,0.8257451686865378,0.03537504094333443
19310,24.0,116,1880,1996,11,204,2756,763,1993,2756,177,0.0420899854862119,0.6821480406386067,0.0039912917271407835,0.2768505079825834,0.7231494920174165,0.07402031930333818
19311,,438,10056,10494,67,473,14054,3986,10068,14054,1209,0.03116550448270955,0.715525828945496,0.004767326028177032,0.2836203216166216,0.7163796783833783,0.033655898676533375
19312,,81,4803,4884,37,221,6517,1829,4688,6517,516,0.012429031763081173,0.7369955500997392,0.005677458953506215,0.2806506061071045,0.7193493938928955,0.03391130888445604
19313,39.0,5055,104273,109328,931,5629,145162,42037,103125,145162,10171,0.034823163086758244,0.7183215993166255,0.0064135242005483525,0.28958680646450174,0.7104131935354983,0.03877736597732189
19314,,899,13991,14890,36,489,19259,5436,13823,19259,1415,0.046679474531387925,0.7264655485746924,0.0018692559322913962,0.2822576457760008,0.7177423542239991,0.0253907264136248
19315,17.0,62,3504,3566,18,599,5379,1328,4051,5379,296,0.011526306004833613,0.6514221974344674,0.0033463469046291134,0.24688603829708125,0.7531139617029188,0.11135898865960216
19316,,1442,21165,22607,378,1582,31623,8323,23300,31623,1487,0.045599721721531795,0.6692913385826772,0.0119533251114695,0.2631945103247636,0.7368054896752364,0.050026879170224206
19317,24.0,473,50083,50556,112,3999,69402,18490,50912,69402,5461,0.006815365551425031,0.7216362640846085,0.0016137863462148065,0.2664188351920694,0.7335811648079306,0.05762081784386617
19318,,609,22661,23270,147,920,30942,8853,22089,30942,2831,0.019681985650572036,0.7323702410962446,0.004750824122551871,0.286115958890828,0.713884041109172,0.02973304893025661
19319,15.0,131,6173,6304,25,479,8736,2382,6354,8736,725,0.014995421245421246,0.7066163003663004,0.0028617216117216115,0.27266483516483514,0.7273351648351648,0.05483058608058608
19320,,265,3960,4225,29,228,5646,1553,4093,5646,383,0.046935883811548,0.7013815090329437,0.005136379737867517,0.27506199078993976,0.7249380092100602,0.040382571732199786
